"","ensembl_gene_id","chromosome_name","start_position","end_position","length"
"1","Ocbimv22010443m.g","KQ427389",85681,85875,194
"2","Ocbimv22014735m.g","KQ429053",9067,9363,296
"3","Ocbimv22008886m.g","KQ426791",702273,710732,8459
"4","Ocbimv22037287m.g","KQ422990",39719,39979,260
"5","Ocbimv22034326m.g","KQ422016",79104,82364,3260
"6","Ocbimv22033040m.g","KQ416466",437025,439861,2836
"7","Ocbimv22028072m.g","KQ416246",31672,42219,10547
"8","Ocbimv22037795m.g","KQ423136",19118,20460,1342
"9","Ocbimv22025249m.g","KQ419745",288326,288502,176
"10","Ocbimv22009214m.g","KQ417575",8934,36456,27522
"11","Ocbimv22023696m.g","KQ416093",22453,22635,182
"12","Ocbimv22038051m.g","KQ423209",111112,111282,170
"13","Ocbimv22008960m.g","KQ426820",75066,75341,275
"14","Ocbimv22035282m.g","KQ422349",135955,172317,36362
"15","Ocbimv22028507m.g","KQ416259",652512,652883,371
"16","Ocbimv22029119m.g","KQ420660",61633,70990,9357
"17","Ocbimv22002861m.g","KQ424808",19643,26132,6489
"18","Ocbimv22038799m.g","KQ423465",136679,136915,236
"19","Ocbimv22014287m.g","KQ428855",22623,24134,1511
"20","Ocbimv22012235m.g","KQ417892",214081,215304,1223
"21","Ocbimv22007914m.g","KQ417459",322406,322982,576
"22","Ocbimv22018422m.g","LGKD01643114",1,494,493
"23","Ocbimv22016233m.g","KQ429763",33927,40523,6596
"24","Ocbimv22011209m.g","KQ417763",34084,35952,1868
"25","Ocbimv22022122m.g","KQ419175",242333,242536,203
"26","Ocbimv22023712m.g","KQ419463",9791,9991,200
"27","Ocbimv22001223m.g","KQ424229",479139,479309,170
"28","Ocbimv22034469m.g","KQ422050",763934,771405,7471
"29","Ocbimv22011538m.g","KQ427775",42867,43189,322
"30","Ocbimv22000826m.g","KQ424081",327700,331259,3559
"31","Ocbimv22019250m.g","KQ431068",108492,108848,356
"32","Ocbimv22016260m.g","KQ418333",326751,328845,2094
"33","Ocbimv22021770m.g","KQ419098",229442,276318,46876
"34","Ocbimv22023557m.g","KQ419432",104529,104821,292
"35","Ocbimv22007001m.g","KQ417370",176264,178205,1941
"36","Ocbimv22024948m.g","KQ419660",480214,508000,27786
"37","Ocbimv22025922m.g","KQ419927",1427115,1427519,404
"38","Ocbimv22031756m.g","KQ421338",434062,434382,320
"39","Ocbimv22039477m.g","KQ423675",228485,257238,28753
"40","Ocbimv22003974m.g","KQ425163",14171,72898,58727
"41","Ocbimv22011909m.g","KQ427949",127710,144390,16680
"42","Ocbimv22034686m.g","KQ416547",68248,73442,5194
"43","Ocbimv22009911m.g","KQ427153",17666,27108,9442
"44","Ocbimv22035757m.g","KQ422527",95445,96456,1011
"45","Ocbimv22018448m.g","KQ415992",571882,572609,727
"46","Ocbimv22002748m.g","KQ417032",262769,264606,1837
"47","Ocbimv22039969m.g","KQ415773",106719,107234,515
"48","Ocbimv22020375m.g","KQ418900",571317,574400,3083
"49","Ocbimv22022865m.g","KQ416078",31252,33802,2550
"50","Ocbimv22007358m.g","KQ426312",151030,151531,501
"51","Ocbimv22003571m.g","KQ417092",4984,5602,618
"52","Ocbimv22008486m.g","KQ426647",292462,292713,251
"53","Ocbimv22024654m.g","KQ419607",252914,253429,515
"54","Ocbimv22028644m.g","KQ420545",33897,41645,7748
"55","Ocbimv22013115m.g","KQ428371",79704,88763,9059
"56","Ocbimv22006434m.g","KQ417319",14006,18927,4921
"57","Ocbimv22026295m.g","KQ420023",331261,343695,12434
"58","Ocbimv22027784m.g","KQ420372",393267,393599,332
"59","Ocbimv22033894m.g","KQ421902",418443,423529,5086
"60","Ocbimv22025086m.g","KQ416137",438581,442490,3909
"61","Ocbimv22022256m.g","KQ419190",140068,140310,242
"62","Ocbimv22021052m.g","KQ431971",6089,10864,4775
"63","Ocbimv22039138m.g","KQ423548",79380,91496,12116
"64","Ocbimv22035777m.g","KQ416600",580868,583542,2674
"65","Ocbimv22021498m.g","KQ419059",329780,330476,696
"66","Ocbimv22004624m.g","KQ417184",414295,414869,574
"67","Ocbimv22016760m.g","KQ418393",149422,150077,655
"68","Ocbimv22020681m.g","KQ418950",88149,88989,840
"69","Ocbimv22001013m.g","KQ424151",289222,289470,248
"70","Ocbimv22018066m.g","KQ418561",337391,337558,167
"71","Ocbimv22015035m.g","KQ418194",669485,671140,1655
"72","Ocbimv22029750m.g","KQ415712",596197,598429,2232
"73","Ocbimv22007149m.g","KQ426214",372825,373650,825
"74","Ocbimv22018123m.g","KQ430572",498219,558449,60230
"75","Ocbimv22006889m.g","KQ426135",83495,83914,419
"76","Ocbimv22017279m.g","KQ418475",251633,252367,734
"77","Ocbimv22009164m.g","KQ417567",83208,84142,934
"78","Ocbimv22002260m.g","KQ424589",104325,105974,1649
"79","Ocbimv22024358m.g","KQ419574",475974,480848,4874
"80","Ocbimv22014463m.g","KQ415931",14703,15074,371
"81","Ocbimv22027301m.g","KQ416220",658314,658517,203
"82","Ocbimv22025099m.g","KQ416137",481529,484588,3059
"83","Ocbimv22023724m.g","KQ416094",967488,980057,12569
"84","Ocbimv22039310m.g","KQ416788",19587,23747,4160
"85","Ocbimv22010258m.g","KQ415873",299907,300263,356
"86","Ocbimv22034834m.g","KQ422189",151301,226050,74749
"87","Ocbimv22013039m.g","KQ428349",350221,367979,17758
"88","Ocbimv22028265m.g","KQ415659",1806049,1806450,401
"89","Ocbimv22038494m.g","KQ423377",261,4854,4593
"90","Ocbimv22027295m.g","KQ416218",292686,402817,110131
"91","Ocbimv22008691m.g","KQ426737",5082,10057,4975
"92","Ocbimv22032655m.g","KQ421628",90656,157913,67257
"93","Ocbimv22003319m.g","KQ417080",28681,29357,676
"94","Ocbimv22011171m.g","KQ417756",118908,130980,12072
"95","Ocbimv22003313m.g","KQ417079",9437,57527,48090
"96","Ocbimv22006715m.g","KQ426075",566271,586767,20496
"97","Ocbimv22037642m.g","KQ423089",2628,8507,5879
"98","Ocbimv22003302m.g","KQ424947",1849,2079,230
"99","Ocbimv22037157m.g","KQ416678",364848,365462,614
"100","Ocbimv22032321m.g","KQ421523",253655,286413,32758
"101","Ocbimv22027883m.g","KQ420387",286772,292872,6100
"102","Ocbimv22012212m.g","KQ415904",194347,196109,1762
"103","Ocbimv22011547m.g","KQ417799",17591,23636,6045
"104","Ocbimv22012540m.g","KQ417917",845556,855214,9658
"105","Ocbimv22030465m.g","KQ420992",151809,163809,12000
"106","Ocbimv22027122m.g","KQ420194",54711,55614,903
"107","Ocbimv22006540m.g","KQ425992",321098,322562,1464
"108","Ocbimv22002585m.g","LGKD01513537",50,599,549
"109","Ocbimv22026706m.g","KQ420096",186126,212821,26695
"110","Ocbimv22019963m.g","KQ418839",216494,247288,30794
"111","Ocbimv22028859m.g","KQ420593",595727,602376,6649
"112","Ocbimv22020833m.g","KQ418970",1742853,1802536,59683
"113","Ocbimv22027840m.g","KQ420375",1384539,1399461,14922
"114","Ocbimv22015929m.g","KQ418303",1031133,1066396,35263
"115","Ocbimv22001170m.g","KQ424211",37882,39488,1606
"116","Ocbimv22002624m.g","KQ417023",765304,765943,639
"117","Ocbimv22027745m.g","KQ420357",14293,15153,860
"118","Ocbimv22021316m.g","KQ419028",227160,229178,2018
"119","Ocbimv22015648m.g","LGKD01620134",76,1529,1453
"120","Ocbimv22037891m.g","KQ423146",41932,65018,23086
"121","Ocbimv22003947m.g","LGKD01526236",339,1241,902
"122","Ocbimv22017521m.g","KQ418504",98923,108746,9823
"123","Ocbimv22035480m.g","KQ422401",114099,150110,36011
"124","Ocbimv22009652m.g","KQ427059",479184,553798,74614
"125","Ocbimv22025592m.g","KQ419857",202585,244350,41765
"126","Ocbimv22034359m.g","KQ422019",422256,422429,173
"127","Ocbimv22003813m.g","KQ417113",470248,475574,5326
"128","Ocbimv22001953m.g","KQ416976",74148,74686,538
"129","Ocbimv22016616m.g","KQ418370",270921,271253,332
"130","Ocbimv22036748m.g","KQ422849",125031,144477,19446
"131","Ocbimv22001700m.g","KQ424387",276502,309182,32680
"132","Ocbimv22016626m.g","KQ415967",225026,225487,461
"133","Ocbimv22028361m.g","KQ420477",378020,379522,1502
"134","Ocbimv22001995m.g","KQ416979",1016189,1037869,21680
"135","Ocbimv22038414m.g","KQ423329",47336,48428,1092
"136","Ocbimv22017048m.g","KQ418444",401822,419276,17454
"137","Ocbimv22039585m.g","KQ423712",212234,241278,29044
"138","Ocbimv22032876m.g","KQ416454",220811,223520,2709
"139","Ocbimv22000002m.g","KQ423819",103062,103370,308
"140","Ocbimv22004851m.g","KQ415809",106183,106722,539
"141","Ocbimv22013190m.g","KQ428420",204187,206197,2010
"142","Ocbimv22007226m.g","KQ426253",95788,99734,3946
"143","Ocbimv22009385m.g","KQ426987",2068,18754,16686
"144","Ocbimv22016012m.g","KQ418310",117439,171149,53710
"145","Ocbimv22033216m.g","KQ421758",87808,97387,9579
"146","Ocbimv22025275m.g","KQ416147",11267,12449,1182
"147","Ocbimv22000790m.g","KQ424066",58436,58756,320
"148","Ocbimv22026939m.g","KQ420146",146891,210537,63646
"149","Ocbimv22024874m.g","KQ419644",219626,219787,161
"150","Ocbimv22022156m.g","LGKD01675762",23,313,290
"151","Ocbimv22022746m.g","KQ416074",760794,779625,18831
"152","Ocbimv22030317m.g","KQ420947",10865,15127,4262
"153","Ocbimv22003279m.g","KQ424933",198159,198575,416
"154","Ocbimv22005292m.g","KQ425571",135607,145022,9415
"155","Ocbimv22021750m.g","KQ419094",216017,216325,308
"156","Ocbimv22021298m.g","KQ419026",288325,288940,615
"157","Ocbimv22015652m.g","KQ418272",26442,26717,275
"158","Ocbimv22005815m.g","KQ417280",20185,26263,6078
"159","Ocbimv22009707m.g","KQ427096",332,926,594
"160","Ocbimv22030731m.g","KQ421080",26237,55335,29098
"161","Ocbimv22002352m.g","KQ424643",51856,52266,410
"162","Ocbimv22004039m.g","KQ425190",75970,76212,242
"163","Ocbimv22007822m.g","KQ417454",97374,97739,365
"164","Ocbimv22007894m.g","KQ426484",161909,163292,1383
"165","Ocbimv22039540m.g","KQ423702",17976,40771,22795
"166","Ocbimv22033980m.g","KQ415733",24455,24856,401
"167","Ocbimv22007033m.g","KQ417370",623905,624201,296
"168","Ocbimv22017847m.g","KQ418552",150988,171491,20503
"169","Ocbimv22021276m.g","KQ416041",568456,571589,3133
"170","Ocbimv22024945m.g","KQ419660",244544,245776,1232
"171","Ocbimv22015082m.g","KQ418194",1558957,1563934,4977
"172","Ocbimv22012269m.g","KQ417897",542664,631847,89183
"173","Ocbimv22031273m.g","KQ416392",8870,16765,7895
"174","Ocbimv22026181m.g","KQ420011",128340,129479,1139
"175","Ocbimv22009259m.g","KQ417578",885431,893477,8046
"176","Ocbimv22023957m.g","KQ419507",115267,160817,45550
"177","Ocbimv22004029m.g","KQ425190",24825,28168,3343
"178","Ocbimv22002173m.g","KQ416993",13791,16171,2380
"179","Ocbimv22003433m.g","KQ417087",937922,943682,5760
"180","Ocbimv22014484m.g","KQ418140",473877,474344,467
"181","Ocbimv22023619m.g","LGKD01690941",125,292,167
"182","Ocbimv22001807m.g","KQ424425",580782,635620,54838
"183","Ocbimv22028043m.g","KQ416244",166667,184083,17416
"184","Ocbimv22024913m.g","KQ416131",934690,946981,12291
"185","Ocbimv22011810m.g","KQ415893",382146,496110,113964
"186","Ocbimv22033213m.g","KQ421754",109176,135100,25924
"187","Ocbimv22027692m.g","KQ416231",5332,21390,16058
"188","Ocbimv22015435m.g","KQ418245",117747,118076,329
"189","Ocbimv22039164m.g","KQ415770",29458,30417,959
"190","Ocbimv22021873m.g","KQ419115",44872,45219,347
"191","Ocbimv22020367m.g","KQ418900",477105,483081,5976
"192","Ocbimv22017361m.g","KQ418485",10710,11075,365
"193","Ocbimv22011211m.g","KQ417763",52688,104095,51407
"194","Ocbimv22026281m.g","KQ420022",636143,643853,7710
"195","Ocbimv22007217m.g","KQ426253",19406,24365,4959
"196","Ocbimv22012449m.g","LGKD01595455",13,915,902
"197","Ocbimv22029051m.g","KQ420635",19023,20403,1380
"198","Ocbimv22020155m.g","KQ418863",346174,361132,14958
"199","Ocbimv22018434m.g","KQ415992",90449,96693,6244
"200","Ocbimv22021435m.g","KQ419049",46592,52346,5754
"201","Ocbimv22022838m.g","LGKD01291934",1,377,376
"202","Ocbimv22021517m.g","LGKD01669010",23,142,119
"203","Ocbimv22032039m.g","KQ421412",8057,140770,132713
"204","Ocbimv22027862m.g","KQ416235",24078,46288,22210
"205","Ocbimv22031595m.g","KQ421288",7116,8424,1308
"206","Ocbimv22016447m.g","KQ415965",368799,368978,179
"207","Ocbimv22016769m.g","KQ418395",163517,163759,242
"208","Ocbimv22006413m.g","KQ425905",88465,89029,564
"209","Ocbimv22002339m.g","KQ415791",255610,256983,1373
"210","Ocbimv22019153m.g","KQ418723",321484,342576,21092
"211","Ocbimv22039724m.g","KQ416816",332538,346113,13575
"212","Ocbimv22013611m.g","KQ418039",231001,232789,1788
"213","Ocbimv22033553m.g","KQ421830",57408,91009,33601
"214","Ocbimv22014379m.g","KQ418124",52378,104592,52214
"215","Ocbimv22025494m.g","KQ419821",1599,2012,413
"216","Ocbimv22022979m.g","KQ419333",101151,136904,35753
"217","Ocbimv22035492m.g","KQ422407",122419,122952,533
"218","Ocbimv22024411m.g","KQ419577",205233,261323,56090
"219","Ocbimv22023989m.g","KQ419514",520225,606554,86329
"220","Ocbimv22033111m.g","KQ421731",14775,44824,30049
"221","Ocbimv22001085m.g","KQ416908",579760,580416,656
"222","Ocbimv22027853m.g","KQ420377",133669,136622,2953
"223","Ocbimv22014411m.g","KQ418129",233800,242081,8281
"224","Ocbimv22014608m.g","KQ429007",21226,27145,5919
"225","Ocbimv22013489m.g","KQ415916",316286,316507,221
"226","Ocbimv22010964m.g","KQ427571",64484,66934,2450
"227","Ocbimv22038240m.g","KQ423245",163467,187881,24414
"228","Ocbimv22028150m.g","KQ420439",214,5729,5515
"229","Ocbimv22035797m.g","KQ422556",31859,32029,170
"230","Ocbimv22032547m.g","KQ421582",65084,69413,4329
"231","Ocbimv22037623m.g","KQ415761",440459,486643,46184
"232","Ocbimv22025157m.g","KQ419713",94603,94950,347
"233","Ocbimv22021970m.g","KQ432478",479,968,489
"234","Ocbimv22023592m.g","KQ433494",6543,7001,458
"235","Ocbimv22010787m.g","KQ427521",223416,242813,19397
"236","Ocbimv22007623m.g","KQ417438",626599,628723,2124
"237","Ocbimv22037022m.g","KQ422909",183676,189876,6200
"238","Ocbimv22020415m.g","KQ431670",12988,50504,37516
"239","Ocbimv22032262m.g","KQ421506",50970,66996,16026
"240","Ocbimv22034725m.g","LGKD01430844",2,295,293
"241","Ocbimv22022045m.g","KQ419152",100256,114125,13869
"242","Ocbimv22029303m.g","KQ420701",9577,76182,66605
"243","Ocbimv22002365m.g","KQ424650",88623,94332,5709
"244","Ocbimv22026660m.g","KQ420089",133286,133957,671
"245","Ocbimv22011039m.g","KQ417740",175557,196576,21019
"246","Ocbimv22006125m.g","KQ417300",144890,152963,8073
"247","Ocbimv22031539m.g","KQ421270",148767,153153,4386
"248","Ocbimv22005364m.g","KQ425596",368011,368857,846
"249","Ocbimv22017659m.g","KQ418525",125030,135687,10657
"250","Ocbimv22024043m.g","KQ419525",96319,96928,609
"251","Ocbimv22000307m.g","KQ416853",23797,37427,13630
"252","Ocbimv22026579m.g","KQ416193",602946,619810,16864
"253","Ocbimv22034378m.g","KQ422021",471260,539371,68111
"254","Ocbimv22019437m.g","KQ418767",170135,193935,23800
"255","Ocbimv22031070m.g","KQ416384",17144,17302,158
"256","Ocbimv22013014m.g","KQ417972",354233,374975,20742
"257","Ocbimv22032371m.g","KQ416430",21238,29041,7803
"258","Ocbimv22022960m.g","KQ416079",233079,234361,1282
"259","Ocbimv22038540m.g","KQ423395",25773,30379,4606
"260","Ocbimv22036696m.g","KQ416653",131422,131697,275
"261","Ocbimv22033923m.g","KQ421906",626245,630392,4147
"262","Ocbimv22010703m.g","KQ417704",46109,55557,9448
"263","Ocbimv22015064m.g","KQ418194",1191438,1264579,73141
"264","Ocbimv22036429m.g","KQ422761",137234,237121,99887
"265","Ocbimv22013477m.g","KQ418026",278136,278799,663
"266","Ocbimv22026647m.g","KQ420085",326608,327510,902
"267","Ocbimv22033435m.g","KQ421810",218908,219515,607
"268","Ocbimv22023165m.g","KQ419366",117557,121752,4195
"269","Ocbimv22038503m.g","KQ423383",5095,5759,664
"270","Ocbimv22008178m.g","KQ417481",1957773,1994091,36318
"271","Ocbimv22039105m.g","KQ416779",449422,449950,528
"272","Ocbimv22025553m.g","KQ419838",99432,99923,491
"273","Ocbimv22001634m.g","KQ416950",611154,661565,50411
"274","Ocbimv22002351m.g","KQ424643",18066,19237,1171
"275","Ocbimv22037715m.g","KQ423110",211835,211990,155
"276","Ocbimv22020314m.g","KQ431600",34944,35671,727
"277","Ocbimv22023942m.g","KQ416106",427886,431381,3495
"278","Ocbimv22038223m.g","KQ416731",670364,674271,3907
"279","Ocbimv22006334m.g","KQ425878",90499,93508,3009
"280","Ocbimv22001115m.g","KQ424184",21283,29607,8324
"281","Ocbimv22036238m.g","KQ416626",1165844,1166449,605
"282","Ocbimv22036966m.g","KQ416666",2177454,2178157,703
"283","Ocbimv22029264m.g","KQ420696",7565,13521,5956
"284","Ocbimv22032591m.g","KQ421603",79052,105816,26764
"285","Ocbimv22039368m.g","KQ423633",602674,607074,4400
"286","Ocbimv22029001m.g","KQ416279",319931,338793,18862
"287","Ocbimv22037525m.g","KQ423058",17337,19194,1857
"288","Ocbimv22013835m.g","KQ418066",110675,143763,33088
"289","Ocbimv22026737m.g","KQ416198",335472,338945,3473
"290","Ocbimv22033611m.g","KQ421847",77290,78581,1291
"291","Ocbimv22031948m.g","KQ421389",41185,43020,1835
"292","Ocbimv22032835m.g","KQ421664",1330455,1344159,13704
"293","Ocbimv22023322m.g","KQ419393",109873,115697,5824
"294","Ocbimv22002674m.g","KQ424735",172396,172699,303
"295","Ocbimv22018991m.g","KQ418708",496738,497208,470
"296","Ocbimv22016975m.g","KQ418431",315209,324730,9521
"297","Ocbimv22018465m.g","LGKD01643250",297,470,173
"298","Ocbimv22038797m.g","KQ423465",39247,39799,552
"299","Ocbimv22037423m.g","KQ416694",2769833,2778925,9092
"300","Ocbimv22037842m.g","KQ423139",487295,504249,16954
"301","Ocbimv22013122m.g","KQ428379",478,25844,25366
"302","Ocbimv22016149m.g","KQ418322",528669,530607,1938
"303","Ocbimv22011857m.g","KQ427927",112244,112950,706
"304","Ocbimv22006740m.g","KQ417345",466988,475683,8695
"305","Ocbimv22037311m.g","KQ416685",18341,18532,191
"306","Ocbimv22034945m.g","KQ422223",21327,22763,1436
"307","Ocbimv22026450m.g","KQ420052",195211,195773,562
"308","Ocbimv22022666m.g","KQ419279",48133,48603,470
"309","Ocbimv22038599m.g","KQ423414",138331,139116,785
"310","Ocbimv22033331m.g","KQ421780",186623,187689,1066
"311","Ocbimv22017033m.g","KQ418441",302683,303096,413
"312","Ocbimv22020732m.g","KQ418957",268350,371892,103542
"313","Ocbimv22022046m.g","KQ419152",141809,142648,839
"314","Ocbimv22011839m.g","KQ417836",179011,179341,330
"315","Ocbimv22002144m.g","KQ415788",1024266,1027905,3639
"316","Ocbimv22016219m.g","KQ418328",531497,531799,302
"317","Ocbimv22018185m.g","KQ415989",100345,100992,647
"318","Ocbimv22003478m.g","KQ425015",720392,767923,47531
"319","Ocbimv22019382m.g","KQ431105",40157,40498,341
"320","Ocbimv22037140m.g","KQ422938",122399,123936,1537
"321","Ocbimv22015397m.g","KQ429320",41142,139713,98571
"322","Ocbimv22029131m.g","KQ420662",3423,3584,161
"323","Ocbimv22021815m.g","KQ419108",369885,370088,203
"324","Ocbimv22018920m.g","KQ430924",329752,342660,12908
"325","Ocbimv22019007m.g","KQ418710",1399296,1399580,284
"326","Ocbimv22004401m.g","KQ415804",69346,82402,13056
"327","Ocbimv22021118m.g","KQ432015",33636,55952,22316
"328","Ocbimv22025463m.g","KQ419808",17,26998,26981
"329","Ocbimv22023136m.g","KQ419355",31813,32160,347
"330","Ocbimv22019431m.g","LGKD01650749",82,591,509
"331","Ocbimv22002780m.g","KQ424779",412747,414465,1718
"332","Ocbimv22032758m.g","KQ421655",198667,199321,654
"333","Ocbimv22015485m.g","KQ418261",68325,77233,8908
"334","Ocbimv22018056m.g","KQ430541",85178,86038,860
"335","Ocbimv22004337m.g","KQ417149",585879,614454,28575
"336","Ocbimv22021397m.g","KQ432116",58865,59287,422
"337","Ocbimv22011720m.g","KQ417826",11569,13569,2000
"338","Ocbimv22010749m.g","KQ427497",3530,5157,1627
"339","Ocbimv22028907m.g","KQ416274",1282132,1329229,47097
"340","Ocbimv22024507m.g","KQ419590",815233,819247,4014
"341","Ocbimv22033221m.g","KQ421758",180873,182505,1632
"342","Ocbimv22007815m.g","KQ426461",353238,356104,2866
"343","Ocbimv22031376m.g","KQ416393",421206,421394,188
"344","Ocbimv22014002m.g","KQ418075",715046,724213,9167
"345","Ocbimv22013279m.g","KQ418007",15692,16846,1154
"346","Ocbimv22032373m.g","KQ416430",175524,176141,617
"347","Ocbimv22001608m.g","KQ416947",32657,34374,1717
"348","Ocbimv22036261m.g","KQ416628",24995,28613,3618
"349","Ocbimv22013231m.g","KQ418002",564051,565190,1139
"350","Ocbimv22029827m.g","KQ420828",957112,960776,3664
"351","Ocbimv22038305m.g","KQ423274",188231,207372,19141
"352","Ocbimv22011182m.g","KQ427664",3311,4544,1233
"353","Ocbimv22032879m.g","KQ421671",832,4125,3293
"354","Ocbimv22018280m.g","KQ418590",434988,450544,15556
"355","Ocbimv22018679m.g","KQ415684",875224,875565,341
"356","Ocbimv22039630m.g","KQ416810",1000383,1038119,37736
"357","Ocbimv22009475m.g","KQ417596",730266,730833,567
"358","Ocbimv22024727m.g","KQ419621",1332902,1334735,1833
"359","Ocbimv22013571m.g","KQ418038",170713,198146,27433
"360","Ocbimv22037215m.g","KQ422966",62752,63964,1212
"361","Ocbimv22003840m.g","KQ425128",532564,562845,30281
"362","Ocbimv22009001m.g","KQ417549",262117,273067,10950
"363","Ocbimv22037067m.g","KQ416671",128771,129598,827
"364","Ocbimv22029748m.g","KQ415712",503946,504401,455
"365","Ocbimv22031957m.g","KQ421389",348891,349453,562
"366","Ocbimv22029228m.g","KQ416294",240734,276783,36049
"367","Ocbimv22028653m.g","KQ420545",150236,156835,6599
"368","Ocbimv22002006m.g","KQ424511",82790,83029,239
"369","Ocbimv22001866m.g","KQ416971",501062,512815,11753
"370","Ocbimv22033589m.g","KQ421839",339583,363030,23447
"371","Ocbimv22028467m.g","KQ420496",164027,186640,22613
"372","Ocbimv22028200m.g","KQ420444",61523,128515,66992
"373","Ocbimv22006963m.g","KQ426167",43108,46001,2893
"374","Ocbimv22028691m.g","KQ420556",74087,74278,191
"375","Ocbimv22038074m.g","KQ423212",17669,18528,859
"376","Ocbimv22028601m.g","KQ416263",676639,687793,11154
"377","Ocbimv22001192m.g","KQ424219",465323,465796,473
"378","Ocbimv22016475m.g","KQ415966",308392,309131,739
"379","Ocbimv22038513m.g","KQ423384",33997,52943,18946
"380","Ocbimv22019498m.g","LGKD01651430",62,286,224
"381","Ocbimv22004242m.g","KQ417143",274160,322064,47904
"382","Ocbimv22011467m.g","KQ417793",94189,134812,40623
"383","Ocbimv22009089m.g","LGKD01173056",25,2233,2208
"384","Ocbimv22002863m.g","KQ424808",127846,128241,395
"385","Ocbimv22004581m.g","KQ425371",71349,112600,41251
"386","Ocbimv22001722m.g","KQ416957",16472,18268,1796
"387","Ocbimv22033781m.g","KQ421871",226806,232354,5548
"388","Ocbimv22012471m.g","KQ417913",26018,44724,18706
"389","Ocbimv22006629m.g","LGKD01548321",48,1623,1575
"390","Ocbimv22004142m.g","KQ417140",58954,61575,2621
"391","Ocbimv22014267m.g","KQ428837",6709,8652,1943
"392","Ocbimv22032083m.g","KQ421430",109490,109762,272
"393","Ocbimv22012225m.g","KQ415905",859731,875820,16089
"394","Ocbimv22023643m.g","KQ419449",46390,46722,332
"395","Ocbimv22025189m.g","KQ419727",16567,24978,8411
"396","Ocbimv22004860m.g","LGKD01533344",399,551,152
"397","Ocbimv22005149m.g","KQ425525",91493,161383,69890
"398","Ocbimv22026362m.g","KQ420033",154383,155415,1032
"399","Ocbimv22024685m.g","KQ419615",368004,368957,953
"400","Ocbimv22026746m.g","KQ416198",509092,512053,2961
"401","Ocbimv22006425m.g","KQ425918",1119,23175,22056
"402","Ocbimv22029892m.g","KQ420838",289809,322089,32280
"403","Ocbimv22014215m.g","KQ418101",232883,235628,2745
"404","Ocbimv22005712m.g","KQ425728",10188,12175,1987
"405","Ocbimv22016778m.g","KQ430015",37193,109368,72175
"406","Ocbimv22013306m.g","KQ418009",359555,384933,25378
"407","Ocbimv22023586m.g","KQ433487",36356,63635,27279
"408","Ocbimv22039876m.g","KQ416832",300509,320989,20480
"409","Ocbimv22033267m.g","KQ421758",1809032,1810527,1495
"410","Ocbimv22005948m.g","KQ417285",137774,138064,290
"411","Ocbimv22012959m.g","KQ417961",8024,19387,11363
"412","Ocbimv22031085m.g","LGKD01387411",3,524,521
"413","Ocbimv22019188m.g","KQ431041",72757,94497,21740
"414","Ocbimv22014950m.g","KQ429139",602308,602535,227
"415","Ocbimv22006214m.g","KQ417304",200534,209386,8852
"416","Ocbimv22024244m.g","KQ419552",5616,17689,12073
"417","Ocbimv22011743m.g","KQ427887",68803,119990,51187
"418","Ocbimv22039169m.g","KQ423559",36477,42332,5855
"419","Ocbimv22013353m.g","KQ428460",52298,53144,846
"420","Ocbimv22005053m.g","KQ417227",29043,30346,1303
"421","Ocbimv22039413m.g","KQ423651",1507114,1526349,19235
"422","Ocbimv22017027m.g","KQ418438",197789,198906,1117
"423","Ocbimv22002994m.g","KQ424859",162685,187138,24453
"424","Ocbimv22023149m.g","KQ419360",145549,147828,2279
"425","Ocbimv22008573m.g","KQ417510",198391,198540,149
"426","Ocbimv22032120m.g","KQ421453",217972,230149,12177
"427","Ocbimv22032664m.g","KQ421628",285616,286219,603
"428","Ocbimv22026319m.g","KQ420026",19832,69541,49709
"429","Ocbimv22033388m.g","KQ416479",616148,637821,21673
"430","Ocbimv22018188m.g","KQ415990",123425,123997,572
"431","Ocbimv22012541m.g","KQ417917",861534,861716,182
"432","Ocbimv22014140m.g","KQ428774",123343,123981,638
"433","Ocbimv22015953m.g","KQ418303",1692606,1693756,1150
"434","Ocbimv22020857m.g","KQ418971",3721,20922,17201
"435","Ocbimv22008839m.g","KQ417537",170617,171027,410
"436","Ocbimv22027319m.g","KQ420258",363347,363499,152
"437","Ocbimv22033783m.g","KQ421871",288869,309173,20304
"438","Ocbimv22016049m.g","KQ429676",3,66096,66093
"439","Ocbimv22019852m.g","KQ418821",884690,886478,1788
"440","Ocbimv22036643m.g","KQ422818",104201,104836,635
"441","Ocbimv22010040m.g","KQ417633",323561,323719,158
"442","Ocbimv22032515m.g","KQ421570",91375,104967,13592
"443","Ocbimv22036608m.g","KQ422804",279667,280222,555
"444","Ocbimv22038615m.g","KQ423415",90747,91274,527
"445","Ocbimv22002336m.g","KQ424634",15082,15975,893
"446","Ocbimv22023481m.g","KQ419416",61007,64352,3345
"447","Ocbimv22005160m.g","LGKD01535723",1208,2266,1058
"448","Ocbimv22038462m.g","KQ416744",21461,21688,227
"449","Ocbimv22026435m.g","KQ420052",2495,2791,296
"450","Ocbimv22038071m.g","LGKD01466316",202,345,143
"451","Ocbimv22019050m.g","KQ418711",1220281,1230968,10687
"452","Ocbimv22039499m.g","KQ423678",23240,25011,1771
"453","Ocbimv22038566m.g","KQ423405",24284,25957,1673
"454","Ocbimv22037191m.g","KQ422962",36993,43853,6860
"455","Ocbimv22004594m.g","KQ417182",409195,409800,605
"456","Ocbimv22012395m.g","KQ417910",129513,154430,24917
"457","Ocbimv22039704m.g","KQ416815",18917,41573,22656
"458","Ocbimv22003291m.g","KQ424938",47761,79662,31901
"459","Ocbimv22025413m.g","KQ419794",42261,49872,7611
"460","Ocbimv22016518m.g","KQ418364",95940,104473,8533
"461","Ocbimv22021987m.g","KQ419141",195099,203965,8866
"462","Ocbimv22006719m.g","KQ415834",119854,137439,17585
"463","Ocbimv22010298m.g","KQ417666",230324,237974,7650
"464","Ocbimv22015261m.g","KQ418216",538345,543088,4743
"465","Ocbimv22034525m.g","KQ422069",112858,113902,1044
"466","Ocbimv22031196m.g","KQ415723",100725,101063,338
"467","Ocbimv22015083m.g","KQ418194",1576966,1599733,22767
"468","Ocbimv22004299m.g","KQ417147",87542,87727,185
"469","Ocbimv22009487m.g","KQ415865",115718,127214,11496
"470","Ocbimv22019645m.g","KQ418789",611841,615711,3870
"471","Ocbimv22020550m.g","KQ418923",28938,29369,431
"472","Ocbimv22027158m.g","KQ416211",15576,46179,30603
"473","Ocbimv22020263m.g","KQ431563",125888,126313,425
"474","Ocbimv22034445m.g","KQ422045",9519,23010,13491
"475","Ocbimv22020593m.g","KQ418929",51061,81966,30905
"476","Ocbimv22001882m.g","KQ424459",283364,306458,23094
"477","Ocbimv22026143m.g","KQ420004",27234,33163,5929
"478","Ocbimv22014705m.g","KQ418168",600505,601876,1371
"479","Ocbimv22034857m.g","KQ416560",31279,31548,269
"480","Ocbimv22010541m.g","KQ417688",241220,241839,619
"481","Ocbimv22036404m.g","KQ416641",59146,60194,1048
"482","Ocbimv22000388m.g","KQ423944",12027,33988,21961
"483","Ocbimv22016935m.g","KQ418425",16397,18057,1660
"484","Ocbimv22008984m.g","KQ426828",2001,58128,56127
"485","Ocbimv22017852m.g","KQ418552",224178,233329,9151
"486","Ocbimv22022958m.g","KQ416079",199676,205605,5929
"487","Ocbimv22028139m.g","KQ416251",1267379,1307963,40584
"488","Ocbimv22022352m.g","KQ419203",121713,122170,457
"489","Ocbimv22016144m.g","KQ418322",336637,337131,494
"490","Ocbimv22005335m.g","KQ417245",98862,99836,974
"491","Ocbimv22033339m.g","KQ421785",61927,62109,182
"492","Ocbimv22032315m.g","KQ421523",185897,207344,21447
"493","Ocbimv22011828m.g","KQ415893",1043948,1076509,32561
"494","Ocbimv22038845m.g","KQ415768",95550,106188,10638
"495","Ocbimv22017788m.g","KQ418545",59781,80844,21063
"496","Ocbimv22033803m.g","KQ421873",250321,327653,77332
"497","Ocbimv22019169m.g","KQ418726",644556,646546,1990
"498","Ocbimv22036665m.g","KQ422824",25441,28932,3491
"499","Ocbimv22035406m.g","KQ422367",337180,344154,6974
"500","Ocbimv22015018m.g","KQ418194",304392,368222,63830
"501","Ocbimv22021107m.g","KQ419007",200937,202327,1390
"502","Ocbimv22005133m.g","KQ415813",1319094,1330738,11644
"503","Ocbimv22026941m.g","KQ420146",220969,279282,58313
"504","Ocbimv22030904m.g","KQ421117",1355238,1356908,1670
"505","Ocbimv22016017m.g","KQ418310",598891,601200,2309
"506","Ocbimv22028394m.g","KQ416257",746635,747120,485
"507","Ocbimv22011170m.g","KQ417756",93076,93894,818
"508","Ocbimv22017287m.g","KQ418476",340586,341729,1143
"509","Ocbimv22036487m.g","KQ422777",1964,14717,12753
"510","Ocbimv22015824m.g","KQ418295",166974,168056,1082
"511","Ocbimv22014525m.g","KQ415932",1224404,1267734,43330
"512","Ocbimv22021312m.g","KQ419027",222976,223173,197
"513","Ocbimv22018880m.g","KQ430914",109179,149392,40213
"514","Ocbimv22035320m.g","KQ422351",614176,614967,791
"515","Ocbimv22031498m.g","LGKD01392683",38,223,185
"516","Ocbimv22022751m.g","KQ432985",5415,66265,60850
"517","Ocbimv22022423m.g","KQ419216",42653,48237,5584
"518","Ocbimv22038047m.g","KQ416722",49423,59199,9776
"519","Ocbimv22000938m.g","KQ424123",85774,86420,646
"520","Ocbimv22009730m.g","KQ417607",18929,19960,1031
"521","Ocbimv22008385m.g","LGKD01562201",3,828,825
"522","Ocbimv22022039m.g","KQ419150",19624,66444,46820
"523","Ocbimv22000940m.g","KQ416897",41296,112141,70845
"524","Ocbimv22018099m.g","KQ430572",16513,18069,1556
"525","Ocbimv22011394m.g","KQ417791",967438,968082,644
"526","Ocbimv22013237m.g","KQ418003",135445,136468,1023
"527","Ocbimv22020486m.g","KQ418919",446706,447207,501
"528","Ocbimv22015601m.g","KQ415946",822218,827066,4848
"529","Ocbimv22013472m.g","KQ428524",147946,167228,19282
"530","Ocbimv22012714m.g","KQ417929",161755,175549,13794
"531","Ocbimv22019138m.g","LGKD01648403",214,741,527
"532","Ocbimv22019282m.g","KQ418740",778658,791101,12443
"533","Ocbimv22024140m.g","KQ419539",13591,28750,15159
"534","Ocbimv22019738m.g","KQ418810",109774,109926,152
"535","Ocbimv22036903m.g","KQ422894",162985,165129,2144
"536","Ocbimv22013690m.g","KQ428611",97524,105781,8257
"537","Ocbimv22009839m.g","KQ417620",690618,691149,531
"538","Ocbimv22034975m.g","KQ422233",268556,268750,194
"539","Ocbimv22022519m.g","KQ419239",571239,572427,1188
"540","Ocbimv22035808m.g","KQ422557",23775,25703,1928
"541","Ocbimv22033336m.g","KQ421784",93190,143542,50352
"542","Ocbimv22020505m.g","KQ418919",671682,680824,9142
"543","Ocbimv22025774m.g","KQ416166",1566288,1566506,218
"544","Ocbimv22011797m.g","KQ427906",80768,81149,381
"545","Ocbimv22034188m.g","KQ421998",24866,25186,320
"546","Ocbimv22014559m.g","KQ418153",75153,76275,1122
"547","Ocbimv22021767m.g","KQ419098",113845,114702,857
"548","Ocbimv22021047m.g","KQ418997",366369,387793,21424
"549","Ocbimv22000979m.g","KQ424142",116580,169325,52745
"550","Ocbimv22034488m.g","KQ422061",139419,139712,293
"551","Ocbimv22037553m.g","KQ423061",57798,58043,245
"552","Ocbimv22003219m.g","KQ417064",142260,177207,34947
"553","Ocbimv22036513m.g","KQ422783",76695,81037,4342
"554","Ocbimv22009080m.g","KQ426865",34650,36290,1640
"555","Ocbimv22001888m.g","KQ424459",1295598,1301455,5857
"556","Ocbimv22006751m.g","KQ417347",185310,185480,170
"557","Ocbimv22001613m.g","KQ416949",291739,292068,329
"558","Ocbimv22020368m.g","KQ418900",483340,483903,563
"559","Ocbimv22034182m.g","KQ416518",503256,569981,66725
"560","Ocbimv22002677m.g","LGKD01514168",192,350,158
"561","Ocbimv22026009m.g","KQ419953",4093,23654,19561
"562","Ocbimv22021302m.g","KQ419026",596432,596857,425
"563","Ocbimv22003334m.g","LGKD01520874",5,412,407
"564","Ocbimv22012658m.g","KQ417923",632734,646784,14050
"565","Ocbimv22023292m.g","LGKD01687670",41,211,170
"566","Ocbimv22032292m.g","KQ421514",337834,338121,287
"567","Ocbimv22029072m.g","KQ420642",122086,122932,846
"568","Ocbimv22010521m.g","KQ417686",863478,864020,542
"569","Ocbimv22000656m.g","KQ424040",3213,29068,25855
"570","Ocbimv22033389m.g","KQ416479",629772,630080,308
"571","Ocbimv22025252m.g","KQ419748",29389,47294,17905
"572","Ocbimv22019225m.g","KQ431062",10772,11059,287
"573","Ocbimv22000081m.g","KQ416839",929,30603,29674
"574","Ocbimv22025452m.g","KQ419807",13386,14616,1230
"575","Ocbimv22038169m.g","LGKD01467082",1,369,368
"576","Ocbimv22008910m.g","KQ417538",202279,224282,22003
"577","Ocbimv22014292m.g","KQ418115",138499,140701,2202
"578","Ocbimv22007556m.g","KQ417425",82350,82667,317
"579","Ocbimv22031251m.g","KQ421206",551334,561745,10411
"580","Ocbimv22022547m.g","KQ432838",7347,22536,15189
"581","Ocbimv22002648m.g","KQ417023",1455133,1480872,25739
"582","Ocbimv22019724m.g","KQ431280",71513,72268,755
"583","Ocbimv22007614m.g","KQ417438",141288,156630,15342
"584","Ocbimv22007309m.g","KQ426287",263343,263679,336
"585","Ocbimv22016689m.g","KQ429962",905,1870,965
"586","Ocbimv22038469m.g","KQ423354",329277,332400,3123
"587","Ocbimv22001591m.g","KQ424366",37217,37411,194
"588","Ocbimv22037453m.g","KQ423031",156702,157323,621
"589","Ocbimv22000043m.g","KQ423834",88069,97172,9103
"590","Ocbimv22035716m.g","KQ422521",177222,186848,9626
"591","Ocbimv22035798m.g","KQ422556",33943,35938,1995
"592","Ocbimv22033987m.g","KQ421938",137358,142120,4762
"593","Ocbimv22025502m.g","KQ419824",166052,166777,725
"594","Ocbimv22011012m.g","KQ427587",177700,202889,25189
"595","Ocbimv22037359m.g","KQ423013",66297,77464,11167
"596","Ocbimv22001213m.g","KQ424229",278438,285953,7515
"597","Ocbimv22033557m.g","KQ421830",126375,146580,20205
"598","Ocbimv22031634m.g","KQ421305",143999,216756,72757
"599","Ocbimv22010980m.g","KQ417730",183137,183901,764
"600","Ocbimv22031886m.g","KQ421372",259225,260212,987
"601","Ocbimv22000797m.g","KQ424071",115891,118034,2143
"602","Ocbimv22026278m.g","KQ420022",627267,633495,6228
"603","Ocbimv22023605m.g","KQ416092",263443,264276,833
"604","Ocbimv22021546m.g","KQ419075",14059,14475,416
"605","Ocbimv22021814m.g","KQ419108",200316,200624,308
"606","Ocbimv22031971m.g","KQ421391",13018,13437,419
"607","Ocbimv22015631m.g","KQ418269",934247,934420,173
"608","Ocbimv22015094m.g","KQ418194",2359587,2422061,62474
"609","Ocbimv22015669m.g","KQ429463",12899,13301,402
"610","Ocbimv22002072m.g","KQ424530",1247585,1250429,2844
"611","Ocbimv22012211m.g","LGKD01593797",21,212,191
"612","Ocbimv22001810m.g","KQ424429",29688,65727,36039
"613","Ocbimv22012735m.g","KQ417931",1641400,1641567,167
"614","Ocbimv22039438m.g","KQ423667",3247,6044,2797
"615","Ocbimv22028660m.g","KQ420545",227455,228006,551
"616","Ocbimv22022375m.g","KQ419208",591002,591373,371
"617","Ocbimv22031799m.g","KQ421350",29956,31458,1502
"618","Ocbimv22032724m.g","KQ421646",25831,26169,338
"619","Ocbimv22001566m.g","KQ415665",54707,55891,1184
"620","Ocbimv22002564m.g","KQ415793",1656908,1713778,56870
"621","Ocbimv22007915m.g","KQ417459",370304,412732,42428
"622","Ocbimv22007508m.g","KQ417417",216452,229984,13532
"623","Ocbimv22032368m.g","KQ421524",71277,80912,9635
"624","Ocbimv22023950m.g","KQ419506",72069,72878,809
"625","Ocbimv22009604m.g","KQ427052",35908,41454,5546
"626","Ocbimv22009380m.g","KQ426986",46876,66144,19268
"627","Ocbimv22034420m.g","KQ416530",334371,338159,3788
"628","Ocbimv22005515m.g","KQ417259",29472,29820,348
"629","Ocbimv22001559m.g","KQ424356",203469,203678,209
"630","Ocbimv22006375m.g","KQ425899",2128,2852,724
"631","Ocbimv22012901m.g","KQ417950",49577,62407,12830
"632","Ocbimv22002924m.g","KQ424848",45030,48637,3607
"633","Ocbimv22038253m.g","KQ423250",371263,386110,14847
"634","Ocbimv22018661m.g","KQ418651",253163,253601,438
"635","Ocbimv22033893m.g","KQ421901",146080,146604,524
"636","Ocbimv22000578m.g","KQ424000",151639,152238,599
"637","Ocbimv22025868m.g","KQ419916",227013,232730,5717
"638","Ocbimv22000983m.g","KQ424142",246228,351120,104892
"639","Ocbimv22011885m.g","KQ417845",83955,84251,296
"640","Ocbimv22019946m.g","KQ418838",491853,529432,37579
"641","Ocbimv22021274m.g","KQ416041",406583,406903,320
"642","Ocbimv22006790m.g","KQ426107",91025,103817,12792
"643","Ocbimv22039620m.g","KQ416810",393792,395445,1653
"644","Ocbimv22008412m.g","KQ426634",172062,172427,365
"645","Ocbimv22000625m.g","KQ416870",85516,117140,31624
"646","Ocbimv22038201m.g","KQ416731",338875,339138,263
"647","Ocbimv22035043m.g","KQ415746",76433,77479,1046
"648","Ocbimv22034885m.g","KQ422208",204888,206718,1830
"649","Ocbimv22012062m.g","KQ417858",239880,242095,2215
"650","Ocbimv22030678m.g","KQ421059",100763,101100,337
"651","Ocbimv22025428m.g","KQ419797",308966,309169,203
"652","Ocbimv22037698m.g","KQ423101",130139,130417,278
"653","Ocbimv22004998m.g","KQ415811",213756,225503,11747
"654","Ocbimv22036773m.g","KQ422855",172,2070,1898
"655","Ocbimv22004859m.g","LGKD01533295",349,814,465
"656","Ocbimv22026642m.g","KQ420085",143137,152786,9649
"657","Ocbimv22013569m.g","KQ418038",148097,154528,6431
"658","Ocbimv22011160m.g","KQ427657",3049,5006,1957
"659","Ocbimv22006469m.g","KQ417324",565634,565900,266
"660","Ocbimv22014289m.g","KQ418115",654,15958,15304
"661","Ocbimv22012558m.g","KQ417917",1199865,1201785,1920
"662","Ocbimv22023093m.g","LGKD01685587",40,240,200
"663","Ocbimv22020694m.g","KQ418954",447147,452078,4931
"664","Ocbimv22026080m.g","KQ419989",97738,98030,292
"665","Ocbimv22003908m.g","KQ425147",2057,2331,274
"666","Ocbimv22012261m.g","KQ417896",66123,67289,1166
"667","Ocbimv22035528m.g","KQ422420",126481,130052,3571
"668","Ocbimv22018338m.g","KQ430665",169532,177500,7968
"669","Ocbimv22014271m.g","KQ418112",42397,56040,13643
"670","Ocbimv22017603m.g","KQ415979",195587,206391,10804
"671","Ocbimv22013166m.g","KQ417996",115594,126045,10451
"672","Ocbimv22025827m.g","KQ419909",359957,360158,201
"673","Ocbimv22029224m.g","KQ416293",85363,87387,2024
"674","Ocbimv22000068m.g","KQ423846",9896,102904,93008
"675","Ocbimv22012607m.g","KQ417921",103832,162191,58359
"676","Ocbimv22034932m.g","KQ416562",201479,202465,986
"677","Ocbimv22017674m.g","KQ430413",90,23688,23598
"678","Ocbimv22011901m.g","KQ427949",4104,5462,1358
"679","Ocbimv22002939m.g","KQ424851",165916,166149,233
"680","Ocbimv22036126m.g","KQ422647",183064,186516,3452
"681","Ocbimv22012451m.g","KQ428165",48887,56103,7216
"682","Ocbimv22004878m.g","KQ417211",442505,443161,656
"683","Ocbimv22022579m.g","KQ419265",206053,217436,11383
"684","Ocbimv22030216m.g","KQ420924",335896,347447,11551
"685","Ocbimv22007762m.g","KQ415847",929748,961323,31575
"686","Ocbimv22029422m.g","KQ420747",279931,280236,305
"687","Ocbimv22019941m.g","KQ418838",225450,226175,725
"688","Ocbimv22022211m.g","KQ416062",30564,30740,176
"689","Ocbimv22018380m.g","LGKD01642829",108,671,563
"690","Ocbimv22021938m.g","KQ432442",1521,2228,707
"691","Ocbimv22031128m.g","KQ415721",64488,68558,4070
"692","Ocbimv22023499m.g","KQ433424",15556,21776,6220
"693","Ocbimv22031007m.g","KQ416382",52154,61518,9364
"694","Ocbimv22006991m.g","KQ417370",73129,76015,2886
"695","Ocbimv22001377m.g","KQ416929",461014,461355,341
"696","Ocbimv22005022m.g","KQ417224",206000,209449,3449
"697","Ocbimv22030303m.g","KQ420942",183065,209802,26737
"698","Ocbimv22007161m.g","KQ417386",525056,525235,179
"699","Ocbimv22022632m.g","KQ432932",339142,354846,15704
"700","Ocbimv22011771m.g","KQ415891",369463,371104,1641
"701","Ocbimv22010931m.g","KQ417725",291692,304104,12412
"702","Ocbimv22012598m.g","LGKD01595903",2896,3123,227
"703","Ocbimv22017740m.g","KQ418536",439541,439765,224
"704","Ocbimv22005691m.g","KQ417274",13617,14231,614
"705","Ocbimv22014577m.g","KQ428994",91188,101423,10235
"706","Ocbimv22009672m.g","KQ427065",25,8083,8058
"707","Ocbimv22017187m.g","LGKD01633652",412,762,350
"708","Ocbimv22021573m.g","KQ432240",22061,63356,41295
"709","Ocbimv22034233m.g","KQ416526",332848,353421,20573
"710","Ocbimv22032444m.g","KQ416431",122696,133319,10623
"711","Ocbimv22023069m.g","KQ433195",4992,15159,10167
"712","Ocbimv22007350m.g","KQ415841",367917,368571,654
"713","Ocbimv22019154m.g","KQ418723",378301,388288,9987
"714","Ocbimv22022677m.g","KQ419280",387764,522154,134390
"715","Ocbimv22021251m.g","KQ419020",89000,99709,10709
"716","Ocbimv22019597m.g","KQ418789",336408,337788,1380
"717","Ocbimv22011647m.g","KQ427830",237258,238611,1353
"718","Ocbimv22016145m.g","KQ418322",341495,385978,44483
"719","Ocbimv22029964m.g","KQ420861",20580,21123,543
"720","Ocbimv22013663m.g","KQ418043",5742,14111,8369
"721","Ocbimv22000121m.g","KQ416841",385665,386361,696
"722","Ocbimv22001848m.g","KQ424449",2817,3871,1054
"723","Ocbimv22002961m.g","KQ417051",1183474,1192200,8726
"724","Ocbimv22011645m.g","KQ427830",205350,254314,48964
"725","Ocbimv22008522m.g","LGKD01563085",41,451,410
"726","Ocbimv22026696m.g","KQ420095",17064,24425,7361
"727","Ocbimv22039352m.g","KQ423630",81143,82501,1358
"728","Ocbimv22007112m.g","KQ417379",239901,240713,812
"729","Ocbimv22038270m.g","KQ416733",344348,345697,1349
"730","Ocbimv22001020m.g","KQ424157",255229,281410,26181
"731","Ocbimv22009739m.g","KQ417609",339141,339984,843
"732","Ocbimv22026897m.g","KQ420138",379655,379846,191
"733","Ocbimv22005360m.g","KQ425596",180607,210453,29846
"734","Ocbimv22027228m.g","KQ420222",603079,604338,1259
"735","Ocbimv22014337m.g","KQ418120",56192,59112,2920
"736","Ocbimv22012202m.g","KQ417888",117221,117436,215
"737","Ocbimv22005667m.g","KQ417272",59370,133316,73946
"738","Ocbimv22032346m.g","KQ421523",1290325,1290501,176
"739","Ocbimv22023405m.g","KQ419401",250429,250777,348
"740","Ocbimv22003957m.g","KQ425160",293328,293919,591
"741","Ocbimv22000913m.g","KQ424114",11195,26319,15124
"742","Ocbimv22024487m.g","KQ416124",706962,717014,10052
"743","Ocbimv22007574m.g","KQ417430",1066295,1066951,656
"744","Ocbimv22030791m.g","KQ416370",72717,73040,323
"745","Ocbimv22015285m.g","KQ429244",15784,91408,75624
"746","Ocbimv22016698m.g","KQ429968",85460,107809,22349
"747","Ocbimv22018227m.g","KQ415990",2081297,2100828,19531
"748","Ocbimv22037316m.g","KQ416685",556362,556583,221
"749","Ocbimv22003741m.g","KQ425080",43149,43415,266
"750","Ocbimv22027800m.g","KQ416233",550077,551164,1087
"751","Ocbimv22019723m.g","KQ431280",70073,70243,170
"752","Ocbimv22035005m.g","KQ422243",24315,26655,2340
"753","Ocbimv22019746m.g","KQ431294",7963,97977,90014
"754","Ocbimv22038863m.g","KQ416769",299585,299833,248
"755","Ocbimv22011067m.g","LGKD01584468",39,263,224
"756","Ocbimv22030318m.g","KQ420947",12573,14874,2301
"757","Ocbimv22026442m.g","KQ420052",90173,131803,41630
"758","Ocbimv22022292m.g","KQ419192",748291,782487,34196
"759","Ocbimv22032927m.g","KQ421685",183611,184365,754
"760","Ocbimv22013225m.g","KQ418002",418846,427027,8181
"761","Ocbimv22000409m.g","KQ423958",40511,41186,675
"762","Ocbimv22013720m.g","KQ428621",236971,237321,350
"763","Ocbimv22030373m.g","KQ420966",294141,315888,21747
"764","Ocbimv22033713m.g","KQ416493",126785,127838,1053
"765","Ocbimv22038293m.g","KQ423264",34363,34563,200
"766","Ocbimv22013931m.g","KQ418072",63424,63804,380
"767","Ocbimv22026012m.g","KQ419957",11402,11927,525
"768","Ocbimv22039653m.g","KQ416811",257888,272181,14293
"769","Ocbimv22025330m.g","KQ419775",38692,50281,11589
"770","Ocbimv22017894m.g","KQ418555",404192,404398,206
"771","Ocbimv22015295m.g","KQ429255",134691,136410,1719
"772","Ocbimv22014473m.g","KQ418139",358912,359115,203
"773","Ocbimv22002135m.g","KQ415788",692981,699609,6628
"774","Ocbimv22013716m.g","KQ428621",81754,82155,401
"775","Ocbimv22036012m.g","KQ422632",371389,371910,521
"776","Ocbimv22018647m.g","KQ418649",508287,528926,20639
"777","Ocbimv22019750m.g","KQ431294",183020,183571,551
"778","Ocbimv22017531m.g","KQ430341",4841,5170,329
"779","Ocbimv22008880m.g","KQ426791",613829,615534,1705
"780","Ocbimv22039511m.g","KQ423680",235537,239050,3513
"781","Ocbimv22025998m.g","KQ419951",70520,70819,299
"782","Ocbimv22035642m.g","KQ422485",24074,25118,1044
"783","Ocbimv22011511m.g","KQ417796",705460,706067,607
"784","Ocbimv22007927m.g","KQ417460",40885,41139,254
"785","Ocbimv22005889m.g","KQ425749",2252,2857,605
"786","Ocbimv22023404m.g","KQ419401",236934,247198,10264
"787","Ocbimv22027141m.g","KQ420199",120735,121883,1148
"788","Ocbimv22034430m.g","KQ422036",317280,317447,167
"789","Ocbimv22022943m.g","KQ419327",30238,30444,206
"790","Ocbimv22020457m.g","KQ416029",251682,252605,923
"791","Ocbimv22011863m.g","KQ427941",16974,75832,58858
"792","Ocbimv22031702m.g","KQ421322",93228,93377,149
"793","Ocbimv22009211m.g","KQ417574",1499531,1499827,296
"794","Ocbimv22022029m.g","KQ419149",248574,314226,65652
"795","Ocbimv22020234m.g","KQ431552",2331,6630,4299
"796","Ocbimv22001841m.g","KQ416969",1034095,1034343,248
"797","Ocbimv22028876m.g","KQ420596",2513,18446,15933
"798","Ocbimv22005710m.g","LGKD01540866",539,1697,1158
"799","Ocbimv22016164m.g","KQ429719",95536,117990,22454
"800","Ocbimv22039321m.g","KQ416788",118129,118711,582
"801","Ocbimv22034674m.g","KQ416547",6598,12320,5722
"802","Ocbimv22014922m.g","KQ418187",603332,619991,16659
"803","Ocbimv22021710m.g","LGKD01670448",366,479,113
"804","Ocbimv22015658m.g","KQ418273",57029,57635,606
"805","Ocbimv22016065m.g","KQ415952",301425,338019,36594
"806","Ocbimv22017829m.g","KQ430486",100609,107165,6556
"807","Ocbimv22030970m.g","KQ416379",587619,589637,2018
"808","Ocbimv22018584m.g","KQ418642",201856,250333,48477
"809","Ocbimv22026202m.g","KQ420016",309653,310431,778
"810","Ocbimv22031673m.g","KQ421308",208870,209634,764
"811","Ocbimv22012263m.g","KQ417896",114331,114825,494
"812","Ocbimv22038099m.g","KQ423214",129795,144107,14312
"813","Ocbimv22019979m.g","KQ418840",467061,468044,983
"814","Ocbimv22023360m.g","KQ419395",213735,217072,3337
"815","Ocbimv22024462m.g","KQ433994",7995,8489,494
"816","Ocbimv22020768m.g","KQ418961",93771,94597,826
"817","Ocbimv22032109m.g","KQ421451",136647,138180,1533
"818","Ocbimv22002414m.g","KQ417009",156945,157127,182
"819","Ocbimv22026935m.g","KQ416205",631597,638221,6624
"820","Ocbimv22036276m.g","KQ416628",1000446,1000850,404
"821","Ocbimv22025652m.g","KQ419877",22896,29691,6795
"822","Ocbimv22008857m.g","KQ426791",297480,307643,10163
"823","Ocbimv22035110m.g","KQ422282",33365,33532,167
"824","Ocbimv22000897m.g","LGKD01495929",195,347,152
"825","Ocbimv22008903m.g","KQ417538",179434,191754,12320
"826","Ocbimv22021057m.g","KQ431974",61580,68524,6944
"827","Ocbimv22028495m.g","KQ420512",53474,54474,1000
"828","Ocbimv22024792m.g","KQ419631",173360,189107,15747
"829","Ocbimv22032069m.g","KQ421417",168553,194864,26311
"830","Ocbimv22031313m.g","KQ421217",788712,942192,153480
"831","Ocbimv22009731m.g","KQ417608",19444,20370,926
"832","Ocbimv22005413m.g","KQ417249",2586058,2597012,10954
"833","Ocbimv22029407m.g","KQ420742",94921,134422,39501
"834","Ocbimv22025472m.g","KQ419810",121107,148102,26995
"835","Ocbimv22016655m.g","KQ418375",573310,593393,20083
"836","Ocbimv22025710m.g","KQ419887",946897,972194,25297
"837","Ocbimv22015689m.g","KQ429472",2103,10542,8439
"838","Ocbimv22008447m.g","KQ415854",81754,96236,14482
"839","Ocbimv22034238m.g","KQ422015",1,1609,1608
"840","Ocbimv22013678m.g","KQ418045",71044,89282,18238
"841","Ocbimv22023196m.g","KQ419368",620789,681759,60970
"842","Ocbimv22012144m.g","KQ417877",452984,544341,91357
"843","Ocbimv22000313m.g","KQ415776",230753,420748,189995
"844","Ocbimv22039944m.g","KQ423808",8600,45590,36990
"845","Ocbimv22033895m.g","KQ421904",55163,55360,197
"846","Ocbimv22038616m.g","KQ423415",144562,145188,626
"847","Ocbimv22032000m.g","KQ421409",831524,836707,5183
"848","Ocbimv22026610m.g","KQ420080",55951,67808,11857
"849","Ocbimv22025408m.g","KQ419790",86186,88769,2583
"850","Ocbimv22008695m.g","KQ426737",34152,38908,4756
"851","Ocbimv22000455m.g","KQ423968",201778,209181,7403
"852","Ocbimv22007215m.g","KQ426253",6800,10988,4188
"853","Ocbimv22001445m.g","KQ416933",461253,463539,2286
"854","Ocbimv22033635m.g","KQ421854",22084,22446,362
"855","Ocbimv22027814m.g","KQ420375",108382,108634,252
"856","Ocbimv22010058m.g","KQ427240",538,759,221
"857","Ocbimv22013211m.g","KQ418002",272575,276395,3820
"858","Ocbimv22013281m.g","KQ418007",78421,83837,5416
"859","Ocbimv22026728m.g","KQ416198",128554,136866,8312
"860","Ocbimv22027721m.g","KQ420347",278188,301392,23204
"861","Ocbimv22008933m.g","KQ426810",49116,50681,1565
"862","Ocbimv22006290m.g","KQ425859",139770,142242,2472
"863","Ocbimv22017394m.g","KQ418489",238073,257516,19443
"864","Ocbimv22021104m.g","KQ432009",64675,65183,508
"865","Ocbimv22024607m.g","KQ419601",1412311,1459192,46881
"866","Ocbimv22002407m.g","KQ424658",197972,201308,3336
"867","Ocbimv22017638m.g","KQ418520",138632,142507,3875
"868","Ocbimv22002864m.g","KQ417043",31485,33971,2486
"869","Ocbimv22015585m.g","KQ415946",73567,79569,6002
"870","Ocbimv22032310m.g","KQ421523",97049,121650,24601
"871","Ocbimv22021478m.g","KQ419056",20183,20344,161
"872","Ocbimv22022117m.g","KQ432608",2879,3124,245
"873","Ocbimv22037432m.g","KQ416694",3138481,3140157,1676
"874","Ocbimv22012745m.g","KQ417934",1043068,1043547,479
"875","Ocbimv22014048m.g","KQ428735",147032,226982,79950
"876","Ocbimv22002054m.g","KQ424530",216324,216614,290
"877","Ocbimv22022787m.g","KQ419298",68369,72350,3981
"878","Ocbimv22010017m.g","KQ427207",16966,41666,24700
"879","Ocbimv22012121m.g","KQ415902",19247,19471,224
"880","Ocbimv22032087m.g","KQ421434",149173,149460,287
"881","Ocbimv22019278m.g","KQ418740",370496,385225,14729
"882","Ocbimv22036167m.g","KQ422662",109141,201017,91876
"883","Ocbimv22037889m.g","KQ423146",10405,39744,29339
"884","Ocbimv22006684m.g","KQ417343",190783,208114,17331
"885","Ocbimv22005332m.g","KQ417243",191166,191411,245
"886","Ocbimv22008296m.g","KQ417495",271607,272059,452
"887","Ocbimv22034967m.g","KQ416565",2782,3051,269
"888","Ocbimv22018231m.g","KQ415990",2200711,2216817,16106
"889","Ocbimv22014132m.g","KQ428769",134394,134849,455
"890","Ocbimv22001538m.g","LGKD01503378",671,1111,440
"891","Ocbimv22017172m.g","KQ418459",356101,356361,260
"892","Ocbimv22037381m.g","KQ416694",797604,871240,73636
"893","Ocbimv22034351m.g","KQ422018",556,1778,1222
"894","Ocbimv22029167m.g","KQ420672",380687,393411,12724
"895","Ocbimv22025376m.g","KQ419786",164740,168275,3535
"896","Ocbimv22002837m.g","KQ417040",265811,273078,7267
"897","Ocbimv22007969m.g","KQ417466",1777806,1815807,38001
"898","Ocbimv22011747m.g","KQ417828",14840,25628,10788
"899","Ocbimv22012622m.g","KQ417921",1091299,1091655,356
"900","Ocbimv22036872m.g","KQ422887",72587,75470,2883
"901","Ocbimv22022403m.g","KQ419215",377693,404556,26863
"902","Ocbimv22021949m.g","KQ419137",255431,277055,21624
"903","Ocbimv22022766m.g","KQ419290",34480,41589,7109
"904","Ocbimv22038401m.g","KQ423321",52790,52990,200
"905","Ocbimv22026770m.g","KQ420112",235889,237694,1805
"906","Ocbimv22028091m.g","KQ416248",259183,260787,1604
"907","Ocbimv22038209m.g","KQ416731",594794,603869,9075
"908","Ocbimv22007176m.g","KQ426223",43377,59541,16164
"909","Ocbimv22020971m.g","LGKD01664037",870,1085,215
"910","Ocbimv22008051m.g","KQ426550",25977,60535,34558
"911","Ocbimv22018828m.g","KQ418685",60410,60568,158
"912","Ocbimv22008628m.g","KQ426707",45535,48836,3301
"913","Ocbimv22031149m.g","LGKD01075625",7,120,113
"914","Ocbimv22028718m.g","KQ416268",611635,614137,2502
"915","Ocbimv22039481m.g","KQ423675",328633,385490,56857
"916","Ocbimv22039915m.g","KQ423795",33305,40699,7394
"917","Ocbimv22032976m.g","KQ421705",367891,368073,182
"918","Ocbimv22030478m.g","KQ420993",33603,55942,22339
"919","Ocbimv22003822m.g","KQ415667",10623,10990,367
"920","Ocbimv22012851m.g","KQ417945",759049,787008,27959
"921","Ocbimv22033039m.g","KQ416466",435231,436201,970
"922","Ocbimv22021260m.g","KQ432063",91928,100948,9020
"923","Ocbimv22018049m.g","KQ430537",71435,71692,257
"924","Ocbimv22026424m.g","KQ420047",399854,400226,372
"925","Ocbimv22031975m.g","KQ416415",52376,68570,16194
"926","Ocbimv22038790m.g","KQ415767",65714,95576,29862
"927","Ocbimv22024183m.g","KQ419545",63248,65084,1836
"928","Ocbimv22005535m.g","KQ425649",25723,29385,3662
"929","Ocbimv22016321m.g","KQ418338",401312,415624,14312
"930","Ocbimv22007678m.g","KQ415846",22735,100804,78069
"931","Ocbimv22036319m.g","KQ415755",6821,10971,4150
"932","Ocbimv22020526m.g","KQ418922",203999,233628,29629
"933","Ocbimv22037098m.g","KQ422920",563657,564421,764
"934","Ocbimv22028879m.g","KQ420600",153141,211583,58442
"935","Ocbimv22038504m.g","KQ423383",5985,7422,1437
"936","Ocbimv22009423m.g","KQ417591",1382502,1383259,757
"937","Ocbimv22013795m.g","KQ418061",241703,243273,1570
"938","Ocbimv22035273m.g","KQ422349",43926,46345,2419
"939","Ocbimv22001670m.g","KQ424381",114414,117761,3347
"940","Ocbimv22012356m.g","KQ428130",98959,114146,15187
"941","Ocbimv22022218m.g","KQ416062",126040,128860,2820
"942","Ocbimv22031451m.g","KQ421252",9629,10165,536
"943","Ocbimv22030966m.g","KQ416379",49528,50640,1112
"944","Ocbimv22025391m.g","KQ419788",44455,46115,1660
"945","Ocbimv22029269m.g","KQ420696",281537,310723,29186
"946","Ocbimv22012823m.g","KQ428249",692,1766,1074
"947","Ocbimv22013348m.g","KQ428460",2749,3870,1121
"948","Ocbimv22032489m.g","KQ421555",79885,84808,4923
"949","Ocbimv22037292m.g","KQ422993",424054,424248,194
"950","Ocbimv22012812m.g","KQ417942",660597,667175,6578
"951","Ocbimv22001039m.g","KQ424158",9613,10288,675
"952","Ocbimv22035316m.g","KQ422351",585083,587331,2248
"953","Ocbimv22019693m.g","KQ418800",48170,57343,9173
"954","Ocbimv22014365m.g","KQ428883",223629,224019,390
"955","Ocbimv22033189m.g","KQ421747",42763,47904,5141
"956","Ocbimv22023662m.g","KQ419456",727996,730001,2005
"957","Ocbimv22002952m.g","KQ424852",107954,126763,18809
"958","Ocbimv22010032m.g","KQ415869",734709,735774,1065
"959","Ocbimv22029467m.g","KQ416308",329118,381483,52365
"960","Ocbimv22038315m.g","KQ423277",219,18899,18680
"961","Ocbimv22028075m.g","KQ416246",197892,198182,290
"962","Ocbimv22025488m.g","KQ419818",310910,330445,19535
"963","Ocbimv22021542m.g","KQ419073",70132,71688,1556
"964","Ocbimv22012902m.g","KQ428275",269,7096,6827
"965","Ocbimv22030644m.g","KQ421042",21479,21940,461
"966","Ocbimv22037779m.g","KQ416711",26542,26721,179
"967","Ocbimv22015104m.g","KQ418194",2782358,2783319,961
"968","Ocbimv22032404m.g","KQ421532",152692,173069,20377
"969","Ocbimv22006572m.g","KQ417336",1303186,1303368,182
"970","Ocbimv22028165m.g","KQ420439",293412,305106,11694
"971","Ocbimv22025378m.g","KQ419786",196411,196800,389
"972","Ocbimv22013525m.g","KQ428545",78017,92185,14168
"973","Ocbimv22010402m.g","KQ417676",368237,370084,1847
"974","Ocbimv22030092m.g","KQ420886",325424,326802,1378
"975","Ocbimv22017500m.g","KQ430326",6422,15636,9214
"976","Ocbimv22008909m.g","KQ417538",201281,201801,520
"977","Ocbimv22016751m.g","KQ429994",3342,33155,29813
"978","Ocbimv22037419m.g","KQ416694",2713163,2728614,15451
"979","Ocbimv22000634m.g","KQ416870",410251,410973,722
"980","Ocbimv22035473m.g","KQ422393",67738,73065,5327
"981","Ocbimv22004845m.g","KQ425444",33315,34109,794
"982","Ocbimv22029684m.g","KQ420800",38398,46101,7703
"983","Ocbimv22013645m.g","KQ418042",164749,201851,37102
"984","Ocbimv22012606m.g","KQ417921",92657,97808,5151
"985","Ocbimv22025489m.g","KQ419818",335722,362815,27093
"986","Ocbimv22001525m.g","KQ416941",167737,167958,221
"987","Ocbimv22009905m.g","KQ417622",560125,665917,105792
"988","Ocbimv22023309m.g","KQ416087",1147234,1148240,1006
"989","Ocbimv22004498m.g","KQ417173",843945,846874,2929
"990","Ocbimv22003823m.g","KQ415667",102315,144883,42568
"991","Ocbimv22037516m.g","KQ423056",273419,273934,515
"992","Ocbimv22020094m.g","KQ418852",94505,95518,1013
"993","Ocbimv22026463m.g","KQ420053",550377,551201,824
"994","Ocbimv22036664m.g","KQ422824",6413,6754,341
"995","Ocbimv22006591m.g","KQ426027",6843,12879,6036
"996","Ocbimv22017536m.g","KQ430344",39066,74898,35832
"997","Ocbimv22001190m.g","KQ424219",372158,372511,353
"998","Ocbimv22023730m.g","KQ433600",24461,25183,722
"999","Ocbimv22001186m.g","KQ424218",249136,249333,197
"1000","Ocbimv22014279m.g","KQ415926",37787,38845,1058
"1001","Ocbimv22038943m.g","KQ423493",347797,348015,218
"1002","Ocbimv22007227m.g","KQ426253",102398,103906,1508
"1003","Ocbimv22032969m.g","KQ421702",526650,526946,296
"1004","Ocbimv22027899m.g","KQ416239",220087,258279,38192
"1005","Ocbimv22034467m.g","KQ422050",750525,754508,3983
"1006","Ocbimv22021323m.g","KQ419029",175546,190379,14833
"1007","Ocbimv22000749m.g","KQ416878",168518,169520,1002
"1008","Ocbimv22035533m.g","KQ422422",596597,597984,1387
"1009","Ocbimv22019675m.g","KQ418796",153857,154670,813
"1010","Ocbimv22007683m.g","KQ415846",167072,172111,5039
"1011","Ocbimv22017367m.g","LGKD01634989",644,1389,745
"1012","Ocbimv22004485m.g","KQ425336",27807,30032,2225
"1013","Ocbimv22005434m.g","KQ417252",63166,67990,4824
"1014","Ocbimv22034055m.g","KQ416508",632339,635244,2905
"1015","Ocbimv22021714m.g","KQ419091",38051,40719,2668
"1016","Ocbimv22018155m.g","KQ418580",59385,60292,907
"1017","Ocbimv22025696m.g","KQ419887",61399,61735,336
"1018","Ocbimv22038499m.g","LGKD01472549",3,317,314
"1019","Ocbimv22030513m.g","KQ421009",698301,698546,245
"1020","Ocbimv22016972m.g","KQ418431",123512,124455,943
"1021","Ocbimv22030583m.g","KQ416357",896087,925502,29415
"1022","Ocbimv22030718m.g","KQ421078",260054,262296,2242
"1023","Ocbimv22031381m.g","KQ421225",4276,23834,19558
"1024","Ocbimv22031528m.g","KQ421265",300079,301112,1033
"1025","Ocbimv22025590m.g","KQ419857",174322,178236,3914
"1026","Ocbimv22014168m.g","KQ418097",121245,134424,13179
"1027","Ocbimv22010605m.g","KQ417698",168478,168831,353
"1028","Ocbimv22022881m.g","KQ419318",395181,413662,18481
"1029","Ocbimv22007868m.g","KQ417455",417239,424270,7031
"1030","Ocbimv22009086m.g","KQ426870",98,865,767
"1031","Ocbimv22017555m.g","KQ415978",293396,293684,288
"1032","Ocbimv22036317m.g","KQ422711",745176,746040,864
"1033","Ocbimv22035524m.g","KQ422418",30769,38432,7663
"1034","Ocbimv22029430m.g","KQ420749",95635,97215,1580
"1035","Ocbimv22002243m.g","KQ416999",514129,515732,1603
"1036","Ocbimv22017673m.g","KQ418526",33364,42116,8752
"1037","Ocbimv22025712m.g","KQ419887",988616,997009,8393
"1038","Ocbimv22029540m.g","KQ420776",127842,194200,66358
"1039","Ocbimv22033924m.g","KQ421906",721252,721506,254
"1040","Ocbimv22013721m.g","KQ428621",257343,257666,323
"1041","Ocbimv22036954m.g","KQ416666",1557325,1594210,36885
"1042","Ocbimv22020788m.g","KQ418964",1096731,1134006,37275
"1043","Ocbimv22017689m.g","KQ430417",120077,120310,233
"1044","Ocbimv22003274m.g","KQ424932",410316,410558,242
"1045","Ocbimv22033944m.g","KQ421910",63625,64400,775
"1046","Ocbimv22030333m.g","KQ420950",1105990,1107316,1326
"1047","Ocbimv22019435m.g","KQ418767",124277,124624,347
"1048","Ocbimv22031471m.g","KQ416399",349254,352424,3170
"1049","Ocbimv22029255m.g","KQ420694",107769,109635,1866
"1050","Ocbimv22004130m.g","KQ425216",975,64160,63185
"1051","Ocbimv22015292m.g","KQ429252",143974,146620,2646
"1052","Ocbimv22000746m.g","KQ416878",5961,6910,949
"1053","Ocbimv22020390m.g","KQ431646",15620,16445,825
"1054","Ocbimv22011311m.g","KQ417780",192024,213782,21758
"1055","Ocbimv22029584m.g","KQ420779",25010,25811,801
"1056","Ocbimv22019107m.g","KQ430964",352337,353070,733
"1057","Ocbimv22013953m.g","KQ418073",81224,96089,14865
"1058","Ocbimv22035516m.g","KQ422416",234547,257392,22845
"1059","Ocbimv22006576m.g","KQ426026",64997,79313,14316
"1060","Ocbimv22013204m.g","KQ415914",366304,366516,212
"1061","Ocbimv22010868m.g","KQ427557",52766,53893,1127
"1062","Ocbimv22010363m.g","KQ427367",53146,53593,447
"1063","Ocbimv22005491m.g","KQ425619",157480,158111,631
"1064","Ocbimv22033888m.g","KQ421899",66729,68514,1785
"1065","Ocbimv22005910m.g","KQ417284",201151,207499,6348
"1066","Ocbimv22008698m.g","KQ426738",114096,116500,2404
"1067","Ocbimv22011462m.g","KQ427759",38522,42781,4259
"1068","Ocbimv22024124m.g","KQ419535",927469,927672,203
"1069","Ocbimv22004387m.g","KQ425289",266526,274654,8128
"1070","Ocbimv22020291m.g","KQ431584",158319,168718,10399
"1071","Ocbimv22027113m.g","KQ420188",29291,30806,1515
"1072","Ocbimv22010333m.g","KQ417670",373583,374617,1034
"1073","Ocbimv22021488m.g","KQ419057",102141,113643,11502
"1074","Ocbimv22011103m.g","KQ417748",47829,88047,40218
"1075","Ocbimv22022835m.g","LGKD01683052",2,739,737
"1076","Ocbimv22030207m.g","KQ420924",142200,142598,398
"1077","Ocbimv22032198m.g","KQ421476",301786,310122,8336
"1078","Ocbimv22003240m.g","KQ424913",285529,285834,305
"1079","Ocbimv22026641m.g","KQ420085",71592,88111,16519
"1080","Ocbimv22016495m.g","KQ429898",91309,92070,761
"1081","Ocbimv22030231m.g","KQ420925",32416,33410,994
"1082","Ocbimv22017387m.g","KQ430272",319434,346670,27236
"1083","Ocbimv22015935m.g","KQ418303",1215062,1215809,747
"1084","Ocbimv22018628m.g","KQ430776",2630,2957,327
"1085","Ocbimv22018179m.g","KQ430594",149617,279774,130157
"1086","Ocbimv22025549m.g","KQ416158",70958,90144,19186
"1087","Ocbimv22036058m.g","KQ422640",4374,8476,4102
"1088","Ocbimv22033168m.g","KQ416469",10494,37297,26803
"1089","Ocbimv22026676m.g","KQ416196",821568,830698,9130
"1090","Ocbimv22010919m.g","KQ417725",82198,100690,18492
"1091","Ocbimv22000360m.g","KQ423941",29176,35371,6195
"1092","Ocbimv22003083m.g","KQ424877",400053,449855,49802
"1093","Ocbimv22003978m.g","KQ425163",119315,150608,31293
"1094","Ocbimv22037276m.g","KQ422988",20176,34135,13959
"1095","Ocbimv22006504m.g","KQ425963",17184,18282,1098
"1096","Ocbimv22010425m.g","KQ427380",71659,92466,20807
"1097","Ocbimv22030254m.g","KQ420929",2,6983,6981
"1098","Ocbimv22009018m.g","KQ426844",875,4303,3428
"1099","Ocbimv22034646m.g","KQ422103",75763,76038,275
"1100","Ocbimv22030682m.g","LGKD01383360",163,327,164
"1101","Ocbimv22002912m.g","KQ424828",975,10657,9682
"1102","Ocbimv22027298m.g","KQ420247",666,78465,77799
"1103","Ocbimv22017790m.g","KQ418545",84257,112153,27896
"1104","Ocbimv22002747m.g","KQ417032",223096,223500,404
"1105","Ocbimv22036721m.g","KQ416655",88238,90544,2306
"1106","Ocbimv22017717m.g","KQ418530",542760,544008,1248
"1107","Ocbimv22004303m.g","KQ417147",150946,182372,31426
"1108","Ocbimv22001757m.g","KQ424404",17487,19101,1614
"1109","Ocbimv22010709m.g","KQ417704",285648,356161,70513
"1110","Ocbimv22039565m.g","KQ423703",1940,2434,494
"1111","Ocbimv22000327m.g","KQ423926",5717,8003,2286
"1112","Ocbimv22024707m.g","LGKD01309636",3,395,392
"1113","Ocbimv22000495m.g","KQ415777",65209,92537,27328
"1114","Ocbimv22016021m.g","KQ429661",4156,83922,79766
"1115","Ocbimv22019120m.g","KQ430983",96416,96835,419
"1116","Ocbimv22032003m.g","KQ421409",937721,938085,364
"1117","Ocbimv22030331m.g","KQ420950",534672,534952,280
"1118","Ocbimv22038093m.g","KQ423214",19369,25975,6606
"1119","Ocbimv22031267m.g","KQ421210",8106,10779,2673
"1120","Ocbimv22038651m.g","KQ423430",1053717,1054396,679
"1121","Ocbimv22006200m.g","KQ417303",12553,41654,29101
"1122","Ocbimv22038294m.g","KQ423264",141385,141783,398
"1123","Ocbimv22026814m.g","KQ420119",53787,64125,10338
"1124","Ocbimv22027824m.g","KQ420375",1083824,1113329,29505
"1125","Ocbimv22013234m.g","KQ418003",36652,59656,23004
"1126","Ocbimv22037255m.g","KQ422978",218236,218763,527
"1127","Ocbimv22019285m.g","KQ418741",130729,144345,13616
"1128","Ocbimv22009474m.g","KQ417596",728089,730097,2008
"1129","Ocbimv22011826m.g","KQ415893",992062,992361,299
"1130","Ocbimv22032307m.g","KQ421521",515591,516525,934
"1131","Ocbimv22004948m.g","KQ417216",133573,136132,2559
"1132","Ocbimv22032914m.g","KQ421684",73685,75016,1331
"1133","Ocbimv22000282m.g","LGKD01490382",195,413,218
"1134","Ocbimv22023034m.g","KQ433192",13208,13451,243
"1135","Ocbimv22004588m.g","KQ417182",35290,35454,164
"1136","Ocbimv22006484m.g","KQ425942",413,1366,953
"1137","Ocbimv22029692m.g","KQ420805",134807,135163,356
"1138","Ocbimv22004008m.g","KQ417132",201285,202336,1051
"1139","Ocbimv22035035m.g","KQ422254",6,48975,48969
"1140","Ocbimv22038861m.g","KQ416769",154687,157870,3183
"1141","Ocbimv22002831m.g","KQ417040",204470,212050,7580
"1142","Ocbimv22009345m.g","KQ417584",467010,477495,10485
"1143","Ocbimv22008601m.g","KQ417510",588431,605946,17515
"1144","Ocbimv22006241m.g","KQ417305",110860,258941,148081
"1145","Ocbimv22038492m.g","KQ423371",117392,117619,227
"1146","Ocbimv22012699m.g","KQ417928",118351,118861,510
"1147","Ocbimv22005264m.g","KQ425561",244607,267363,22756
"1148","Ocbimv22016343m.g","KQ429822",65492,66288,796
"1149","Ocbimv22029755m.g","LGKD01372205",237,713,476
"1150","Ocbimv22033984m.g","KQ421936",314994,315993,999
"1151","Ocbimv22000509m.g","KQ415777",432782,435471,2689
"1152","Ocbimv22031503m.g","KQ421263",235312,235965,653
"1153","Ocbimv22012675m.g","KQ417924",592504,632869,40365
"1154","Ocbimv22031895m.g","KQ421374",101965,102117,152
"1155","Ocbimv22025375m.g","KQ419782",15907,89987,74080
"1156","Ocbimv22018244m.g","KQ418587",20690,22933,2243
"1157","Ocbimv22032670m.g","KQ421632",1388,3463,2075
"1158","Ocbimv22010695m.g","LGKD01581418",1,383,382
"1159","Ocbimv22026966m.g","KQ420154",264339,266018,1679
"1160","Ocbimv22007948m.g","KQ426499",300975,301244,269
"1161","Ocbimv22026915m.g","KQ416204",76353,77442,1089
"1162","Ocbimv22038508m.g","KQ423384",3974,11928,7954
"1163","Ocbimv22016034m.g","KQ418312",63023,63214,191
"1164","Ocbimv22016617m.g","KQ418370",293224,311509,18285
"1165","Ocbimv22034456m.g","KQ422046",33632,34722,1090
"1166","Ocbimv22002218m.g","KQ424575",77548,77810,262
"1167","Ocbimv22015074m.g","KQ418194",1294200,1306281,12081
"1168","Ocbimv22017579m.g","KQ418509",9193,15461,6268
"1169","Ocbimv22034023m.g","KQ421946",596986,629580,32594
"1170","Ocbimv22037497m.g","KQ423047",228528,228722,194
"1171","Ocbimv22014329m.g","KQ418119",5716,23967,18251
"1172","Ocbimv22006358m.g","KQ425890",43043,44104,1061
"1173","Ocbimv22035502m.g","KQ422411",258253,268878,10625
"1174","Ocbimv22036314m.g","KQ422711",662981,663358,377
"1175","Ocbimv22038297m.g","KQ416735",13668,13911,243
"1176","Ocbimv22021154m.g","KQ419009",571967,576196,4229
"1177","Ocbimv22001305m.g","KQ424264",217876,296009,78133
"1178","Ocbimv22038810m.g","KQ423471",19722,23001,3279
"1179","Ocbimv22018130m.g","KQ418575",60452,63134,2682
"1180","Ocbimv22020024m.g","KQ418843",83683,84345,662
"1181","Ocbimv22029390m.g","KQ416303",643335,704204,60869
"1182","Ocbimv22013293m.g","KQ418007",541476,550552,9076
"1183","Ocbimv22016583m.g","KQ418368",362335,363119,784
"1184","Ocbimv22012805m.g","KQ417942",414327,440687,26360
"1185","Ocbimv22004721m.g","KQ417202",155,500,345
"1186","Ocbimv22037620m.g","KQ415761",164668,164871,203
"1187","Ocbimv22001025m.g","KQ424157",353906,355183,1277
"1188","Ocbimv22026117m.g","KQ419989",911472,930782,19310
"1189","Ocbimv22016571m.g","KQ418368",126020,126687,667
"1190","Ocbimv22032413m.g","KQ421532",280326,289203,8877
"1191","Ocbimv22026803m.g","KQ416202",130013,130246,233
"1192","Ocbimv22038689m.g","KQ423444",214761,214985,224
"1193","Ocbimv22029711m.g","KQ420813",232969,233298,329
"1194","Ocbimv22017038m.g","KQ418443",17735,105589,87854
"1195","Ocbimv22016026m.g","LGKD01623719",338,1381,1043
"1196","Ocbimv22026607m.g","KQ420079",100954,101274,320
"1197","Ocbimv22016114m.g","KQ418320",235593,267721,32128
"1198","Ocbimv22019550m.g","KQ418783",498359,541045,42686
"1199","Ocbimv22004585m.g","LGKD01531450",4,641,637
"1200","Ocbimv22035355m.g","KQ416582",112040,112543,503
"1201","Ocbimv22038310m.g","KQ423275",342275,343030,755
"1202","Ocbimv22037721m.g","KQ423117",25014,50524,25510
"1203","Ocbimv22000023m.g","KQ423826",18437,35692,17255
"1204","Ocbimv22033381m.g","KQ416479",484760,486819,2059
"1205","Ocbimv22035279m.g","KQ422349",106076,115527,9451
"1206","Ocbimv22022638m.g","KQ432938",3,1138,1135
"1207","Ocbimv22007853m.g","KQ417455",202565,211819,9254
"1208","Ocbimv22004941m.g","KQ417215",341633,341821,188
"1209","Ocbimv22021211m.g","KQ432038",292836,332128,39292
"1210","Ocbimv22011932m.g","KQ427949",592543,594042,1499
"1211","Ocbimv22029150m.g","KQ416288",250467,250859,392
"1212","Ocbimv22008206m.g","KQ426582",11112,110931,99819
"1213","Ocbimv22030930m.g","KQ421121",82163,118372,36209
"1214","Ocbimv22002541m.g","KQ424680",63448,65758,2310
"1215","Ocbimv22014225m.g","KQ418104",162592,163032,440
"1216","Ocbimv22014938m.g","KQ429139",279069,279239,170
"1217","Ocbimv22014276m.g","KQ418112",196351,196591,240
"1218","Ocbimv22005855m.g","KQ417280",231019,232898,1879
"1219","Ocbimv22003283m.g","KQ424936",69402,95629,26227
"1220","Ocbimv22015551m.g","KQ429416",145255,191722,46467
"1221","Ocbimv22022788m.g","KQ419298",161357,162256,899
"1222","Ocbimv22019926m.g","KQ418836",38928,110988,72060
"1223","Ocbimv22033873m.g","KQ421896",420277,432688,12411
"1224","Ocbimv22039174m.g","KQ423560",65416,73551,8135
"1225","Ocbimv22028366m.g","KQ420477",447758,454029,6271
"1226","Ocbimv22026138m.g","KQ416184",238952,239320,368
"1227","Ocbimv22002487m.g","KQ424671",204117,232294,28177
"1228","Ocbimv22010903m.g","KQ427565",221992,226047,4055
"1229","Ocbimv22020458m.g","KQ431703",91641,101535,9894
"1230","Ocbimv22022044m.g","KQ419152",80650,96187,15537
"1231","Ocbimv22030403m.g","KQ420971",78562,91654,13092
"1232","Ocbimv22002700m.g","KQ417027",93676,93870,194
"1233","Ocbimv22028661m.g","KQ420545",278677,285044,6367
"1234","Ocbimv22013260m.g","KQ428426",151125,151286,161
"1235","Ocbimv22021411m.g","KQ419041",709098,710837,1739
"1236","Ocbimv22017799m.g","KQ418547",769398,769646,248
"1237","Ocbimv22021761m.g","KQ419095",156002,156229,227
"1238","Ocbimv22023219m.g","KQ419376",282030,283202,1172
"1239","Ocbimv22026581m.g","KQ420075",22919,89610,66691
"1240","Ocbimv22013839m.g","KQ418068",24674,25652,978
"1241","Ocbimv22001050m.g","KQ416905",4240,5183,943
"1242","Ocbimv22036158m.g","KQ422660",56766,58225,1459
"1243","Ocbimv22030516m.g","KQ421009",1329576,1330975,1399
"1244","Ocbimv22009009m.g","KQ426837",1592,7266,5674
"1245","Ocbimv22012907m.g","KQ428280",66,11994,11928
"1246","Ocbimv22039665m.g","KQ423723",201128,201382,254
"1247","Ocbimv22023115m.g","KQ419350",797008,798339,1331
"1248","Ocbimv22024261m.g","KQ419558",98,57664,57566
"1249","Ocbimv22032049m.g","KQ415660",965625,978654,13029
"1250","Ocbimv22037505m.g","KQ416699",4075,16118,12043
"1251","Ocbimv22014303m.g","KQ418115",1011256,1015501,4245
"1252","Ocbimv22034583m.g","KQ416537",104955,105829,874
"1253","Ocbimv22019508m.g","KQ431173",6,1364,1358
"1254","Ocbimv22037121m.g","KQ416673",440929,444414,3485
"1255","Ocbimv22024618m.g","KQ416126",617891,619153,1262
"1256","Ocbimv22017262m.g","KQ430232",69479,70533,1054
"1257","Ocbimv22015646m.g","KQ418271",355082,355249,167
"1258","Ocbimv22019082m.g","KQ418715",605387,645267,39880
"1259","Ocbimv22016771m.g","KQ418396",62388,76057,13669
"1260","Ocbimv22009460m.g","KQ427011",52307,57809,5502
"1261","Ocbimv22023783m.g","KQ416096",1377065,1377763,698
"1262","Ocbimv22038236m.g","KQ423244",85294,108566,23272
"1263","Ocbimv22003285m.g","KQ424936",110658,146585,35927
"1264","Ocbimv22009631m.g","KQ427059",49880,50752,872
"1265","Ocbimv22010678m.g","KQ417701",345431,388425,42994
"1266","Ocbimv22030255m.g","KQ420929",7166,22282,15116
"1267","Ocbimv22032610m.g","KQ421607",118759,180725,61966
"1268","Ocbimv22011048m.g","KQ417740",264140,271166,7026
"1269","Ocbimv22004419m.g","KQ415804",339361,340246,885
"1270","Ocbimv22017775m.g","LGKD01638975",298,600,302
"1271","Ocbimv22019001m.g","KQ418710",437075,437230,155
"1272","Ocbimv22039937m.g","KQ423801",136501,175047,38546
"1273","Ocbimv22027987m.g","KQ420415",176443,181978,5535
"1274","Ocbimv22039175m.g","KQ415771",15450,132011,116561
"1275","Ocbimv22039330m.g","KQ416788",285435,285716,281
"1276","Ocbimv22026564m.g","KQ416193",241193,241360,167
"1277","Ocbimv22027929m.g","KQ420404",602164,615425,13261
"1278","Ocbimv22016060m.g","KQ415952",120907,121068,161
"1279","Ocbimv22036366m.g","KQ422726",19164,56952,37788
"1280","Ocbimv22038944m.g","KQ423493",373202,374230,1028
"1281","Ocbimv22016621m.g","KQ418370",542033,542449,416
"1282","Ocbimv22001088m.g","KQ424176",3348,26628,23280
"1283","Ocbimv22014546m.g","KQ428981",174201,175038,837
"1284","Ocbimv22004640m.g","KQ417191",30248,43283,13035
"1285","Ocbimv22016229m.g","KQ429762",14978,15301,323
"1286","Ocbimv22037011m.g","LGKD01455923",2,1186,1184
"1287","Ocbimv22030122m.g","KQ420902",29976,64129,34153
"1288","Ocbimv22034741m.g","KQ422141",12478,13030,552
"1289","Ocbimv22038589m.g","KQ423413",268,102465,102197
"1290","Ocbimv22003891m.g","KQ417119",176791,176943,152
"1291","Ocbimv22016526m.g","KQ418364",437175,437348,173
"1292","Ocbimv22011677m.g","KQ417816",326822,340805,13983
"1293","Ocbimv22023928m.g","KQ419500",780160,798927,18767
"1294","Ocbimv22039874m.g","KQ416832",239380,255939,16559
"1295","Ocbimv22023261m.g","LGKD01686991",1,504,503
"1296","Ocbimv22025233m.g","KQ419743",3812,35487,31675
"1297","Ocbimv22037364m.g","KQ416691",48013,48339,326
"1298","Ocbimv22010533m.g","KQ427428",56549,70121,13572
"1299","Ocbimv22035941m.g","KQ422615",194365,194694,329
"1300","Ocbimv22025706m.g","KQ419887",678517,678810,293
"1301","Ocbimv22008632m.g","KQ426714",128721,128879,158
"1302","Ocbimv22021297m.g","KQ419026",197506,218982,21476
"1303","Ocbimv22038699m.g","KQ416761",8793,10515,1722
"1304","Ocbimv22022929m.g","KQ419326",659667,694727,35060
"1305","Ocbimv22008959m.g","KQ426820",58272,58520,248
"1306","Ocbimv22026293m.g","KQ420023",304858,308172,3314
"1307","Ocbimv22034108m.g","KQ421978",45359,57667,12308
"1308","Ocbimv22008284m.g","KQ417494",177078,177443,365
"1309","Ocbimv22000422m.g","KQ423958",369035,383650,14615
"1310","Ocbimv22031894m.g","KQ421373",376967,377332,365
"1311","Ocbimv22039225m.g","KQ423590",34281,34906,625
"1312","Ocbimv22038623m.g","KQ423422",398366,398704,338
"1313","Ocbimv22010579m.g","KQ417692",127344,143193,15849
"1314","Ocbimv22026135m.g","KQ419994",604146,604577,431
"1315","Ocbimv22030964m.g","KQ421138",262101,264065,1964
"1316","Ocbimv22031155m.g","KQ421177",74270,121031,46761
"1317","Ocbimv22010573m.g","KQ417691",521156,594060,72904
"1318","Ocbimv22020185m.g","KQ431525",1,815,814
"1319","Ocbimv22037879m.g","KQ416713",9713,10911,1198
"1320","Ocbimv22029945m.g","KQ416325",118878,119858,980
"1321","Ocbimv22008476m.g","KQ415854",720005,740086,20081
"1322","Ocbimv22029501m.g","KQ416311",65,47817,47752
"1323","Ocbimv22013643m.g","KQ418042",83049,84964,1915
"1324","Ocbimv22035343m.g","KQ422362",198881,262154,63273
"1325","Ocbimv22009328m.g","LGKD01569805",3,164,161
"1326","Ocbimv22006977m.g","LGKD01551684",15,320,305
"1327","Ocbimv22015314m.g","LGKD01616872",131,1093,962
"1328","Ocbimv22017561m.g","KQ418506",246305,327425,81120
"1329","Ocbimv22012557m.g","KQ417917",1187248,1187659,411
"1330","Ocbimv22027202m.g","KQ420217",372377,372703,326
"1331","Ocbimv22013428m.g","KQ418022",27466,27934,468
"1332","Ocbimv22012770m.g","KQ428229",97986,98189,203
"1333","Ocbimv22033329m.g","KQ421780",147226,160252,13026
"1334","Ocbimv22019862m.g","KQ418823",38218,41866,3648
"1335","Ocbimv22007108m.g","KQ417379",65725,66057,332
"1336","Ocbimv22005002m.g","KQ415811",625312,628939,3627
"1337","Ocbimv22030462m.g","KQ420992",78653,108428,29775
"1338","Ocbimv22028106m.g","KQ416249",397249,398661,1412
"1339","Ocbimv22008000m.g","KQ415849",196,14661,14465
"1340","Ocbimv22000879m.g","KQ416889",151305,151628,323
"1341","Ocbimv22037933m.g","LGKD01105445",51,296,245
"1342","Ocbimv22033369m.g","KQ421800",163002,164688,1686
"1343","Ocbimv22026047m.g","KQ419973",500857,503499,2642
"1344","Ocbimv22033569m.g","KQ421836",9130,10255,1125
"1345","Ocbimv22001370m.g","LGKD01501680",3,1577,1574
"1346","Ocbimv22019836m.g","KQ418821",350296,351800,1504
"1347","Ocbimv22008582m.g","KQ417510",297491,302612,5121
"1348","Ocbimv22002955m.g","KQ424852",143273,169962,26689
"1349","Ocbimv22027297m.g","KQ416219",61385,62760,1375
"1350","Ocbimv22033143m.g","KQ421736",29017,48555,19538
"1351","Ocbimv22002731m.g","KQ417030",652792,654718,1926
"1352","Ocbimv22031139m.g","KQ421173",216455,239074,22619
"1353","Ocbimv22003112m.g","KQ417059",36442,37461,1019
"1354","Ocbimv22006515m.g","KQ417330",156741,168141,11400
"1355","Ocbimv22012934m.g","KQ417957",203921,206487,2566
"1356","Ocbimv22028243m.g","KQ415659",82873,98443,15570
"1357","Ocbimv22012523m.g","KQ417917",599518,619714,20196
"1358","Ocbimv22030545m.g","KQ421018",227111,227335,224
"1359","Ocbimv22005462m.g","KQ425611",139405,146323,6918
"1360","Ocbimv22005129m.g","KQ415813",1187883,1205756,17873
"1361","Ocbimv22002188m.g","KQ424569",189148,205267,16119
"1362","Ocbimv22026446m.g","KQ420052",143650,144262,612
"1363","Ocbimv22027984m.g","KQ420415",133203,138026,4823
"1364","Ocbimv22011683m.g","LGKD01589216",1,575,574
"1365","Ocbimv22010276m.g","KQ427344",93406,94248,842
"1366","Ocbimv22029181m.g","KQ420672",619153,619938,785
"1367","Ocbimv22022055m.g","LGKD01674441",54,3801,3747
"1368","Ocbimv22021155m.g","KQ419009",586599,588153,1554
"1369","Ocbimv22021443m.g","KQ419049",174696,178893,4197
"1370","Ocbimv22014057m.g","KQ415672",3960,4969,1009
"1371","Ocbimv22031875m.g","KQ421370",16539,16904,365
"1372","Ocbimv22027033m.g","KQ420166",660205,662437,2232
"1373","Ocbimv22015286m.g","KQ429244",71767,72119,352
"1374","Ocbimv22017160m.g","LGKD01633341",3,1102,1099
"1375","Ocbimv22036766m.g","KQ416656",39847,42643,2796
"1376","Ocbimv22035973m.g","KQ422621",114291,155073,40782
"1377","Ocbimv22006414m.g","KQ425905",102024,103166,1142
"1378","Ocbimv22030453m.g","KQ416350",319570,322939,3369
"1379","Ocbimv22000917m.g","KQ424114",61585,62278,693
"1380","Ocbimv22003181m.g","KQ424903",2895,3320,425
"1381","Ocbimv22027525m.g","KQ420299",104523,109836,5313
"1382","Ocbimv22020598m.g","KQ431746",132540,133757,1217
"1383","Ocbimv22008707m.g","KQ426740",378727,379250,523
"1384","Ocbimv22037905m.g","KQ423158",12790,13189,399
"1385","Ocbimv22003466m.g","KQ425015",393365,402481,9116
"1386","Ocbimv22017631m.g","KQ418516",264236,267539,3303
"1387","Ocbimv22010765m.g","KQ427511",6764,12590,5826
"1388","Ocbimv22033343m.g","KQ421787",195,2758,2563
"1389","Ocbimv22017415m.g","KQ418493",85824,90764,4940
"1390","Ocbimv22000792m.g","KQ424068",91495,94067,2572
"1391","Ocbimv22010983m.g","KQ417731",150539,170894,20355
"1392","Ocbimv22039578m.g","LGKD01484011",3,350,347
"1393","Ocbimv22020442m.g","KQ431688",7743,8036,293
"1394","Ocbimv22033772m.g","KQ421866",471806,471988,182
"1395","Ocbimv22020786m.g","KQ418964",1048215,1069776,21561
"1396","Ocbimv22012507m.g","KQ417917",328661,335502,6841
"1397","Ocbimv22038880m.g","KQ423486",1188,20026,18838
"1398","Ocbimv22023173m.g","KQ419366",421932,433519,11587
"1399","Ocbimv22003365m.g","KQ417085",287682,288388,706
"1400","Ocbimv22000723m.g","KQ416877",588823,602190,13367
"1401","Ocbimv22036197m.g","KQ416625",113881,114147,266
"1402","Ocbimv22026473m.g","KQ420055",7766,24382,16616
"1403","Ocbimv22037496m.g","KQ423047",203447,204400,953
"1404","Ocbimv22025495m.g","KQ419821",182187,182711,524
"1405","Ocbimv22002112m.g","KQ424547",6565,8053,1488
"1406","Ocbimv22005922m.g","KQ417284",413641,417211,3570
"1407","Ocbimv22038594m.g","KQ423414",79621,80173,552
"1408","Ocbimv22027291m.g","KQ416218",113648,113806,158
"1409","Ocbimv22009067m.g","KQ417558",168655,189340,20685
"1410","Ocbimv22028967m.g","KQ416278",41371,42871,1500
"1411","Ocbimv22001774m.g","KQ416962",125613,129948,4335
"1412","Ocbimv22038926m.g","KQ423490",139029,145934,6905
"1413","Ocbimv22028717m.g","KQ416268",606605,611610,5005
"1414","Ocbimv22026425m.g","KQ420047",400835,404500,3665
"1415","Ocbimv22005960m.g","KQ417285",863895,864276,381
"1416","Ocbimv22005858m.g","KQ417280",269838,270815,977
"1417","Ocbimv22029175m.g","KQ420672",492139,493674,1535
"1418","Ocbimv22019103m.g","KQ430964",245921,250560,4639
"1419","Ocbimv22022065m.g","KQ419156",154748,155471,723
"1420","Ocbimv22029929m.g","KQ420851",28357,41224,12867
"1421","Ocbimv22019479m.g","KQ416011",576063,577242,1179
"1422","Ocbimv22025965m.g","KQ419937",82420,183555,101135
"1423","Ocbimv22027430m.g","KQ420273",143121,151383,8262
"1424","Ocbimv22032977m.g","KQ421705",481297,481737,440
"1425","Ocbimv22026588m.g","KQ420076",20660,21732,1072
"1426","Ocbimv22037545m.g","KQ423058",950156,998832,48676
"1427","Ocbimv22006573m.g","KQ417336",1332526,1353884,21358
"1428","Ocbimv22020214m.g","KQ418873",632316,644763,12447
"1429","Ocbimv22005919m.g","KQ417284",346402,348319,1917
"1430","Ocbimv22003084m.g","KQ424877",419908,420293,385
"1431","Ocbimv22035094m.g","KQ416571",508827,509081,254
"1432","Ocbimv22020577m.g","KQ418926",221212,248674,27462
"1433","Ocbimv22021593m.g","KQ432245",31887,34035,2148
"1434","Ocbimv22022513m.g","KQ419238",65847,67031,1184
"1435","Ocbimv22015665m.g","KQ418273",695976,705232,9256
"1436","Ocbimv22033765m.g","KQ421866",56541,57066,525
"1437","Ocbimv22022923m.g","KQ419326",523972,534463,10491
"1438","Ocbimv22018509m.g","LGKD01643800",207,1211,1004
"1439","Ocbimv22028782m.g","KQ420583",34769,36241,1472
"1440","Ocbimv22032819m.g","KQ421661",48966,72441,23475
"1441","Ocbimv22009724m.g","KQ417606",117129,118773,1644
"1442","Ocbimv22022765m.g","LGKD01682201",194,376,182
"1443","Ocbimv22002865m.g","KQ424811",53335,53789,454
"1444","Ocbimv22019983m.g","KQ418840",1117992,1118811,819
"1445","Ocbimv22026125m.g","KQ419991",138745,143543,4798
"1446","Ocbimv22021835m.g","KQ415687",1036558,1052952,16394
"1447","Ocbimv22007497m.g","KQ415843",282852,283085,233
"1448","Ocbimv22013598m.g","LGKD01602784",4,513,509
"1449","Ocbimv22014290m.g","KQ418115",16123,37378,21255
"1450","Ocbimv22030138m.g","KQ420908",76290,77295,1005
"1451","Ocbimv22038532m.g","KQ416750",101529,104675,3146
"1452","Ocbimv22009398m.g","KQ426993",120,362,242
"1453","Ocbimv22019061m.g","KQ430959",2219,14262,12043
"1454","Ocbimv22016576m.g","KQ418368",279232,279468,236
"1455","Ocbimv22031363m.g","KQ421221",744619,744786,167
"1456","Ocbimv22033164m.g","KQ421737",1479795,1480405,610
"1457","Ocbimv22002368m.g","KQ424652",34053,34301,248
"1458","Ocbimv22029404m.g","KQ416304",150837,151031,194
"1459","Ocbimv22028288m.g","KQ420458",117742,118217,475
"1460","Ocbimv22029566m.g","KQ420776",768040,768777,737
"1461","Ocbimv22037415m.g","KQ416694",2628518,2639573,11055
"1462","Ocbimv22000112m.g","KQ423864",341489,342247,758
"1463","Ocbimv22022006m.g","KQ432511",2791,7317,4526
"1464","Ocbimv22023179m.g","KQ419368",130898,133897,2999
"1465","Ocbimv22035007m.g","KQ422245",115256,133201,17945
"1466","Ocbimv22029758m.g","KQ420820",21902,22165,263
"1467","Ocbimv22000432m.g","KQ423963",117730,121239,3509
"1468","Ocbimv22030365m.g","KQ420965",3938,21373,17435
"1469","Ocbimv22019303m.g","KQ418746",322,858,536
"1470","Ocbimv22027012m.g","KQ420162",692733,704147,11414
"1471","Ocbimv22002633m.g","KQ417023",915742,933652,17910
"1472","Ocbimv22001822m.g","KQ416966",609760,611480,1720
"1473","Ocbimv22016633m.g","KQ415967",1018149,1018421,272
"1474","Ocbimv22020399m.g","KQ431653",21572,21910,338
"1475","Ocbimv22012223m.g","KQ415905",714474,715225,751
"1476","Ocbimv22006949m.g","KQ426164",5026,5370,344
"1477","Ocbimv22001278m.g","KQ424250",351600,351866,266
"1478","Ocbimv22022024m.g","KQ432519",2735,3595,860
"1479","Ocbimv22002206m.g","KQ416995",227963,242308,14345
"1480","Ocbimv22015886m.g","KQ415948",70330,70911,581
"1481","Ocbimv22002175m.g","KQ416993",137422,139094,1672
"1482","Ocbimv22024505m.g","KQ419590",811895,813211,1316
"1483","Ocbimv22029403m.g","KQ420741",1647931,1649376,1445
"1484","Ocbimv22008431m.g","KQ417501",219966,235219,15253
"1485","Ocbimv22019702m.g","KQ418802",117392,117781,389
"1486","Ocbimv22035425m.g","KQ422381",151268,153671,2403
"1487","Ocbimv22006964m.g","KQ426167",105816,115745,9929
"1488","Ocbimv22014656m.g","KQ429026",525874,549465,23591
"1489","Ocbimv22036016m.g","KQ422632",474800,481077,6277
"1490","Ocbimv22003767m.g","KQ417110",75177,75567,390
"1491","Ocbimv22012088m.g","KQ417871",17935,18963,1028
"1492","Ocbimv22022075m.g","KQ419158",144700,145140,440
"1493","Ocbimv22016825m.g","KQ430050",73587,250477,176890
"1494","Ocbimv22009557m.g","KQ415865",1781782,1790212,8430
"1495","Ocbimv22016658m.g","KQ418375",769585,770322,737
"1496","Ocbimv22025458m.g","KQ419807",214188,218469,4281
"1497","Ocbimv22032791m.g","KQ421658",563997,564266,269
"1498","Ocbimv22002616m.g","KQ417023",477069,477242,173
"1499","Ocbimv22009700m.g","KQ417605",153843,154025,182
"1500","Ocbimv22013717m.g","KQ428621",84864,85475,611
"1501","Ocbimv22005090m.g","KQ425518",124592,125230,638
"1502","Ocbimv22023349m.g","KQ419395",136844,140298,3454
"1503","Ocbimv22035616m.g","KQ422474",92354,124084,31730
"1504","Ocbimv22034838m.g","KQ416559",221969,223774,1805
"1505","Ocbimv22008782m.g","KQ426774",51744,52640,896
"1506","Ocbimv22019844m.g","KQ418821",617886,638439,20553
"1507","Ocbimv22007322m.g","KQ426291",24118,25085,967
"1508","Ocbimv22010207m.g","KQ427309",17806,50091,32285
"1509","Ocbimv22005716m.g","KQ425728",87635,166714,79079
"1510","Ocbimv22027973m.g","KQ420414",278612,279709,1097
"1511","Ocbimv22031611m.g","KQ421296",111262,112102,840
"1512","Ocbimv22007950m.g","KQ426499",310239,374968,64729
"1513","Ocbimv22029260m.g","KQ420695",66743,68266,1523
"1514","Ocbimv22000506m.g","KQ415777",300619,301353,734
"1515","Ocbimv22027361m.g","KQ420265",202254,204444,2190
"1516","Ocbimv22035803m.g","KQ422556",336622,386421,49799
"1517","Ocbimv22014199m.g","KQ418100",183060,183245,185
"1518","Ocbimv22019033m.g","KQ418711",998560,999112,552
"1519","Ocbimv22004461m.g","KQ425320",94368,157107,62739
"1520","Ocbimv22023262m.g","KQ419381",1,470,469
"1521","Ocbimv22030209m.g","KQ420924",192772,192990,218
"1522","Ocbimv22004163m.g","KQ425220",156264,169574,13310
"1523","Ocbimv22022755m.g","KQ432985",80802,82165,1363
"1524","Ocbimv22023208m.g","KQ419369",118852,129547,10695
"1525","Ocbimv22006594m.g","KQ426027",30219,42387,12168
"1526","Ocbimv22027082m.g","KQ420176",10510,19598,9088
"1527","Ocbimv22039929m.g","KQ423797",242346,250371,8025
"1528","Ocbimv22010590m.g","KQ417694",9172,41338,32166
"1529","Ocbimv22032268m.g","KQ421507",150319,170569,20250
"1530","Ocbimv22022798m.g","KQ419300",365170,373454,8284
"1531","Ocbimv22014807m.g","KQ429094",50,277,227
"1532","Ocbimv22005786m.g","KQ415823",484567,490957,6390
"1533","Ocbimv22034847m.g","KQ422193",9453,12366,2913
"1534","Ocbimv22020205m.g","KQ418873",422619,442212,19593
"1535","Ocbimv22029872m.g","KQ420828",2011144,2011521,377
"1536","Ocbimv22022225m.g","KQ419185",241526,241948,422
"1537","Ocbimv22000427m.g","KQ416857",9386,18969,9583
"1538","Ocbimv22030264m.g","KQ416339",168769,169083,314
"1539","Ocbimv22030518m.g","KQ421009",1435857,1437490,1633
"1540","Ocbimv22001755m.g","KQ424402",20993,21163,170
"1541","Ocbimv22020683m.g","KQ418952",67350,116326,48976
"1542","Ocbimv22030891m.g","KQ421117",269528,269809,281
"1543","Ocbimv22031942m.g","KQ415727",134850,135014,164
"1544","Ocbimv22020488m.g","KQ418919",486868,494071,7203
"1545","Ocbimv22034662m.g","KQ416545",167547,246703,79156
"1546","Ocbimv22035455m.g","KQ416587",45300,45593,293
"1547","Ocbimv22002211m.g","KQ424575",6190,7263,1073
"1548","Ocbimv22017144m.g","KQ418454",83177,111434,28257
"1549","Ocbimv22011156m.g","KQ417754",17969,18631,662
"1550","Ocbimv22005318m.g","KQ417240",316298,317685,1387
"1551","Ocbimv22010857m.g","LGKD01582974",149,457,308
"1552","Ocbimv22031246m.g","KQ421206",409613,436640,27027
"1553","Ocbimv22009023m.g","KQ426845",1681,1998,317
"1554","Ocbimv22032337m.g","KQ421523",816157,872587,56430
"1555","Ocbimv22012337m.g","KQ415907",754096,770430,16334
"1556","Ocbimv22008641m.g","LGKD01564332",37,219,182
"1557","Ocbimv22016885m.g","KQ418418",36928,38348,1420
"1558","Ocbimv22000028m.g","KQ423827",374606,374758,152
"1559","Ocbimv22006906m.g","KQ417361",581880,583646,1766
"1560","Ocbimv22034005m.g","KQ421943",147824,150108,2284
"1561","Ocbimv22010632m.g","KQ415669",3169395,3169730,335
"1562","Ocbimv22028533m.g","KQ420517",441446,476093,34647
"1563","Ocbimv22035126m.g","KQ422286",7972,8504,532
"1564","Ocbimv22032748m.g","KQ421655",2745,3594,849
"1565","Ocbimv22004515m.g","KQ417175",57245,57541,296
"1566","Ocbimv22039786m.g","KQ416823",43139,43600,461
"1567","Ocbimv22024453m.g","KQ416123",114597,115650,1053
"1568","Ocbimv22034652m.g","KQ416544",149663,169819,20156
"1569","Ocbimv22005282m.g","KQ425568",5922,10754,4832
"1570","Ocbimv22027239m.g","KQ416215",581151,608622,27471
"1571","Ocbimv22018107m.g","KQ430572",372072,382717,10645
"1572","Ocbimv22025037m.g","KQ416136",551181,605849,54668
"1573","Ocbimv22024808m.g","KQ419631",423395,431746,8351
"1574","Ocbimv22008175m.g","KQ417481",1861575,1861878,303
"1575","Ocbimv22023352m.g","KQ419395",152376,157468,5092
"1576","Ocbimv22005647m.g","KQ417269",39160,61013,21853
"1577","Ocbimv22004046m.g","KQ425190",117738,119157,1419
"1578","Ocbimv22037849m.g","KQ423139",583188,588585,5397
"1579","Ocbimv22010315m.g","KQ427353",14057,14598,541
"1580","Ocbimv22024208m.g","KQ419550",46828,53286,6458
"1581","Ocbimv22030425m.g","KQ420978",191680,205953,14273
"1582","Ocbimv22031898m.g","KQ421375",1855,53448,51593
"1583","Ocbimv22004125m.g","KQ425211",3561,3752,191
"1584","Ocbimv22023802m.g","KQ419478",401744,401941,197
"1585","Ocbimv22032731m.g","KQ421648",41614,98472,56858
"1586","Ocbimv22030842m.g","KQ421110",138189,148087,9898
"1587","Ocbimv22036090m.g","KQ416616",2142845,2143018,173
"1588","Ocbimv22009834m.g","KQ417620",521195,535555,14360
"1589","Ocbimv22010399m.g","KQ417676",326013,345616,19603
"1590","Ocbimv22015540m.g","KQ429409",1,261,260
"1591","Ocbimv22008718m.g","KQ415858",509741,513104,3363
"1592","Ocbimv22038723m.g","KQ423456",4274,9963,5689
"1593","Ocbimv22035092m.g","KQ416571",311175,313619,2444
"1594","Ocbimv22029015m.g","KQ416279",810237,846967,36730
"1595","Ocbimv22029739m.g","KQ420814",226591,281567,54976
"1596","Ocbimv22009468m.g","KQ417596",242217,242546,329
"1597","Ocbimv22007022m.g","KQ417370",541998,546061,4063
"1598","Ocbimv22023373m.g","KQ419395",284828,284980,152
"1599","Ocbimv22015379m.g","KQ429304",10036,10694,658
"1600","Ocbimv22005511m.g","KQ425642",8865,9236,371
"1601","Ocbimv22013250m.g","KQ428426",5320,49044,43724
"1602","Ocbimv22030634m.g","KQ421039",175112,176083,971
"1603","Ocbimv22004658m.g","KQ425412",3200,141828,138628
"1604","Ocbimv22021487m.g","KQ419057",93115,98148,5033
"1605","Ocbimv22025221m.g","KQ419740",51980,52210,230
"1606","Ocbimv22001619m.g","KQ424370",13111,14152,1041
"1607","Ocbimv22026347m.g","KQ420031",166281,200212,33931
"1608","Ocbimv22027475m.g","KQ416225",110893,111229,336
"1609","Ocbimv22003711m.g","KQ417103",68454,114256,45802
"1610","Ocbimv22024314m.g","KQ419565",3932,54487,50555
"1611","Ocbimv22035746m.g","KQ422521",498160,500371,2211
"1612","Ocbimv22030535m.g","KQ421017",12128,13673,1545
"1613","Ocbimv22013741m.g","KQ428640",12308,62444,50136
"1614","Ocbimv22012387m.g","KQ417908",175394,176230,836
"1615","Ocbimv22008961m.g","KQ426820",80320,82428,2108
"1616","Ocbimv22005427m.g","KQ425603",16235,19001,2766
"1617","Ocbimv22029065m.g","KQ420639",763449,815212,51763
"1618","Ocbimv22021222m.g","KQ419015",92716,93288,572
"1619","Ocbimv22017191m.g","KQ430193",26451,27468,1017
"1620","Ocbimv22016010m.g","KQ418310",61379,74130,12751
"1621","Ocbimv22031612m.g","KQ421296",113529,113768,239
"1622","Ocbimv22004363m.g","KQ417154",160583,160813,230
"1623","Ocbimv22035809m.g","KQ416601",166683,167226,543
"1624","Ocbimv22036886m.g","KQ416665",35651,35986,335
"1625","Ocbimv22025100m.g","KQ416137",487678,626854,139176
"1626","Ocbimv22009802m.g","KQ417617",254998,255168,170
"1627","Ocbimv22010100m.g","KQ427255",61671,62984,1313
"1628","Ocbimv22035873m.g","KQ416608",411154,411333,179
"1629","Ocbimv22028050m.g","KQ416245",82276,126125,43849
"1630","Ocbimv22021809m.g","KQ432335",28,2531,2503
"1631","Ocbimv22007391m.g","KQ426321",51633,84669,33036
"1632","Ocbimv22030762m.g","KQ421084",12281,13872,1591
"1633","Ocbimv22004043m.g","KQ425190",97012,102684,5672
"1634","Ocbimv22028783m.g","KQ420583",45932,113160,67228
"1635","Ocbimv22003120m.g","KQ417060",78363,79838,1475
"1636","Ocbimv22017330m.g","KQ418483",139446,146631,7185
"1637","Ocbimv22039351m.g","KQ423630",80600,80857,257
"1638","Ocbimv22016353m.g","KQ415679",499644,504237,4593
"1639","Ocbimv22015290m.g","KQ429252",4525,93035,88510
"1640","Ocbimv22008200m.g","KQ417485",7023,12239,5216
"1641","Ocbimv22028066m.g","KQ420424",192904,193137,233
"1642","Ocbimv22006847m.g","KQ417358",286434,297844,11410
"1643","Ocbimv22020052m.g","KQ418846",1013,46525,45512
"1644","Ocbimv22009051m.g","KQ415859",768122,820362,52240
"1645","Ocbimv22030700m.g","KQ421074",117565,138900,21335
"1646","Ocbimv22009765m.g","KQ417611",535185,564816,29631
"1647","Ocbimv22004873m.g","KQ417211",353708,354325,617
"1648","Ocbimv22030783m.g","KQ421086",231815,232342,527
"1649","Ocbimv22026810m.g","KQ420119",1697,17288,15591
"1650","Ocbimv22008205m.g","KQ417486",7816,48083,40267
"1651","Ocbimv22011276m.g","KQ417772",199754,202771,3017
"1652","Ocbimv22020917m.g","KQ418974",1495864,1496106,242
"1653","Ocbimv22011460m.g","KQ427753",128402,130552,2150
"1654","Ocbimv22011497m.g","KQ417796",253102,278075,24973
"1655","Ocbimv22039400m.g","KQ423645",7406,13227,5821
"1656","Ocbimv22039200m.g","KQ423574",122845,126207,3362
"1657","Ocbimv22006252m.g","KQ417305",468319,470527,2208
"1658","Ocbimv22032157m.g","KQ421462",6761,21130,14369
"1659","Ocbimv22015975m.g","KQ415949",352744,367584,14840
"1660","Ocbimv22039267m.g","KQ423598",247117,247755,638
"1661","Ocbimv22025701m.g","KQ419887",189420,198720,9300
"1662","Ocbimv22034127m.g","KQ421984",100722,101135,413
"1663","Ocbimv22026839m.g","KQ420126",477102,480798,3696
"1664","Ocbimv22025156m.g","KQ419713",70637,70996,359
"1665","Ocbimv22016657m.g","KQ418375",690794,707285,16491
"1666","Ocbimv22039448m.g","KQ423671",39200,88086,48886
"1667","Ocbimv22036826m.g","KQ422866",56145,126416,70271
"1668","Ocbimv22035848m.g","KQ422575",94366,117224,22858
"1669","Ocbimv22034556m.g","KQ422077",37812,38036,224
"1670","Ocbimv22025676m.g","KQ419886",122681,122950,269
"1671","Ocbimv22001508m.g","KQ424337",111432,132281,20849
"1672","Ocbimv22027161m.g","KQ416211",48106,70968,22862
"1673","Ocbimv22020084m.g","KQ431444",7289,13105,5816
"1674","Ocbimv22007572m.g","KQ417430",986479,987686,1207
"1675","Ocbimv22013334m.g","KQ418012",570662,571156,494
"1676","Ocbimv22014214m.g","KQ418101",208071,212006,3935
"1677","Ocbimv22005995m.g","KQ425779",40485,40891,406
"1678","Ocbimv22005554m.g","KQ417261",59265,60559,1294
"1679","Ocbimv22037993m.g","KQ423197",32741,33958,1217
"1680","Ocbimv22001653m.g","KQ416951",295324,295509,185
"1681","Ocbimv22008496m.g","KQ417506",246459,246804,345
"1682","Ocbimv22038038m.g","KQ423205",45873,49162,3289
"1683","Ocbimv22032716m.g","KQ416447",68521,68754,233
"1684","Ocbimv22009055m.g","KQ415859",801165,801653,488
"1685","Ocbimv22014263m.g","KQ418110",25233,27260,2027
"1686","Ocbimv22038491m.g","KQ423371",55359,61967,6608
"1687","Ocbimv22015767m.g","KQ429546",3197,10219,7022
"1688","Ocbimv22026568m.g","KQ416193",469100,471994,2894
"1689","Ocbimv22038108m.g","KQ423217",5595,37007,31412
"1690","Ocbimv22009032m.g","KQ426847",64388,92908,28520
"1691","Ocbimv22020066m.g","KQ418849",91486,105768,14282
"1692","Ocbimv22028581m.g","KQ420525",251092,272613,21521
"1693","Ocbimv22034216m.g","KQ422009",359318,359605,287
"1694","Ocbimv22036529m.g","KQ422784",41036,43031,1995
"1695","Ocbimv22023836m.g","KQ416100",4211,145399,141188
"1696","Ocbimv22032856m.g","KQ416453",121172,121420,248
"1697","Ocbimv22004670m.g","KQ417195",147977,188335,40358
"1698","Ocbimv22036634m.g","KQ416651",1634066,1634660,594
"1699","Ocbimv22026714m.g","KQ420097",270485,270640,155
"1700","Ocbimv22013102m.g","KQ417981",858464,865031,6567
"1701","Ocbimv22026201m.g","KQ420016",249220,258967,9747
"1702","Ocbimv22024440m.g","KQ419579",10178,14529,4351
"1703","Ocbimv22028347m.g","KQ420477",80645,83845,3200
"1704","Ocbimv22000933m.g","KQ424120",150541,159183,8642
"1705","Ocbimv22028956m.g","KQ416277",171557,172027,470
"1706","Ocbimv22005577m.g","KQ425655",265792,268767,2975
"1707","Ocbimv22003469m.g","KQ425015",541631,546945,5314
"1708","Ocbimv22009887m.g","KQ417621",526246,526621,375
"1709","Ocbimv22003740m.g","KQ425078",201879,254040,52161
"1710","Ocbimv22031081m.g","KQ421155",51056,62336,11280
"1711","Ocbimv22037694m.g","KQ423101",94862,96382,1520
"1712","Ocbimv22009456m.g","LGKD01570824",210,437,227
"1713","Ocbimv22035785m.g","KQ422536",8792,41962,33170
"1714","Ocbimv22035743m.g","KQ422521",445766,447197,1431
"1715","Ocbimv22016736m.g","KQ418390",3195,4904,1709
"1716","Ocbimv22005975m.g","KQ425769",114766,114933,167
"1717","Ocbimv22017272m.g","KQ418475",34004,89972,55968
"1718","Ocbimv22013187m.g","KQ428420",83171,128108,44937
"1719","Ocbimv22035587m.g","KQ422447",789374,810347,20973
"1720","Ocbimv22011416m.g","KQ415885",4858,7526,2668
"1721","Ocbimv22038502m.g","KQ423383",1715,4499,2784
"1722","Ocbimv22010975m.g","KQ427574",71887,72123,236
"1723","Ocbimv22027843m.g","KQ420375",1465523,1477457,11934
"1724","Ocbimv22005611m.g","KQ425676",940613,982499,41886
"1725","Ocbimv22022408m.g","KQ416068",13858,17720,3862
"1726","Ocbimv22000586m.g","KQ424015",67739,123621,55882
"1727","Ocbimv22001568m.g","KQ416943",111608,115725,4117
"1728","Ocbimv22015254m.g","KQ418216",281224,282024,800
"1729","Ocbimv22011442m.g","KQ427746",543070,545067,1997
"1730","Ocbimv22031716m.g","KQ421325",155504,181890,26386
"1731","Ocbimv22024451m.g","KQ416123",20455,21396,941
"1732","Ocbimv22003267m.g","KQ424932",202690,203934,1244
"1733","Ocbimv22018819m.g","KQ430888",3484,4134,650
"1734","Ocbimv22031709m.g","KQ421325",52264,63133,10869
"1735","Ocbimv22006066m.g","KQ417293",397337,456005,58668
"1736","Ocbimv22036255m.g","LGKD01011080",238,657,419
"1737","Ocbimv22013312m.g","KQ418009",680693,680995,302
"1738","Ocbimv22038713m.g","KQ423448",34020,42216,8196
"1739","Ocbimv22022672m.g","KQ432945",3393,3914,521
"1740","Ocbimv22035407m.g","KQ422367",349731,364819,15088
"1741","Ocbimv22027560m.g","KQ420305",23298,28865,5567
"1742","Ocbimv22036560m.g","KQ416645",44000,53027,9027
"1743","Ocbimv22013927m.g","KQ428714",56352,80316,23964
"1744","Ocbimv22015621m.g","KQ418269",313413,317396,3983
"1745","Ocbimv22027382m.g","KQ420268",442655,464073,21418
"1746","Ocbimv22033938m.g","KQ416499",259119,283880,24761
"1747","Ocbimv22033838m.g","KQ421893",107687,130250,22563
"1748","Ocbimv22022713m.g","KQ432975",238831,252575,13744
"1749","Ocbimv22001616m.g","KQ416949",343098,343277,179
"1750","Ocbimv22029913m.g","KQ420843",24767,25180,413
"1751","Ocbimv22021010m.g","KQ431930",8780,9243,463
"1752","Ocbimv22030099m.g","KQ416331",620750,621040,290
"1753","Ocbimv22005788m.g","KQ415823",547533,602285,54752
"1754","Ocbimv22011609m.g","KQ427797",113566,144391,30825
"1755","Ocbimv22014622m.g","KQ429014",27227,33628,6401
"1756","Ocbimv22029124m.g","KQ420660",108959,132482,23523
"1757","Ocbimv22020515m.g","KQ418921",836014,836334,320
"1758","Ocbimv22036083m.g","KQ416616",1262382,1273718,11336
"1759","Ocbimv22006741m.g","KQ417345",476152,521943,45791
"1760","Ocbimv22012898m.g","KQ417950",18627,19335,708
"1761","Ocbimv22037607m.g","KQ423077",813762,814843,1081
"1762","Ocbimv22031932m.g","KQ421377",43226,43603,377
"1763","Ocbimv22026732m.g","KQ416198",233350,235356,2006
"1764","Ocbimv22021275m.g","KQ416041",488405,488620,215
"1765","Ocbimv22033757m.g","KQ421866",1241,31055,29814
"1766","Ocbimv22027882m.g","KQ420387",278047,278394,347
"1767","Ocbimv22039483m.g","KQ423675",395340,447436,52096
"1768","Ocbimv22003222m.g","KQ424909",491638,491943,305
"1769","Ocbimv22030199m.g","KQ420923",36284,45513,9229
"1770","Ocbimv22010622m.g","KQ415669",1509688,1521383,11695
"1771","Ocbimv22003869m.g","KQ417118",270408,313363,42955
"1772","Ocbimv22035544m.g","KQ422426",231424,244461,13037
"1773","Ocbimv22034854m.g","KQ422196",385758,385988,230
"1774","Ocbimv22031609m.g","KQ421295",5758,13472,7714
"1775","Ocbimv22003216m.g","KQ417064",26378,34017,7639
"1776","Ocbimv22011578m.g","KQ417806",322497,323830,1333
"1777","Ocbimv22006828m.g","KQ417358",44455,62206,17751
"1778","Ocbimv22037259m.g","KQ422984",36,233,197
"1779","Ocbimv22007951m.g","LGKD01559340",818,2008,1190
"1780","Ocbimv22005584m.g","KQ425655",373617,413685,40068
"1781","Ocbimv22010042m.g","KQ417634",162430,163080,650
"1782","Ocbimv22005800m.g","KQ415823",1106614,1131702,25088
"1783","Ocbimv22005416m.g","KQ417249",2683128,2685670,2542
"1784","Ocbimv22023487m.g","KQ416088",393839,395697,1858
"1785","Ocbimv22003948m.g","KQ415800",16546,70013,53467
"1786","Ocbimv22010507m.g","KQ417683",15219,15491,272
"1787","Ocbimv22019797m.g","KQ431316",2434,3848,1414
"1788","Ocbimv22010609m.g","KQ415669",507113,507617,504
"1789","Ocbimv22016464m.g","KQ418359",246188,268817,22629
"1790","Ocbimv22004961m.g","KQ425486",462,4624,4162
"1791","Ocbimv22001833m.g","KQ424439",114407,132023,17616
"1792","Ocbimv22028360m.g","KQ420477",373180,377213,4033
"1793","Ocbimv22019317m.g","KQ418749",192310,201601,9291
"1794","Ocbimv22039317m.g","KQ416788",73313,87889,14576
"1795","Ocbimv22005835m.g","KQ417280",119884,120831,947
"1796","Ocbimv22037079m.g","KQ422919",849915,891904,41989
"1797","Ocbimv22017294m.g","KQ430242",31169,40498,9329
"1798","Ocbimv22021051m.g","KQ431971",11,1114,1103
"1799","Ocbimv22031290m.g","KQ421217",308238,314449,6211
"1800","Ocbimv22025132m.g","KQ419701",101433,102482,1049
"1801","Ocbimv22011836m.g","KQ415893",1420051,1420245,194
"1802","Ocbimv22016669m.g","KQ418376",311262,312167,905
"1803","Ocbimv22022620m.g","KQ432925",7117,7344,227
"1804","Ocbimv22001105m.g","KQ424182",143822,144232,410
"1805","Ocbimv22031274m.g","KQ416392",23965,39145,15180
"1806","Ocbimv22036483m.g","KQ422772",46044,46472,428
"1807","Ocbimv22027647m.g","KQ420329",280066,304424,24358
"1808","Ocbimv22026668m.g","KQ416196",418928,419664,736
"1809","Ocbimv22035257m.g","KQ415748",397373,416725,19352
"1810","Ocbimv22039262m.g","KQ423598",204926,215649,10723
"1811","Ocbimv22015403m.g","KQ418240",92331,94893,2562
"1812","Ocbimv22026865m.g","KQ420132",686068,690412,4344
"1813","Ocbimv22016373m.g","KQ415962",1012365,1012688,323
"1814","Ocbimv22015871m.g","KQ418298",31880,32293,413
"1815","Ocbimv22007886m.g","KQ417458",198253,198872,619
"1816","Ocbimv22023462m.g","KQ419414",409879,420853,10974
"1817","Ocbimv22015461m.g","KQ429360",123974,124495,521
"1818","Ocbimv22002053m.g","KQ424530",214357,214668,311
"1819","Ocbimv22028291m.g","KQ420459",12494,12652,158
"1820","Ocbimv22017853m.g","KQ418552",233429,243315,9886
"1821","Ocbimv22030989m.g","KQ416380",155696,192830,37134
"1822","Ocbimv22011889m.g","KQ417845",710973,711314,341
"1823","Ocbimv22025771m.g","KQ416166",915713,917269,1556
"1824","Ocbimv22026072m.g","KQ419983",422214,422477,263
"1825","Ocbimv22032988m.g","LGKD01411925",36,440,404
"1826","Ocbimv22023659m.g","KQ419456",448059,513426,65367
"1827","Ocbimv22004169m.g","KQ425220",216972,218960,1988
"1828","Ocbimv22003570m.g","KQ417091",430805,430978,173
"1829","Ocbimv22017205m.g","KQ430209",106269,108035,1766
"1830","Ocbimv22000799m.g","KQ424072",94960,96780,1820
"1831","Ocbimv22036161m.g","KQ422662",11137,11307,170
"1832","Ocbimv22009929m.g","KQ417623",305472,326482,21010
"1833","Ocbimv22030533m.g","KQ421016",50994,102128,51134
"1834","Ocbimv22020816m.g","KQ418970",428528,441934,13406
"1835","Ocbimv22003248m.g","KQ417068",856132,856290,158
"1836","Ocbimv22039224m.g","KQ423589",1583,2472,889
"1837","Ocbimv22033347m.g","KQ416475",179984,193973,13989
"1838","Ocbimv22013131m.g","KQ417985",364780,375102,10322
"1839","Ocbimv22035063m.g","KQ422263",203922,205997,2075
"1840","Ocbimv22016912m.g","KQ418422",791959,792138,179
"1841","Ocbimv22017707m.g","KQ415981",401594,402960,1366
"1842","Ocbimv22022901m.g","KQ433121",62639,101250,38611
"1843","Ocbimv22004041m.g","KQ425190",84507,85738,1231
"1844","Ocbimv22006907m.g","KQ426137",111,674,563
"1845","Ocbimv22028318m.g","KQ420472",33299,33466,167
"1846","Ocbimv22025716m.g","KQ419887",1066494,1067038,544
"1847","Ocbimv22014636m.g","LGKD01611404",1,1288,1287
"1848","Ocbimv22039842m.g","KQ416831",82327,83739,1412
"1849","Ocbimv22021096m.g","KQ419003",122269,122637,368
"1850","Ocbimv22033859m.g","KQ421896",233360,239334,5974
"1851","Ocbimv22037386m.g","KQ416694",1051776,1062847,11071
"1852","Ocbimv22023081m.g","KQ419345",111446,111631,185
"1853","Ocbimv22038069m.g","KQ416724",380405,381272,867
"1854","Ocbimv22020538m.g","KQ418922",1207492,1389714,182222
"1855","Ocbimv22002927m.g","KQ424849",325,45647,45322
"1856","Ocbimv22038847m.g","KQ415768",113891,160491,46600
"1857","Ocbimv22003764m.g","KQ425096",26939,29356,2417
"1858","Ocbimv22029608m.g","KQ420782",12535,24842,12307
"1859","Ocbimv22015776m.g","LGKD01622064",50,259,209
"1860","Ocbimv22000294m.g","KQ415775",186223,186576,353
"1861","Ocbimv22000785m.g","KQ424065",146442,163411,16969
"1862","Ocbimv22009847m.g","KQ417620",757182,767471,10289
"1863","Ocbimv22007438m.g","KQ417414",42598,43344,746
"1864","Ocbimv22012942m.g","KQ428307",41072,41314,242
"1865","Ocbimv22005504m.g","KQ425633",80339,90339,10000
"1866","Ocbimv22021721m.g","KQ419091",497759,498019,260
"1867","Ocbimv22018335m.g","KQ430665",82813,88972,6159
"1868","Ocbimv22018396m.g","KQ430684",95486,137420,41934
"1869","Ocbimv22026101m.g","KQ419989",363091,368983,5892
"1870","Ocbimv22030515m.g","KQ421009",1248491,1255616,7125
"1871","Ocbimv22022038m.g","LGKD01674243",2,205,203
"1872","Ocbimv22029142m.g","KQ420662",1058953,1059204,251
"1873","Ocbimv22008286m.g","KQ426610",32885,108446,75561
"1874","Ocbimv22035699m.g","KQ422516",917789,935622,17833
"1875","Ocbimv22008580m.g","KQ417510",281956,293994,12038
"1876","Ocbimv22015166m.g","KQ418202",25955,26399,444
"1877","Ocbimv22011253m.g","KQ417771",194914,232119,37205
"1878","Ocbimv22033532m.g","KQ421824",669798,671777,1979
"1879","Ocbimv22028017m.g","KQ420421",10976,11149,173
"1880","Ocbimv22038263m.g","KQ423254",53561,53728,167
"1881","Ocbimv22003639m.g","KQ425061",79814,80886,1072
"1882","Ocbimv22023536m.g","KQ419426",2167,10764,8597
"1883","Ocbimv22012640m.g","KQ428192",108126,123826,15700
"1884","Ocbimv22030198m.g","KQ420923",30751,40860,10109
"1885","Ocbimv22015675m.g","KQ429470",105921,126037,20116
"1886","Ocbimv22000245m.g","KQ423905",82795,84244,1449
"1887","Ocbimv22037285m.g","KQ422989",339712,339923,211
"1888","Ocbimv22015448m.g","KQ418250",137653,139596,1943
"1889","Ocbimv22027502m.g","KQ416226",304612,329405,24793
"1890","Ocbimv22031429m.g","KQ421241",488137,500250,12113
"1891","Ocbimv22000993m.g","KQ416902",156749,192449,35700
"1892","Ocbimv22026083m.g","KQ419989",121120,128299,7179
"1893","Ocbimv22030918m.g","KQ421117",1836826,1850270,13444
"1894","Ocbimv22031625m.g","KQ421305",2687,8258,5571
"1895","Ocbimv22028723m.g","KQ416270",530011,542931,12920
"1896","Ocbimv22013179m.g","KQ418000",20,16624,16604
"1897","Ocbimv22018843m.g","KQ416003",970112,977803,7691
"1898","Ocbimv22039671m.g","KQ416813",652693,654897,2204
"1899","Ocbimv22033276m.g","KQ421759",442713,442973,260
"1900","Ocbimv22030672m.g","KQ416362",58051,58927,876
"1901","Ocbimv22037256m.g","LGKD01101550",38,442,404
"1902","Ocbimv22023862m.g","KQ416102",561721,562491,770
"1903","Ocbimv22027322m.g","KQ420260",347094,347279,185
"1904","Ocbimv22033504m.g","KQ421821",425677,459314,33637
"1905","Ocbimv22021364m.g","KQ432092",1009,33218,32209
"1906","Ocbimv22033243m.g","KQ421758",809473,915072,105599
"1907","Ocbimv22032844m.g","KQ421665",161360,161737,377
"1908","Ocbimv22037053m.g","KQ416670",844,39018,38174
"1909","Ocbimv22025663m.g","KQ419878",243401,244504,1103
"1910","Ocbimv22000736m.g","KQ416877",1160769,1161867,1098
"1911","Ocbimv22015706m.g","KQ429490",44307,44615,308
"1912","Ocbimv22019682m.g","KQ431257",19,1052,1033
"1913","Ocbimv22012250m.g","KQ417893",1494939,1499448,4509
"1914","Ocbimv22028382m.g","KQ416257",407447,438592,31145
"1915","Ocbimv22001623m.g","KQ416950",272526,274007,1481
"1916","Ocbimv22023422m.g","KQ433386",15096,17282,2186
"1917","Ocbimv22009786m.g","KQ427132",99301,104985,5684
"1918","Ocbimv22002050m.g","KQ424530",180735,186375,5640
"1919","Ocbimv22021340m.g","KQ432088",6419,9140,2721
"1920","Ocbimv22001944m.g","KQ416975",110770,111692,922
"1921","Ocbimv22035557m.g","KQ422436",97077,120010,22933
"1922","Ocbimv22026338m.g","KQ420029",260747,262531,1784
"1923","Ocbimv22010690m.g","KQ415880",287674,287901,227
"1924","Ocbimv22034483m.g","KQ422055",122918,138031,15113
"1925","Ocbimv22036065m.g","KQ416616",352569,353418,849
"1926","Ocbimv22005797m.g","KQ415823",942039,943830,1791
"1927","Ocbimv22033092m.g","KQ421725",33025,44640,11615
"1928","Ocbimv22039845m.g","KQ416831",126141,134935,8794
"1929","Ocbimv22019109m.g","KQ430968",21066,66920,45854
"1930","Ocbimv22035048m.g","KQ416569",21203,39319,18116
"1931","Ocbimv22002710m.g","KQ424755",249224,257058,7834
"1932","Ocbimv22000540m.g","KQ416866",36136,36375,239
"1933","Ocbimv22037601m.g","KQ423077",663833,667510,3677
"1934","Ocbimv22039388m.g","KQ423638",184439,185229,790
"1935","Ocbimv22032725m.g","KQ421646",33086,34636,1550
"1936","Ocbimv22008084m.g","KQ426561",175470,317079,141609
"1937","Ocbimv22032518m.g","KQ421573",9532,10392,860
"1938","Ocbimv22004212m.g","KQ425227",82317,82781,464
"1939","Ocbimv22014975m.g","KQ418188",572478,586704,14226
"1940","Ocbimv22017115m.g","KQ418451",175579,176133,554
"1941","Ocbimv22019572m.g","KQ418785",98671,103538,4867
"1942","Ocbimv22014842m.g","KQ415935",115572,153850,38278
"1943","Ocbimv22031596m.g","KQ421289",15222,31139,15917
"1944","Ocbimv22015201m.g","KQ418205",323540,327549,4009
"1945","Ocbimv22021170m.g","KQ415686",436717,437012,295
"1946","Ocbimv22035790m.g","KQ422541",48487,83819,35332
"1947","Ocbimv22026534m.g","KQ420065",197006,203192,6186
"1948","Ocbimv22013046m.g","KQ428352",1284,1442,158
"1949","Ocbimv22003170m.g","KQ417062",88817,110834,22017
"1950","Ocbimv22018091m.g","KQ418571",371152,382585,11433
"1951","Ocbimv22009195m.g","KQ417572",27548,28209,661
"1952","Ocbimv22009461m.g","KQ427011",77296,77715,419
"1953","Ocbimv22015511m.g","KQ415945",431861,432013,152
"1954","Ocbimv22031204m.g","KQ421200",121507,123381,1874
"1955","Ocbimv22000458m.g","KQ416860",19522,26889,7367
"1956","Ocbimv22030305m.g","KQ420942",279186,289957,10771
"1957","Ocbimv22011819m.g","KQ415893",549182,616096,66914
"1958","Ocbimv22030790m.g","KQ416370",42260,42646,386
"1959","Ocbimv22014019m.g","KQ418079",165745,189663,23918
"1960","Ocbimv22039390m.g","KQ423638",201551,202391,840
"1961","Ocbimv22030276m.g","KQ416340",172890,173084,194
"1962","Ocbimv22030164m.g","KQ416336",593361,593537,176
"1963","Ocbimv22038485m.g","KQ423363",276176,276475,299
"1964","Ocbimv22018758m.g","LGKD01645829",147,724,577
"1965","Ocbimv22000606m.g","KQ424017",4525,5139,614
"1966","Ocbimv22024379m.g","KQ419576",159093,161449,2356
"1967","Ocbimv22029025m.g","KQ416281",3051,25205,22154
"1968","Ocbimv22001374m.g","KQ416929",5911,114820,108909
"1969","Ocbimv22028134m.g","KQ416251",1027266,1042966,15700
"1970","Ocbimv22005708m.g","KQ425725",40454,42050,1596
"1971","Ocbimv22029079m.g","KQ420642",163914,164468,554
"1972","Ocbimv22018580m.g","KQ418642",118111,135370,17259
"1973","Ocbimv22010095m.g","KQ417641",463434,463745,311
"1974","Ocbimv22036619m.g","KQ416651",343763,343993,230
"1975","Ocbimv22006203m.g","KQ417304",109060,114821,5761
"1976","Ocbimv22027706m.g","KQ420346",601005,650185,49180
"1977","Ocbimv22029244m.g","KQ420691",211667,232903,21236
"1978","Ocbimv22038089m.g","KQ423213",236002,239993,3991
"1979","Ocbimv22035261m.g","KQ416580",82312,130675,48363
"1980","Ocbimv22024863m.g","KQ419643",370354,370575,221
"1981","Ocbimv22014767m.g","KQ418176",668019,675591,7572
"1982","Ocbimv22019531m.g","KQ418783",25795,28691,2896
"1983","Ocbimv22014228m.g","KQ428805",11676,12998,1322
"1984","Ocbimv22038094m.g","KQ423214",30839,37016,6177
"1985","Ocbimv22014434m.g","KQ428919",1399,6994,5595
"1986","Ocbimv22023988m.g","KQ419514",474029,474686,657
"1987","Ocbimv22030437m.g","KQ420988",176145,176339,194
"1988","Ocbimv22007311m.g","KQ426287",280340,281476,1136
"1989","Ocbimv22000664m.g","KQ416875",42270,42867,597
"1990","Ocbimv22009775m.g","KQ417613",191944,192768,824
"1991","Ocbimv22024481m.g","KQ416124",391539,419069,27530
"1992","Ocbimv22038786m.g","KQ423464",174089,177433,3344
"1993","Ocbimv22033864m.g","KQ421896",274421,305511,31090
"1994","Ocbimv22020736m.g","KQ418957",708239,834377,126138
"1995","Ocbimv22004412m.g","KQ415804",233585,242085,8500
"1996","Ocbimv22001656m.g","KQ416951",365967,377836,11869
"1997","Ocbimv22000537m.g","KQ423989",195125,204456,9331
"1998","Ocbimv22025938m.g","KQ419930",683765,685977,2212
"1999","Ocbimv22011777m.g","KQ415891",1203454,1203700,246
"2000","Ocbimv22014588m.g","KQ428995",146933,147112,179
"2001","Ocbimv22005099m.g","KQ417228",871256,871471,215
"2002","Ocbimv22014718m.g","KQ418170",1482,46159,44677
"2003","Ocbimv22018442m.g","KQ415992",412205,412767,562
"2004","Ocbimv22017399m.g","LGKD01635278",8,190,182
"2005","Ocbimv22003030m.g","KQ417055",1292357,1309584,17227
"2006","Ocbimv22023474m.g","KQ433417",83403,199010,115607
"2007","Ocbimv22031693m.g","KQ421308",918873,941314,22441
"2008","Ocbimv22004633m.g","KQ425400",2487,6695,4208
"2009","Ocbimv22003288m.g","KQ417076",147983,148297,314
"2010","Ocbimv22028908m.g","KQ416274",1332540,1373205,40665
"2011","Ocbimv22014489m.g","KQ428965",42626,43103,477
"2012","Ocbimv22008558m.g","KQ415857",75548,88671,13123
"2013","Ocbimv22029562m.g","KQ420776",660305,666849,6544
"2014","Ocbimv22034394m.g","KQ422028",126645,153136,26491
"2015","Ocbimv22031497m.g","KQ421261",449010,461584,12574
"2016","Ocbimv22002164m.g","KQ424564",81231,92197,10966
"2017","Ocbimv22028534m.g","KQ420517",498501,523117,24616
"2018","Ocbimv22013445m.g","KQ428508",143893,180823,36930
"2019","Ocbimv22034693m.g","KQ416547",86014,89494,3480
"2020","Ocbimv22029591m.g","KQ420779",335693,346695,11002
"2021","Ocbimv22011066m.g","KQ427615",31056,40740,9684
"2022","Ocbimv22038168m.g","KQ416728",20296,20673,377
"2023","Ocbimv22039067m.g","KQ423531",453816,469559,15743
"2024","Ocbimv22021693m.g","KQ416051",1688910,1690817,1907
"2025","Ocbimv22015278m.g","KQ415941",58383,68022,9639
"2026","Ocbimv22032024m.g","KQ421411",201397,207603,6206
"2027","Ocbimv22013590m.g","KQ418038",557664,568293,10629
"2028","Ocbimv22016241m.g","KQ429763",270747,270989,242
"2029","Ocbimv22026702m.g","KQ420096",47948,57433,9485
"2030","Ocbimv22001674m.g","KQ416953",8285,15386,7101
"2031","Ocbimv22026326m.g","KQ420027",23141,27718,4577
"2032","Ocbimv22028640m.g","KQ415707",267910,268167,257
"2033","Ocbimv22029251m.g","KQ420694",73044,74443,1399
"2034","Ocbimv22032027m.g","KQ421411",260086,263842,3756
"2035","Ocbimv22036512m.g","KQ422783",72963,76633,3670
"2036","Ocbimv22000636m.g","KQ424026",11443,25669,14226
"2037","Ocbimv22001569m.g","LGKD01503787",13,129,116
"2038","Ocbimv22035865m.g","KQ422586",385025,385225,200
"2039","Ocbimv22016334m.g","KQ429813",720,1172,452
"2040","Ocbimv22019474m.g","KQ416011",302204,303630,1426
"2041","Ocbimv22013849m.g","KQ418068",95164,96735,1571
"2042","Ocbimv22015402m.g","KQ418240",70720,91842,21122
"2043","Ocbimv22030432m.g","KQ416349",21683,21946,263
"2044","Ocbimv22020809m.g","LGKD01663551",168,335,167
"2045","Ocbimv22039619m.g","KQ416810",316726,321148,4422
"2046","Ocbimv22009842m.g","KQ417620",724813,737244,12431
"2047","Ocbimv22015350m.g","KQ429286",7078,50171,43093
"2048","Ocbimv22003015m.g","KQ417055",35708,36395,687
"2049","Ocbimv22015420m.g","KQ418241",545774,546148,374
"2050","Ocbimv22018270m.g","KQ418590",54023,66327,12304
"2051","Ocbimv22006487m.g","KQ425942",19238,46695,27457
"2052","Ocbimv22003990m.g","KQ425170",30413,31899,1486
"2053","Ocbimv22006511m.g","KQ425967",157723,158160,437
"2054","Ocbimv22013199m.g","KQ415914",234160,237509,3349
"2055","Ocbimv22005662m.g","KQ417271",384731,385942,1211
"2056","Ocbimv22027290m.g","KQ416218",2666,27655,24989
"2057","Ocbimv22009701m.g","KQ427095",11869,21589,9720
"2058","Ocbimv22009782m.g","KQ427127",2678,2872,194
"2059","Ocbimv22031129m.g","KQ415721",69876,113360,43484
"2060","Ocbimv22025085m.g","KQ416137",427816,431740,3924
"2061","Ocbimv22035582m.g","LGKD01441408",248,589,341
"2062","Ocbimv22030275m.g","KQ415717",140990,176390,35400
"2063","Ocbimv22013828m.g","KQ428683",15511,36831,21320
"2064","Ocbimv22020418m.g","KQ431671",11084,12442,1358
"2065","Ocbimv22023520m.g","KQ433432",83354,109951,26597
"2066","Ocbimv22010568m.g","KQ417691",472771,483202,10431
"2067","Ocbimv22018990m.g","KQ418708",455957,456241,284
"2068","Ocbimv22035349m.g","KQ422362",333020,350528,17508
"2069","Ocbimv22029787m.g","KQ420822",21244,94840,73596
"2070","Ocbimv22005370m.g","KQ425599",82081,84505,2424
"2071","Ocbimv22015315m.g","KQ418220",2854,7372,4518
"2072","Ocbimv22034411m.g","KQ422033",17949,30093,12144
"2073","Ocbimv22008545m.g","KQ426678",43830,48624,4794
"2074","Ocbimv22035725m.g","KQ422521",252975,253633,658
"2075","Ocbimv22010754m.g","KQ417713",147704,147862,158
"2076","Ocbimv22018658m.g","KQ418651",79500,97169,17669
"2077","Ocbimv22038354m.g","KQ423289",407,577,170
"2078","Ocbimv22038384m.g","KQ416738",972758,973252,494
"2079","Ocbimv22034485m.g","KQ422055",213161,240066,26905
"2080","Ocbimv22010062m.g","KQ417640",37054,40276,3222
"2081","Ocbimv22036750m.g","KQ422849",148768,170813,22045
"2082","Ocbimv22036376m.g","KQ416636",32257,33054,797
"2083","Ocbimv22008914m.g","KQ426806",6890,7431,541
"2084","Ocbimv22035930m.g","KQ422611",132809,150596,17787
"2085","Ocbimv22003070m.g","KQ424877",122360,122617,257
"2086","Ocbimv22005825m.g","KQ417280",85088,85453,365
"2087","Ocbimv22001758m.g","KQ424404",19577,20092,515
"2088","Ocbimv22033852m.g","KQ421896",99355,103798,4443
"2089","Ocbimv22002723m.g","KQ424761",18344,18790,446
"2090","Ocbimv22001355m.g","KQ416924",831809,849351,17542
"2091","Ocbimv22020791m.g","KQ418964",1167084,1167442,358
"2092","Ocbimv22009901m.g","KQ417622",345356,345824,468
"2093","Ocbimv22023706m.g","KQ419461",33635,34199,564
"2094","Ocbimv22005243m.g","KQ417234",331333,373491,42158
"2095","Ocbimv22000145m.g","KQ423870",32253,40497,8244
"2096","Ocbimv22023948m.g","KQ419504",11463,23536,12073
"2097","Ocbimv22038063m.g","KQ423210",116374,118355,1981
"2098","Ocbimv22008039m.g","KQ417475",141184,141354,170
"2099","Ocbimv22015918m.g","KQ418303",239783,284132,44349
"2100","Ocbimv22013576m.g","KQ418038",320448,331092,10644
"2101","Ocbimv22022402m.g","KQ419215",368620,374332,5712
"2102","Ocbimv22033043m.g","KQ421721",196934,209719,12785
"2103","Ocbimv22026449m.g","KQ420052",192346,194444,2098
"2104","Ocbimv22018601m.g","KQ418644",771118,809367,38249
"2105","Ocbimv22025552m.g","KQ416158",118794,121736,2942
"2106","Ocbimv22019504m.g","KQ416013",308354,331242,22888
"2107","Ocbimv22016681m.g","KQ418380",118773,120252,1479
"2108","Ocbimv22036440m.g","KQ422762",233362,234252,890
"2109","Ocbimv22006945m.g","KQ426160",62533,66838,4305
"2110","Ocbimv22028539m.g","KQ416260",80898,88399,7501
"2111","Ocbimv22015270m.g","KQ418216",1192849,1193661,812
"2112","Ocbimv22026436m.g","KQ420052",26527,40405,13878
"2113","Ocbimv22008921m.g","KQ426806",133718,134070,352
"2114","Ocbimv22027630m.g","KQ420320",379104,391264,12160
"2115","Ocbimv22029820m.g","KQ420828",868734,869402,668
"2116","Ocbimv22029105m.g","KQ420650",173560,204688,31128
"2117","Ocbimv22006056m.g","KQ417293",133092,133571,479
"2118","Ocbimv22016090m.g","KQ415954",254997,255574,577
"2119","Ocbimv22003310m.g","KQ424959",15,647,632
"2120","Ocbimv22001427m.g","KQ416933",91298,111263,19965
"2121","Ocbimv22017889m.g","KQ418555",19457,20268,811
"2122","Ocbimv22012065m.g","KQ417860",11823,12774,951
"2123","Ocbimv22008853m.g","KQ426791",48541,48934,393
"2124","Ocbimv22020534m.g","KQ418922",1135501,1135903,402
"2125","Ocbimv22016468m.g","KQ415966",20907,22607,1700
"2126","Ocbimv22004360m.g","KQ417152",980631,981219,588
"2127","Ocbimv22037560m.g","KQ416701",185589,187271,1682
"2128","Ocbimv22028118m.g","KQ420434",136635,137099,464
"2129","Ocbimv22013818m.g","KQ418063",6243,39812,33569
"2130","Ocbimv22024168m.g","KQ419543",382979,452665,69686
"2131","Ocbimv22000406m.g","KQ423957",42825,43397,572
"2132","Ocbimv22018138m.g","KQ415987",261922,271966,10044
"2133","Ocbimv22010390m.g","KQ415876",1911661,1911990,329
"2134","Ocbimv22021386m.g","KQ432116",8059,12029,3970
"2135","Ocbimv22035899m.g","KQ422595",370822,380399,9577
"2136","Ocbimv22015790m.g","KQ418293",241990,293738,51748
"2137","Ocbimv22020942m.g","KQ418982",69179,97789,28610
"2138","Ocbimv22033946m.g","KQ421912",125821,154898,29077
"2139","Ocbimv22025974m.g","KQ419939",30947,36326,5379
"2140","Ocbimv22036188m.g","KQ422667",390692,390970,278
"2141","Ocbimv22006232m.g","KQ425847",266183,269819,3636
"2142","Ocbimv22004966m.g","KQ417218",170258,171163,905
"2143","Ocbimv22037192m.g","KQ416682",3622,5016,1394
"2144","Ocbimv22008477m.g","KQ415854",778338,781403,3065
"2145","Ocbimv22020987m.g","KQ418989",45817,46879,1062
"2146","Ocbimv22036475m.g","KQ416642",112636,113437,801
"2147","Ocbimv22017396m.g","KQ430278",1,394,393
"2148","Ocbimv22005285m.g","KQ425570",24127,38864,14737
"2149","Ocbimv22025359m.g","KQ419781",100604,171765,71161
"2150","Ocbimv22025251m.g","KQ419747",12021,16625,4604
"2151","Ocbimv22017215m.g","KQ418468",282801,320006,37205
"2152","Ocbimv22011732m.g","KQ427883",8281,44834,36553
"2153","Ocbimv22021067m.g","KQ431974",223481,225753,2272
"2154","Ocbimv22014131m.g","KQ428769",12296,101759,89463
"2155","Ocbimv22005142m.g","KQ415813",1637639,1637902,263
"2156","Ocbimv22017546m.g","LGKD01636392",16,171,155
"2157","Ocbimv22000603m.g","KQ424015",426618,427060,442
"2158","Ocbimv22015640m.g","KQ418271",151572,151988,416
"2159","Ocbimv22007698m.g","KQ415846",1889936,1891039,1103
"2160","Ocbimv22007515m.g","KQ426358",48277,48654,377
"2161","Ocbimv22022876m.g","KQ419318",279695,313417,33722
"2162","Ocbimv22038340m.g","KQ415764",524677,524927,250
"2163","Ocbimv22004834m.g","KQ417209",144149,149807,5658
"2164","Ocbimv22009270m.g","KQ426944",111536,156037,44501
"2165","Ocbimv22038575m.g","KQ416752",10612,11151,539
"2166","Ocbimv22000882m.g","KQ424103",5214,5615,401
"2167","Ocbimv22031124m.g","KQ421171",89775,90401,626
"2168","Ocbimv22002619m.g","KQ417023",687545,713845,26300
"2169","Ocbimv22029098m.g","KQ420648",7215,8171,956
"2170","Ocbimv22031109m.g","KQ416385",1293872,1294030,158
"2171","Ocbimv22005565m.g","KQ425654",158840,178226,19386
"2172","Ocbimv22004409m.g","KQ415804",153383,200319,46936
"2173","Ocbimv22018225m.g","KQ415990",1989174,2000775,11601
"2174","Ocbimv22027420m.g","KQ420270",160750,166732,5982
"2175","Ocbimv22010061m.g","KQ417640",18532,19448,916
"2176","Ocbimv22005240m.g","KQ425549",68719,82567,13848
"2177","Ocbimv22032614m.g","KQ421607",264221,279980,15759
"2178","Ocbimv22007851m.g","KQ417455",179367,201370,22003
"2179","Ocbimv22035390m.g","KQ422367",2701,98559,95858
"2180","Ocbimv22017026m.g","KQ418438",157547,157801,254
"2181","Ocbimv22002808m.g","KQ417037",440950,451535,10585
"2182","Ocbimv22011290m.g","KQ417776",209591,209869,278
"2183","Ocbimv22004489m.g","KQ417173",49277,50855,1578
"2184","Ocbimv22015302m.g","KQ418217",35216,51540,16324
"2185","Ocbimv22035384m.g","KQ422366",67079,71018,3939
"2186","Ocbimv22021617m.g","LGKD01669795",511,819,308
"2187","Ocbimv22009926m.g","KQ417623",154628,159325,4697
"2188","Ocbimv22015111m.g","KQ418195",106229,107466,1237
"2189","Ocbimv22017557m.g","KQ415978",297061,325248,28187
"2190","Ocbimv22012061m.g","KQ417858",226541,231767,5226
"2191","Ocbimv22029199m.g","KQ420675",150157,167196,17039
"2192","Ocbimv22024593m.g","KQ419601",810776,830621,19845
"2193","Ocbimv22020075m.g","KQ418849",248069,375295,127226
"2194","Ocbimv22039685m.g","KQ416813",2054610,2055509,899
"2195","Ocbimv22010909m.g","KQ417724",139956,142067,2111
"2196","Ocbimv22028537m.g","KQ416260",5006,72120,67114
"2197","Ocbimv22026156m.g","KQ420006",218076,219790,1714
"2198","Ocbimv22017422m.g","KQ418495",8589,48910,40321
"2199","Ocbimv22004752m.g","KQ425434",147932,246920,98988
"2200","Ocbimv22029304m.g","KQ420701",111961,112890,929
"2201","Ocbimv22012533m.g","KQ417917",761481,764129,2648
"2202","Ocbimv22001022m.g","KQ424157",292762,292996,234
"2203","Ocbimv22019464m.g","KQ418770",271458,288880,17422
"2204","Ocbimv22016961m.g","KQ418430",222959,229827,6868
"2205","Ocbimv22037693m.g","KQ423101",91517,91916,399
"2206","Ocbimv22020226m.g","KQ431541",140821,142053,1232
"2207","Ocbimv22024653m.g","KQ419607",202280,255555,53275
"2208","Ocbimv22030594m.g","KQ421034",368905,369465,560
"2209","Ocbimv22009232m.g","KQ426935",77417,87057,9640
"2210","Ocbimv22023252m.g","KQ419380",372107,383200,11093
"2211","Ocbimv22030687m.g","KQ421067",39670,41554,1884
"2212","Ocbimv22035607m.g","KQ422462",3423,3743,320
"2213","Ocbimv22034783m.g","KQ422172",42267,72597,30330
"2214","Ocbimv22002398m.g","KQ424657",30392,30802,410
"2215","Ocbimv22010977m.g","KQ427579",28140,28557,417
"2216","Ocbimv22015532m.g","KQ429401",14189,28513,14324
"2217","Ocbimv22003638m.g","LGKD01139073",159,527,368
"2218","Ocbimv22011034m.g","KQ427610",70,339,269
"2219","Ocbimv22039768m.g","KQ423744",105206,107316,2110
"2220","Ocbimv22010449m.g","KQ427392",250307,267318,17011
"2221","Ocbimv22036239m.g","KQ422688",75510,75938,428
"2222","Ocbimv22005588m.g","KQ425656",55181,105890,50709
"2223","Ocbimv22035617m.g","KQ422474",100306,102226,1920
"2224","Ocbimv22032512m.g","KQ421570",54040,54495,455
"2225","Ocbimv22028946m.g","KQ420605",732275,735886,3611
"2226","Ocbimv22028081m.g","KQ416247",90420,90722,302
"2227","Ocbimv22011791m.g","KQ417832",1185139,1191150,6011
"2228","Ocbimv22016170m.g","KQ429720",168606,191946,23340
"2229","Ocbimv22038580m.g","KQ423411",227470,244610,17140
"2230","Ocbimv22015632m.g","KQ418269",1064878,1075922,11044
"2231","Ocbimv22030699m.g","KQ421074",71647,74920,3273
"2232","Ocbimv22009207m.g","KQ417574",399248,399478,230
"2233","Ocbimv22023488m.g","KQ416088",511108,553266,42158
"2234","Ocbimv22010338m.g","KQ415875",7307,13452,6145
"2235","Ocbimv22006065m.g","KQ417293",387932,388204,272
"2236","Ocbimv22010373m.g","KQ415876",353287,353791,504
"2237","Ocbimv22000630m.g","KQ416870",259591,260103,512
"2238","Ocbimv22033596m.g","KQ421843",77948,134087,56139
"2239","Ocbimv22021481m.g","KQ419056",129296,134947,5651
"2240","Ocbimv22008318m.g","KQ417497",16696,18156,1460
"2241","Ocbimv22013536m.g","LGKD01602496",57,326,269
"2242","Ocbimv22039276m.g","KQ416787",68090,86987,18897
"2243","Ocbimv22017767m.g","KQ418543",153105,153332,227
"2244","Ocbimv22017723m.g","KQ430437",126720,127414,694
"2245","Ocbimv22008495m.g","KQ417506",212292,213143,851
"2246","Ocbimv22021671m.g","KQ416049",409025,449739,40714
"2247","Ocbimv22039275m.g","KQ416787",10031,58711,48680
"2248","Ocbimv22035615m.g","KQ422474",14994,15176,182
"2249","Ocbimv22039689m.g","KQ416814",3503,5233,1730
"2250","Ocbimv22016561m.g","KQ418367",674476,674982,506
"2251","Ocbimv22013905m.g","KQ428708",39543,39866,323
"2252","Ocbimv22031299m.g","KQ421217",401675,404600,2925
"2253","Ocbimv22001289m.g","KQ416918",1090980,1091204,224
"2254","Ocbimv22026633m.g","KQ420083",22328,22740,412
"2255","Ocbimv22002353m.g","KQ424644",71188,75853,4665
"2256","Ocbimv22010894m.g","KQ427563",601,62187,61586
"2257","Ocbimv22039955m.g","KQ423809",36148,40102,3954
"2258","Ocbimv22009870m.g","KQ417620",1974560,1977183,2623
"2259","Ocbimv22019988m.g","KQ418840",1271006,1271266,260
"2260","Ocbimv22019833m.g","KQ431332",578924,600730,21806
"2261","Ocbimv22005073m.g","KQ425511",28435,28928,493
"2262","Ocbimv22021566m.g","KQ419078",296408,297229,821
"2263","Ocbimv22010314m.g","KQ417668",57473,57715,242
"2264","Ocbimv22017041m.g","KQ418444",75,12533,12458
"2265","Ocbimv22030442m.g","KQ416350",7863,104074,96211
"2266","Ocbimv22001351m.g","KQ416924",631152,632447,1295
"2267","Ocbimv22021450m.g","KQ432154",23091,24928,1837
"2268","Ocbimv22007154m.g","KQ417385",90825,99767,8942
"2269","Ocbimv22032038m.g","KQ421411",507992,537635,29643
"2270","Ocbimv22012719m.g","KQ417929",292314,308584,16270
"2271","Ocbimv22028902m.g","KQ416274",1054107,1081634,27527
"2272","Ocbimv22019876m.g","LGKD01654863",38,412,374
"2273","Ocbimv22012253m.g","KQ428084",2000,8851,6851
"2274","Ocbimv22011185m.g","KQ427664",87877,89226,1349
"2275","Ocbimv22025291m.g","KQ419763",66844,69151,2307
"2276","Ocbimv22016139m.g","KQ418322",234464,261209,26745
"2277","Ocbimv22008024m.g","KQ426531",14754,15182,428
"2278","Ocbimv22015241m.g","KQ418214",30548,31923,1375
"2279","Ocbimv22007109m.g","KQ417379",91372,92299,927
"2280","Ocbimv22032372m.g","KQ416430",70899,71583,684
"2281","Ocbimv22026873m.g","KQ420132",889414,897657,8243
"2282","Ocbimv22025224m.g","KQ416145",660341,660721,380
"2283","Ocbimv22017489m.g","KQ430316",59313,63612,4299
"2284","Ocbimv22033378m.g","KQ416479",353858,373626,19768
"2285","Ocbimv22010960m.g","KQ427570",237359,238163,804
"2286","Ocbimv22027491m.g","KQ416226",606,30638,30032
"2287","Ocbimv22011859m.g","KQ427929",13115,26371,13256
"2288","Ocbimv22008078m.g","KQ426561",76144,79832,3688
"2289","Ocbimv22028938m.g","KQ420605",55331,64436,9105
"2290","Ocbimv22036839m.g","KQ422871",95509,100616,5107
"2291","Ocbimv22014456m.g","KQ428936",29500,31466,1966
"2292","Ocbimv22025532m.g","KQ419831",433460,434578,1118
"2293","Ocbimv22000981m.g","KQ424142",220058,225588,5530
"2294","Ocbimv22019798m.g","KQ431316",137098,137328,230
"2295","Ocbimv22035234m.g","KQ422338",175153,185207,10054
"2296","Ocbimv22016530m.g","KQ418364",665582,687674,22092
"2297","Ocbimv22000598m.g","KQ424015",350779,381522,30743
"2298","Ocbimv22005832m.g","KQ417280",110676,110849,173
"2299","Ocbimv22004430m.g","KQ425304",37652,39532,1880
"2300","Ocbimv22027378m.g","KQ420268",183184,428325,245141
"2301","Ocbimv22019124m.g","KQ430988",43940,59450,15510
"2302","Ocbimv22018904m.g","KQ430924",169870,173258,3388
"2303","Ocbimv22013255m.g","KQ428426",93421,97856,4435
"2304","Ocbimv22030163m.g","KQ416336",270715,271191,476
"2305","Ocbimv22018858m.g","KQ418693",121085,121636,551
"2306","Ocbimv22038371m.g","KQ423298",8724,9849,1125
"2307","Ocbimv22033971m.g","KQ416503",382530,382922,392
"2308","Ocbimv22026874m.g","KQ420132",893463,893786,323
"2309","Ocbimv22007274m.g","KQ417397",56021,95521,39500
"2310","Ocbimv22005902m.g","KQ417284",20080,20490,410
"2311","Ocbimv22012679m.g","KQ417925",5599,7219,1620
"2312","Ocbimv22010299m.g","KQ417666",322422,322622,200
"2313","Ocbimv22037600m.g","KQ423077",617683,639825,22142
"2314","Ocbimv22017868m.g","KQ418552",468304,496115,27811
"2315","Ocbimv22010232m.g","KQ427324",4,858,854
"2316","Ocbimv22027602m.g","KQ420313",482770,483165,395
"2317","Ocbimv22025760m.g","KQ416166",499109,500104,995
"2318","Ocbimv22026447m.g","KQ420052",153178,154706,1528
"2319","Ocbimv22007189m.g","KQ426231",81773,82829,1056
"2320","Ocbimv22004950m.g","KQ417216",153276,155694,2418
"2321","Ocbimv22020032m.g","KQ418843",276840,277938,1098
"2322","Ocbimv22031072m.g","KQ416384",37506,37742,236
"2323","Ocbimv22015758m.g","KQ418290",18316,74232,55916
"2324","Ocbimv22020057m.g","KQ418847",15395,74824,59429
"2325","Ocbimv22023719m.g","KQ416094",599281,599667,386
"2326","Ocbimv22031630m.g","KQ421305",79584,84790,5206
"2327","Ocbimv22009048m.g","KQ415859",752287,758043,5756
"2328","Ocbimv22006048m.g","KQ417292",148500,149081,581
"2329","Ocbimv22002425m.g","KQ417009",1314440,1321969,7529
"2330","Ocbimv22017257m.g","KQ430229",1,489,488
"2331","Ocbimv22013546m.g","KQ428560",5638,7937,2299
"2332","Ocbimv22032528m.g","LGKD01405169",127,429,302
"2333","Ocbimv22027583m.g","KQ420308",89207,90502,1295
"2334","Ocbimv22028905m.g","KQ416274",1143845,1178320,34475
"2335","Ocbimv22011010m.g","KQ427587",147910,162293,14383
"2336","Ocbimv22015539m.g","KQ429407",69109,69418,309
"2337","Ocbimv22009276m.g","KQ426944",370292,378658,8366
"2338","Ocbimv22011273m.g","KQ427696",16638,17123,485
"2339","Ocbimv22020837m.g","KQ418970",2214702,2221453,6751
"2340","Ocbimv22013242m.g","KQ418003",364806,365072,266
"2341","Ocbimv22018816m.g","KQ418683",194013,194330,317
"2342","Ocbimv22034640m.g","KQ422097",374722,376274,1552
"2343","Ocbimv22000431m.g","KQ423963",64273,86352,22079
"2344","Ocbimv22022282m.g","KQ419192",580573,596535,15962
"2345","Ocbimv22000803m.g","LGKD01494738",3,863,860
"2346","Ocbimv22029654m.g","KQ416315",40727,86283,45556
"2347","Ocbimv22025693m.g","KQ419887",46008,48507,2499
"2348","Ocbimv22001261m.g","KQ424243",270522,270775,253
"2349","Ocbimv22035228m.g","KQ416579",36545,36928,383
"2350","Ocbimv22031855m.g","KQ421359",8130,9213,1083
"2351","Ocbimv22005193m.g","KQ425540",2920,71657,68737
"2352","Ocbimv22018239m.g","KQ430604",1945,12885,10940
"2353","Ocbimv22008105m.g","KQ426567",178143,178697,554
"2354","Ocbimv22037581m.g","KQ423077",46035,47503,1468
"2355","Ocbimv22000075m.g","LGKD01488510",51,466,415
"2356","Ocbimv22029783m.g","KQ420821",271695,282496,10801
"2357","Ocbimv22010704m.g","KQ417704",56356,73851,17495
"2358","Ocbimv22014592m.g","KQ428995",278915,298217,19302
"2359","Ocbimv22007506m.g","KQ417417",190033,193205,3172
"2360","Ocbimv22037702m.g","KQ423103",6359,25614,19255
"2361","Ocbimv22003785m.g","KQ417112",678249,703944,25695
"2362","Ocbimv22019848m.g","KQ418821",716126,720359,4233
"2363","Ocbimv22018941m.g","KQ418701",118938,121647,2709
"2364","Ocbimv22000926m.g","KQ416895",705093,706922,1829
"2365","Ocbimv22031554m.g","KQ421273",693839,695153,1314
"2366","Ocbimv22006822m.g","KQ417358",8501,10004,1503
"2367","Ocbimv22031601m.g","KQ421289",128491,137444,8953
"2368","Ocbimv22009856m.g","KQ417620",1266753,1268339,1586
"2369","Ocbimv22018968m.g","KQ430934",87097,107599,20502
"2370","Ocbimv22026496m.g","KQ420059",268087,289353,21266
"2371","Ocbimv22027618m.g","LGKD01347967",39,296,257
"2372","Ocbimv22019071m.g","KQ416006",297688,352168,54480
"2373","Ocbimv22005618m.g","KQ425681",90871,101901,11030
"2374","Ocbimv22033552m.g","KQ421830",53042,53399,357
"2375","Ocbimv22015415m.g","KQ418241",114537,157071,42534
"2376","Ocbimv22004075m.g","KQ417133",597780,598128,348
"2377","Ocbimv22033120m.g","KQ421731",273226,315815,42589
"2378","Ocbimv22019980m.g","KQ418840",801274,802587,1313
"2379","Ocbimv22035066m.g","KQ422263",237746,240445,2699
"2380","Ocbimv22013437m.g","KQ428507",19103,20703,1600
"2381","Ocbimv22002455m.g","KQ424659",232964,234276,1312
"2382","Ocbimv22012760m.g","KQ417936",203586,204239,653
"2383","Ocbimv22018535m.g","KQ415995",98347,105753,7406
"2384","Ocbimv22009351m.g","KQ417585",807437,829093,21656
"2385","Ocbimv22023755m.g","KQ416096",495994,498468,2474
"2386","Ocbimv22006874m.g","KQ426130",118572,128173,9601
"2387","Ocbimv22000511m.g","KQ415777",528306,529203,897
"2388","Ocbimv22027937m.g","KQ420404",1218633,1218818,185
"2389","Ocbimv22018881m.g","KQ430914",150607,154382,3775
"2390","Ocbimv22021079m.g","KQ418998",1729009,1729580,571
"2391","Ocbimv22034596m.g","KQ422083",33000,33158,158
"2392","Ocbimv22021963m.g","KQ432471",95335,95860,525
"2393","Ocbimv22032002m.g","KQ421409",933225,936657,3432
"2394","Ocbimv22033438m.g","LGKD01417240",38,229,191
"2395","Ocbimv22017420m.g","KQ418494",22051,23922,1871
"2396","Ocbimv22003949m.g","KQ425159",686,22098,21412
"2397","Ocbimv22016834m.g","KQ418409",86447,100749,14302
"2398","Ocbimv22014703m.g","KQ418168",595187,605613,10426
"2399","Ocbimv22029462m.g","KQ420758",61806,62932,1126
"2400","Ocbimv22036973m.g","KQ416666",2452458,2462138,9680
"2401","Ocbimv22033042m.g","KQ421721",47053,47403,350
"2402","Ocbimv22007396m.g","KQ426326",527369,527608,239
"2403","Ocbimv22037399m.g","KQ416694",1477771,1477983,212
"2404","Ocbimv22001244m.g","KQ424238",112183,129775,17592
"2405","Ocbimv22020437m.g","KQ431676",4922,27704,22782
"2406","Ocbimv22029700m.g","KQ420810",41,723,682
"2407","Ocbimv22010582m.g","KQ417693",151710,151874,164
"2408","Ocbimv22011944m.g","KQ417847",1035785,1063302,27517
"2409","Ocbimv22005653m.g","KQ425702",272215,280626,8411
"2410","Ocbimv22031772m.g","KQ421342",186118,211589,25471
"2411","Ocbimv22036813m.g","KQ416658",1253489,1253965,476
"2412","Ocbimv22036514m.g","KQ422783",81268,97115,15847
"2413","Ocbimv22012718m.g","KQ417929",274304,286501,12197
"2414","Ocbimv22011282m.g","KQ427699",75533,84622,9089
"2415","Ocbimv22016695m.g","KQ429968",14438,14862,424
"2416","Ocbimv22006744m.g","KQ426095",87411,87590,179
"2417","Ocbimv22014756m.g","KQ418175",676945,677133,188
"2418","Ocbimv22036413m.g","KQ416641",295970,320560,24590
"2419","Ocbimv22012970m.g","KQ417965",2925,20801,17876
"2420","Ocbimv22021448m.g","LGKD01668288",767,1186,419
"2421","Ocbimv22029080m.g","KQ420642",171424,211231,39807
"2422","Ocbimv22031931m.g","KQ421377",41281,41766,485
"2423","Ocbimv22025879m.g","KQ416175",174055,174963,908
"2424","Ocbimv22006598m.g","KQ426027",92195,110879,18684
"2425","Ocbimv22036377m.g","LGKD01450868",1,953,952
"2426","Ocbimv22039615m.g","KQ416810",57626,58051,425
"2427","Ocbimv22008092m.g","KQ426567",49341,49958,617
"2428","Ocbimv22008456m.g","KQ415854",338460,348120,9660
"2429","Ocbimv22025740m.g","KQ415694",135561,146846,11285
"2430","Ocbimv22003425m.g","KQ417087",610703,626753,16050
"2431","Ocbimv22037341m.g","KQ423006",115291,141732,26441
"2432","Ocbimv22039908m.g","KQ416834",350192,351349,1157
"2433","Ocbimv22029943m.g","KQ416325",109713,113021,3308
"2434","Ocbimv22036127m.g","KQ422647",191568,198933,7365
"2435","Ocbimv22017779m.g","KQ430471",12637,30427,17790
"2436","Ocbimv22001204m.g","KQ424229",49971,101016,51045
"2437","Ocbimv22017611m.g","KQ430378",126750,127376,626
"2438","Ocbimv22014558m.g","KQ418153",65860,66926,1066
"2439","Ocbimv22017437m.g","KQ418496",76444,82716,6272
"2440","Ocbimv22008696m.g","KQ426737",41234,63235,22001
"2441","Ocbimv22010877m.g","KQ417722",13305,13790,485
"2442","Ocbimv22025955m.g","KQ416177",44015,212607,168592
"2443","Ocbimv22004115m.g","KQ417137",361762,402664,40902
"2444","Ocbimv22004795m.g","KQ417208",365,6077,5712
"2445","Ocbimv22033704m.g","KQ421859",27985,36896,8911
"2446","Ocbimv22021845m.g","KQ415687",1146543,1151120,4577
"2447","Ocbimv22038114m.g","KQ423217",54739,104632,49893
"2448","Ocbimv22015231m.g","KQ429228",19435,31903,12468
"2449","Ocbimv22001112m.g","KQ424182",331761,344820,13059
"2450","Ocbimv22029431m.g","KQ416306",140652,140801,149
"2451","Ocbimv22026191m.g","KQ420015",189268,189657,389
"2452","Ocbimv22009162m.g","KQ426907",5090,14545,9455
"2453","Ocbimv22020326m.g","KQ418892",436039,436206,167
"2454","Ocbimv22024057m.g","KQ419527",141558,143320,1762
"2455","Ocbimv22008439m.g","KQ426638",31254,38146,6892
"2456","Ocbimv22039684m.g","KQ416813",2000171,2000944,773
"2457","Ocbimv22010517m.g","KQ417685",130185,146745,16560
"2458","Ocbimv22000573m.g","KQ423998",230618,237340,6722
"2459","Ocbimv22004148m.g","KQ417141",350321,351239,918
"2460","Ocbimv22016299m.g","KQ429801",17648,18652,1004
"2461","Ocbimv22030831m.g","KQ421105",17611,24374,6763
"2462","Ocbimv22003153m.g","KQ424899",21853,27686,5833
"2463","Ocbimv22002296m.g","LGKD01129792",13,183,170
"2464","Ocbimv22011097m.g","KQ417747",528243,538739,10496
"2465","Ocbimv22011205m.g","KQ427679",102151,102375,224
"2466","Ocbimv22016023m.g","KQ429661",84169,122000,37831
"2467","Ocbimv22007760m.g","KQ415847",877987,881565,3578
"2468","Ocbimv22007540m.g","KQ426371",52458,52631,173
"2469","Ocbimv22006130m.g","KQ417300",324389,324709,320
"2470","Ocbimv22034999m.g","KQ422238",36616,38557,1941
"2471","Ocbimv22029222m.g","KQ420685",416156,416350,194
"2472","Ocbimv22024412m.g","KQ419577",264455,265139,684
"2473","Ocbimv22026043m.g","KQ419973",68,12089,12021
"2474","Ocbimv22003472m.g","KQ425015",615348,654865,39517
"2475","Ocbimv22011707m.g","KQ417824",470269,471639,1370
"2476","Ocbimv22002381m.g","KQ417007",140116,206925,66809
"2477","Ocbimv22011379m.g","KQ417791",513532,524929,11397
"2478","Ocbimv22003735m.g","KQ425077",47289,47588,299
"2479","Ocbimv22028682m.g","KQ420554",88226,103916,15690
"2480","Ocbimv22025444m.g","KQ419801",236488,238845,2357
"2481","Ocbimv22024369m.g","KQ419574",909176,914287,5111
"2482","Ocbimv22039459m.g","KQ423671",237445,243955,6510
"2483","Ocbimv22034796m.g","KQ422176",286963,287676,713
"2484","Ocbimv22037491m.g","KQ423046",91899,95970,4071
"2485","Ocbimv22016807m.g","KQ418402",232849,233391,542
"2486","Ocbimv22016741m.g","KQ418391",353,1039,686
"2487","Ocbimv22001605m.g","KQ424367",276396,276681,285
"2488","Ocbimv22016864m.g","KQ418413",279510,287252,7742
"2489","Ocbimv22026800m.g","KQ420118",277,30352,30075
"2490","Ocbimv22022086m.g","KQ416059",148990,149556,566
"2491","Ocbimv22009489m.g","KQ415865",344121,344402,281
"2492","Ocbimv22015149m.g","KQ418200",466517,484501,17984
"2493","Ocbimv22028427m.g","KQ415705",232424,232609,185
"2494","Ocbimv22038296m.g","KQ416734",11104,21832,10728
"2495","Ocbimv22003642m.g","KQ417098",35879,43980,8101
"2496","Ocbimv22000532m.g","KQ423988",69827,91383,21556
"2497","Ocbimv22010279m.g","KQ427344",108633,114059,5426
"2498","Ocbimv22021514m.g","KQ419064",23905,24477,572
"2499","Ocbimv22006787m.g","LGKD01549702",149,364,215
"2500","Ocbimv22005191m.g","KQ425538",280555,280737,182
"2501","Ocbimv22021457m.g","KQ416046",66701,67059,358
"2502","Ocbimv22022144m.g","KQ419176",635,8174,7539
"2503","Ocbimv22019161m.g","KQ431024",16561,19635,3074
"2504","Ocbimv22020905m.g","KQ418974",305911,309668,3757
"2505","Ocbimv22016285m.g","KQ429791",16192,17424,1232
"2506","Ocbimv22030859m.g","KQ416373",556028,641033,85005
"2507","Ocbimv22002385m.g","KQ417007",235174,237165,1991
"2508","Ocbimv22004134m.g","KQ417138",641765,642051,286
"2509","Ocbimv22001599m.g","KQ424367",171766,194339,22573
"2510","Ocbimv22035944m.g","KQ416612",924310,928211,3901
"2511","Ocbimv22026742m.g","KQ416198",417382,425708,8326
"2512","Ocbimv22004756m.g","KQ417205",19270,23151,3881
"2513","Ocbimv22027544m.g","KQ420299",1688134,1696138,8004
"2514","Ocbimv22012127m.g","KQ415902",100137,132457,32320
"2515","Ocbimv22029237m.g","KQ420690",111074,161185,50111
"2516","Ocbimv22032207m.g","KQ416425",66327,67928,1601
"2517","Ocbimv22028854m.g","KQ420593",247603,248007,404
"2518","Ocbimv22015901m.g","KQ429626",59865,61320,1455
"2519","Ocbimv22025092m.g","KQ416137",461646,461996,350
"2520","Ocbimv22021888m.g","KQ432395",213,629,416
"2521","Ocbimv22004389m.g","KQ425289",310876,341989,31113
"2522","Ocbimv22033872m.g","KQ421896",375282,386818,11536
"2523","Ocbimv22029915m.g","KQ420844",4201,81521,77320
"2524","Ocbimv22002813m.g","KQ417037",922469,922703,234
"2525","Ocbimv22007727m.g","KQ426439",65463,66147,684
"2526","Ocbimv22015321m.g","KQ418220",82085,82912,827
"2527","Ocbimv22014834m.g","KQ429098",15935,16084,149
"2528","Ocbimv22013865m.g","KQ428699",47798,49543,1745
"2529","Ocbimv22004271m.g","KQ425254",9614,12991,3377
"2530","Ocbimv22026492m.g","KQ416189",291618,341010,49392
"2531","Ocbimv22025571m.g","KQ419849",8038,38273,30235
"2532","Ocbimv22031198m.g","KQ421200",19958,21430,1472
"2533","Ocbimv22009179m.g","KQ426911",67022,100657,33635
"2534","Ocbimv22000960m.g","KQ415782",485574,487187,1613
"2535","Ocbimv22034136m.g","KQ421984",200645,209213,8568
"2536","Ocbimv22026526m.g","KQ416191",298945,299229,284
"2537","Ocbimv22010270m.g","KQ427339",153420,184054,30634
"2538","Ocbimv22000596m.g","KQ424015",290824,301154,10330
"2539","Ocbimv22037663m.g","KQ416705",1684529,1685155,626
"2540","Ocbimv22031943m.g","KQ415727",445025,445775,750
"2541","Ocbimv22012727m.g","KQ417931",57168,57537,369
"2542","Ocbimv22010254m.g","KQ415873",219813,244102,24289
"2543","Ocbimv22031094m.g","LGKD01075090",160,366,206
"2544","Ocbimv22021395m.g","KQ432116",42260,47044,4784
"2545","Ocbimv22019855m.g","KQ418823",4,3146,3142
"2546","Ocbimv22002552m.g","KQ424685",28415,29041,626
"2547","Ocbimv22009189m.g","KQ426914",37423,38038,615
"2548","Ocbimv22032657m.g","KQ421628",186138,195962,9824
"2549","Ocbimv22032476m.g","KQ421549",625805,670727,44922
"2550","Ocbimv22031878m.g","KQ421370",67571,67788,217
"2551","Ocbimv22007249m.g","KQ426259",344089,344851,762
"2552","Ocbimv22035765m.g","KQ416600",33766,44571,10805
"2553","Ocbimv22005328m.g","KQ417241",34505,34870,365
"2554","Ocbimv22031545m.g","KQ421273",241533,249598,8065
"2555","Ocbimv22030498m.g","KQ416353",151268,151907,639
"2556","Ocbimv22015780m.g","KQ429566",73900,78285,4385
"2557","Ocbimv22013747m.g","KQ428648",45682,46056,374
"2558","Ocbimv22030517m.g","KQ421009",1412621,1412899,278
"2559","Ocbimv22005811m.g","KQ415823",1357683,1371062,13379
"2560","Ocbimv22036817m.g","KQ416658",2152320,2206851,54531
"2561","Ocbimv22038235m.g","KQ423241",45779,78399,32620
"2562","Ocbimv22013406m.g","KQ428493",24103,24480,377
"2563","Ocbimv22001452m.g","KQ416933",677373,681568,4195
"2564","Ocbimv22011737m.g","KQ427887",2940,9149,6209
"2565","Ocbimv22026713m.g","KQ420097",189723,256621,66898
"2566","Ocbimv22010763m.g","KQ427506",6714,6923,209
"2567","Ocbimv22014380m.g","KQ418124",113541,126183,12642
"2568","Ocbimv22021735m.g","KQ419092",269619,312837,43218
"2569","Ocbimv22004695m.g","KQ417198",275649,281390,5741
"2570","Ocbimv22002744m.g","KQ417032",3403,59640,56237
"2571","Ocbimv22029280m.g","KQ420696",407808,437385,29577
"2572","Ocbimv22032439m.g","KQ421540",181868,183164,1296
"2573","Ocbimv22036895m.g","KQ422894",49096,84528,35432
"2574","Ocbimv22023380m.g","KQ419395",338691,346350,7659
"2575","Ocbimv22012307m.g","KQ428118",8184,11440,3256
"2576","Ocbimv22038367m.g","KQ423295",90723,191114,100391
"2577","Ocbimv22033322m.g","KQ421773",37949,38431,482
"2578","Ocbimv22026730m.g","KQ416198",175105,182928,7823
"2579","Ocbimv22039355m.g","KQ423631",74262,121392,47130
"2580","Ocbimv22039021m.g","KQ423513",31460,32050,590
"2581","Ocbimv22037956m.g","KQ423185",120228,120647,419
"2582","Ocbimv22019696m.g","KQ418800",59104,92896,33792
"2583","Ocbimv22023492m.g","KQ419417",48307,85896,37589
"2584","Ocbimv22013066m.g","KQ428358",20334,37503,17169
"2585","Ocbimv22022741m.g","KQ416074",618104,620549,2445
"2586","Ocbimv22035662m.g","KQ422493",426378,427471,1093
"2587","Ocbimv22007770m.g","KQ426456",10555,13070,2515
"2588","Ocbimv22013980m.g","KQ428717",8451,20532,12081
"2589","Ocbimv22004366m.g","KQ425281",153891,211801,57910
"2590","Ocbimv22034793m.g","KQ416555",309262,327339,18077
"2591","Ocbimv22023420m.g","LGKD01688365",2,172,170
"2592","Ocbimv22008894m.g","KQ426792",170065,187912,17847
"2593","Ocbimv22011072m.g","KQ427619",44700,48700,4000
"2594","Ocbimv22035503m.g","KQ422411",375290,393897,18607
"2595","Ocbimv22017565m.g","KQ418506",442741,470091,27350
"2596","Ocbimv22024215m.g","KQ419550",118480,134490,16010
"2597","Ocbimv22011808m.g","KQ415893",267393,330818,63425
"2598","Ocbimv22030579m.g","KQ416357",469713,471474,1761
"2599","Ocbimv22034726m.g","KQ422130",47559,50603,3044
"2600","Ocbimv22004516m.g","KQ417175",58877,70189,11312
"2601","Ocbimv22037590m.g","KQ423077",312614,353170,40556
"2602","Ocbimv22013185m.g","KQ428420",54092,59125,5033
"2603","Ocbimv22011102m.g","KQ417748",35549,39243,3694
"2604","Ocbimv22027317m.g","KQ420258",117428,130196,12768
"2605","Ocbimv22021342m.g","KQ416042",16039,19474,3435
"2606","Ocbimv22034602m.g","KQ422084",530974,549914,18940
"2607","Ocbimv22018085m.g","KQ418571",296853,304644,7791
"2608","Ocbimv22029855m.g","KQ420828",1694420,1708836,14416
"2609","Ocbimv22011106m.g","KQ427639",9753,10804,1051
"2610","Ocbimv22034013m.g","KQ421946",254991,269390,14399
"2611","Ocbimv22035263m.g","KQ422346",4117,5329,1212
"2612","Ocbimv22028002m.g","KQ420415",594707,600226,5519
"2613","Ocbimv22001198m.g","KQ424224",248647,248838,191
"2614","Ocbimv22001304m.g","KQ424264",112006,112502,496
"2615","Ocbimv22032989m.g","KQ421710",14678,63648,48970
"2616","Ocbimv22006385m.g","KQ417317",205,2677,2472
"2617","Ocbimv22001834m.g","KQ424440",1833,3872,2039
"2618","Ocbimv22018888m.g","KQ430914",194730,194987,257
"2619","Ocbimv22021412m.g","KQ419042",14,73211,73197
"2620","Ocbimv22033312m.g","KQ421769",127501,128200,699
"2621","Ocbimv22035409m.g","KQ422367",370334,370826,492
"2622","Ocbimv22038804m.g","KQ423466",19366,37816,18450
"2623","Ocbimv22032616m.g","KQ421607",308193,337747,29554
"2624","Ocbimv22032349m.g","KQ421523",1344071,1351399,7328
"2625","Ocbimv22036278m.g","KQ416628",1092471,1092755,284
"2626","Ocbimv22022559m.g","KQ432864",384,977,593
"2627","Ocbimv22008283m.g","KQ417494",80384,80596,212
"2628","Ocbimv22001276m.g","KQ424250",252760,253014,254
"2629","Ocbimv22016511m.g","KQ429904",144669,165275,20606
"2630","Ocbimv22033598m.g","KQ421843",135185,153951,18766
"2631","Ocbimv22021979m.g","KQ419141",120090,129216,9126
"2632","Ocbimv22014229m.g","KQ428805",18615,19078,463
"2633","Ocbimv22026755m.g","KQ420109",155928,254740,98812
"2634","Ocbimv22021004m.g","KQ431922",104376,131249,26873
"2635","Ocbimv22011239m.g","KQ417766",387130,388117,987
"2636","Ocbimv22018071m.g","KQ430546",5797,6009,212
"2637","Ocbimv22010430m.g","KQ427383",7066,17322,10256
"2638","Ocbimv22008800m.g","KQ426774",143007,143162,155
"2639","Ocbimv22016916m.g","KQ418422",954130,954396,266
"2640","Ocbimv22037460m.g","KQ423038",151669,151977,308
"2641","Ocbimv22008067m.g","KQ426557",56820,67236,10416
"2642","Ocbimv22008538m.g","KQ426670",68756,69567,811
"2643","Ocbimv22020109m.g","KQ418855",568353,568862,509
"2644","Ocbimv22026545m.g","KQ420068",249359,281430,32071
"2645","Ocbimv22000457m.g","LGKD01491926",298,828,530
"2646","Ocbimv22005011m.g","KQ417224",22580,27099,4519
"2647","Ocbimv22032780m.g","KQ421658",62933,72968,10035
"2648","Ocbimv22020118m.g","KQ431468",1338,14268,12930
"2649","Ocbimv22012338m.g","KQ415907",772363,774694,2331
"2650","Ocbimv22034002m.g","KQ416507",620413,622085,1672
"2651","Ocbimv22010806m.g","LGKD01582605",33,221,188
"2652","Ocbimv22024822m.g","KQ419633",6922,66380,59458
"2653","Ocbimv22023109m.g","KQ419350",115081,120359,5278
"2654","Ocbimv22009885m.g","KQ417621",469079,523385,54306
"2655","Ocbimv22036563m.g","KQ416645",237231,261130,23899
"2656","Ocbimv22004947m.g","KQ417216",73854,127109,53255
"2657","Ocbimv22024053m.g","KQ433771",41476,82440,40964
"2658","Ocbimv22029555m.g","KQ420776",430494,430757,263
"2659","Ocbimv22020603m.g","KQ431753",368,2046,1678
"2660","Ocbimv22024730m.g","KQ416128",276895,277368,473
"2661","Ocbimv22004445m.g","KQ417160",50706,55864,5158
"2662","Ocbimv22027055m.g","KQ420170",27665,40168,12503
"2663","Ocbimv22034912m.g","KQ415742",77363,78328,965
"2664","Ocbimv22032793m.g","KQ421658",570322,588187,17865
"2665","Ocbimv22006593m.g","KQ426027",19936,25642,5706
"2666","Ocbimv22018761m.g","KQ418670",28760,29698,938
"2667","Ocbimv22009645m.g","KQ427059",421644,462764,41120
"2668","Ocbimv22022684m.g","KQ419281",410850,411203,353
"2669","Ocbimv22029999m.g","KQ420877",297085,297498,413
"2670","Ocbimv22000355m.g","KQ423937",154845,157451,2606
"2671","Ocbimv22024410m.g","KQ419577",186599,187654,1055
"2672","Ocbimv22002725m.g","KQ424762",54309,102813,48504
"2673","Ocbimv22007711m.g","KQ417446",8477,30712,22235
"2674","Ocbimv22001863m.g","KQ416971",352823,376075,23252
"2675","Ocbimv22031106m.g","KQ416385",518808,523463,4655
"2676","Ocbimv22019842m.g","KQ418821",603816,608211,4395
"2677","Ocbimv22035271m.g","KQ422349",31120,37105,5985
"2678","Ocbimv22003544m.g","KQ417090",1642375,1684844,42469
"2679","Ocbimv22032667m.g","KQ421629",34741,42780,8039
"2680","Ocbimv22001396m.g","KQ416930",352006,355849,3843
"2681","Ocbimv22031487m.g","KQ421261",97914,114595,16681
"2682","Ocbimv22035101m.g","KQ416572",179602,179781,179
"2683","Ocbimv22028544m.g","KQ416260",440819,441112,293
"2684","Ocbimv22007738m.g","LGKD01557946",2,202,200
"2685","Ocbimv22014107m.g","LGKD01606499",250,468,218
"2686","Ocbimv22009889m.g","KQ417621",557907,570040,12133
"2687","Ocbimv22011638m.g","KQ427828",31828,32260,432
"2688","Ocbimv22002847m.g","KQ417042",50433,50744,311
"2689","Ocbimv22029934m.g","KQ416325",867,1643,776
"2690","Ocbimv22021095m.g","LGKD01665402",14,499,485
"2691","Ocbimv22029756m.g","KQ420820",5485,11822,6337
"2692","Ocbimv22035583m.g","KQ422447",166989,167156,167
"2693","Ocbimv22004797m.g","KQ417208",106950,107144,194
"2694","Ocbimv22030242m.g","KQ416338",313927,314541,614
"2695","Ocbimv22028631m.g","KQ420537",473044,473535,491
"2696","Ocbimv22010672m.g","KQ417701",248872,257423,8551
"2697","Ocbimv22027892m.g","KQ420390",12783,13055,272
"2698","Ocbimv22029553m.g","KQ420776",378266,379126,860
"2699","Ocbimv22013822m.g","KQ418063",471079,472793,1714
"2700","Ocbimv22032517m.g","LGKD01405033",4,608,604
"2701","Ocbimv22036106m.g","KQ416617",186195,186570,375
"2702","Ocbimv22037322m.g","KQ423001",376058,390803,14745
"2703","Ocbimv22004206m.g","KQ415801",47791,63286,15495
"2704","Ocbimv22014562m.g","KQ418153",169015,173725,4710
"2705","Ocbimv22016469m.g","KQ415966",97203,97733,530
"2706","Ocbimv22039849m.g","KQ423780",227246,227545,299
"2707","Ocbimv22024748m.g","KQ419623",66770,68197,1427
"2708","Ocbimv22026066m.g","KQ419981",33573,35143,1570
"2709","Ocbimv22035664m.g","KQ422496",71952,73231,1279
"2710","Ocbimv22026792m.g","KQ420117",707841,708098,257
"2711","Ocbimv22004250m.g","KQ425239",186185,186562,377
"2712","Ocbimv22028561m.g","KQ420522",13074,72416,59342
"2713","Ocbimv22038555m.g","KQ423398",221445,222323,878
"2714","Ocbimv22029995m.g","KQ420877",14064,18419,4355
"2715","Ocbimv22004895m.g","KQ417213",48356,58015,9659
"2716","Ocbimv22017813m.g","KQ418549",699305,699670,365
"2717","Ocbimv22029771m.g","KQ420820",536714,539984,3270
"2718","Ocbimv22033192m.g","KQ421749",21426,22481,1055
"2719","Ocbimv22037014m.g","KQ422907",3298,58127,54829
"2720","Ocbimv22030023m.g","KQ420886",623,14575,13952
"2721","Ocbimv22030651m.g","KQ421049",55187,55744,557
"2722","Ocbimv22025042m.g","KQ416136",615688,636031,20343
"2723","Ocbimv22022728m.g","KQ416074",332306,348939,16633
"2724","Ocbimv22020440m.g","KQ431681",18476,18958,482
"2725","Ocbimv22030986m.g","KQ416380",99052,99724,672
"2726","Ocbimv22019036m.g","KQ418711",1013756,1029709,15953
"2727","Ocbimv22007412m.g","KQ426334",41089,41678,589
"2728","Ocbimv22025332m.g","KQ419775",214545,248638,34093
"2729","Ocbimv22013317m.g","KQ418010",36781,104583,67802
"2730","Ocbimv22020976m.g","KQ418987",60135,61244,1109
"2731","Ocbimv22010742m.g","KQ427491",7258,83067,75809
"2732","Ocbimv22035831m.g","KQ422568",23935,24207,272
"2733","Ocbimv22023169m.g","KQ419366",244218,245844,1626
"2734","Ocbimv22014004m.g","KQ418075",813474,813892,418
"2735","Ocbimv22028007m.g","KQ416243",222006,222167,161
"2736","Ocbimv22011315m.g","KQ417780",305675,315500,9825
"2737","Ocbimv22038877m.g","KQ423484",121683,122030,347
"2738","Ocbimv22005665m.g","KQ417272",38987,52421,13434
"2739","Ocbimv22015727m.g","KQ429522",9326,10103,777
"2740","Ocbimv22039346m.g","KQ423628",43595,46232,2637
"2741","Ocbimv22010329m.g","KQ417670",203740,204387,647
"2742","Ocbimv22018081m.g","KQ418571",108521,108679,158
"2743","Ocbimv22016682m.g","KQ418381",8015,19984,11969
"2744","Ocbimv22004840m.g","KQ417209",175415,183614,8199
"2745","Ocbimv22039107m.g","KQ416779",458073,462092,4019
"2746","Ocbimv22009356m.g","KQ417585",1115925,1180965,65040
"2747","Ocbimv22032529m.g","KQ421577",13330,13620,290
"2748","Ocbimv22026288m.g","KQ420023",213436,221375,7939
"2749","Ocbimv22029621m.g","KQ420787",137245,137574,329
"2750","Ocbimv22023000m.g","KQ419337",175830,183508,7678
"2751","Ocbimv22033296m.g","KQ421766",89623,92177,2554
"2752","Ocbimv22016881m.g","KQ418417",17598,45274,27676
"2753","Ocbimv22012960m.g","KQ417962",43924,44448,524
"2754","Ocbimv22003547m.g","KQ417090",1688718,1705163,16445
"2755","Ocbimv22013924m.g","KQ428714",34484,34852,368
"2756","Ocbimv22012217m.g","KQ428081",20609,20932,323
"2757","Ocbimv22011426m.g","KQ427746",22914,99236,76322
"2758","Ocbimv22024470m.g","KQ419584",645,68002,67357
"2759","Ocbimv22008790m.g","KQ426774",95450,100208,4758
"2760","Ocbimv22037983m.g","KQ416717",215016,262278,47262
"2761","Ocbimv22023217m.g","KQ419376",169888,170097,209
"2762","Ocbimv22034795m.g","KQ422176",214688,238107,23419
"2763","Ocbimv22020734m.g","KQ418957",484320,495804,11484
"2764","Ocbimv22039402m.g","KQ423651",497222,497404,182
"2765","Ocbimv22022226m.g","KQ419185",367026,367178,152
"2766","Ocbimv22024704m.g","KQ419618",1,230,229
"2767","Ocbimv22026658m.g","KQ420086",29898,30799,901
"2768","Ocbimv22036614m.g","KQ416649",217247,219294,2047
"2769","Ocbimv22020937m.g","KQ418980",111615,111869,254
"2770","Ocbimv22001195m.g","KQ424223",12882,21835,8953
"2771","Ocbimv22000082m.g","KQ416839",32705,37050,4345
"2772","Ocbimv22024400m.g","KQ415693",575719,577730,2011
"2773","Ocbimv22000662m.g","KQ424045",34066,99876,65810
"2774","Ocbimv22008007m.g","KQ415849",228627,233507,4880
"2775","Ocbimv22019722m.g","KQ431279",159,434,275
"2776","Ocbimv22016767m.g","KQ418395",9743,147212,137469
"2777","Ocbimv22019752m.g","KQ431294",297460,315960,18500
"2778","Ocbimv22033486m.g","KQ421821",179481,181567,2086
"2779","Ocbimv22028773m.g","KQ420579",724210,746409,22199
"2780","Ocbimv22015442m.g","KQ429341",11810,13311,1501
"2781","Ocbimv22028475m.g","KQ420501",37,1108,1071
"2782","Ocbimv22023530m.g","KQ419425",532294,533328,1034
"2783","Ocbimv22000873m.g","KQ424096",657149,690858,33709
"2784","Ocbimv22001644m.g","KQ416950",1926256,1926742,486
"2785","Ocbimv22007089m.g","KQ417377",795389,845493,50104
"2786","Ocbimv22011303m.g","KQ417777",257424,257970,546
"2787","Ocbimv22018451m.g","KQ415992",594804,600799,5995
"2788","Ocbimv22023293m.g","KQ416087",240811,387404,146593
"2789","Ocbimv22024951m.g","LGKD01312051",3,662,659
"2790","Ocbimv22003206m.g","KQ424906",978,5006,4028
"2791","Ocbimv22032115m.g","KQ421451",293310,293961,651
"2792","Ocbimv22004021m.g","KQ425188",293392,296772,3380
"2793","Ocbimv22033179m.g","KQ421741",96585,99535,2950
"2794","Ocbimv22019577m.g","KQ418789",54151,68091,13940
"2795","Ocbimv22034271m.g","KQ422015",384471,385241,770
"2796","Ocbimv22037179m.g","KQ422960",264041,265846,1805
"2797","Ocbimv22011029m.g","KQ427597",210860,212019,1159
"2798","Ocbimv22033019m.g","KQ421718",555508,555906,398
"2799","Ocbimv22022963m.g","KQ416079",305037,323814,18777
"2800","Ocbimv22037783m.g","KQ416711",50043,68332,18289
"2801","Ocbimv22033549m.g","KQ421828",20252,45911,25659
"2802","Ocbimv22023319m.g","KQ416087",2026304,2027595,1291
"2803","Ocbimv22003338m.g","KQ424979",16404,17513,1109
"2804","Ocbimv22023584m.g","KQ433487",17965,19722,1757
"2805","Ocbimv22013875m.g","KQ418069",160091,170621,10530
"2806","Ocbimv22009105m.g","KQ426880",69390,69677,287
"2807","Ocbimv22018977m.g","KQ418705",466,2176,1710
"2808","Ocbimv22006339m.g","KQ425879",156796,213789,56993
"2809","Ocbimv22039149m.g","KQ423551",27596,42419,14823
"2810","Ocbimv22020242m.g","KQ431554",26848,28544,1696
"2811","Ocbimv22027938m.g","KQ420404",1224725,1259310,34585
"2812","Ocbimv22028420m.g","KQ420483",219572,233836,14264
"2813","Ocbimv22021967m.g","KQ432471",183385,184180,795
"2814","Ocbimv22021480m.g","KQ419056",102472,126945,24473
"2815","Ocbimv22026454m.g","LGKD01331299",3694,3927,233
"2816","Ocbimv22036790m.g","KQ416657",383415,445055,61640
"2817","Ocbimv22013208m.g","KQ418002",199099,208116,9017
"2818","Ocbimv22009912m.g","KQ427153",49312,70383,21071
"2819","Ocbimv22003065m.g","KQ424877",5953,10739,4786
"2820","Ocbimv22014436m.g","KQ418134",150615,151220,605
"2821","Ocbimv22012537m.g","KQ417917",808861,809085,224
"2822","Ocbimv22014041m.g","KQ428727",16116,17115,999
"2823","Ocbimv22010862m.g","KQ427549",105007,158551,53544
"2824","Ocbimv22023480m.g","KQ433417",337881,340559,2678
"2825","Ocbimv22025642m.g","KQ419872",28821,30314,1493
"2826","Ocbimv22004028m.g","KQ425190",19807,23694,3887
"2827","Ocbimv22039205m.g","KQ423574",188783,190347,1564
"2828","Ocbimv22011302m.g","KQ417777",239432,239686,254
"2829","Ocbimv22018879m.g","KQ430914",107597,108070,473
"2830","Ocbimv22028306m.g","KQ420468",1427,22566,21139
"2831","Ocbimv22025925m.g","KQ419928",3488,4139,651
"2832","Ocbimv22024181m.g","KQ419545",35219,38890,3671
"2833","Ocbimv22026417m.g","KQ420047",262308,268046,5738
"2834","Ocbimv22021336m.g","KQ419033",51646,52977,1331
"2835","Ocbimv22038958m.g","KQ423493",970099,997280,27181
"2836","Ocbimv22039852m.g","KQ423780",552456,552629,173
"2837","Ocbimv22012042m.g","KQ427981",57983,58294,311
"2838","Ocbimv22003023m.g","KQ417055",666131,667677,1546
"2839","Ocbimv22014421m.g","KQ428911",320,556,236
"2840","Ocbimv22018872m.g","KQ418693",482458,490701,8243
"2841","Ocbimv22011317m.g","KQ417780",397397,399115,1718
"2842","Ocbimv22030157m.g","KQ420911",89340,90183,843
"2843","Ocbimv22036502m.g","KQ422781",51507,52040,533
"2844","Ocbimv22037955m.g","KQ423183",7318,7539,221
"2845","Ocbimv22036057m.g","KQ416615",182438,183414,976
"2846","Ocbimv22038590m.g","KQ423413",8063,8320,257
"2847","Ocbimv22037954m.g","KQ423183",232,20620,20388
"2848","Ocbimv22017258m.g","KQ418472",72508,73961,1453
"2849","Ocbimv22021301m.g","KQ419026",541711,553810,12099
"2850","Ocbimv22039145m.g","KQ416781",549588,549803,215
"2851","Ocbimv22039088m.g","KQ423545",52428,53017,589
"2852","Ocbimv22021867m.g","KQ419114",46122,46325,203
"2853","Ocbimv22002074m.g","KQ424534",56184,56489,305
"2854","Ocbimv22025268m.g","KQ419754",43757,44834,1077
"2855","Ocbimv22016637m.g","KQ418371",93180,230684,137504
"2856","Ocbimv22019261m.g","KQ418739",236671,236990,319
"2857","Ocbimv22031410m.g","KQ421232",210459,210806,347
"2858","Ocbimv22035659m.g","KQ422493",379063,385189,6126
"2859","Ocbimv22029118m.g","KQ420660",2193,51338,49145
"2860","Ocbimv22037351m.g","LGKD01460065",62,268,206
"2861","Ocbimv22021115m.g","KQ419008",332561,395079,62518
"2862","Ocbimv22001188m.g","KQ424219",309261,310227,966
"2863","Ocbimv22033447m.g","KQ421816",427927,625407,197480
"2864","Ocbimv22034600m.g","KQ422084",448923,501263,52340
"2865","Ocbimv22007651m.g","KQ426409",25408,27813,2405
"2866","Ocbimv22013091m.g","KQ417980",300435,321888,21453
"2867","Ocbimv22005888m.g","LGKD01541401",2,1035,1033
"2868","Ocbimv22005525m.g","KQ425647",16754,17434,680
"2869","Ocbimv22025181m.g","KQ419721",728907,785421,56514
"2870","Ocbimv22037613m.g","KQ423077",1083864,1085701,1837
"2871","Ocbimv22013325m.g","KQ418012",225946,226163,217
"2872","Ocbimv22039335m.g","KQ416788",423374,423643,269
"2873","Ocbimv22008734m.g","KQ417528",256959,305409,48450
"2874","Ocbimv22019990m.g","KQ418840",1320567,1320749,182
"2875","Ocbimv22025277m.g","KQ419758",97934,115412,17478
"2876","Ocbimv22027169m.g","KQ420208",19124,73221,54097
"2877","Ocbimv22010796m.g","KQ417715",60931,97365,36434
"2878","Ocbimv22001844m.g","KQ424446",20248,20463,215
"2879","Ocbimv22029110m.g","KQ420654",91173,91481,308
"2880","Ocbimv22033485m.g","KQ421821",127503,142183,14680
"2881","Ocbimv22002039m.g","KQ424526",8444,24372,15928
"2882","Ocbimv22021492m.g","KQ432177",12068,22112,10044
"2883","Ocbimv22036655m.g","KQ422819",277297,278016,719
"2884","Ocbimv22037269m.g","KQ422987",22306,29691,7385
"2885","Ocbimv22034159m.g","KQ416515",77437,78315,878
"2886","Ocbimv22009063m.g","KQ417557",13402,14605,1203
"2887","Ocbimv22031758m.g","KQ421338",640806,641006,200
"2888","Ocbimv22002575m.g","KQ424700",9946,10341,395
"2889","Ocbimv22024971m.g","KQ419670",165150,169490,4340
"2890","Ocbimv22017895m.g","KQ418555",854102,854398,296
"2891","Ocbimv22031534m.g","KQ421269",15818,19774,3956
"2892","Ocbimv22022861m.g","KQ419314",26024,26173,149
"2893","Ocbimv22037485m.g","KQ416697",649630,651705,2075
"2894","Ocbimv22037777m.g","KQ423131",229217,248816,19599
"2895","Ocbimv22013455m.g","KQ428518",147044,153874,6830
"2896","Ocbimv22023560m.g","KQ419432",148676,155911,7235
"2897","Ocbimv22014221m.g","KQ418103",172411,172693,282
"2898","Ocbimv22015106m.g","KQ429156",6204,12976,6772
"2899","Ocbimv22027793m.g","KQ416233",458369,479766,21397
"2900","Ocbimv22021946m.g","KQ432446",4035,4202,167
"2901","Ocbimv22034099m.g","KQ421974",73812,73970,158
"2902","Ocbimv22015957m.g","KQ429629",14034,33762,19728
"2903","Ocbimv22036273m.g","KQ416628",726925,727798,873
"2904","Ocbimv22018756m.g","KQ416000",275719,276203,484
"2905","Ocbimv22011186m.g","KQ427669",38265,38498,233
"2906","Ocbimv22010332m.g","KQ417670",307412,369717,62305
"2907","Ocbimv22005702m.g","KQ417274",333359,393868,60509
"2908","Ocbimv22030297m.g","KQ420942",14050,23406,9356
"2909","Ocbimv22016696m.g","KQ429968",49369,60056,10687
"2910","Ocbimv22020141m.g","KQ418859",413221,414832,1611
"2911","Ocbimv22020978m.g","KQ418988",17477,17821,344
"2912","Ocbimv22022912m.g","KQ419324",472448,472771,323
"2913","Ocbimv22005646m.g","KQ417269",611,1375,764
"2914","Ocbimv22020369m.g","KQ418900",487496,491352,3856
"2915","Ocbimv22037362m.g","KQ423016",387189,387347,158
"2916","Ocbimv22021357m.g","KQ416042",1965695,1968847,3152
"2917","Ocbimv22013272m.g","KQ418005",89,9191,9102
"2918","Ocbimv22019012m.g","KQ418711",40795,41655,860
"2919","Ocbimv22020727m.g","LGKD01662701",2,304,302
"2920","Ocbimv22004247m.g","KQ417143",532666,555852,23186
"2921","Ocbimv22016088m.g","KQ415954",48675,49610,935
"2922","Ocbimv22031504m.g","KQ421263",249985,263185,13200
"2923","Ocbimv22019283m.g","KQ418741",37024,59205,22181
"2924","Ocbimv22008657m.g","KQ417518",602503,622377,19874
"2925","Ocbimv22038143m.g","KQ423217",658323,664504,6181
"2926","Ocbimv22008469m.g","KQ415854",536799,546435,9636
"2927","Ocbimv22018095m.g","KQ418571",566601,567093,492
"2928","Ocbimv22023594m.g","LGKD01690531",345,890,545
"2929","Ocbimv22027847m.g","KQ420377",54747,80723,25976
"2930","Ocbimv22025653m.g","KQ419877",35134,54581,19447
"2931","Ocbimv22036046m.g","KQ422636",113332,113740,408
"2932","Ocbimv22012859m.g","KQ417945",872581,875324,2743
"2933","Ocbimv22039328m.g","KQ416788",202284,210999,8715
"2934","Ocbimv22006386m.g","KQ417317",33615,33929,314
"2935","Ocbimv22015863m.g","KQ418297",413077,414654,1577
"2936","Ocbimv22014231m.g","KQ428805",29928,30133,205
"2937","Ocbimv22000115m.g","KQ416840",325978,327306,1328
"2938","Ocbimv22015825m.g","KQ418295",170706,170939,233
"2939","Ocbimv22036403m.g","KQ422755",31514,51383,19869
"2940","Ocbimv22025184m.g","KQ419724",3669,3866,197
"2941","Ocbimv22003504m.g","KQ417089",1475584,1475760,176
"2942","Ocbimv22038749m.g","KQ416765",84147,84975,828
"2943","Ocbimv22015293m.g","KQ429253",68132,68317,185
"2944","Ocbimv22021854m.g","KQ415687",1457601,1460775,3174
"2945","Ocbimv22023634m.g","KQ419448",164260,166965,2705
"2946","Ocbimv22023648m.g","KQ419450",3543,3806,263
"2947","Ocbimv22007462m.g","KQ426348",13469,17987,4518
"2948","Ocbimv22036836m.g","KQ422871",17099,37767,20668
"2949","Ocbimv22039590m.g","KQ416806",399800,399970,170
"2950","Ocbimv22036555m.g","KQ422791",204127,204832,705
"2951","Ocbimv22020648m.g","KQ418945",882767,890972,8205
"2952","Ocbimv22011902m.g","KQ427949",10428,18031,7603
"2953","Ocbimv22032981m.g","KQ421706",112164,119012,6848
"2954","Ocbimv22016844m.g","KQ418413",19106,32861,13755
"2955","Ocbimv22038078m.g","KQ423213",16723,50625,33902
"2956","Ocbimv22023561m.g","KQ419432",155918,160858,4940
"2957","Ocbimv22011659m.g","KQ417815",2933,56270,53337
"2958","Ocbimv22037987m.g","KQ416717",301690,304033,2343
"2959","Ocbimv22010242m.g","KQ417660",442384,442997,613
"2960","Ocbimv22011994m.g","KQ417851",748537,771289,22752
"2961","Ocbimv22035709m.g","KQ416599",157786,193336,35550
"2962","Ocbimv22007298m.g","LGKD01020352",59,244,185
"2963","Ocbimv22033002m.g","KQ421715",20409,20899,490
"2964","Ocbimv22009501m.g","KQ415865",471777,479383,7606
"2965","Ocbimv22005582m.g","KQ425655",365945,366329,384
"2966","Ocbimv22005329m.g","KQ417241",129635,130021,386
"2967","Ocbimv22028180m.g","KQ420441",82325,83169,844
"2968","Ocbimv22018928m.g","KQ418698",66674,83780,17106
"2969","Ocbimv22017615m.g","KQ430378",196338,200156,3818
"2970","Ocbimv22018076m.g","KQ418569",489190,489387,197
"2971","Ocbimv22032766m.g","KQ421655",622688,624366,1678
"2972","Ocbimv22036289m.g","KQ422697",342965,343330,365
"2973","Ocbimv22009224m.g","KQ426929",443,1846,1403
"2974","Ocbimv22019277m.g","KQ418740",339856,365085,25229
"2975","Ocbimv22026230m.g","KQ420017",719587,719763,176
"2976","Ocbimv22002932m.g","KQ417050",505464,507533,2069
"2977","Ocbimv22011755m.g","KQ427892",13048,14026,978
"2978","Ocbimv22026021m.g","KQ419957",305830,307935,2105
"2979","Ocbimv22029953m.g","KQ420859",216772,223837,7065
"2980","Ocbimv22029121m.g","KQ420660",80168,83224,3056
"2981","Ocbimv22027261m.g","KQ420240",42508,65334,22826
"2982","Ocbimv22036763m.g","KQ416656",34932,35423,491
"2983","Ocbimv22026474m.g","KQ420055",46229,84426,38197
"2984","Ocbimv22000984m.g","KQ424142",450036,450215,179
"2985","Ocbimv22024635m.g","KQ419605",384736,436792,52056
"2986","Ocbimv22013784m.g","LGKD01604307",16,267,251
"2987","Ocbimv22008764m.g","KQ426761",3490,74781,71291
"2988","Ocbimv22034428m.g","KQ416531",230594,245149,14555
"2989","Ocbimv22000976m.g","KQ424142",30789,32253,1464
"2990","Ocbimv22034603m.g","KQ422084",552361,557280,4919
"2991","Ocbimv22034806m.g","KQ422178",257618,271500,13882
"2992","Ocbimv22029412m.g","KQ416305",49709,49906,197
"2993","Ocbimv22023591m.g","KQ433494",1370,1867,497
"2994","Ocbimv22026245m.g","KQ420021",305401,493715,188314
"2995","Ocbimv22034810m.g","KQ422178",307807,344110,36303
"2996","Ocbimv22015347m.g","KQ415942",232652,246088,13436
"2997","Ocbimv22025762m.g","KQ416166",508416,513079,4663
"2998","Ocbimv22029726m.g","KQ420813",683091,684013,922
"2999","Ocbimv22022298m.g","LGKD01676589",21,1081,1060
"3000","Ocbimv22002707m.g","KQ424753",1071,1592,521
"3001","Ocbimv22039223m.g","KQ423589",5,371,366
"3002","Ocbimv22036250m.g","KQ416627",363634,364050,416
"3003","Ocbimv22036929m.g","KQ416666",418151,418829,678
"3004","Ocbimv22005430m.g","KQ425603",84580,140625,56045
"3005","Ocbimv22033394m.g","KQ416479",827833,830995,3162
"3006","Ocbimv22026049m.g","KQ419973",625181,674023,48842
"3007","Ocbimv22038636m.g","KQ423429",14076,32003,17927
"3008","Ocbimv22013182m.g","KQ428420",4208,16209,12001
"3009","Ocbimv22035584m.g","KQ422447",215939,227055,11116
"3010","Ocbimv22002329m.g","KQ424629",190346,191595,1249
"3011","Ocbimv22039349m.g","KQ423628",90120,91324,1204
"3012","Ocbimv22021895m.g","KQ419123",181760,182005,245
"3013","Ocbimv22010598m.g","KQ427456",62529,62955,426
"3014","Ocbimv22016879m.g","KQ418416",131812,132407,595
"3015","Ocbimv22015466m.g","KQ418255",75305,82543,7238
"3016","Ocbimv22036332m.g","KQ422714",3625,21127,17502
"3017","Ocbimv22013896m.g","KQ428707",136078,199999,63921
"3018","Ocbimv22025516m.g","KQ419831",1366,116099,114733
"3019","Ocbimv22011414m.g","KQ417791",1367702,1394271,26569
"3020","Ocbimv22017161m.g","KQ415974",25776,109769,83993
"3021","Ocbimv22012408m.g","KQ428155",21420,23106,1686
"3022","Ocbimv22015459m.g","KQ429360",85553,118349,32796
"3023","Ocbimv22009915m.g","KQ427156",20589,21057,468
"3024","Ocbimv22017280m.g","KQ418475",283809,284312,503
"3025","Ocbimv22027704m.g","KQ420346",231425,292920,61495
"3026","Ocbimv22001829m.g","KQ424439",33867,55206,21339
"3027","Ocbimv22006246m.g","KQ417305",367452,368741,1289
"3028","Ocbimv22006209m.g","KQ417304",154946,164070,9124
"3029","Ocbimv22016787m.g","KQ430029",30869,56067,25198
"3030","Ocbimv22004789m.g","KQ425437",241571,242122,551
"3031","Ocbimv22024745m.g","KQ419623",43652,49953,6301
"3032","Ocbimv22001366m.g","KQ416925",345640,357569,11929
"3033","Ocbimv22038244m.g","KQ423246",129015,177145,48130
"3034","Ocbimv22007386m.g","KQ426315",119410,120972,1562
"3035","Ocbimv22022871m.g","LGKD01683669",1386,1907,521
"3036","Ocbimv22011049m.g","KQ417740",270391,270814,423
"3037","Ocbimv22036945m.g","KQ416666",1023384,1037417,14033
"3038","Ocbimv22000433m.g","KQ423963",122153,123600,1447
"3039","Ocbimv22001916m.g","KQ424476",11739,13422,1683
"3040","Ocbimv22013969m.g","KQ428715",113013,127704,14691
"3041","Ocbimv22027499m.g","KQ416226",153324,203419,50095
"3042","Ocbimv22039760m.g","KQ423738",119163,119678,515
"3043","Ocbimv22010930m.g","KQ417725",287687,289938,2251
"3044","Ocbimv22003960m.g","KQ425160",469218,490538,21320
"3045","Ocbimv22021405m.g","KQ432116",144030,158555,14525
"3046","Ocbimv22021223m.g","KQ419015",135568,135804,236
"3047","Ocbimv22022255m.g","KQ419190",81892,82095,203
"3048","Ocbimv22005619m.g","KQ425681",110043,118676,8633
"3049","Ocbimv22004646m.g","KQ417192",545291,546703,1412
"3050","Ocbimv22022762m.g","KQ432990",140961,147718,6757
"3051","Ocbimv22038311m.g","KQ423275",417186,417626,440
"3052","Ocbimv22011965m.g","KQ427955",2901,26886,23985
"3053","Ocbimv22021245m.g","KQ419018",686463,687341,878
"3054","Ocbimv22038035m.g","KQ415762",499024,499592,568
"3055","Ocbimv22018158m.g","KQ418580",284695,284877,182
"3056","Ocbimv22020589m.g","KQ416030",31002,33098,2096
"3057","Ocbimv22021787m.g","KQ419102",106339,106722,383
"3058","Ocbimv22020947m.g","KQ418982",295739,344115,48376
"3059","Ocbimv22018190m.g","KQ415990",208145,234086,25941
"3060","Ocbimv22018736m.g","KQ418665",47301,48125,824
"3061","Ocbimv22039553m.g","KQ416802",404665,418841,14176
"3062","Ocbimv22016804m.g","KQ418402",145473,166474,21001
"3063","Ocbimv22031748m.g","KQ421337",243483,244717,1234
"3064","Ocbimv22033023m.g","KQ416464",536616,537068,452
"3065","Ocbimv22005388m.g","KQ417249",750903,857670,106767
"3066","Ocbimv22026644m.g","KQ420085",244244,252399,8155
"3067","Ocbimv22026986m.g","KQ420157",463793,465006,1213
"3068","Ocbimv22008646m.g","KQ426718",16079,16402,323
"3069","Ocbimv22019372m.g","KQ431103",6265,37370,31105
"3070","Ocbimv22013127m.g","KQ417985",298988,315077,16089
"3071","Ocbimv22036818m.g","KQ416658",2219379,2219579,200
"3072","Ocbimv22008171m.g","KQ417481",1623336,1624734,1398
"3073","Ocbimv22006621m.g","KQ417337",160928,164247,3319
"3074","Ocbimv22013400m.g","KQ428489",5093,16158,11065
"3075","Ocbimv22008018m.g","KQ417470",95538,95864,326
"3076","Ocbimv22000795m.g","KQ424071",1,6287,6286
"3077","Ocbimv22031912m.g","KQ421376",915910,933868,17958
"3078","Ocbimv22037733m.g","KQ423122",69705,71905,2200
"3079","Ocbimv22032567m.g","KQ421593",132592,132889,297
"3080","Ocbimv22001160m.g","KQ416913",153072,153272,200
"3081","Ocbimv22039458m.g","KQ423671",204735,231469,26734
"3082","Ocbimv22032897m.g","KQ416458",30311,31136,825
"3083","Ocbimv22026298m.g","KQ420023",365782,376080,10298
"3084","Ocbimv22010767m.g","KQ427511",31949,75331,43382
"3085","Ocbimv22030160m.g","KQ420914",62682,62864,182
"3086","Ocbimv22029893m.g","KQ420840",47302,47679,377
"3087","Ocbimv22011688m.g","KQ417819",85490,109845,24355
"3088","Ocbimv22032124m.g","KQ421454",160848,170292,9444
"3089","Ocbimv22002269m.g","KQ424600",90339,90559,220
"3090","Ocbimv22028816m.g","KQ416272",564454,567181,2727
"3091","Ocbimv22028512m.g","KQ420516",486359,486772,413
"3092","Ocbimv22012932m.g","KQ417957",190409,192003,1594
"3093","Ocbimv22001998m.g","KQ416979",1131590,1132709,1119
"3094","Ocbimv22025279m.g","KQ419758",130463,133563,3100
"3095","Ocbimv22038608m.g","KQ416754",293916,356140,62224
"3096","Ocbimv22018853m.g","KQ430907",20685,22536,1851
"3097","Ocbimv22025878m.g","KQ416175",61138,61464,326
"3098","Ocbimv22038587m.g","KQ423412",281403,281930,527
"3099","Ocbimv22011117m.g","KQ427644",472753,473118,365
"3100","Ocbimv22014894m.g","KQ429131",407919,409839,1920
"3101","Ocbimv22033253m.g","KQ421758",1440202,1450838,10636
"3102","Ocbimv22008170m.g","KQ417481",1616629,1619920,3291
"3103","Ocbimv22009440m.g","KQ426997",3628,27540,23912
"3104","Ocbimv22033286m.g","KQ421765",118621,128079,9458
"3105","Ocbimv22016766m.g","LGKD01630296",1,436,435
"3106","Ocbimv22015218m.g","KQ429209",336202,336746,544
"3107","Ocbimv22029084m.g","KQ420642",273401,303909,30508
"3108","Ocbimv22030896m.g","KQ421117",1135492,1135755,263
"3109","Ocbimv22035707m.g","KQ416599",121110,147820,26710
"3110","Ocbimv22023350m.g","KQ419395",144787,147999,3212
"3111","Ocbimv22018364m.g","KQ418610",101788,170542,68754
"3112","Ocbimv22025692m.g","KQ419887",18823,46329,27506
"3113","Ocbimv22015247m.g","KQ418215",144091,144951,860
"3114","Ocbimv22039647m.g","KQ423718",86441,95081,8640
"3115","Ocbimv22038924m.g","KQ423490",91183,91350,167
"3116","Ocbimv22034189m.g","KQ421998",26003,26434,431
"3117","Ocbimv22038702m.g","KQ416761",107325,135296,27971
"3118","Ocbimv22038956m.g","KQ423493",944783,947620,2837
"3119","Ocbimv22019416m.g","KQ418762",118,15817,15699
"3120","Ocbimv22037052m.g","KQ422910",2305,23477,21172
"3121","Ocbimv22004549m.g","KQ425356",8991,9305,314
"3122","Ocbimv22016694m.g","KQ429968",13580,18153,4573
"3123","Ocbimv22037214m.g","KQ422966",839,56073,55234
"3124","Ocbimv22002430m.g","KQ417009",1465126,1466445,1319
"3125","Ocbimv22016528m.g","KQ418364",550579,551502,923
"3126","Ocbimv22007465m.g","KQ426354",54904,57325,2421
"3127","Ocbimv22004298m.g","KQ417146",192891,207352,14461
"3128","Ocbimv22017473m.g","KQ430313",10360,21460,11100
"3129","Ocbimv22007779m.g","KQ426456",194182,195535,1353
"3130","Ocbimv22014771m.g","KQ418176",812407,812856,449
"3131","Ocbimv22023266m.g","KQ419385",42,1462,1420
"3132","Ocbimv22002161m.g","KQ424564",13727,15334,1607
"3133","Ocbimv22017488m.g","KQ430316",41630,45890,4260
"3134","Ocbimv22002484m.g","KQ424671",65502,111756,46254
"3135","Ocbimv22018812m.g","KQ416002",1058554,1075697,17143
"3136","Ocbimv22031838m.g","KQ421356",677229,704161,26932
"3137","Ocbimv22039259m.g","KQ423598",89840,92053,2213
"3138","Ocbimv22039754m.g","KQ416821",301140,303768,2628
"3139","Ocbimv22009106m.g","KQ426880",155926,156212,286
"3140","Ocbimv22015763m.g","KQ418290",183194,183369,175
"3141","Ocbimv22030844m.g","KQ421111",12113,12283,170
"3142","Ocbimv22022087m.g","KQ416059",326088,328608,2520
"3143","Ocbimv22026890m.g","KQ420137",113943,117244,3301
"3144","Ocbimv22034985m.g","KQ422234",20753,24051,3298
"3145","Ocbimv22024782m.g","KQ419630",41256,41411,155
"3146","Ocbimv22030381m.g","KQ420970",9203,17621,8418
"3147","Ocbimv22003503m.g","KQ417089",1425836,1426117,281
"3148","Ocbimv22029622m.g","KQ420787",507852,508127,275
"3149","Ocbimv22035370m.g","KQ416583",204193,218596,14403
"3150","Ocbimv22013543m.g","KQ418034",173406,175795,2389
"3151","Ocbimv22007940m.g","KQ426499",87776,88388,612
"3152","Ocbimv22010336m.g","KQ417671",142058,162405,20347
"3153","Ocbimv22029184m.g","KQ420673",94691,343269,248578
"3154","Ocbimv22019570m.g","KQ418785",17331,17663,332
"3155","Ocbimv22025271m.g","KQ419754",247346,247636,290
"3156","Ocbimv22032855m.g","KQ416453",108520,145238,36718
"3157","Ocbimv22038178m.g","KQ416729",2311,8586,6275
"3158","Ocbimv22020264m.g","KQ431563",131904,132540,636
"3159","Ocbimv22032728m.g","KQ421646",54423,55919,1496
"3160","Ocbimv22015440m.g","KQ429340",85001,90314,5313
"3161","Ocbimv22038940m.g","KQ416772",680882,681334,452
"3162","Ocbimv22019865m.g","LGKD01262398",112,411,299
"3163","Ocbimv22023929m.g","KQ419500",815125,830605,15480
"3164","Ocbimv22033325m.g","KQ421780",59530,60509,979
"3165","Ocbimv22017783m.g","KQ430473",251304,252455,1151
"3166","Ocbimv22003148m.g","KQ424897",303511,304569,1058
"3167","Ocbimv22010372m.g","KQ415876",351662,388899,37237
"3168","Ocbimv22025182m.g","KQ419721",822684,823352,668
"3169","Ocbimv22037470m.g","KQ415759",732380,732778,398
"3170","Ocbimv22031747m.g","KQ421337",201778,216688,14910
"3171","Ocbimv22025929m.g","KQ419930",417887,420470,2583
"3172","Ocbimv22019016m.g","KQ418711",207102,207254,152
"3173","Ocbimv22035720m.g","KQ422521",223258,232118,8860
"3174","Ocbimv22020864m.g","KQ418971",136818,148452,11634
"3175","Ocbimv22015693m.g","KQ418276",110759,125843,15084
"3176","Ocbimv22035456m.g","KQ416587",80491,80700,209
"3177","Ocbimv22025159m.g","KQ419714",55252,56643,1391
"3178","Ocbimv22036118m.g","KQ416618",187940,201634,13694
"3179","Ocbimv22014302m.g","KQ418115",923373,923642,269
"3180","Ocbimv22004245m.g","KQ417143",489344,519061,29717
"3181","Ocbimv22012102m.g","KQ428038",2603,4211,1608
"3182","Ocbimv22025342m.g","KQ416150",15680,15856,176
"3183","Ocbimv22016801m.g","KQ418402",11587,23024,11437
"3184","Ocbimv22006498m.g","KQ425961",566,1269,703
"3185","Ocbimv22031744m.g","KQ421337",31456,31751,295
"3186","Ocbimv22031499m.g","KQ421263",20789,21636,847
"3187","Ocbimv22014779m.g","KQ418176",1283921,1310122,26201
"3188","Ocbimv22008813m.g","KQ426774",234077,236853,2776
"3189","Ocbimv22038912m.g","KQ416771",1477574,1480400,2826
"3190","Ocbimv22020150m.g","KQ418862",18213,18365,152
"3191","Ocbimv22003668m.g","KQ417100",236998,299856,62858
"3192","Ocbimv22000753m.g","KQ416878",472450,473201,751
"3193","Ocbimv22017533m.g","KQ430341",9025,9210,185
"3194","Ocbimv22013159m.g","KQ428399",15084,18818,3734
"3195","Ocbimv22004191m.g","KQ425220",517315,520774,3459
"3196","Ocbimv22002139m.g","KQ415788",809785,810267,482
"3197","Ocbimv22026543m.g","KQ420068",69849,70466,617
"3198","Ocbimv22009369m.g","LGKD01570234",34,471,437
"3199","Ocbimv22030492m.g","KQ416352",174942,175112,170
"3200","Ocbimv22008273m.g","KQ417492",621110,627075,5965
"3201","Ocbimv22008873m.g","KQ426791",428525,435081,6556
"3202","Ocbimv22021602m.g","KQ432245",82733,88313,5580
"3203","Ocbimv22027146m.g","KQ420203",180632,182895,2263
"3204","Ocbimv22026180m.g","KQ420011",95332,122184,26852
"3205","Ocbimv22011841m.g","KQ417838",25095,25947,852
"3206","Ocbimv22029524m.g","KQ420768",4266,4782,516
"3207","Ocbimv22035686m.g","KQ422516",479699,480541,842
"3208","Ocbimv22030822m.g","KQ416371",642863,643556,693
"3209","Ocbimv22023269m.g","KQ419388",128547,174266,45719
"3210","Ocbimv22039179m.g","KQ415772",97248,99079,1831
"3211","Ocbimv22010088m.g","KQ417641",286024,290915,4891
"3212","Ocbimv22034434m.g","KQ422036",884045,885036,991
"3213","Ocbimv22003629m.g","KQ425049",159679,161512,1833
"3214","Ocbimv22012396m.g","KQ417910",245820,246134,314
"3215","Ocbimv22020709m.g","KQ416032",284775,285603,828
"3216","Ocbimv22006095m.g","KQ425809",4834,8360,3526
"3217","Ocbimv22005879m.g","KQ417280",408487,410347,1860
"3218","Ocbimv22034836m.g","KQ422189",245066,302941,57875
"3219","Ocbimv22018377m.g","KQ418610",260254,274519,14265
"3220","Ocbimv22010230m.g","KQ427321",1400,3536,2136
"3221","Ocbimv22017708m.g","KQ415981",632685,632954,269
"3222","Ocbimv22003509m.g","KQ425021",72923,73336,413
"3223","Ocbimv22034269m.g","KQ422015",355602,378852,23250
"3224","Ocbimv22020747m.g","KQ431819",244625,257463,12838
"3225","Ocbimv22008871m.g","KQ426791",403703,409255,5552
"3226","Ocbimv22003415m.g","KQ417086",1048946,1051363,2417
"3227","Ocbimv22021507m.g","KQ419061",126471,144512,18041
"3228","Ocbimv22010547m.g","KQ427431",143607,184034,40427
"3229","Ocbimv22039675m.g","KQ416813",1083693,1084479,786
"3230","Ocbimv22003680m.g","KQ425065",29313,29939,626
"3231","Ocbimv22005692m.g","KQ417274",31350,32214,864
"3232","Ocbimv22007260m.g","KQ417395",183482,184140,658
"3233","Ocbimv22006043m.g","KQ417291",98572,139309,40737
"3234","Ocbimv22031518m.g","KQ421263",924276,924665,389
"3235","Ocbimv22013227m.g","KQ418002",438218,442091,3873
"3236","Ocbimv22031708m.g","KQ421325",21795,45064,23269
"3237","Ocbimv22002141m.g","KQ415788",852192,857070,4878
"3238","Ocbimv22007844m.g","KQ417455",108697,127225,18528
"3239","Ocbimv22016428m.g","KQ418351",152688,177275,24587
"3240","Ocbimv22010589m.g","KQ427442",598,20493,19895
"3241","Ocbimv22020430m.g","KQ416027",160470,180318,19848
"3242","Ocbimv22008932m.g","KQ426810",912,20041,19129
"3243","Ocbimv22001300m.g","KQ424262",323009,369229,46220
"3244","Ocbimv22008983m.g","KQ426827",1374,14997,13623
"3245","Ocbimv22023817m.g","LGKD01693013",207,560,353
"3246","Ocbimv22002435m.g","KQ417009",2090401,2092932,2531
"3247","Ocbimv22038027m.g","KQ416719",1062065,1115128,53063
"3248","Ocbimv22020785m.g","KQ418964",1009744,1036696,26952
"3249","Ocbimv22038637m.g","KQ423430",69060,69509,449
"3250","Ocbimv22030343m.g","KQ420958",67160,112632,45472
"3251","Ocbimv22005378m.g","KQ417249",257288,314692,57404
"3252","Ocbimv22015008m.g","KQ418194",131285,132033,748
"3253","Ocbimv22009726m.g","KQ427101",90466,91093,627
"3254","Ocbimv22001416m.g","KQ424302",300451,347417,46966
"3255","Ocbimv22023846m.g","KQ433670",9770,15683,5913
"3256","Ocbimv22018513m.g","KQ415994",25351,48547,23196
"3257","Ocbimv22038203m.g","KQ416731",405671,406075,404
"3258","Ocbimv22035936m.g","KQ422614",7143,7514,371
"3259","Ocbimv22030773m.g","KQ421085",230958,231657,699
"3260","Ocbimv22000376m.g","KQ423941",452608,452939,331
"3261","Ocbimv22013097m.g","KQ417981",593697,594899,1202
"3262","Ocbimv22022113m.g","LGKD01675491",15,239,224
"3263","Ocbimv22009987m.g","KQ427199",1846,51645,49799
"3264","Ocbimv22028746m.g","KQ420574",139650,140012,362
"3265","Ocbimv22003349m.g","KQ424990",80181,116348,36167
"3266","Ocbimv22039074m.g","KQ423536",422598,423290,692
"3267","Ocbimv22027374m.g","KQ420268",130619,130852,233
"3268","Ocbimv22029415m.g","KQ416305",187401,187997,596
"3269","Ocbimv22009059m.g","KQ417556",246315,252074,5759
"3270","Ocbimv22008100m.g","KQ426567",110261,110865,604
"3271","Ocbimv22038425m.g","KQ423336",199194,200060,866
"3272","Ocbimv22001054m.g","KQ424168",179814,181371,1557
"3273","Ocbimv22008392m.g","KQ426629",20278,68800,48522
"3274","Ocbimv22025583m.g","KQ416160",37511,37735,224
"3275","Ocbimv22004341m.g","KQ425268",2122,57965,55843
"3276","Ocbimv22020728m.g","LGKD01662719",64,367,303
"3277","Ocbimv22023756m.g","KQ416096",524855,525211,356
"3278","Ocbimv22007296m.g","KQ417401",111570,111794,224
"3279","Ocbimv22002733m.g","KQ417030",916257,916598,341
"3280","Ocbimv22035091m.g","KQ422274",134473,142234,7761
"3281","Ocbimv22000843m.g","KQ415664",141360,141662,302
"3282","Ocbimv22019220m.g","KQ418736",16084,16245,161
"3283","Ocbimv22014420m.g","KQ428909",69633,70022,389
"3284","Ocbimv22000883m.g","KQ424103",17536,17936,400
"3285","Ocbimv22012031m.g","KQ427978",141261,190405,49144
"3286","Ocbimv22003981m.g","KQ425165",147209,181146,33937
"3287","Ocbimv22006548m.g","KQ426003",50385,95698,45313
"3288","Ocbimv22012597m.g","LGKD01595903",961,1559,598
"3289","Ocbimv22000208m.g","KQ423900",13185,30961,17776
"3290","Ocbimv22029777m.g","KQ420820",1007021,1016730,9709
"3291","Ocbimv22002303m.g","KQ424627",131121,138386,7265
"3292","Ocbimv22014778m.g","KQ418176",1249682,1267750,18068
"3293","Ocbimv22008884m.g","KQ426791",689575,697927,8352
"3294","Ocbimv22036446m.g","KQ422765",363768,415614,51846
"3295","Ocbimv22015497m.g","KQ418263",646956,648101,1145
"3296","Ocbimv22012877m.g","KQ428260",94837,101356,6519
"3297","Ocbimv22028027m.g","KQ416244",17893,20506,2613
"3298","Ocbimv22006677m.g","KQ426074",17539,17841,302
"3299","Ocbimv22038256m.g","KQ423250",708719,708973,254
"3300","Ocbimv22037840m.g","KQ423139",473887,475360,1473
"3301","Ocbimv22000238m.g","KQ423903",173594,193297,19703
"3302","Ocbimv22018072m.g","KQ430554",17909,35546,17637
"3303","Ocbimv22027232m.g","KQ420223",77585,105190,27605
"3304","Ocbimv22005141m.g","KQ415813",1628571,1628846,275
"3305","Ocbimv22008956m.g","KQ417543",104041,106187,2146
"3306","Ocbimv22011033m.g","KQ427609",475,2362,1887
"3307","Ocbimv22014180m.g","KQ418098",107071,123060,15989
"3308","Ocbimv22033830m.g","KQ421891",249064,251324,2260
"3309","Ocbimv22008354m.g","KQ417498",51846,52605,759
"3310","Ocbimv22023625m.g","LGKD01691013",1,528,527
"3311","Ocbimv22030571m.g","KQ421026",23261,29399,6138
"3312","Ocbimv22021936m.g","KQ432434",8016,8741,725
"3313","Ocbimv22031018m.g","KQ421144",90978,92262,1284
"3314","Ocbimv22030766m.g","KQ421085",112461,134193,21732
"3315","Ocbimv22022823m.g","KQ433034",26663,47315,20652
"3316","Ocbimv22027511m.g","KQ420294",409748,409900,152
"3317","Ocbimv22029132m.g","KQ420662",78588,116748,38160
"3318","Ocbimv22035519m.g","KQ422416",325234,329513,4279
"3319","Ocbimv22017525m.g","KQ418504",225682,230437,4755
"3320","Ocbimv22005486m.g","KQ425619",83798,92155,8357
"3321","Ocbimv22011700m.g","KQ427867",2172,8232,6060
"3322","Ocbimv22027676m.g","KQ416230",1413314,1414598,1284
"3323","Ocbimv22038290m.g","KQ423260",402481,403302,821
"3324","Ocbimv22024243m.g","LGKD01697005",95,448,353
"3325","Ocbimv22018678m.g","KQ415684",660914,662732,1818
"3326","Ocbimv22009578m.g","KQ427029",123446,125280,1834
"3327","Ocbimv22013474m.g","KQ428524",172561,177023,4462
"3328","Ocbimv22021189m.g","KQ416040",180263,278074,97811
"3329","Ocbimv22006648m.g","KQ426052",17505,49992,32487
"3330","Ocbimv22025240m.g","KQ419743",246285,274994,28709
"3331","Ocbimv22034778m.g","LGKD01432635",260,460,200
"3332","Ocbimv22022570m.g","KQ419262",52116,57570,5454
"3333","Ocbimv22021580m.g","KQ419080",320539,320727,188
"3334","Ocbimv22026762m.g","KQ420110",171904,173456,1552
"3335","Ocbimv22001395m.g","KQ416930",336799,351662,14863
"3336","Ocbimv22013074m.g","KQ428366",13957,15340,1383
"3337","Ocbimv22038559m.g","KQ416751",301863,303205,1342
"3338","Ocbimv22005650m.g","KQ425700",74659,78309,3650
"3339","Ocbimv22034208m.g","KQ416523",473040,473943,903
"3340","Ocbimv22016481m.g","KQ429891",85360,92065,6705
"3341","Ocbimv22002739m.g","KQ424767",100106,100441,335
"3342","Ocbimv22016601m.g","KQ418370",535,9526,8991
"3343","Ocbimv22007542m.g","KQ426371",68484,68993,509
"3344","Ocbimv22013994m.g","KQ428718",108290,108734,444
"3345","Ocbimv22004605m.g","KQ417183",116081,116728,647
"3346","Ocbimv22025344m.g","KQ419779",16267,16782,515
"3347","Ocbimv22001697m.g","KQ424387",21499,53647,32148
"3348","Ocbimv22030771m.g","KQ421085",213111,213898,787
"3349","Ocbimv22033417m.g","KQ421808",470976,471440,464
"3350","Ocbimv22008046m.g","KQ417476",28575,38680,10105
"3351","Ocbimv22005648m.g","KQ417269",76866,104595,27729
"3352","Ocbimv22010702m.g","KQ417704",39026,45590,6564
"3353","Ocbimv22037800m.g","KQ423136",70090,81132,11042
"3354","Ocbimv22002380m.g","KQ417007",123267,123716,449
"3355","Ocbimv22028353m.g","KQ420477",228479,251339,22860
"3356","Ocbimv22032110m.g","KQ421451",194567,194728,161
"3357","Ocbimv22006280m.g","KQ425850",158343,159633,1290
"3358","Ocbimv22031675m.g","KQ421308",247429,253265,5836
"3359","Ocbimv22039376m.g","KQ423634",271662,274963,3301
"3360","Ocbimv22026367m.g","KQ416188",71970,103888,31918
"3361","Ocbimv22012524m.g","KQ417917",637379,656091,18712
"3362","Ocbimv22035810m.g","KQ416601",439258,439506,248
"3363","Ocbimv22008658m.g","KQ417518",624743,634891,10148
"3364","Ocbimv22026819m.g","KQ420120",189526,200135,10609
"3365","Ocbimv22025450m.g","KQ419803",97625,101501,3876
"3366","Ocbimv22002346m.g","KQ424639",25290,71513,46223
"3367","Ocbimv22031301m.g","KQ421217",477853,489050,11197
"3368","Ocbimv22031752m.g","KQ421338",129760,130857,1097
"3369","Ocbimv22027003m.g","KQ420162",60822,125120,64298
"3370","Ocbimv22022537m.g","KQ419243",47954,49751,1797
"3371","Ocbimv22010311m.g","KQ427350",106560,157487,50927
"3372","Ocbimv22016099m.g","KQ429708",207050,208442,1392
"3373","Ocbimv22032611m.g","KQ421607",196142,198426,2284
"3374","Ocbimv22026881m.g","KQ420132",1090534,1093272,2738
"3375","Ocbimv22035827m.g","KQ416602",553410,554021,611
"3376","Ocbimv22007319m.g","KQ417403",255807,255968,161
"3377","Ocbimv22039748m.g","KQ416818",825796,849168,23372
"3378","Ocbimv22010670m.g","KQ417701",167884,184512,16628
"3379","Ocbimv22029107m.g","KQ416286",137324,138414,1090
"3380","Ocbimv22035589m.g","KQ416593",12383,14881,2498
"3381","Ocbimv22000158m.g","KQ423877",83855,84052,197
"3382","Ocbimv22024606m.g","KQ419601",1346793,1392662,45869
"3383","Ocbimv22036902m.g","KQ422894",125790,151694,25904
"3384","Ocbimv22021042m.g","LGKD01273892",55,377,322
"3385","Ocbimv22010263m.g","KQ427334",49185,49364,179
"3386","Ocbimv22010308m.g","KQ427350",42121,79309,37188
"3387","Ocbimv22039962m.g","KQ423812",46757,64829,18072
"3388","Ocbimv22019018m.g","KQ418711",354703,386787,32084
"3389","Ocbimv22037068m.g","KQ416671",129697,131493,1796
"3390","Ocbimv22001637m.g","KQ416950",1279281,1279915,634
"3391","Ocbimv22035332m.g","KQ422358",13610,14359,749
"3392","Ocbimv22015792m.g","KQ418293",431686,431877,191
"3393","Ocbimv22022418m.g","KQ419216",6883,7962,1079
"3394","Ocbimv22021518m.g","KQ419065",5355,37895,32540
"3395","Ocbimv22022705m.g","KQ416073",231015,234284,3269
"3396","Ocbimv22008722m.g","KQ417527",9131,9512,381
"3397","Ocbimv22035895m.g","KQ422595",246436,258991,12555
"3398","Ocbimv22010371m.g","KQ415876",316492,351544,35052
"3399","Ocbimv22030355m.g","KQ420961",409017,409466,449
"3400","Ocbimv22007364m.g","KQ426313",38056,51309,13253
"3401","Ocbimv22017321m.g","KQ418483",29937,88396,58459
"3402","Ocbimv22017704m.g","LGKD01243875",17,196,179
"3403","Ocbimv22001230m.g","KQ416917",580998,581740,742
"3404","Ocbimv22020175m.g","LGKD01657530",143,316,173
"3405","Ocbimv22018153m.g","KQ418578",55412,56207,795
"3406","Ocbimv22039146m.g","KQ416781",716725,716901,176
"3407","Ocbimv22026835m.g","KQ420126",412810,413118,308
"3408","Ocbimv22016004m.g","KQ429656",2215,5439,3224
"3409","Ocbimv22031532m.g","KQ421267",905,28659,27754
"3410","Ocbimv22026228m.g","KQ420017",637929,646013,8084
"3411","Ocbimv22019442m.g","KQ418767",341104,341699,595
"3412","Ocbimv22007591m.g","KQ426392",1428,13180,11752
"3413","Ocbimv22015779m.g","KQ429566",11385,72423,61038
"3414","Ocbimv22014843m.g","KQ415935",155123,155984,861
"3415","Ocbimv22011631m.g","KQ417812",497061,543008,45947
"3416","Ocbimv22020507m.g","KQ418919",697630,699692,2062
"3417","Ocbimv22028775m.g","KQ420579",784186,786090,1904
"3418","Ocbimv22019364m.g","KQ416009",118276,120992,2716
"3419","Ocbimv22001633m.g","KQ416950",600059,609596,9537
"3420","Ocbimv22012149m.g","KQ417877",978236,978400,164
"3421","Ocbimv22019911m.g","KQ431376",40758,43266,2508
"3422","Ocbimv22036121m.g","KQ422647",83814,93394,9580
"3423","Ocbimv22000479m.g","KQ416864",18935,19243,308
"3424","Ocbimv22029191m.g","KQ420673",416765,423754,6989
"3425","Ocbimv22023693m.g","KQ419460",178071,201544,23473
"3426","Ocbimv22001336m.g","KQ424278",49255,49543,288
"3427","Ocbimv22035506m.g","KQ422411",530216,531898,1682
"3428","Ocbimv22031636m.g","KQ421305",217055,222572,5517
"3429","Ocbimv22005661m.g","KQ417271",348008,368754,20746
"3430","Ocbimv22033140m.g","KQ421736",5994,10872,4878
"3431","Ocbimv22016575m.g","KQ418368",235693,263403,27710
"3432","Ocbimv22023729m.g","KQ433600",22501,22713,212
"3433","Ocbimv22022438m.g","KQ419216",153474,165239,11765
"3434","Ocbimv22011375m.g","KQ417791",273044,305476,32432
"3435","Ocbimv22009684m.g","KQ427081",42362,49463,7101
"3436","Ocbimv22015963m.g","KQ429629",134089,144618,10529
"3437","Ocbimv22009518m.g","KQ415865",746841,747986,1145
"3438","Ocbimv22016810m.g","KQ418403",145924,146292,368
"3439","Ocbimv22024428m.g","KQ419577",491057,506393,15336
"3440","Ocbimv22024344m.g","KQ419574",267971,306280,38309
"3441","Ocbimv22039240m.g","KQ423591",284569,285491,922
"3442","Ocbimv22025165m.g","KQ416141",174867,183038,8171
"3443","Ocbimv22036553m.g","KQ422791",61186,97475,36289
"3444","Ocbimv22019677m.g","KQ418796",259077,260847,1770
"3445","Ocbimv22013368m.g","KQ428463",12969,24618,11649
"3446","Ocbimv22029231m.g","KQ416294",339910,340173,263
"3447","Ocbimv22002463m.g","KQ424662",34083,34364,281
"3448","Ocbimv22001647m.g","KQ416950",1996195,2006240,10045
"3449","Ocbimv22032521m.g","KQ421575",15655,29015,13360
"3450","Ocbimv22013851m.g","KQ415921",55004,57972,2968
"3451","Ocbimv22021249m.g","KQ419020",69071,80830,11759
"3452","Ocbimv22017635m.g","KQ418518",273323,282798,9475
"3453","Ocbimv22023606m.g","KQ416092",294968,311788,16820
"3454","Ocbimv22014788m.g","KQ429073",4486,7848,3362
"3455","Ocbimv22016205m.g","KQ415958",155221,157678,2457
"3456","Ocbimv22025672m.g","KQ419883",240214,240480,266
"3457","Ocbimv22030983m.g","KQ416380",41179,59124,17945
"3458","Ocbimv22036708m.g","KQ416654",287839,289798,1959
"3459","Ocbimv22016380m.g","KQ415962",1604386,1606610,2224
"3460","Ocbimv22025334m.g","KQ419775",248920,250785,1865
"3461","Ocbimv22002070m.g","KQ424530",1164521,1182910,18389
"3462","Ocbimv22024819m.g","KQ419631",808249,832707,24458
"3463","Ocbimv22007228m.g","KQ426253",106005,109049,3044
"3464","Ocbimv22001611m.g","KQ416947",547182,547358,176
"3465","Ocbimv22039521m.g","KQ423686",169052,169465,413
"3466","Ocbimv22016322m.g","KQ418338",432671,438429,5758
"3467","Ocbimv22021344m.g","KQ416042",399973,401343,1370
"3468","Ocbimv22004567m.g","KQ425361",412505,501785,89280
"3469","Ocbimv22012393m.g","KQ417910",81945,108459,26514
"3470","Ocbimv22005045m.g","KQ425504",15726,91250,75524
"3471","Ocbimv22014839m.g","KQ415935",93970,94362,392
"3472","Ocbimv22026508m.g","KQ420060",24117,36895,12778
"3473","Ocbimv22007808m.g","KQ426461",83975,93939,9964
"3474","Ocbimv22002111m.g","KQ424546",373,26988,26615
"3475","Ocbimv22016272m.g","KQ429784",150679,192573,41894
"3476","Ocbimv22036294m.g","KQ422707",7,639,632
"3477","Ocbimv22003683m.g","KQ425066",48921,70730,21809
"3478","Ocbimv22016449m.g","KQ415965",865509,865868,359
"3479","Ocbimv22006182m.g","KQ417301",5755,14747,8992
"3480","Ocbimv22021045m.g","KQ418997",184561,286080,101519
"3481","Ocbimv22024905m.g","KQ416131",557577,557813,236
"3482","Ocbimv22017616m.g","LGKD01636965",169,381,212
"3483","Ocbimv22030660m.g","KQ421052",151501,151839,338
"3484","Ocbimv22001838m.g","KQ424443",24554,25156,602
"3485","Ocbimv22000956m.g","KQ415782",219889,300771,80882
"3486","Ocbimv22024490m.g","KQ419588",409748,424658,14910
"3487","Ocbimv22019316m.g","KQ418749",166212,184945,18733
"3488","Ocbimv22006433m.g","KQ417319",9121,13830,4709
"3489","Ocbimv22007201m.g","KQ426236",8179,8535,356
"3490","Ocbimv22013321m.g","KQ418012",7622,97415,89793
"3491","Ocbimv22005990m.g","KQ415827",61343,77819,16476
"3492","Ocbimv22031098m.g","KQ421163",997257,1002302,5045
"3493","Ocbimv22037442m.g","KQ423024",352015,352311,296
"3494","Ocbimv22002293m.g","KQ417001",505109,505258,149
"3495","Ocbimv22024805m.g","KQ419631",262906,264152,1246
"3496","Ocbimv22016152m.g","KQ418322",865291,865990,699
"3497","Ocbimv22027886m.g","KQ420388",116151,116624,473
"3498","Ocbimv22018084m.g","KQ418571",291492,293959,2467
"3499","Ocbimv22017548m.g","KQ415978",5491,43589,38098
"3500","Ocbimv22029828m.g","KQ420828",960473,983998,23525
"3501","Ocbimv22002059m.g","KQ424530",382670,398330,15660
"3502","Ocbimv22020951m.g","KQ418982",553350,553652,302
"3503","Ocbimv22002281m.g","KQ424615",137783,138890,1107
"3504","Ocbimv22035418m.g","KQ422373",87243,87482,239
"3505","Ocbimv22025208m.g","KQ419728",69008,70629,1621
"3506","Ocbimv22018429m.g","KQ415992",36134,39961,3827
"3507","Ocbimv22004273m.g","KQ425254",23472,27166,3694
"3508","Ocbimv22002025m.g","KQ424513",206767,239405,32638
"3509","Ocbimv22036848m.g","KQ422876",166948,167914,966
"3510","Ocbimv22019085m.g","KQ418715",1043099,1043424,325
"3511","Ocbimv22025863m.g","KQ419916",186269,205630,19361
"3512","Ocbimv22014897m.g","LGKD01614038",6,877,871
"3513","Ocbimv22010759m.g","KQ417713",916948,917502,554
"3514","Ocbimv22036697m.g","KQ416653",166744,192655,25911
"3515","Ocbimv22032671m.g","KQ421633",35114,36181,1067
"3516","Ocbimv22027915m.g","KQ420401",7861,71380,63519
"3517","Ocbimv22008410m.g","KQ426634",116708,118356,1648
"3518","Ocbimv22025636m.g","KQ419868",87710,129774,42064
"3519","Ocbimv22002546m.g","KQ417014",86615,86788,173
"3520","Ocbimv22024214m.g","KQ419550",103698,114136,10438
"3521","Ocbimv22024856m.g","KQ419640",229406,229810,404
"3522","Ocbimv22036947m.g","KQ416666",1126238,1161592,35354
"3523","Ocbimv22039228m.g","KQ423590",141316,176319,35003
"3524","Ocbimv22039613m.g","KQ423717",166386,167239,853
"3525","Ocbimv22024675m.g","KQ419612",239,55261,55022
"3526","Ocbimv22027486m.g","KQ416225",519812,527737,7925
"3527","Ocbimv22010468m.g","KQ417681",45,11103,11058
"3528","Ocbimv22004219m.g","KQ425236",117711,117872,161
"3529","Ocbimv22007343m.g","KQ415841",23562,28073,4511
"3530","Ocbimv22001150m.g","KQ416913",65086,100644,35558
"3531","Ocbimv22034307m.g","KQ422015",1239770,1240884,1114
"3532","Ocbimv22025644m.g","KQ419874",164232,164489,257
"3533","Ocbimv22027487m.g","KQ420289",65191,128766,63575
"3534","Ocbimv22037912m.g","KQ423164",160654,160908,254
"3535","Ocbimv22013868m.g","KQ418069",84462,87382,2920
"3536","Ocbimv22002871m.g","KQ424812",277709,277900,191
"3537","Ocbimv22038391m.g","KQ423306",2985,3230,245
"3538","Ocbimv22037995m.g","KQ416719",179673,180152,479
"3539","Ocbimv22026466m.g","KQ420053",904270,907170,2900
"3540","Ocbimv22031391m.g","KQ421226",155128,184366,29238
"3541","Ocbimv22015720m.g","KQ429511",16481,16929,448
"3542","Ocbimv22026317m.g","KQ420026",1558,1935,377
"3543","Ocbimv22006122m.g","KQ417300",125525,125776,251
"3544","Ocbimv22033424m.g","KQ421809",132231,168555,36324
"3545","Ocbimv22038410m.g","KQ423329",5551,15977,10426
"3546","Ocbimv22039106m.g","KQ416779",450350,451697,1347
"3547","Ocbimv22012638m.g","KQ428192",74742,75429,687
"3548","Ocbimv22026490m.g","KQ416189",234971,235632,661
"3549","Ocbimv22002283m.g","KQ424620",11054,12687,1633
"3550","Ocbimv22038619m.g","KQ423419",143068,144212,1144
"3551","Ocbimv22021456m.g","KQ416046",36792,72176,35384
"3552","Ocbimv22034933m.g","KQ416562",285519,285821,302
"3553","Ocbimv22019015m.g","KQ418711",187457,193827,6370
"3554","Ocbimv22001011m.g","KQ424151",52592,52858,266
"3555","Ocbimv22009264m.g","KQ417578",1207500,1218230,10730
"3556","Ocbimv22015598m.g","KQ415946",600192,603079,2887
"3557","Ocbimv22032903m.g","KQ421682",3,341,338
"3558","Ocbimv22039710m.g","KQ416815",543104,543262,158
"3559","Ocbimv22028555m.g","KQ416260",1541660,1541878,218
"3560","Ocbimv22026828m.g","KQ420126",34283,46772,12489
"3561","Ocbimv22015977m.g","KQ415949",796631,797170,539
"3562","Ocbimv22029463m.g","KQ420758",172308,172487,179
"3563","Ocbimv22016934m.g","KQ430090",37906,43517,5611
"3564","Ocbimv22003588m.g","KQ417094",138187,138786,599
"3565","Ocbimv22036815m.g","KQ416658",1721637,1722104,467
"3566","Ocbimv22000564m.g","KQ416867",63807,64373,566
"3567","Ocbimv22003521m.g","KQ425021",259208,268777,9569
"3568","Ocbimv22020086m.g","KQ431445",48481,71369,22888
"3569","Ocbimv22039311m.g","KQ416788",29287,30432,1145
"3570","Ocbimv22003115m.g","KQ417059",78315,82217,3902
"3571","Ocbimv22008949m.g","KQ426816",254140,255047,907
"3572","Ocbimv22003938m.g","KQ425152",3607,28357,24750
"3573","Ocbimv22021648m.g","KQ432265",4865,9100,4235
"3574","Ocbimv22022205m.g","KQ416062",523,4766,4243
"3575","Ocbimv22005614m.g","KQ425681",1328,14392,13064
"3576","Ocbimv22022993m.g","KQ433178",1376,1531,155
"3577","Ocbimv22010867m.g","KQ427557",31357,33916,2559
"3578","Ocbimv22033011m.g","KQ421718",100908,112607,11699
"3579","Ocbimv22028672m.g","KQ420549",198071,198358,287
"3580","Ocbimv22027484m.g","KQ416225",461875,463626,1751
"3581","Ocbimv22038968m.g","KQ416773",122284,122622,338
"3582","Ocbimv22021537m.g","KQ419071",252282,287634,35352
"3583","Ocbimv22005980m.g","KQ417288",279290,302763,23473
"3584","Ocbimv22036235m.g","KQ416626",1025209,1029270,4061
"3585","Ocbimv22029707m.g","KQ416318",62746,78159,15413
"3586","Ocbimv22038706m.g","KQ416761",331943,335136,3193
"3587","Ocbimv22004030m.g","KQ425190",30267,33855,3588
"3588","Ocbimv22037763m.g","KQ416710",1045559,1046149,590
"3589","Ocbimv22014618m.g","KQ415934",191792,197408,5616
"3590","Ocbimv22029511m.g","KQ416311",168980,230561,61581
"3591","Ocbimv22020152m.g","KQ418863",54844,174733,119889
"3592","Ocbimv22003424m.g","KQ417087",456562,457100,538
"3593","Ocbimv22007376m.g","KQ426313",451037,451480,443
"3594","Ocbimv22010993m.g","KQ417731",287357,288035,678
"3595","Ocbimv22005557m.g","KQ417261",341650,341871,221
"3596","Ocbimv22033979m.g","KQ421934",104928,139120,34192
"3597","Ocbimv22012897m.g","KQ417950",8650,16996,8346
"3598","Ocbimv22010072m.g","KQ427251",4656,8200,3544
"3599","Ocbimv22033776m.g","KQ421869",282742,284182,1440
"3600","Ocbimv22007547m.g","KQ426371",276158,316102,39944
"3601","Ocbimv22022709m.g","KQ432975",129134,131798,2664
"3602","Ocbimv22007910m.g","KQ417459",276205,279116,2911
"3603","Ocbimv22019649m.g","KQ431217",85529,85795,266
"3604","Ocbimv22038858m.g","KQ415768",647361,647772,411
"3605","Ocbimv22016283m.g","KQ429791",9567,11221,1654
"3606","Ocbimv22028004m.g","KQ420415",677657,679645,1988
"3607","Ocbimv22030104m.g","KQ420892",62028,74403,12375
"3608","Ocbimv22011943m.g","KQ417847",1014743,1017876,3133
"3609","Ocbimv22023386m.g","KQ419396",38348,38599,251
"3610","Ocbimv22021536m.g","KQ419071",222649,229371,6722
"3611","Ocbimv22023506m.g","KQ433428",3437,3844,407
"3612","Ocbimv22039281m.g","KQ416787",140892,210046,69154
"3613","Ocbimv22025348m.g","KQ419780",51821,73450,21629
"3614","Ocbimv22000067m.g","KQ423844",22741,24655,1914
"3615","Ocbimv22026829m.g","KQ420126",58568,68098,9530
"3616","Ocbimv22012175m.g","KQ417880",967400,967627,227
"3617","Ocbimv22002316m.g","KQ424629",8184,13877,5693
"3618","Ocbimv22015066m.g","KQ418194",1255820,1256917,1097
"3619","Ocbimv22034321m.g","KQ422016",7530,17531,10001
"3620","Ocbimv22026926m.g","KQ416205",580123,581472,1349
"3621","Ocbimv22007856m.g","KQ417455",315921,316454,533
"3622","Ocbimv22029821m.g","KQ420828",873565,875281,1716
"3623","Ocbimv22013409m.g","KQ418021",8086,25322,17236
"3624","Ocbimv22010825m.g","KQ427529",81550,81813,263
"3625","Ocbimv22032603m.g","KQ421605",23312,23899,587
"3626","Ocbimv22034534m.g","KQ416536",149768,150016,248
"3627","Ocbimv22030511m.g","KQ421009",649921,650277,356
"3628","Ocbimv22003645m.g","LGKD01523231",114,647,533
"3629","Ocbimv22020980m.g","KQ418988",385552,450151,64599
"3630","Ocbimv22014056m.g","KQ428738",86820,87623,803
"3631","Ocbimv22025005m.g","KQ419682",85165,85356,191
"3632","Ocbimv22017037m.g","LGKD01034724",6,167,161
"3633","Ocbimv22022127m.g","KQ419175",417313,417590,277
"3634","Ocbimv22021771m.g","KQ419098",717174,717843,669
"3635","Ocbimv22032060m.g","KQ421415",154428,191601,37173
"3636","Ocbimv22029513m.g","KQ416311",502137,505100,2963
"3637","Ocbimv22036457m.g","KQ422771",15568,19966,4398
"3638","Ocbimv22037519m.g","KQ423056",466942,468016,1074
"3639","Ocbimv22010515m.g","LGKD01580158",43,297,254
"3640","Ocbimv22009006m.g","KQ417549",382335,383186,851
"3641","Ocbimv22035846m.g","KQ422575",86443,87910,1467
"3642","Ocbimv22004638m.g","KQ417191",11298,17142,5844
"3643","Ocbimv22007566m.g","KQ417429",187217,187522,305
"3644","Ocbimv22004425m.g","KQ415804",449636,450902,1266
"3645","Ocbimv22019428m.g","LGKD01650657",304,561,257
"3646","Ocbimv22020381m.g","KQ418901",21181,21468,287
"3647","Ocbimv22036687m.g","LGKD01453822",49,322,273
"3648","Ocbimv22002527m.g","KQ424677",3401,7567,4166
"3649","Ocbimv22011296m.g","KQ417777",146132,146664,532
"3650","Ocbimv22033157m.g","KQ421737",432310,442505,10195
"3651","Ocbimv22013075m.g","KQ417979",1445,44175,42730
"3652","Ocbimv22039579m.g","KQ423707",47731,57884,10153
"3653","Ocbimv22020897m.g","KQ418974",215873,221822,5949
"3654","Ocbimv22016174m.g","KQ429724",17955,19649,1694
"3655","Ocbimv22014485m.g","KQ428962",3,5263,5260
"3656","Ocbimv22014811m.g","KQ429096",286995,287483,488
"3657","Ocbimv22039576m.g","KQ423704",91219,95581,4362
"3658","Ocbimv22004523m.g","KQ415805",664440,665432,992
"3659","Ocbimv22020660m.g","KQ418947",90191,115189,24998
"3660","Ocbimv22025259m.g","KQ419750",84135,93759,9624
"3661","Ocbimv22029328m.g","KQ416298",198957,215242,16285
"3662","Ocbimv22008355m.g","KQ417498",115083,158156,43073
"3663","Ocbimv22011363m.g","KQ417791",181177,267018,85841
"3664","Ocbimv22031464m.g","KQ416399",263343,270063,6720
"3665","Ocbimv22019164m.g","KQ418725",4759,6078,1319
"3666","Ocbimv22010739m.g","LGKD01581941",215,709,494
"3667","Ocbimv22036964m.g","KQ416666",1873675,1956236,82561
"3668","Ocbimv22027949m.g","KQ420409",131966,145976,14010
"3669","Ocbimv22038648m.g","KQ423430",777822,781903,4081
"3670","Ocbimv22008210m.g","KQ426582",155473,171310,15837
"3671","Ocbimv22037312m.g","KQ416685",154613,154792,179
"3672","Ocbimv22030238m.g","KQ420927",79535,80485,950
"3673","Ocbimv22001266m.g","KQ424244",394195,396295,2100
"3674","Ocbimv22004268m.g","KQ415802",160501,165768,5267
"3675","Ocbimv22021909m.g","KQ432421",15384,17058,1674
"3676","Ocbimv22014170m.g","KQ428790",16693,79794,63101
"3677","Ocbimv22031827m.g","KQ421356",148775,180122,31347
"3678","Ocbimv22039780m.g","KQ416822",106491,135154,28663
"3679","Ocbimv22011063m.g","KQ427615",10018,10392,374
"3680","Ocbimv22009613m.g","LGKD01572067",13895,16360,2465
"3681","Ocbimv22033999m.g","KQ416507",194567,195819,1252
"3682","Ocbimv22022008m.g","KQ432511",19080,24341,5261
"3683","Ocbimv22032597m.g","KQ416441",384670,386760,2090
"3684","Ocbimv22027975m.g","KQ420414",410350,410631,281
"3685","Ocbimv22038753m.g","KQ416765",88477,88668,191
"3686","Ocbimv22012475m.g","KQ417914",30643,31176,533
"3687","Ocbimv22023191m.g","KQ419368",435759,451383,15624
"3688","Ocbimv22020068m.g","KQ418849",137662,154475,16813
"3689","Ocbimv22003961m.g","KQ425160",497726,504380,6654
"3690","Ocbimv22008541m.g","KQ426672",6679,7629,950
"3691","Ocbimv22007911m.g","KQ417459",285542,291808,6266
"3692","Ocbimv22017784m.g","KQ430473",286214,292192,5978
"3693","Ocbimv22034541m.g","KQ416536",324699,342455,17756
"3694","Ocbimv22028726m.g","KQ416270",720380,722796,2416
"3695","Ocbimv22032348m.g","KQ421523",1329463,1338115,8652
"3696","Ocbimv22018136m.g","KQ418576",160121,297051,136930
"3697","Ocbimv22036628m.g","KQ416651",1497656,1590734,93078
"3698","Ocbimv22004211m.g","KQ425226",17232,18117,885
"3699","Ocbimv22018064m.g","KQ418561",256714,272680,15966
"3700","Ocbimv22003324m.g","KQ417080",184781,186284,1503
"3701","Ocbimv22011401m.g","KQ417791",1079805,1080629,824
"3702","Ocbimv22019350m.g","KQ418754",45181,45838,657
"3703","Ocbimv22007949m.g","KQ426499",304395,305038,643
"3704","Ocbimv22017544m.g","KQ430345",140591,151298,10707
"3705","Ocbimv22014096m.g","LGKD01606365",3,155,152
"3706","Ocbimv22035672m.g","KQ422500",204029,213586,9557
"3707","Ocbimv22007791m.g","KQ426456",415575,416269,694
"3708","Ocbimv22019425m.g","KQ418762",76640,84402,7762
"3709","Ocbimv22015275m.g","KQ415941",19981,23193,3212
"3710","Ocbimv22023414m.g","KQ433360",39983,41861,1878
"3711","Ocbimv22015635m.g","KQ418269",1124415,1133549,9134
"3712","Ocbimv22014910m.g","KQ418187",296114,297094,980
"3713","Ocbimv22008377m.g","KQ417498",1093639,1093800,161
"3714","Ocbimv22022111m.g","KQ419169",40666,91857,51191
"3715","Ocbimv22009190m.g","KQ426914",81980,86855,4875
"3716","Ocbimv22036873m.g","KQ422887",76042,82465,6423
"3717","Ocbimv22025339m.g","KQ419776",18762,52216,33454
"3718","Ocbimv22007906m.g","KQ417459",162963,211701,48738
"3719","Ocbimv22037749m.g","KQ416708",493091,494775,1684
"3720","Ocbimv22011272m.g","KQ417771",1666727,1666999,272
"3721","Ocbimv22028992m.g","KQ416279",35241,37465,2224
"3722","Ocbimv22020219m.g","KQ431541",53535,71536,18001
"3723","Ocbimv22032719m.g","KQ421646",2880,3641,761
"3724","Ocbimv22018457m.g","KQ415992",683977,694319,10342
"3725","Ocbimv22011207m.g","KQ417763",52,4916,4864
"3726","Ocbimv22017079m.g","KQ430159",112326,124493,12167
"3727","Ocbimv22016409m.g","KQ429848",32855,34057,1202
"3728","Ocbimv22016674m.g","KQ418378",220818,220976,158
"3729","Ocbimv22039104m.g","KQ416779",437810,449411,11601
"3730","Ocbimv22037002m.g","KQ422903",458475,484836,26361
"3731","Ocbimv22027872m.g","KQ416236",237949,335689,97740
"3732","Ocbimv22018958m.g","KQ418702",427240,427956,716
"3733","Ocbimv22032504m.g","KQ421564",352367,354280,1913
"3734","Ocbimv22002643m.g","KQ417023",1301349,1301580,231
"3735","Ocbimv22020920m.g","KQ418974",1833425,1837444,4019
"3736","Ocbimv22007588m.g","KQ426385",355184,355655,471
"3737","Ocbimv22033306m.g","KQ421769",90712,92998,2286
"3738","Ocbimv22028675m.g","KQ420550",9350,27510,18160
"3739","Ocbimv22028381m.g","KQ416257",357057,400093,43036
"3740","Ocbimv22019553m.g","KQ418783",541221,542006,785
"3741","Ocbimv22020807m.g","LGKD01663517",142,330,188
"3742","Ocbimv22022153m.g","KQ419176",649606,652649,3043
"3743","Ocbimv22022756m.g","KQ432986",6761,6952,191
"3744","Ocbimv22011960m.g","KQ417847",1367259,1379762,12503
"3745","Ocbimv22038007m.g","KQ416719",341203,341857,654
"3746","Ocbimv22038342m.g","KQ416737",547879,548394,515
"3747","Ocbimv22004236m.g","KQ417143",124459,153672,29213
"3748","Ocbimv22015294m.g","KQ429255",115788,116003,215
"3749","Ocbimv22023901m.g","KQ419496",172166,172880,714
"3750","Ocbimv22038422m.g","KQ423334",120884,122434,1550
"3751","Ocbimv22031408m.g","KQ421232",107850,138406,30556
"3752","Ocbimv22021887m.g","KQ419121",59569,60156,587
"3753","Ocbimv22015674m.g","KQ429470",96312,97013,701
"3754","Ocbimv22002033m.g","KQ424524",90866,91270,404
"3755","Ocbimv22010187m.g","KQ417653",722054,750861,28807
"3756","Ocbimv22028080m.g","KQ416247",39791,40240,449
"3757","Ocbimv22011907m.g","KQ427949",95219,116832,21613
"3758","Ocbimv22038183m.g","KQ423231",160620,177188,16568
"3759","Ocbimv22009284m.g","KQ426946",40,285,245
"3760","Ocbimv22035229m.g","KQ416579",204683,208262,3579
"3761","Ocbimv22010237m.g","KQ427325",21283,28354,7071
"3762","Ocbimv22007918m.g","KQ417459",467314,467538,224
"3763","Ocbimv22017897m.g","KQ418555",1528066,1575236,47170
"3764","Ocbimv22002789m.g","KQ424785",212007,249309,37302
"3765","Ocbimv22028951m.g","KQ420605",815478,832802,17324
"3766","Ocbimv22003664m.g","KQ417100",92869,93318,449
"3767","Ocbimv22026165m.g","KQ420009",8374,52059,43685
"3768","Ocbimv22020630m.g","KQ418945",48251,48841,590
"3769","Ocbimv22016011m.g","KQ418310",87232,115327,28095
"3770","Ocbimv22038455m.g","KQ416743",19410,30783,11373
"3771","Ocbimv22017583m.g","KQ430365",62219,114916,52697
"3772","Ocbimv22006622m.g","KQ417337",186847,187119,272
"3773","Ocbimv22004804m.g","KQ417208",146967,160958,13991
"3774","Ocbimv22002245m.g","KQ416999",959971,1081075,121104
"3775","Ocbimv22013055m.g","KQ417977",178244,186721,8477
"3776","Ocbimv22009774m.g","KQ417613",165445,165609,164
"3777","Ocbimv22003157m.g","KQ417062",30703,35169,4466
"3778","Ocbimv22008487m.g","KQ426647",295979,296182,203
"3779","Ocbimv22023573m.g","KQ419433",154669,186859,32190
"3780","Ocbimv22005153m.g","KQ425531",540157,540315,158
"3781","Ocbimv22037775m.g","KQ423131",122476,224366,101890
"3782","Ocbimv22016397m.g","KQ418341",15250,21909,6659
"3783","Ocbimv22030514m.g","KQ421009",1119897,1121600,1703
"3784","Ocbimv22022595m.g","KQ419269",14835,23574,8739
"3785","Ocbimv22036980m.g","KQ422898",19414,24999,5585
"3786","Ocbimv22000084m.g","KQ416839",47093,49975,2882
"3787","Ocbimv22020130m.g","KQ418859",124936,157390,32454
"3788","Ocbimv22031392m.g","KQ421229",4217,4670,453
"3789","Ocbimv22019905m.g","KQ418834",2296,20415,18119
"3790","Ocbimv22036850m.g","KQ422876",311163,311372,209
"3791","Ocbimv22007273m.g","KQ417397",45433,46463,1030
"3792","Ocbimv22028058m.g","KQ420424",121991,126887,4896
"3793","Ocbimv22027247m.g","KQ420228",16239,16865,626
"3794","Ocbimv22014774m.g","KQ418176",1004453,1021499,17046
"3795","Ocbimv22002366m.g","KQ424650",133096,133696,600
"3796","Ocbimv22025691m.g","KQ416164",199453,199674,221
"3797","Ocbimv22014017m.g","KQ418079",2898,3092,194
"3798","Ocbimv22025704m.g","KQ419887",269091,395077,125986
"3799","Ocbimv22017857m.g","KQ418552",251450,286267,34817
"3800","Ocbimv22039730m.g","KQ423737",29663,32225,2562
"3801","Ocbimv22008004m.g","KQ415849",65984,95296,29312
"3802","Ocbimv22033300m.g","KQ415661",128153,128488,335
"3803","Ocbimv22031011m.g","KQ416382",561837,562022,185
"3804","Ocbimv22014495m.g","KQ418142",143304,143734,430
"3805","Ocbimv22013305m.g","KQ418009",354985,359485,4500
"3806","Ocbimv22024566m.g","KQ419597",21329,22318,989
"3807","Ocbimv22030726m.g","KQ421079",230132,230389,257
"3808","Ocbimv22027982m.g","KQ420415",65208,66266,1058
"3809","Ocbimv22006110m.g","KQ417297",354057,356195,2138
"3810","Ocbimv22017727m.g","KQ418532",108616,108917,301
"3811","Ocbimv22025937m.g","KQ419930",619297,619678,381
"3812","Ocbimv22030874m.g","KQ416373",1003073,1048972,45899
"3813","Ocbimv22001401m.g","KQ424300",40633,40827,194
"3814","Ocbimv22026536m.g","KQ420065",252036,252260,224
"3815","Ocbimv22007418m.g","KQ426334",97211,112915,15704
"3816","Ocbimv22018588m.g","KQ418644",138606,138953,347
"3817","Ocbimv22016437m.g","KQ418355",2598,19749,17151
"3818","Ocbimv22011283m.g","KQ417775",13227,13544,317
"3819","Ocbimv22012294m.g","KQ417901",109326,110153,827
"3820","Ocbimv22034038m.g","KQ416508",377949,398212,20263
"3821","Ocbimv22018637m.g","KQ430779",1,1005,1004
"3822","Ocbimv22035154m.g","KQ422291",7949,182173,174224
"3823","Ocbimv22032302m.g","KQ421519",260588,261422,834
"3824","Ocbimv22004218m.g","KQ425236",108228,110250,2022
"3825","Ocbimv22020476m.g","KQ418919",99763,100693,930
"3826","Ocbimv22025547m.g","KQ416158",11091,11427,336
"3827","Ocbimv22023632m.g","KQ419448",84818,85794,976
"3828","Ocbimv22003061m.g","KQ424870",34671,38319,3648
"3829","Ocbimv22001403m.g","KQ424300",65043,68507,3464
"3830","Ocbimv22019206m.g","KQ418734",42453,43948,1495
"3831","Ocbimv22009353m.g","KQ417585",1086298,1095856,9558
"3832","Ocbimv22008054m.g","KQ426552",41623,52385,10762
"3833","Ocbimv22015982m.g","KQ418304",155981,156181,200
"3834","Ocbimv22014708m.g","KQ418168",646799,647574,775
"3835","Ocbimv22028425m.g","KQ420485",44285,64494,20209
"3836","Ocbimv22027946m.g","KQ420409",646,5858,5212
"3837","Ocbimv22002412m.g","KQ417009",88996,89477,481
"3838","Ocbimv22026483m.g","KQ420055",815051,842171,27120
"3839","Ocbimv22000805m.g","KQ416885",253991,254167,176
"3840","Ocbimv22013094m.g","KQ417981",498889,499068,179
"3841","Ocbimv22002456m.g","KQ424659",237771,254873,17102
"3842","Ocbimv22010401m.g","KQ417676",362544,362789,245
"3843","Ocbimv22015876m.g","KQ429601",11880,63337,51457
"3844","Ocbimv22017777m.g","KQ430470",12773,22739,9966
"3845","Ocbimv22038816m.g","KQ416766",11894,49976,38082
"3846","Ocbimv22009891m.g","KQ417621",576648,581580,4932
"3847","Ocbimv22037786m.g","KQ416711",230087,299036,68949
"3848","Ocbimv22037101m.g","KQ422922",33761,34795,1034
"3849","Ocbimv22024349m.g","KQ419574",365424,366082,658
"3850","Ocbimv22004140m.g","KQ417140",1623,45504,43881
"3851","Ocbimv22014990m.g","KQ418193",171062,171871,809
"3852","Ocbimv22010158m.g","KQ427290",82150,134682,52532
"3853","Ocbimv22024442m.g","KQ416122",13751,14638,887
"3854","Ocbimv22005441m.g","KQ417252",874634,879118,4484
"3855","Ocbimv22039086m.g","KQ423542",161745,192383,30638
"3856","Ocbimv22001216m.g","KQ424229",296744,327021,30277
"3857","Ocbimv22020627m.g","LGKD01662321",917,4229,3312
"3858","Ocbimv22034104m.g","KQ421976",17612,22625,5013
"3859","Ocbimv22022786m.g","KQ419298",67447,68264,817
"3860","Ocbimv22012143m.g","KQ417877",376894,389615,12721
"3861","Ocbimv22030240m.g","KQ416338",78550,78822,272
"3862","Ocbimv22002603m.g","KQ417021",1616954,1640266,23312
"3863","Ocbimv22021578m.g","KQ419080",165122,165577,455
"3864","Ocbimv22016255m.g","KQ418333",135536,221333,85797
"3865","Ocbimv22023356m.g","KQ419395",165202,166041,839
"3866","Ocbimv22029942m.g","KQ416325",104863,105750,887
"3867","Ocbimv22033936m.g","KQ416499",240857,259439,18582
"3868","Ocbimv22027184m.g","KQ416213",242912,258914,16002
"3869","Ocbimv22039601m.g","KQ416808",258776,260201,1425
"3870","Ocbimv22038977m.g","KQ423497",29331,30909,1578
"3871","Ocbimv22006426m.g","KQ425918",16650,16925,275
"3872","Ocbimv22014241m.g","KQ428817",7483,20349,12866
"3873","Ocbimv22019802m.g","KQ418816",56480,58090,1610
"3874","Ocbimv22039084m.g","KQ423542",9231,11693,2462
"3875","Ocbimv22007488m.g","KQ415843",156743,161393,4650
"3876","Ocbimv22029306m.g","KQ420703",139976,140194,218
"3877","Ocbimv22034921m.g","KQ415742",408750,409023,273
"3878","Ocbimv22026287m.g","KQ420023",176945,211652,34707
"3879","Ocbimv22001523m.g","KQ416941",7,8537,8530
"3880","Ocbimv22008006m.g","KQ415849",203695,224019,20324
"3881","Ocbimv22024385m.g","KQ415693",254517,275995,21478
"3882","Ocbimv22031777m.g","KQ421343",36807,130974,94167
"3883","Ocbimv22017578m.g","KQ418508",100625,100875,250
"3884","Ocbimv22013802m.g","KQ418061",328201,336883,8682
"3885","Ocbimv22027730m.g","KQ420350",73098,74388,1290
"3886","Ocbimv22000166m.g","KQ416846",345164,346961,1797
"3887","Ocbimv22005331m.g","KQ417243",138731,139709,978
"3888","Ocbimv22008401m.g","KQ426629",178662,179232,570
"3889","Ocbimv22025572m.g","KQ419849",40040,45060,5020
"3890","Ocbimv22000684m.g","KQ424055",357506,357952,446
"3891","Ocbimv22007496m.g","KQ415843",244427,282511,38084
"3892","Ocbimv22009362m.g","KQ417587",107732,108123,391
"3893","Ocbimv22022021m.g","KQ432511",76703,77774,1071
"3894","Ocbimv22029966m.g","KQ420863",104414,104806,392
"3895","Ocbimv22007823m.g","KQ417454",114538,119578,5040
"3896","Ocbimv22034175m.g","KQ416518",402369,455684,53315
"3897","Ocbimv22001005m.g","KQ424146",479496,479795,299
"3898","Ocbimv22033460m.g","KQ421819",35536,36705,1169
"3899","Ocbimv22016663m.g","KQ418376",61882,77431,15549
"3900","Ocbimv22030364m.g","KQ420963",131257,148935,17678
"3901","Ocbimv22015889m.g","KQ418299",259648,291708,32060
"3902","Ocbimv22010253m.g","KQ415873",169279,204931,35652
"3903","Ocbimv22028246m.g","KQ415659",107564,130866,23302
"3904","Ocbimv22006730m.g","KQ417344",169053,174547,5494
"3905","Ocbimv22003074m.g","KQ424877",202360,202527,167
"3906","Ocbimv22005847m.g","KQ417280",179146,179841,695
"3907","Ocbimv22038535m.g","KQ416750",626337,628115,1778
"3908","Ocbimv22000278m.g","KQ423910",528110,573305,45195
"3909","Ocbimv22008297m.g","KQ417495",534641,535063,422
"3910","Ocbimv22035098m.g","KQ422278",36012,36681,669
"3911","Ocbimv22025832m.g","KQ419909",407100,408176,1076
"3912","Ocbimv22005269m.g","KQ415814",278163,407871,129708
"3913","Ocbimv22034642m.g","KQ422099",280616,280927,311
"3914","Ocbimv22031819m.g","KQ415726",944042,948130,4088
"3915","Ocbimv22016179m.g","KQ418323",255016,255261,245
"3916","Ocbimv22025776m.g","KQ416166",1651417,1652613,1196
"3917","Ocbimv22003001m.g","KQ424862",125006,125875,869
"3918","Ocbimv22033527m.g","KQ421824",285954,286632,678
"3919","Ocbimv22035149m.g","KQ422290",417603,425240,7637
"3920","Ocbimv22008345m.g","KQ417497",1874135,1874374,239
"3921","Ocbimv22017676m.g","KQ430413",30589,49435,18846
"3922","Ocbimv22006739m.g","KQ417345",420116,466747,46631
"3923","Ocbimv22039492m.g","KQ423677",25459,25659,200
"3924","Ocbimv22032838m.g","KQ421664",1588776,1589331,555
"3925","Ocbimv22025932m.g","KQ419930",451979,452647,668
"3926","Ocbimv22009437m.g","KQ426995",53336,60466,7130
"3927","Ocbimv22005920m.g","KQ417284",381524,381898,374
"3928","Ocbimv22017173m.g","KQ418459",426249,471766,45517
"3929","Ocbimv22036264m.g","KQ416628",169183,172072,2889
"3930","Ocbimv22025991m.g","KQ419945",4850,5455,605
"3931","Ocbimv22028976m.g","KQ416278",293428,295086,1658
"3932","Ocbimv22002241m.g","KQ416999",310253,310669,416
"3933","Ocbimv22009210m.g","KQ417574",1409488,1409802,314
"3934","Ocbimv22029951m.g","KQ420859",50183,60081,9898
"3935","Ocbimv22022175m.g","KQ419180",543078,553627,10549
"3936","Ocbimv22008709m.g","KQ426740",405942,407428,1486
"3937","Ocbimv22023822m.g","KQ419484",55077,76959,21882
"3938","Ocbimv22000407m.g","KQ423957",53302,54483,1181
"3939","Ocbimv22004949m.g","KQ417216",136630,144508,7878
"3940","Ocbimv22023408m.g","KQ419402",196256,196540,284
"3941","Ocbimv22035475m.g","KQ422396",18238,18654,416
"3942","Ocbimv22009131m.g","KQ426892",85116,86579,1463
"3943","Ocbimv22021358m.g","KQ416042",1985213,2015818,30605
"3944","Ocbimv22001260m.g","KQ424243",258508,260075,1567
"3945","Ocbimv22021772m.g","KQ419098",767755,769954,2199
"3946","Ocbimv22016908m.g","KQ418422",279893,280180,287
"3947","Ocbimv22025305m.g","KQ419766",14856,15044,188
"3948","Ocbimv22027163m.g","KQ416211",101076,101614,538
"3949","Ocbimv22006437m.g","KQ417319",24340,29787,5447
"3950","Ocbimv22022722m.g","KQ416074",494,12421,11927
"3951","Ocbimv22002685m.g","KQ424738",123132,134788,11656
"3952","Ocbimv22006870m.g","KQ426128",30868,95656,64788
"3953","Ocbimv22023996m.g","KQ419515",450706,450882,176
"3954","Ocbimv22005495m.g","KQ425621",78305,111180,32875
"3955","Ocbimv22025281m.g","KQ419759",16047,76098,60051
"3956","Ocbimv22019331m.g","KQ418750",268944,271689,2745
"3957","Ocbimv22034293m.g","KQ422015",986604,1008050,21446
"3958","Ocbimv22011561m.g","KQ427779",1623,22490,20867
"3959","Ocbimv22021475m.g","KQ416046",2316713,2343373,26660
"3960","Ocbimv22015431m.g","KQ429332",337973,349521,11548
"3961","Ocbimv22021719m.g","KQ419091",396780,430124,33344
"3962","Ocbimv22028490m.g","KQ420505",309543,331197,21654
"3963","Ocbimv22011555m.g","KQ417802",149082,151674,2592
"3964","Ocbimv22004886m.g","KQ425461",3820,4142,322
"3965","Ocbimv22029232m.g","KQ416294",359659,372838,13179
"3966","Ocbimv22009985m.g","KQ427196",91134,91910,776
"3967","Ocbimv22026136m.g","KQ419994",624988,636650,11662
"3968","Ocbimv22035734m.g","KQ422521",353489,353789,300
"3969","Ocbimv22002154m.g","KQ416990",180544,182653,2109
"3970","Ocbimv22027094m.g","KQ420181",7716,14185,6469
"3971","Ocbimv22014660m.g","KQ429033",37290,37442,152
"3972","Ocbimv22036020m.g","KQ422632",532763,557969,25206
"3973","Ocbimv22005818m.g","KQ417280",41403,42308,905
"3974","Ocbimv22032868m.g","KQ416454",40818,41677,859
"3975","Ocbimv22019235m.g","KQ418737",66256,78267,12011
"3976","Ocbimv22036455m.g","KQ422770",106239,107777,1538
"3977","Ocbimv22029375m.g","KQ420733",123094,133457,10363
"3978","Ocbimv22022389m.g","KQ432745",21465,26586,5121
"3979","Ocbimv22018229m.g","KQ415990",2121858,2192081,70223
"3980","Ocbimv22021747m.g","KQ419094",133409,195261,61852
"3981","Ocbimv22033209m.g","KQ421754",24650,94855,70205
"3982","Ocbimv22004533m.g","KQ415805",1879877,1880560,683
"3983","Ocbimv22017663m.g","KQ418525",207419,211042,3623
"3984","Ocbimv22020114m.g","KQ418856",158104,158469,365
"3985","Ocbimv22024383m.g","KQ433973",68527,97368,28841
"3986","Ocbimv22025729m.g","KQ419891",123450,123969,519
"3987","Ocbimv22037041m.g","KQ422909",625123,639820,14697
"3988","Ocbimv22028663m.g","KQ420545",332375,338575,6200
"3989","Ocbimv22017633m.g","LGKD01637304",1,561,560
"3990","Ocbimv22025026m.g","KQ416136",393344,417480,24136
"3991","Ocbimv22027780m.g","KQ420370",181398,181607,209
"3992","Ocbimv22028244m.g","KQ415659",102600,103669,1069
"3993","Ocbimv22009337m.g","KQ426953",255039,255464,425
"3994","Ocbimv22027919m.g","KQ420404",233675,238918,5243
"3995","Ocbimv22017184m.g","KQ418462",939797,940054,257
"3996","Ocbimv22014171m.g","KQ428790",42905,43673,768
"3997","Ocbimv22023593m.g","LGKD01690518",2,187,185
"3998","Ocbimv22022115m.g","LGKD01675578",12,143,131
"3999","Ocbimv22023460m.g","KQ419414",364680,366072,1392
"4000","Ocbimv22032369m.g","KQ421524",75961,77707,1746
"4001","Ocbimv22005286m.g","KQ425570",42017,45476,3459
"4002","Ocbimv22020568m.g","KQ418926",139059,140002,943
"4003","Ocbimv22007010m.g","KQ417370",331293,332033,740
"4004","Ocbimv22029023m.g","LGKD01362677",3,490,487
"4005","Ocbimv22005900m.g","KQ415825",180733,181355,622
"4006","Ocbimv22012478m.g","KQ428168",50204,51901,1697
"4007","Ocbimv22020289m.g","KQ431584",80439,145063,64624
"4008","Ocbimv22039797m.g","KQ416825",430574,430723,149
"4009","Ocbimv22000858m.g","KQ424096",42563,42778,215
"4010","Ocbimv22006213m.g","KQ417304",186575,201719,15144
"4011","Ocbimv22032640m.g","KQ421625",137356,163267,25911
"4012","Ocbimv22013840m.g","KQ418068",26160,26960,800
"4013","Ocbimv22017362m.g","KQ418485",54818,56656,1838
"4014","Ocbimv22010717m.g","KQ427476",283402,284985,1583
"4015","Ocbimv22014576m.g","KQ428994",66612,73444,6832
"4016","Ocbimv22030878m.g","KQ421116",32934,67520,34586
"4017","Ocbimv22039498m.g","KQ416800",107365,113063,5698
"4018","Ocbimv22033695m.g","KQ416491",396142,423364,27222
"4019","Ocbimv22033741m.g","KQ421864",77834,78049,215
"4020","Ocbimv22002209m.g","KQ416995",247543,254354,6811
"4021","Ocbimv22023385m.g","KQ419396",8669,41162,32493
"4022","Ocbimv22018983m.g","KQ418706",47657,48378,721
"4023","Ocbimv22014298m.g","KQ418115",359474,363046,3572
"4024","Ocbimv22026471m.g","KQ420054",7416,9016,1600
"4025","Ocbimv22013354m.g","KQ428462",1,534,533
"4026","Ocbimv22001958m.g","KQ416977",80192,80557,365
"4027","Ocbimv22004992m.g","KQ415811",12669,13082,413
"4028","Ocbimv22018098m.g","KQ418571",857062,858672,1610
"4029","Ocbimv22037043m.g","KQ422909",727393,727584,191
"4030","Ocbimv22037055m.g","KQ422913",86,10138,10052
"4031","Ocbimv22031742m.g","KQ421337",5961,8169,2208
"4032","Ocbimv22014034m.g","KQ418080",340044,340304,260
"4033","Ocbimv22037353m.g","KQ423013",7212,11285,4073
"4034","Ocbimv22002651m.g","KQ417023",1533810,1535535,1725
"4035","Ocbimv22005320m.g","KQ417240",349295,432396,83101
"4036","Ocbimv22028354m.g","KQ420477",254066,258862,4796
"4037","Ocbimv22039273m.g","KQ423600",253593,336452,82859
"4038","Ocbimv22029392m.g","KQ416303",711363,754229,42866
"4039","Ocbimv22006508m.g","KQ425966",80495,84295,3800
"4040","Ocbimv22032228m.g","KQ421487",73025,90026,17001
"4041","Ocbimv22017338m.g","KQ418483",180202,180632,430
"4042","Ocbimv22038266m.g","KQ423255",262791,263393,602
"4043","Ocbimv22020754m.g","KQ431838",61720,62049,329
"4044","Ocbimv22019162m.g","KQ431024",16993,18506,1513
"4045","Ocbimv22013594m.g","KQ418038",571991,604919,32928
"4046","Ocbimv22038515m.g","KQ423384",61203,86078,24875
"4047","Ocbimv22039790m.g","KQ416823",201238,201483,245
"4048","Ocbimv22020039m.g","KQ418844",100580,122399,21819
"4049","Ocbimv22027243m.g","KQ416216",192560,195120,2560
"4050","Ocbimv22033404m.g","KQ421804",42681,45533,2852
"4051","Ocbimv22013572m.g","KQ418038",205895,247997,42102
"4052","Ocbimv22021356m.g","KQ416042",1924712,1978109,53397
"4053","Ocbimv22029985m.g","KQ420872",78419,137856,59437
"4054","Ocbimv22023956m.g","KQ419507",104843,105091,248
"4055","Ocbimv22017286m.g","KQ418476",337535,339944,2409
"4056","Ocbimv22036326m.g","KQ415755",159985,181732,21747
"4057","Ocbimv22019049m.g","KQ418711",1212073,1215284,3211
"4058","Ocbimv22031473m.g","KQ416399",364088,365086,998
"4059","Ocbimv22011757m.g","KQ427892",60819,76961,16142
"4060","Ocbimv22001178m.g","KQ424217",57480,57959,479
"4061","Ocbimv22013191m.g","KQ428420",208187,219266,11079
"4062","Ocbimv22012925m.g","KQ417955",8387,62038,53651
"4063","Ocbimv22022918m.g","KQ419326",324875,325726,851
"4064","Ocbimv22035989m.g","KQ422628",23115,23483,368
"4065","Ocbimv22033434m.g","KQ421810",212986,229295,16309
"4066","Ocbimv22021792m.g","KQ419103",37919,40031,2112
"4067","Ocbimv22027773m.g","KQ420365",516907,531346,14439
"4068","Ocbimv22004118m.g","KQ425206",28202,28636,434
"4069","Ocbimv22000334m.g","KQ423927",5533,6026,493
"4070","Ocbimv22030556m.g","KQ421022",83087,133444,50357
"4071","Ocbimv22019256m.g","KQ418739",27983,53125,25142
"4072","Ocbimv22023740m.g","KQ419470",562934,563820,886
"4073","Ocbimv22009248m.g","KQ417578",449827,515139,65312
"4074","Ocbimv22035755m.g","KQ422527",35052,35351,299
"4075","Ocbimv22025125m.g","KQ419697",119241,119774,533
"4076","Ocbimv22026527m.g","KQ420065",21354,27593,6239
"4077","Ocbimv22027798m.g","KQ416233",531885,532055,170
"4078","Ocbimv22034870m.g","KQ416560",142940,152031,9091
"4079","Ocbimv22007193m.g","KQ426234",33602,46587,12985
"4080","Ocbimv22016203m.g","KQ418327",120706,129676,8970
"4081","Ocbimv22035352m.g","KQ416582",43450,49684,6234
"4082","Ocbimv22035691m.g","KQ422516",605168,605971,803
"4083","Ocbimv22037104m.g","KQ422923",13,33179,33166
"4084","Ocbimv22036207m.g","KQ422679",3948,12769,8821
"4085","Ocbimv22020806m.g","KQ416034",53205,58607,5402
"4086","Ocbimv22026845m.g","KQ420128",57400,58274,874
"4087","Ocbimv22017347m.g","KQ418483",369395,376318,6923
"4088","Ocbimv22008419m.g","KQ417500",47786,64156,16370
"4089","Ocbimv22013785m.g","LGKD01604330",9,191,182
"4090","Ocbimv22036382m.g","KQ422735",161553,257310,95757
"4091","Ocbimv22011897m.g","KQ415894",156458,157318,860
"4092","Ocbimv22037526m.g","KQ423058",24382,40999,16617
"4093","Ocbimv22009791m.g","LGKD01573787",83,253,170
"4094","Ocbimv22022815m.g","KQ433029",78612,93945,15333
"4095","Ocbimv22029537m.g","KQ420776",70804,87735,16931
"4096","Ocbimv22011455m.g","KQ427753",17817,73532,55715
"4097","Ocbimv22005025m.g","KQ417224",263739,268150,4411
"4098","Ocbimv22013817m.g","KQ418063",4228,6217,1989
"4099","Ocbimv22012481m.g","KQ417917",5576,9063,3487
"4100","Ocbimv22009453m.g","KQ415864",187542,187700,158
"4101","Ocbimv22009433m.g","KQ426995",4250,7568,3318
"4102","Ocbimv22027541m.g","KQ420299",1374869,1379904,5035
"4103","Ocbimv22020436m.g","KQ416027",638716,648550,9834
"4104","Ocbimv22010007m.g","KQ427204",98650,139291,40641
"4105","Ocbimv22030147m.g","KQ420910",79952,80212,260
"4106","Ocbimv22006032m.g","KQ425787",11684,35328,23644
"4107","Ocbimv22035481m.g","KQ422401",151011,167121,16110
"4108","Ocbimv22006789m.g","KQ426107",81899,89455,7556
"4109","Ocbimv22029408m.g","KQ420742",140316,142813,2497
"4110","Ocbimv22025177m.g","KQ416141",1000844,1001538,694
"4111","Ocbimv22024430m.g","KQ419577",520067,521248,1181
"4112","Ocbimv22030376m.g","KQ420969",210011,210935,924
"4113","Ocbimv22004872m.g","KQ417211",290765,301072,10307
"4114","Ocbimv22018655m.g","KQ430789",25407,26718,1311
"4115","Ocbimv22001991m.g","KQ416979",944412,944579,167
"4116","Ocbimv22019213m.g","KQ418734",127671,128011,340
"4117","Ocbimv22014374m.g","KQ418123",48618,48785,167
"4118","Ocbimv22004730m.g","KQ417204",574649,575326,677
"4119","Ocbimv22019828m.g","KQ431332",307245,366262,59017
"4120","Ocbimv22002999m.g","KQ424860",21433,21747,314
"4121","Ocbimv22005481m.g","KQ417255",80954,82406,1452
"4122","Ocbimv22020621m.g","KQ418942",2332,2700,368
"4123","Ocbimv22029880m.g","KQ420828",2354137,2376830,22693
"4124","Ocbimv22039945m.g","KQ423808",114916,130474,15558
"4125","Ocbimv22024973m.g","KQ419670",169893,190011,20118
"4126","Ocbimv22001162m.g","KQ416913",171318,176700,5382
"4127","Ocbimv22002038m.g","KQ424526",1464,5177,3713
"4128","Ocbimv22034284m.g","KQ422015",841331,856916,15585
"4129","Ocbimv22029361m.g","KQ420721",1810,48502,46692
"4130","Ocbimv22025541m.g","KQ419832",46205,47982,1777
"4131","Ocbimv22009627m.g","KQ427058",40906,41418,512
"4132","Ocbimv22001763m.g","KQ416962",11500,13959,2459
"4133","Ocbimv22009165m.g","KQ417567",132444,133847,1403
"4134","Ocbimv22028238m.g","KQ416254",105071,105268,197
"4135","Ocbimv22003215m.g","KQ417064",2724,25892,23168
"4136","Ocbimv22001275m.g","KQ424250",159068,159295,227
"4137","Ocbimv22005974m.g","KQ425769",15353,22876,7523
"4138","Ocbimv22024643m.g","KQ419605",507487,565690,58203
"4139","Ocbimv22025256m.g","KQ419749",27683,27952,269
"4140","Ocbimv22030292m.g","KQ420941",271736,277918,6182
"4141","Ocbimv22018831m.g","KQ418685",535637,535795,158
"4142","Ocbimv22023224m.g","KQ419376",621376,635063,13687
"4143","Ocbimv22025867m.g","KQ419916",217682,225588,7906
"4144","Ocbimv22033706m.g","KQ416492",317690,318160,470
"4145","Ocbimv22030192m.g","KQ420920",45364,69449,24085
"4146","Ocbimv22020006m.g","KQ431390",305,1315,1010
"4147","Ocbimv22013568m.g","KQ418038",143330,143932,602
"4148","Ocbimv22037628m.g","KQ415761",814198,814975,777
"4149","Ocbimv22032148m.g","KQ421460",219636,224250,4614
"4150","Ocbimv22002776m.g","KQ424779",78007,78351,344
"4151","Ocbimv22022716m.g","KQ419286",185864,186103,239
"4152","Ocbimv22029546m.g","KQ420776",258790,259186,396
"4153","Ocbimv22027597m.g","KQ420313",298059,298986,927
"4154","Ocbimv22002291m.g","KQ417001",414090,414257,167
"4155","Ocbimv22011487m.g","KQ417795",355814,374543,18729
"4156","Ocbimv22024157m.g","KQ419543",34358,34663,305
"4157","Ocbimv22028450m.g","KQ420490",118207,120354,2147
"4158","Ocbimv22004220m.g","LGKD01528348",3,200,197
"4159","Ocbimv22037963m.g","KQ416716",106665,106910,245
"4160","Ocbimv22000091m.g","KQ416839",164487,164663,176
"4161","Ocbimv22015993m.g","KQ418307",138541,140371,1830
"4162","Ocbimv22008064m.g","KQ426557",5943,19957,14014
"4163","Ocbimv22025151m.g","KQ419712",43979,45418,1439
"4164","Ocbimv22021996m.g","KQ432489",3920,4069,149
"4165","Ocbimv22022182m.g","KQ419180",746871,747080,209
"4166","Ocbimv22032843m.g","KQ421665",41420,44387,2967
"4167","Ocbimv22026324m.g","KQ420026",203768,205536,1768
"4168","Ocbimv22037559m.g","KQ416701",159712,175513,15801
"4169","Ocbimv22005770m.g","KQ417278",2814,4870,2056
"4170","Ocbimv22019823m.g","KQ431332",248738,267309,18571
"4171","Ocbimv22027179m.g","KQ416213",180936,183980,3044
"4172","Ocbimv22030923m.g","KQ421117",1898075,1930337,32262
"4173","Ocbimv22029922m.g","KQ420849",69593,75776,6183
"4174","Ocbimv22018116m.g","KQ430572",412852,413980,1128
"4175","Ocbimv22020303m.g","KQ418887",15872,19154,3282
"4176","Ocbimv22037802m.g","KQ423136",94106,113558,19452
"4177","Ocbimv22009093m.g","KQ417561",24189,28347,4158
"4178","Ocbimv22024051m.g","KQ433771",3704,4574,870
"4179","Ocbimv22029571m.g","KQ420777",69443,70714,1271
"4180","Ocbimv22030706m.g","KQ421075",68264,76458,8194
"4181","Ocbimv22005347m.g","KQ425590",32635,36168,3533
"4182","Ocbimv22031217m.g","KQ421200",345907,354589,8682
"4183","Ocbimv22023512m.g","KQ419420",330732,332209,1477
"4184","Ocbimv22019197m.g","KQ418732",450689,451033,344
"4185","Ocbimv22003151m.g","KQ424898",76964,77602,638
"4186","Ocbimv22026830m.g","KQ420126",81975,87032,5057
"4187","Ocbimv22002567m.g","KQ424695",1,279,278
"4188","Ocbimv22008827m.g","KQ426780",3414,4153,739
"4189","Ocbimv22025919m.g","KQ419927",899307,899471,164
"4190","Ocbimv22005706m.g","KQ425725",29756,31242,1486
"4191","Ocbimv22039806m.g","KQ416826",58885,59097,212
"4192","Ocbimv22009919m.g","KQ417623",2839,3370,531
"4193","Ocbimv22021177m.g","KQ415686",612405,612662,257
"4194","Ocbimv22016235m.g","KQ429763",48783,55865,7082
"4195","Ocbimv22016234m.g","KQ429763",40776,43767,2991
"4196","Ocbimv22029285m.g","KQ420696",672034,683446,11412
"4197","Ocbimv22013244m.g","KQ418003",415364,460841,45477
"4198","Ocbimv22002985m.g","KQ424856",845,1195,350
"4199","Ocbimv22006914m.g","KQ426142",4859,5533,674
"4200","Ocbimv22034990m.g","KQ422234",49418,54052,4634
"4201","Ocbimv22035977m.g","KQ422621",184611,214892,30281
"4202","Ocbimv22034610m.g","KQ416539",286439,287792,1353
"4203","Ocbimv22018832m.g","KQ418685",759169,760152,983
"4204","Ocbimv22022365m.g","KQ432701",104,1679,1575
"4205","Ocbimv22016185m.g","KQ418323",884251,884766,515
"4206","Ocbimv22018592m.g","KQ418644",526593,542857,16264
"4207","Ocbimv22009104m.g","KQ417562",317498,317656,158
"4208","Ocbimv22034841m.g","KQ422191",57223,66712,9489
"4209","Ocbimv22016277m.g","LGKD01626238",75,230,155
"4210","Ocbimv22021944m.g","KQ419136",455710,475186,19476
"4211","Ocbimv22001778m.g","KQ424413",66,1007,941
"4212","Ocbimv22014680m.g","KQ418168",369645,387228,17583
"4213","Ocbimv22002169m.g","KQ416992",152543,152993,450
"4214","Ocbimv22038905m.g","KQ416771",1113891,1114350,459
"4215","Ocbimv22034785m.g","KQ416552",10971,25751,14780
"4216","Ocbimv22005636m.g","KQ425692",225461,244132,18671
"4217","Ocbimv22003360m.g","KQ417084",440541,440690,149
"4218","Ocbimv22015375m.g","KQ415674",983987,984280,293
"4219","Ocbimv22028651m.g","KQ420545",128097,142682,14585
"4220","Ocbimv22014453m.g","KQ415930",419280,455161,35881
"4221","Ocbimv22023666m.g","KQ433566",23047,23582,535
"4222","Ocbimv22010723m.g","KQ427478",180444,193230,12786
"4223","Ocbimv22025030m.g","KQ416136",417498,422189,4691
"4224","Ocbimv22014159m.g","KQ418096",98068,110380,12312
"4225","Ocbimv22033128m.g","KQ421731",418012,420491,2479
"4226","Ocbimv22004962m.g","KQ425487",121897,122319,422
"4227","Ocbimv22033109m.g","KQ416467",13529,15983,2454
"4228","Ocbimv22021349m.g","KQ416042",1414539,1415103,564
"4229","Ocbimv22034086m.g","KQ421968",121911,122804,893
"4230","Ocbimv22026422m.g","KQ420047",367835,369117,1282
"4231","Ocbimv22001759m.g","KQ424404",197590,199281,1691
"4232","Ocbimv22009930m.g","KQ417623",341525,349930,8405
"4233","Ocbimv22014706m.g","KQ418168",608311,612813,4502
"4234","Ocbimv22012670m.g","KQ417924",531304,555499,24195
"4235","Ocbimv22005076m.g","KQ425516",162673,177196,14523
"4236","Ocbimv22003997m.g","KQ417129",547819,548052,233
"4237","Ocbimv22009231m.g","KQ426935",54150,69316,15166
"4238","Ocbimv22004894m.g","KQ417213",19218,19502,284
"4239","Ocbimv22033072m.g","KQ421721",950457,957475,7018
"4240","Ocbimv22001385m.g","KQ416930",84288,89907,5619
"4241","Ocbimv22003778m.g","KQ417112",228483,249491,21008
"4242","Ocbimv22006051m.g","KQ417293",32183,78036,45853
"4243","Ocbimv22037456m.g","KQ423037",60943,61945,1002
"4244","Ocbimv22010892m.g","KQ417722",657445,657838,393
"4245","Ocbimv22013379m.g","KQ418018",771388,773810,2422
"4246","Ocbimv22006120m.g","KQ417300",106527,107425,898
"4247","Ocbimv22002713m.g","KQ424755",300082,300397,315
"4248","Ocbimv22038970m.g","KQ423495",68832,70444,1612
"4249","Ocbimv22001702m.g","KQ424387",375726,376953,1227
"4250","Ocbimv22029948m.g","KQ420857",352,3522,3170
"4251","Ocbimv22014620m.g","KQ429014",1677,4617,2940
"4252","Ocbimv22038185m.g","KQ423231",190188,213730,23542
"4253","Ocbimv22004467m.g","KQ425324",25655,25840,185
"4254","Ocbimv22029852m.g","KQ420828",1592632,1600591,7959
"4255","Ocbimv22022436m.g","KQ419216",141251,146337,5086
"4256","Ocbimv22039139m.g","KQ423548",96213,109705,13492
"4257","Ocbimv22023237m.g","KQ433284",18174,34476,16302
"4258","Ocbimv22032681m.g","KQ416444",180451,181505,1054
"4259","Ocbimv22035964m.g","KQ416612",1912446,1922446,10000
"4260","Ocbimv22027914m.g","KQ420397",417417,417926,509
"4261","Ocbimv22033573m.g","KQ421836",365555,381974,16419
"4262","Ocbimv22014373m.g","KQ415673",77779,78401,622
"4263","Ocbimv22000239m.g","KQ423903",194076,213959,19883
"4264","Ocbimv22012210m.g","KQ428077",34334,34819,485
"4265","Ocbimv22037744m.g","KQ416708",396467,406019,9552
"4266","Ocbimv22019139m.g","KQ431001",2254,3950,1696
"4267","Ocbimv22007710m.g","KQ426436",39075,39314,239
"4268","Ocbimv22038644m.g","KQ423430",699614,701463,1849
"4269","Ocbimv22034544m.g","KQ416536",346177,363495,17318
"4270","Ocbimv22008441m.g","KQ426638",50505,53057,2552
"4271","Ocbimv22005005m.g","KQ415811",1411047,1516205,105158
"4272","Ocbimv22003281m.g","KQ424936",6953,38244,31291
"4273","Ocbimv22039831m.g","KQ416828",213621,214551,930
"4274","Ocbimv22021722m.g","KQ416053",13215,13466,251
"4275","Ocbimv22037115m.g","KQ416673",44569,45517,948
"4276","Ocbimv22005311m.g","KQ425580",17217,21214,3997
"4277","Ocbimv22004047m.g","KQ425190",119739,120635,896
"4278","Ocbimv22014984m.g","KQ418190",412152,412911,759
"4279","Ocbimv22008678m.g","KQ426727",74986,102382,27396
"4280","Ocbimv22023361m.g","KQ419395",222798,223796,998
"4281","Ocbimv22027875m.g","KQ420386",60337,60757,420
"4282","Ocbimv22017772m.g","KQ430468",235092,241809,6717
"4283","Ocbimv22021647m.g","KQ432262",4022,4198,176
"4284","Ocbimv22030169m.g","KQ420915",436792,441442,4650
"4285","Ocbimv22008795m.g","KQ426774",113858,118420,4562
"4286","Ocbimv22038301m.g","KQ423274",36609,37723,1114
"4287","Ocbimv22008866m.g","KQ426791",362471,369917,7446
"4288","Ocbimv22015557m.g","KQ429416",282780,310164,27384
"4289","Ocbimv22023879m.g","KQ419491",115613,127426,11813
"4290","Ocbimv22022303m.g","KQ419193",123683,132563,8880
"4291","Ocbimv22004490m.g","KQ417173",170002,170406,404
"4292","Ocbimv22037468m.g","KQ415759",375771,376851,1080
"4293","Ocbimv22007186m.g","KQ426231",41739,41927,188
"4294","Ocbimv22039479m.g","KQ423675",262704,315392,52688
"4295","Ocbimv22003899m.g","KQ425138",74231,74521,290
"4296","Ocbimv22034415m.g","KQ422034",24769,24936,167
"4297","Ocbimv22019451m.g","KQ418769",2125,8635,6510
"4298","Ocbimv22028657m.g","KQ420545",170494,172416,1922
"4299","Ocbimv22037587m.g","KQ423077",253013,296955,43942
"4300","Ocbimv22031963m.g","KQ421389",631484,677682,46198
"4301","Ocbimv22030902m.g","KQ421117",1347994,1349286,1292
"4302","Ocbimv22009463m.g","KQ427011",130567,141158,10591
"4303","Ocbimv22010720m.g","KQ427478",137150,137755,605
"4304","Ocbimv22006100m.g","LGKD01543022",1,371,370
"4305","Ocbimv22015729m.g","KQ429526",265,417,152
"4306","Ocbimv22036582m.g","KQ422794",203480,205932,2452
"4307","Ocbimv22035422m.g","KQ422378",204909,206242,1333
"4308","Ocbimv22011167m.g","KQ417756",67395,84753,17358
"4309","Ocbimv22023543m.g","KQ416091",3681,18278,14597
"4310","Ocbimv22011136m.g","KQ427653",75098,86004,10906
"4311","Ocbimv22002892m.g","KQ424814",505746,518578,12832
"4312","Ocbimv22000108m.g","KQ423864",187924,189225,1301
"4313","Ocbimv22003432m.g","KQ417087",929146,929538,392
"4314","Ocbimv22021470m.g","KQ416046",1974206,1974603,397
"4315","Ocbimv22012906m.g","LGKD01597420",604,939,335
"4316","Ocbimv22012772m.g","KQ417939",74755,75417,662
"4317","Ocbimv22006045m.g","KQ425798",66291,84058,17767
"4318","Ocbimv22020496m.g","KQ418919",579993,595358,15365
"4319","Ocbimv22037701m.g","KQ423101",171011,175997,4986
"4320","Ocbimv22034539m.g","KQ416536",276377,283635,7258
"4321","Ocbimv22014511m.g","KQ415932",200575,201551,976
"4322","Ocbimv22005382m.g","KQ417249",436524,436769,245
"4323","Ocbimv22011642m.g","KQ427828",63924,64963,1039
"4324","Ocbimv22036211m.g","KQ422680",155492,157730,2238
"4325","Ocbimv22038682m.g","KQ423442",10032,86592,76560
"4326","Ocbimv22039297m.g","KQ423609",792839,793134,295
"4327","Ocbimv22029763m.g","KQ420820",297702,302833,5131
"4328","Ocbimv22029149m.g","KQ416288",202090,202275,185
"4329","Ocbimv22006127m.g","KQ417300",195225,236712,41487
"4330","Ocbimv22004154m.g","KQ425220",55282,58538,3256
"4331","Ocbimv22005447m.g","KQ417252",1684743,1777063,92320
"4332","Ocbimv22033957m.g","KQ421920",89718,90974,1256
"4333","Ocbimv22022446m.g","KQ419216",370152,370388,236
"4334","Ocbimv22004506m.g","KQ417173",2418027,2418362,335
"4335","Ocbimv22018767m.g","KQ418671",34103,45590,11487
"4336","Ocbimv22004026m.g","KQ425190",12439,13079,640
"4337","Ocbimv22013502m.g","KQ418031",879009,881591,2582
"4338","Ocbimv22022058m.g","KQ419155",494,65150,64656
"4339","Ocbimv22010965m.g","KQ427571",67128,69510,2382
"4340","Ocbimv22013084m.g","KQ428368",96946,98485,1539
"4341","Ocbimv22003647m.g","KQ425062",3866,5473,1607
"4342","Ocbimv22031721m.g","KQ421325",216965,220303,3338
"4343","Ocbimv22001285m.g","KQ416918",50172,51932,1760
"4344","Ocbimv22000106m.g","KQ423864",86210,86530,320
"4345","Ocbimv22027766m.g","KQ420361",47873,55665,7792
"4346","Ocbimv22021098m.g","KQ419003",394591,394959,368
"4347","Ocbimv22030836m.g","KQ421109",66783,67430,647
"4348","Ocbimv22025730m.g","KQ419891",232291,324197,91906
"4349","Ocbimv22015400m.g","KQ418240",1496,2016,520
"4350","Ocbimv22035256m.g","KQ415748",327125,327741,616
"4351","Ocbimv22006173m.g","KQ417300",2406467,2408211,1744
"4352","Ocbimv22030454m.g","KQ416350",342159,348021,5862
"4353","Ocbimv22029789m.g","KQ420822",95095,95722,627
"4354","Ocbimv22020348m.g","KQ418899",91657,118403,26746
"4355","Ocbimv22030336m.g","KQ420951",52667,57128,4461
"4356","Ocbimv22020275m.g","KQ416024",61632,61808,176
"4357","Ocbimv22005928m.g","KQ417284",534630,535145,515
"4358","Ocbimv22001209m.g","KQ424229",187036,187209,173
"4359","Ocbimv22020993m.g","KQ418990",101016,101427,411
"4360","Ocbimv22030257m.g","KQ420929",32934,59855,26921
"4361","Ocbimv22036316m.g","KQ422711",719927,747592,27665
"4362","Ocbimv22010692m.g","KQ417703",174073,174312,239
"4363","Ocbimv22028655m.g","KQ420545",160818,167910,7092
"4364","Ocbimv22028766m.g","KQ420579",466387,467790,1403
"4365","Ocbimv22037797m.g","KQ423136",38472,40459,1987
"4366","Ocbimv22028604m.g","KQ416263",777748,794810,17062
"4367","Ocbimv22023563m.g","KQ419432",182788,185630,2842
"4368","Ocbimv22016987m.g","KQ418431",811769,842408,30639
"4369","Ocbimv22006175m.g","KQ417300",2440086,2440481,395
"4370","Ocbimv22029089m.g","KQ420643",48742,50379,1637
"4371","Ocbimv22029906m.g","KQ420841",234216,235036,820
"4372","Ocbimv22032212m.g","KQ416425",855875,857980,2105
"4373","Ocbimv22014499m.g","LGKD01220644",89,541,452
"4374","Ocbimv22028710m.g","KQ420562",195091,202173,7082
"4375","Ocbimv22022659m.g","KQ419278",113505,114174,669
"4376","Ocbimv22021217m.g","KQ419013",210292,235505,25213
"4377","Ocbimv22009303m.g","KQ417581",155947,156895,948
"4378","Ocbimv22033328m.g","KQ421780",140901,144015,3114
"4379","Ocbimv22018180m.g","KQ430594",154595,154795,200
"4380","Ocbimv22033664m.g","KQ421858",254948,259716,4768
"4381","Ocbimv22033427m.g","KQ421809",202494,237191,34697
"4382","Ocbimv22036441m.g","KQ422762",242439,243370,931
"4383","Ocbimv22030806m.g","KQ421092",94544,122833,28289
"4384","Ocbimv22027310m.g","KQ416221",463906,464295,389
"4385","Ocbimv22026586m.g","KQ420075",338074,338939,865
"4386","Ocbimv22007597m.g","KQ426396",99645,131850,32205
"4387","Ocbimv22029579m.g","KQ420777",264090,265114,1024
"4388","Ocbimv22035072m.g","KQ422264",5514,22598,17084
"4389","Ocbimv22039847m.g","KQ416831",188772,194458,5686
"4390","Ocbimv22039097m.g","KQ416779",101995,109320,7325
"4391","Ocbimv22032559m.g","KQ421588",74180,74344,164
"4392","Ocbimv22035274m.g","KQ422349",48597,73526,24929
"4393","Ocbimv22035729m.g","KQ422521",319538,320522,984
"4394","Ocbimv22036265m.g","KQ416628",222853,236332,13479
"4395","Ocbimv22039345m.g","KQ423627",41251,42708,1457
"4396","Ocbimv22014580m.g","KQ428994",130986,175907,44921
"4397","Ocbimv22020247m.g","KQ418877",124258,124509,251
"4398","Ocbimv22030610m.g","KQ416359",991822,992019,197
"4399","Ocbimv22010099m.g","KQ427255",26886,61413,34527
"4400","Ocbimv22011667m.g","KQ415889",437649,437913,264
"4401","Ocbimv22020180m.g","KQ431512",111907,112083,176
"4402","Ocbimv22007499m.g","KQ417417",13076,13882,806
"4403","Ocbimv22000095m.g","KQ416839",219951,233422,13471
"4404","Ocbimv22011011m.g","KQ427587",168305,175939,7634
"4405","Ocbimv22031621m.g","KQ415725",176291,176614,323
"4406","Ocbimv22013553m.g","KQ418037",9200,10078,878
"4407","Ocbimv22018054m.g","KQ430541",49136,62397,13261
"4408","Ocbimv22028300m.g","KQ420464",82079,83280,1201
"4409","Ocbimv22012252m.g","KQ428084",947,1669,722
"4410","Ocbimv22022917m.g","KQ419326",297152,309062,11910
"4411","Ocbimv22019075m.g","KQ418715",53771,68546,14775
"4412","Ocbimv22013295m.g","KQ418007",568912,610227,41315
"4413","Ocbimv22028376m.g","KQ416257",113138,114124,986
"4414","Ocbimv22036358m.g","KQ422722",40543,66792,26249
"4415","Ocbimv22024551m.g","KQ419593",112082,114724,2642
"4416","Ocbimv22001116m.g","KQ424184",67521,150926,83405
"4417","Ocbimv22030838m.g","KQ421109",126137,144285,18148
"4418","Ocbimv22001638m.g","KQ416950",1436846,1437148,302
"4419","Ocbimv22027810m.g","KQ416233",1096916,1131571,34655
"4420","Ocbimv22028597m.g","KQ416263",523244,542785,19541
"4421","Ocbimv22005802m.g","KQ415823",1142147,1142681,534
"4422","Ocbimv22030246m.g","KQ416338",618480,620710,2230
"4423","Ocbimv22035058m.g","KQ422263",101701,133367,31666
"4424","Ocbimv22002265m.g","KQ424597",1631,4268,2637
"4425","Ocbimv22037171m.g","KQ422952",1223,3516,2293
"4426","Ocbimv22012534m.g","KQ417917",790159,792297,2138
"4427","Ocbimv22012854m.g","KQ417945",803836,804833,997
"4428","Ocbimv22022421m.g","KQ419216",30824,37521,6697
"4429","Ocbimv22000241m.g","KQ423903",240522,241490,968
"4430","Ocbimv22038724m.g","KQ423457",13584,97692,84108
"4431","Ocbimv22004907m.g","KQ417213",567090,567712,622
"4432","Ocbimv22009986m.g","KQ427198",8237,45279,37042
"4433","Ocbimv22019470m.g","KQ418771",385143,385966,823
"4434","Ocbimv22015721m.g","KQ429511",19603,29742,10139
"4435","Ocbimv22024137m.g","KQ419538",546807,547157,350
"4436","Ocbimv22003317m.g","KQ424970",15404,15562,158
"4437","Ocbimv22031739m.g","KQ421336",283592,336291,52699
"4438","Ocbimv22010792m.g","KQ417715",497,8991,8494
"4439","Ocbimv22032173m.g","KQ421467",7311,10191,2880
"4440","Ocbimv22001667m.g","KQ416951",674099,678483,4384
"4441","Ocbimv22013925m.g","KQ428714",37043,37770,727
"4442","Ocbimv22017481m.g","KQ430313",135847,148312,12465
"4443","Ocbimv22033591m.g","KQ421839",504934,505227,293
"4444","Ocbimv22018214m.g","KQ415990",1758789,1831863,73074
"4445","Ocbimv22034068m.g","KQ416508",875232,875602,370
"4446","Ocbimv22022665m.g","KQ419279",43897,44422,525
"4447","Ocbimv22016047m.g","KQ429675",63838,74350,10512
"4448","Ocbimv22006794m.g","LGKD01549807",231,830,599
"4449","Ocbimv22026695m.g","KQ416197",118584,119444,860
"4450","Ocbimv22009242m.g","KQ417578",216506,217020,514
"4451","Ocbimv22036683m.g","KQ422834",43325,43516,191
"4452","Ocbimv22012026m.g","KQ427973",316109,316840,731
"4453","Ocbimv22031354m.g","KQ421221",23711,24167,456
"4454","Ocbimv22003036m.g","KQ417055",1548630,1549007,377
"4455","Ocbimv22002153m.g","KQ416990",103990,104262,272
"4456","Ocbimv22028932m.g","KQ420604",6096,6525,429
"4457","Ocbimv22009844m.g","KQ417620",738213,739487,1274
"4458","Ocbimv22011196m.g","KQ415884",755342,755722,380
"4459","Ocbimv22039843m.g","KQ416831",92087,111954,19867
"4460","Ocbimv22036666m.g","KQ422824",42834,48960,6126
"4461","Ocbimv22010235m.g","KQ427325",9844,17712,7868
"4462","Ocbimv22014461m.g","KQ428942",133263,138283,5020
"4463","Ocbimv22029320m.g","KQ416297",109403,118374,8971
"4464","Ocbimv22034472m.g","KQ416534",540088,540345,257
"4465","Ocbimv22008146m.g","KQ417481",540275,540703,428
"4466","Ocbimv22000850m.g","KQ424093",608795,609803,1008
"4467","Ocbimv22036770m.g","KQ422853",3593,29278,25685
"4468","Ocbimv22012406m.g","KQ428150",88625,90094,1469
"4469","Ocbimv22022700m.g","KQ432967",17225,21212,3987
"4470","Ocbimv22000721m.g","KQ416877",542434,561767,19333
"4471","Ocbimv22007920m.g","KQ417459",538543,558519,19976
"4472","Ocbimv22015058m.g","KQ418194",915714,983689,67975
"4473","Ocbimv22039634m.g","KQ416810",1062809,1083930,21121
"4474","Ocbimv22037165m.g","KQ422946",24982,171265,146283
"4475","Ocbimv22013200m.g","KQ415914",326953,327108,155
"4476","Ocbimv22007713m.g","KQ417446",60627,60800,173
"4477","Ocbimv22020262m.g","KQ431563",123777,125731,1954
"4478","Ocbimv22033413m.g","KQ421806",90863,92354,1491
"4479","Ocbimv22022732m.g","KQ416074",417760,417933,173
"4480","Ocbimv22003418m.g","KQ417086",1552366,1565596,13230
"4481","Ocbimv22038298m.g","KQ416735",17097,17573,476
"4482","Ocbimv22029230m.g","KQ416294",324942,353101,28159
"4483","Ocbimv22007172m.g","KQ417388",76074,77078,1004
"4484","Ocbimv22038896m.g","KQ416771",424960,425184,224
"4485","Ocbimv22015840m.g","KQ418295",318439,323154,4715
"4486","Ocbimv22005256m.g","KQ417236",44359,48230,3871
"4487","Ocbimv22024547m.g","KQ419593",98101,98460,359
"4488","Ocbimv22021132m.g","KQ419009",5780,79425,73645
"4489","Ocbimv22019321m.g","KQ418749",262380,266230,3850
"4490","Ocbimv22033639m.g","KQ421854",205464,206341,877
"4491","Ocbimv22028686m.g","KQ420555",96135,96422,287
"4492","Ocbimv22023974m.g","KQ419513",35362,36045,683
"4493","Ocbimv22027221m.g","KQ416214",345892,346155,263
"4494","Ocbimv22005007m.g","KQ415811",1523735,1532774,9039
"4495","Ocbimv22024608m.g","KQ419601",1464931,1466685,1754
"4496","Ocbimv22002913m.g","KQ424828",20564,32814,12250
"4497","Ocbimv22006081m.g","KQ417294",103968,133357,29389
"4498","Ocbimv22035028m.g","KQ416568",1074448,1074609,161
"4499","Ocbimv22018721m.g","KQ418660",98801,99232,431
"4500","Ocbimv22019252m.g","KQ431068",230126,230998,872
"4501","Ocbimv22029350m.g","KQ420715",175141,177922,2781
"4502","Ocbimv22028302m.g","KQ420464",384044,384262,218
"4503","Ocbimv22008846m.g","KQ426789",45287,48570,3283
"4504","Ocbimv22005966m.g","KQ425764",89372,91467,2095
"4505","Ocbimv22015642m.g","KQ418271",177584,183647,6063
"4506","Ocbimv22001146m.g","KQ416912",219088,219658,570
"4507","Ocbimv22026838m.g","KQ420126",447537,477063,29526
"4508","Ocbimv22000175m.g","KQ423882",25566,78149,52583
"4509","Ocbimv22024454m.g","KQ416123",115694,149484,33790
"4510","Ocbimv22031040m.g","KQ421144",431261,445639,14378
"4511","Ocbimv22021855m.g","KQ415687",1461558,1476799,15241
"4512","Ocbimv22035705m.g","KQ416599",94421,112085,17664
"4513","Ocbimv22001537m.g","KQ424351",362887,370350,7463
"4514","Ocbimv22005247m.g","KQ417234",521109,522006,897
"4515","Ocbimv22022621m.g","KQ432925",12522,14395,1873
"4516","Ocbimv22035477m.g","KQ422397",3738,11386,7648
"4517","Ocbimv22000745m.g","KQ416877",1358850,1359496,646
"4518","Ocbimv22010637m.g","KQ427463",218206,251215,33009
"4519","Ocbimv22016665m.g","KQ418376",252365,259639,7274
"4520","Ocbimv22019346m.g","KQ418754",8034,9752,1718
"4521","Ocbimv22007692m.g","KQ415846",705662,716907,11245
"4522","Ocbimv22025473m.g","KQ419811",58092,101271,43179
"4523","Ocbimv22000046m.g","KQ423834",106180,113512,7332
"4524","Ocbimv22035579m.g","KQ422444",26437,30686,4249
"4525","Ocbimv22003262m.g","KQ424929",674,928,254
"4526","Ocbimv22007221m.g","KQ426253",42957,53234,10277
"4527","Ocbimv22011391m.g","KQ417791",874028,886108,12080
"4528","Ocbimv22008945m.g","KQ426816",189094,191581,2487
"4529","Ocbimv22012340m.g","KQ415907",904453,916250,11797
"4530","Ocbimv22033516m.g","KQ421823",351454,352504,1050
"4531","Ocbimv22015716m.g","KQ429505",14227,47205,32978
"4532","Ocbimv22031697m.g","KQ421315",118,591,473
"4533","Ocbimv22035321m.g","KQ422351",657028,658028,1000
"4534","Ocbimv22008667m.g","KQ417519",592355,593479,1124
"4535","Ocbimv22034115m.g","KQ416513",488249,491043,2794
"4536","Ocbimv22035988m.g","KQ422623",142197,143794,1597
"4537","Ocbimv22016930m.g","KQ430089",92525,122301,29776
"4538","Ocbimv22004602m.g","KQ417182",798406,800627,2221
"4539","Ocbimv22007988m.g","KQ417469",1685,9733,8048
"4540","Ocbimv22035932m.g","KQ422612",22334,22651,317
"4541","Ocbimv22004209m.g","KQ415801",145425,150401,4976
"4542","Ocbimv22012360m.g","KQ428130",158728,189820,31092
"4543","Ocbimv22024366m.g","KQ419574",814845,818042,3197
"4544","Ocbimv22002580m.g","LGKD01513455",3,482,479
"4545","Ocbimv22038557m.g","KQ416751",81925,145675,63750
"4546","Ocbimv22006946m.g","KQ417365",30066,35661,5595
"4547","Ocbimv22000415m.g","KQ423958",304164,311031,6867
"4548","Ocbimv22034877m.g","LGKD01433980",2,151,149
"4549","Ocbimv22003863m.g","KQ417118",191519,192349,830
"4550","Ocbimv22016263m.g","KQ418333",688323,688484,161
"4551","Ocbimv22029610m.g","KQ420782",39681,41133,1452
"4552","Ocbimv22009516m.g","KQ415865",739907,741855,1948
"4553","Ocbimv22006311m.g","KQ425873",108726,108896,170
"4554","Ocbimv22034937m.g","KQ416562",466886,475705,8819
"4555","Ocbimv22039411m.g","KQ423651",1493261,1499668,6407
"4556","Ocbimv22037478m.g","KQ423042",102279,102434,155
"4557","Ocbimv22020588m.g","KQ416030",13483,28062,14579
"4558","Ocbimv22033829m.g","KQ421891",235623,246859,11236
"4559","Ocbimv22016897m.g","KQ418420",297006,298366,1360
"4560","Ocbimv22001890m.g","LGKD01506567",5,475,470
"4561","Ocbimv22025775m.g","KQ416166",1650490,1650711,221
"4562","Ocbimv22023906m.g","KQ433699",5432,30989,25557
"4563","Ocbimv22034920m.g","KQ415742",407292,408113,821
"4564","Ocbimv22017159m.g","LGKD01633311",1,471,470
"4565","Ocbimv22031661m.g","KQ421307",148954,151597,2643
"4566","Ocbimv22028445m.g","KQ420489",20402,27398,6996
"4567","Ocbimv22037167m.g","KQ422946",154162,154527,365
"4568","Ocbimv22027029m.g","KQ420166",268805,296872,28067
"4569","Ocbimv22027585m.g","KQ420311",7770,38861,31091
"4570","Ocbimv22024999m.g","KQ419679",20587,25051,4464
"4571","Ocbimv22020923m.g","KQ418974",2153743,2154873,1130
"4572","Ocbimv22027677m.g","KQ416230",1456096,1464558,8462
"4573","Ocbimv22018351m.g","KQ418610",35913,38240,2327
"4574","Ocbimv22034022m.g","KQ421946",532508,566285,33777
"4575","Ocbimv22024559m.g","KQ419595",4847,5026,179
"4576","Ocbimv22002319m.g","KQ424629",79069,91838,12769
"4577","Ocbimv22014857m.g","KQ418182",155559,155744,185
"4578","Ocbimv22019530m.g","KQ431198",33,6431,6398
"4579","Ocbimv22034514m.g","KQ422066",74248,76054,1806
"4580","Ocbimv22032506m.g","KQ421566",11288,21409,10121
"4581","Ocbimv22025639m.g","KQ419868",296433,297989,1556
"4582","Ocbimv22035874m.g","KQ416608",648045,648864,819
"4583","Ocbimv22036311m.g","KQ422711",333009,333478,469
"4584","Ocbimv22009215m.g","KQ417575",70533,71358,825
"4585","Ocbimv22004657m.g","KQ417194",40838,44878,4040
"4586","Ocbimv22004560m.g","KQ425361",215724,228114,12390
"4587","Ocbimv22034880m.g","KQ422206",13622,14652,1030
"4588","Ocbimv22038350m.g","KQ416737",1398888,1411741,12853
"4589","Ocbimv22035144m.g","KQ422290",161979,162182,203
"4590","Ocbimv22006342m.g","KQ425880",11612,11917,305
"4591","Ocbimv22033784m.g","KQ421871",319944,353529,33585
"4592","Ocbimv22034931m.g","KQ416562",198570,199092,522
"4593","Ocbimv22018856m.g","KQ430910",5695,14115,8420
"4594","Ocbimv22037767m.g","KQ423130",194695,199776,5081
"4595","Ocbimv22025717m.g","KQ419887",1084099,1084408,309
"4596","Ocbimv22005642m.g","KQ425692",279228,289861,10633
"4597","Ocbimv22012276m.g","KQ417898",133337,138258,4921
"4598","Ocbimv22028600m.g","KQ416263",628383,631099,2716
"4599","Ocbimv22037382m.g","KQ416694",900204,900431,227
"4600","Ocbimv22012148m.g","KQ417877",950385,950558,173
"4601","Ocbimv22008704m.g","KQ426740",318673,323172,4499
"4602","Ocbimv22002978m.g","KQ417051",2441787,2442107,320
"4603","Ocbimv22016451m.g","KQ415965",1234988,1235179,191
"4604","Ocbimv22027148m.g","KQ420203",939614,941375,1761
"4605","Ocbimv22022457m.g","KQ419220",218002,218157,155
"4606","Ocbimv22008765m.g","KQ417531",1413,110316,108903
"4607","Ocbimv22019700m.g","KQ431267",49680,49859,179
"4608","Ocbimv22036658m.g","KQ422819",370366,375087,4721
"4609","Ocbimv22020899m.g","KQ418974",231178,238253,7075
"4610","Ocbimv22034634m.g","KQ422095",172993,173229,236
"4611","Ocbimv22035855m.g","KQ422578",21778,137593,115815
"4612","Ocbimv22038536m.g","KQ423393",1062,4628,3566
"4613","Ocbimv22006759m.g","KQ417347",1027398,1027790,392
"4614","Ocbimv22002087m.g","KQ424537",134804,138228,3424
"4615","Ocbimv22009071m.g","LGKD01567409",3,203,200
"4616","Ocbimv22037035m.g","KQ422909",463487,473210,9723
"4617","Ocbimv22010217m.g","KQ427311",122666,124880,2214
"4618","Ocbimv22020798m.g","LGKD01663461",1,351,350
"4619","Ocbimv22023717m.g","KQ433592",15954,16121,167
"4620","Ocbimv22008021m.g","KQ417470",1012307,1012491,184
"4621","Ocbimv22026154m.g","KQ420004",543926,546431,2505
"4622","Ocbimv22011792m.g","KQ417832",1337652,1350736,13084
"4623","Ocbimv22005503m.g","KQ425633",67849,68848,999
"4624","Ocbimv22019737m.g","KQ418810",6080,21918,15838
"4625","Ocbimv22016016m.g","KQ418310",312884,314265,1381
"4626","Ocbimv22010565m.g","KQ417691",411927,412562,635
"4627","Ocbimv22010802m.g","KQ417715",230943,313001,82058
"4628","Ocbimv22019127m.g","KQ418719",4522,13910,9388
"4629","Ocbimv22023447m.g","KQ433405",3515,8698,5183
"4630","Ocbimv22018648m.g","KQ418649",531912,537187,5275
"4631","Ocbimv22014022m.g","KQ418079",315625,315993,368
"4632","Ocbimv22012900m.g","KQ417950",26988,37771,10783
"4633","Ocbimv22036706m.g","KQ416654",206858,207910,1052
"4634","Ocbimv22018961m.g","KQ418702",587447,588750,1303
"4635","Ocbimv22036868m.g","KQ416664",169598,169909,311
"4636","Ocbimv22021997m.g","LGKD01282983",145,444,299
"4637","Ocbimv22022362m.g","LGKD01677255",315,870,555
"4638","Ocbimv22026823m.g","KQ420123",393649,393804,155
"4639","Ocbimv22035219m.g","KQ422320",42541,126012,83471
"4640","Ocbimv22008479m.g","KQ426644",3,911,908
"4641","Ocbimv22016605m.g","KQ418370",60110,83931,23821
"4642","Ocbimv22017318m.g","KQ418483",9804,14782,4978
"4643","Ocbimv22016129m.g","KQ418320",712108,726954,14846
"4644","Ocbimv22019351m.g","KQ418754",53421,55100,1679
"4645","Ocbimv22007986m.g","LGKD01559658",1,317,316
"4646","Ocbimv22002973m.g","KQ417051",2081796,2100954,19158
"4647","Ocbimv22002216m.g","KQ424575",58022,58300,278
"4648","Ocbimv22035968m.g","KQ422621",36926,40490,3564
"4649","Ocbimv22026555m.g","KQ416192",340885,346176,5291
"4650","Ocbimv22013660m.g","KQ428587",16233,16987,754
"4651","Ocbimv22005312m.g","KQ425580",22678,27962,5284
"4652","Ocbimv22039923m.g","KQ423797",78699,127626,48927
"4653","Ocbimv22024774m.g","KQ419627",81796,83988,2192
"4654","Ocbimv22019110m.g","KQ430972",4774,22144,17370
"4655","Ocbimv22013347m.g","LGKD01600737",7046,7505,459
"4656","Ocbimv22019921m.g","KQ431376",280549,281586,1037
"4657","Ocbimv22035457m.g","KQ416587",99783,100684,901
"4658","Ocbimv22028464m.g","KQ420496",90684,90986,302
"4659","Ocbimv22022188m.g","KQ419180",931473,932351,878
"4660","Ocbimv22016160m.g","KQ429719",26686,28107,1421
"4661","Ocbimv22009544m.g","KQ415865",1190367,1235289,44922
"4662","Ocbimv22004824m.g","KQ417209",13740,33938,20198
"4663","Ocbimv22027021m.g","KQ420163",139144,168045,28901
"4664","Ocbimv22000003m.g","KQ423819",104182,135986,31804
"4665","Ocbimv22009723m.g","KQ417606",3402,3701,299
"4666","Ocbimv22023612m.g","KQ419441",55667,91617,35950
"4667","Ocbimv22022597m.g","KQ419269",53861,55993,2132
"4668","Ocbimv22012130m.g","KQ415902",149598,165420,15822
"4669","Ocbimv22033941m.g","KQ421907",16431,16727,296
"4670","Ocbimv22015276m.g","KQ415941",31145,32362,1217
"4671","Ocbimv22033607m.g","KQ421846",151067,162894,11827
"4672","Ocbimv22022903m.g","KQ433130",8990,47674,38684
"4673","Ocbimv22035269m.g","KQ422349",16042,17789,1747
"4674","Ocbimv22008140m.g","KQ417481",229629,230202,573
"4675","Ocbimv22029282m.g","KQ420696",476072,590503,114431
"4676","Ocbimv22013341m.g","KQ428453",7377,9320,1943
"4677","Ocbimv22020345m.g","KQ431635",186118,186396,278
"4678","Ocbimv22002378m.g","KQ415792",836214,846589,10375
"4679","Ocbimv22002644m.g","KQ417023",1312614,1371788,59174
"4680","Ocbimv22001741m.g","KQ416959",114759,115490,731
"4681","Ocbimv22022760m.g","KQ432990",39857,78237,38380
"4682","Ocbimv22016501m.g","KQ418363",58550,106852,48302
"4683","Ocbimv22016100m.g","KQ429708",208451,210465,2014
"4684","Ocbimv22026316m.g","KQ420025",113174,118364,5190
"4685","Ocbimv22002823m.g","KQ417038",302,84411,84109
"4686","Ocbimv22002926m.g","KQ424848",129637,130309,672
"4687","Ocbimv22013134m.g","KQ417985",599970,601823,1853
"4688","Ocbimv22032574m.g","KQ421598",112345,112737,392
"4689","Ocbimv22016291m.g","KQ429791",39468,42224,2756
"4690","Ocbimv22019860m.g","KQ418823",20623,21570,947
"4691","Ocbimv22009342m.g","KQ417584",296141,296380,239
"4692","Ocbimv22007534m.g","KQ426366",87093,114792,27699
"4693","Ocbimv22025940m.g","KQ419930",868883,975234,106351
"4694","Ocbimv22025210m.g","KQ419730",53,657,604
"4695","Ocbimv22010736m.g","LGKD01581847",374,562,188
"4696","Ocbimv22025559m.g","KQ419842",4575,4985,410
"4697","Ocbimv22019118m.g","KQ430983",10284,11886,1602
"4698","Ocbimv22023841m.g","KQ419485",521658,534635,12977
"4699","Ocbimv22021036m.g","KQ418995",700,9215,8515
"4700","Ocbimv22026863m.g","KQ420132",623060,623462,402
"4701","Ocbimv22020424m.g","LGKD01660246",194,454,260
"4702","Ocbimv22039493m.g","KQ423677",38138,103861,65723
"4703","Ocbimv22005544m.g","KQ425649",543294,557296,14002
"4704","Ocbimv22005283m.g","LGKD01536480",10,123,113
"4705","Ocbimv22006643m.g","KQ426045",255266,278470,23204
"4706","Ocbimv22001981m.g","KQ415787",1019449,1042041,22592
"4707","Ocbimv22012439m.g","KQ417911",966638,1031256,64618
"4708","Ocbimv22035890m.g","KQ422595",196202,205671,9469
"4709","Ocbimv22018654m.g","KQ430783",140679,141882,1203
"4710","Ocbimv22010470m.g","KQ417681",76796,79310,2514
"4711","Ocbimv22037703m.g","KQ423103",25641,41997,16356
"4712","Ocbimv22028108m.g","KQ416249",512700,512930,230
"4713","Ocbimv22030097m.g","KQ416331",100848,149350,48502
"4714","Ocbimv22000171m.g","KQ416847",336365,337059,694
"4715","Ocbimv22001292m.g","KQ424254",60416,70260,9844
"4716","Ocbimv22015011m.g","KQ418194",199419,262403,62984
"4717","Ocbimv22005155m.g","KQ425533",5787,79760,73973
"4718","Ocbimv22003694m.g","KQ425067",67635,78794,11159
"4719","Ocbimv22033105m.g","KQ421727",477192,477422,230
"4720","Ocbimv22023378m.g","KQ419395",322756,330404,7648
"4721","Ocbimv22024040m.g","KQ416109",2065441,2067474,2033
"4722","Ocbimv22038695m.g","KQ423444",281099,281522,423
"4723","Ocbimv22027071m.g","KQ420175",70192,70605,413
"4724","Ocbimv22012674m.g","KQ417924",591133,591405,272
"4725","Ocbimv22016690m.g","LGKD01629407",295,1125,830
"4726","Ocbimv22000905m.g","KQ416890",75622,77129,1507
"4727","Ocbimv22006535m.g","KQ425992",85678,87981,2303
"4728","Ocbimv22008547m.g","KQ426682",114963,115214,251
"4729","Ocbimv22003964m.g","KQ425160",550573,581864,31291
"4730","Ocbimv22024753m.g","KQ419623",90147,97881,7734
"4731","Ocbimv22023976m.g","KQ419513",101731,103979,2248
"4732","Ocbimv22007702m.g","KQ426423",48575,49305,730
"4733","Ocbimv22014723m.g","KQ418170",123878,126385,2507
"4734","Ocbimv22004129m.g","KQ425215",29,1962,1933
"4735","Ocbimv22018562m.g","KQ418637",124702,154953,30251
"4736","Ocbimv22033884m.g","KQ421897",4247,7057,2810
"4737","Ocbimv22009729m.g","KQ417607",13598,14551,953
"4738","Ocbimv22002150m.g","KQ424561",228066,239772,11706
"4739","Ocbimv22021024m.g","KQ418994",238268,238509,241
"4740","Ocbimv22034721m.g","KQ416548",211520,211669,149
"4741","Ocbimv22007748m.g","KQ415847",619343,646239,26896
"4742","Ocbimv22009864m.g","KQ417620",1753852,1756209,2357
"4743","Ocbimv22023513m.g","KQ419420",377359,377559,200
"4744","Ocbimv22016490m.g","KQ429895",2340,15770,13430
"4745","Ocbimv22019930m.g","KQ418836",262890,263233,343
"4746","Ocbimv22007356m.g","KQ426312",34678,38200,3522
"4747","Ocbimv22018186m.g","KQ415990",23776,87749,63973
"4748","Ocbimv22000306m.g","KQ423917",106109,157934,51825
"4749","Ocbimv22032787m.g","KQ421658",497706,537915,40209
"4750","Ocbimv22000768m.g","KQ416879",259185,282242,23057
"4751","Ocbimv22027097m.g","KQ420181",554971,555156,185
"4752","Ocbimv22025419m.g","KQ419796",47232,48047,815
"4753","Ocbimv22012574m.g","KQ417917",1521626,1564222,42596
"4754","Ocbimv22003292m.g","KQ424942",39776,118190,78414
"4755","Ocbimv22008216m.g","KQ417487",831337,832035,698
"4756","Ocbimv22035248m.g","KQ422341",86730,90368,3638
"4757","Ocbimv22004604m.g","KQ417183",72803,73907,1104
"4758","Ocbimv22025975m.g","KQ419940",17539,26913,9374
"4759","Ocbimv22014590m.g","KQ428995",178897,182384,3487
"4760","Ocbimv22035701m.g","KQ422517",21352,21612,260
"4761","Ocbimv22034824m.g","KQ422187",446028,446238,210
"4762","Ocbimv22036474m.g","KQ416642",110767,137616,26849
"4763","Ocbimv22037479m.g","KQ423043",51611,54354,2743
"4764","Ocbimv22004081m.g","KQ417133",668290,672831,4541
"4765","Ocbimv22011408m.g","KQ417791",1150103,1157752,7649
"4766","Ocbimv22010555m.g","KQ417691",254883,317841,62958
"4767","Ocbimv22020761m.g","KQ418961",74074,101242,27168
"4768","Ocbimv22030539m.g","KQ421018",67403,75265,7862
"4769","Ocbimv22018232m.g","KQ415990",2222402,2245399,22997
"4770","Ocbimv22033074m.g","KQ421721",1031814,1133845,102031
"4771","Ocbimv22032426m.g","KQ421533",580874,583396,2522
"4772","Ocbimv22006525m.g","KQ417333",320354,321219,865
"4773","Ocbimv22022031m.g","KQ419149",328041,342372,14331
"4774","Ocbimv22022989m.g","KQ419334",268983,269998,1015
"4775","Ocbimv22027200m.g","KQ420217",317112,317354,242
"4776","Ocbimv22037853m.g","KQ423139",672278,672616,338
"4777","Ocbimv22008557m.g","KQ415857",61969,69022,7053
"4778","Ocbimv22000629m.g","KQ416870",200792,202482,1690
"4779","Ocbimv22036916m.g","KQ422894",438067,459327,21260
"4780","Ocbimv22020671m.g","KQ418949",111862,114740,2878
"4781","Ocbimv22023387m.g","KQ419396",41501,47066,5565
"4782","Ocbimv22018667m.g","KQ418652",82989,125366,42377
"4783","Ocbimv22006813m.g","KQ417353",208744,219067,10323
"4784","Ocbimv22001442m.g","KQ416933",300709,315589,14880
"4785","Ocbimv22007026m.g","KQ417370",566155,567805,1650
"4786","Ocbimv22029643m.g","KQ416314",81155,82244,1089
"4787","Ocbimv22031508m.g","KQ421263",313602,321833,8231
"4788","Ocbimv22002902m.g","KQ424815",12692,47539,34847
"4789","Ocbimv22015205m.g","KQ429203",12366,13061,695
"4790","Ocbimv22036710m.g","KQ416654",324181,325122,941
"4791","Ocbimv22018472m.g","KQ430702",59399,65511,6112
"4792","Ocbimv22016830m.g","KQ430050",320605,321012,407
"4793","Ocbimv22008460m.g","KQ415854",427491,429003,1512
"4794","Ocbimv22019291m.g","KQ418741",294804,295928,1124
"4795","Ocbimv22038813m.g","KQ423471",47833,53118,5285
"4796","Ocbimv22028999m.g","KQ416279",226934,227215,281
"4797","Ocbimv22002989m.g","KQ424859",16326,16610,284
"4798","Ocbimv22018038m.g","KQ418560",623658,624439,781
"4799","Ocbimv22033882m.g","KQ416497",64671,65570,899
"4800","Ocbimv22015723m.g","KQ418281",104461,105421,960
"4801","Ocbimv22004794m.g","KQ417207",312820,313137,317
"4802","Ocbimv22027119m.g","KQ420193",323809,323979,170
"4803","Ocbimv22037888m.g","KQ423143",209824,210162,338
"4804","Ocbimv22006577m.g","KQ426026",92104,102244,10140
"4805","Ocbimv22035336m.g","KQ416581",189757,196488,6731
"4806","Ocbimv22012905m.g","KQ428275",65255,65884,629
"4807","Ocbimv22005657m.g","KQ417271",221022,224639,3617
"4808","Ocbimv22035960m.g","KQ416612",1776680,1812840,36160
"4809","Ocbimv22032045m.g","KQ421413",72102,89540,17438
"4810","Ocbimv22011664m.g","LGKD01589011",11,211,200
"4811","Ocbimv22003498m.g","KQ417089",159991,160864,873
"4812","Ocbimv22018571m.g","KQ430766",23644,24003,359
"4813","Ocbimv22022207m.g","KQ416062",17876,19306,1430
"4814","Ocbimv22002750m.g","KQ417032",577859,600148,22289
"4815","Ocbimv22012421m.g","KQ417911",222493,349613,127120
"4816","Ocbimv22001794m.g","KQ424420",197783,201263,3480
"4817","Ocbimv22023111m.g","KQ419350",513027,533877,20850
"4818","Ocbimv22014739m.g","KQ429057",51255,51425,170
"4819","Ocbimv22010398m.g","KQ417676",259963,295583,35620
"4820","Ocbimv22031179m.g","KQ415722",19499,22514,3015
"4821","Ocbimv22030263m.g","KQ416339",158935,160310,1375
"4822","Ocbimv22030345m.g","KQ420958",418669,430585,11916
"4823","Ocbimv22001125m.g","KQ424192",11976,41583,29607
"4824","Ocbimv22025454m.g","KQ419807",103056,143743,40687
"4825","Ocbimv22039050m.g","KQ423525",136930,137211,281
"4826","Ocbimv22008687m.g","KQ426728",121685,122629,944
"4827","Ocbimv22029853m.g","KQ420828",1600822,1660072,59250
"4828","Ocbimv22001141m.g","KQ424206",49607,53264,3657
"4829","Ocbimv22009274m.g","KQ426944",180500,185244,4744
"4830","Ocbimv22026355m.g","KQ420032",283995,301669,17674
"4831","Ocbimv22017130m.g","KQ418453",49689,60248,10559
"4832","Ocbimv22037825m.g","KQ423139",225055,226385,1330
"4833","Ocbimv22014304m.g","KQ428857",2,1349,1347
"4834","Ocbimv22010927m.g","KQ417725",238707,240714,2007
"4835","Ocbimv22007804m.g","KQ426459",13719,17382,3663
"4836","Ocbimv22035467m.g","KQ422391",273463,330430,56967
"4837","Ocbimv22012242m.g","KQ428083",8497,9361,864
"4838","Ocbimv22035550m.g","KQ422436",6178,42600,36422
"4839","Ocbimv22016521m.g","KQ418364",198371,242585,44214
"4840","Ocbimv22037523m.g","KQ423057",169509,170083,574
"4841","Ocbimv22039840m.g","KQ416831",26127,42782,16655
"4842","Ocbimv22007660m.g","KQ426411",20377,20697,320
"4843","Ocbimv22021127m.g","KQ416039",1666498,1669954,3456
"4844","Ocbimv22022680m.g","KQ419281",212272,226111,13839
"4845","Ocbimv22020644m.g","KQ418945",844375,861215,16840
"4846","Ocbimv22001556m.g","KQ424355",87847,88167,320
"4847","Ocbimv22037605m.g","KQ423077",792191,793286,1095
"4848","Ocbimv22008602m.g","KQ417510",622418,647961,25543
"4849","Ocbimv22027658m.g","LGKD01348694",1805,2356,551
"4850","Ocbimv22013548m.g","KQ428560",29889,74549,44660
"4851","Ocbimv22005091m.g","KQ425519",66598,67974,1376
"4852","Ocbimv22005820m.g","KQ417280",57758,75212,17454
"4853","Ocbimv22035020m.g","KQ416568",100157,100435,278
"4854","Ocbimv22010201m.g","KQ417655",341918,342169,251
"4855","Ocbimv22010659m.g","KQ427464",430252,616270,186018
"4856","Ocbimv22037806m.g","KQ423139",439,6609,6170
"4857","Ocbimv22010182m.g","KQ417653",633724,635325,1601
"4858","Ocbimv22033819m.g","KQ421880",235123,235296,173
"4859","Ocbimv22028233m.g","KQ416253",88569,90287,1718
"4860","Ocbimv22002665m.g","KQ424726",91976,92765,789
"4861","Ocbimv22037213m.g","KQ416683",372659,374181,1522
"4862","Ocbimv22033690m.g","KQ416491",282814,286555,3741
"4863","Ocbimv22005270m.g","KQ415814",432286,432483,197
"4864","Ocbimv22003597m.g","KQ425041",28661,28856,195
"4865","Ocbimv22031505m.g","KQ421263",262647,287444,24797
"4866","Ocbimv22003977m.g","KQ425163",88373,111070,22697
"4867","Ocbimv22039610m.g","KQ423717",91414,91824,410
"4868","Ocbimv22035857m.g","KQ422582",236865,237305,440
"4869","Ocbimv22024729m.g","KQ416128",132538,132771,233
"4870","Ocbimv22023158m.g","KQ433247",17182,17412,230
"4871","Ocbimv22015704m.g","KQ429490",511,66299,65788
"4872","Ocbimv22037396m.g","KQ416694",1257041,1259433,2392
"4873","Ocbimv22034902m.g","KQ422210",131149,135625,4476
"4874","Ocbimv22037258m.g","KQ415758",3,971,968
"4875","Ocbimv22007067m.g","KQ417374",217756,221523,3767
"4876","Ocbimv22037054m.g","KQ416670",67085,68579,1494
"4877","Ocbimv22021109m.g","KQ419007",412329,412532,203
"4878","Ocbimv22012120m.g","KQ415902",400,12958,12558
"4879","Ocbimv22019970m.g","KQ418839",536570,558670,22100
"4880","Ocbimv22032822m.g","KQ421661",170359,172151,1792
"4881","Ocbimv22008120m.g","KQ426568",83894,84353,459
"4882","Ocbimv22018382m.g","KQ418612",56998,62423,5425
"4883","Ocbimv22031096m.g","KQ421162",813,10353,9540
"4884","Ocbimv22039713m.g","KQ416816",37389,37697,308
"4885","Ocbimv22011955m.g","KQ417847",1308121,1318492,10371
"4886","Ocbimv22016796m.g","KQ418400",108325,108531,206
"4887","Ocbimv22020471m.g","KQ418919",32817,36651,3834
"4888","Ocbimv22009158m.g","KQ426905",195425,197519,2094
"4889","Ocbimv22014677m.g","KQ418168",210470,254143,43673
"4890","Ocbimv22004923m.g","KQ425469",189843,190172,329
"4891","Ocbimv22034776m.g","KQ422169",5903,120042,114139
"4892","Ocbimv22014773m.g","KQ418176",979042,1001071,22029
"4893","Ocbimv22026041m.g","KQ419968",32152,36436,4284
"4894","Ocbimv22012010m.g","KQ427966",4213,23857,19644
"4895","Ocbimv22033564m.g","KQ421835",27068,28219,1151
"4896","Ocbimv22031012m.g","KQ416382",704283,704474,191
"4897","Ocbimv22011470m.g","KQ417793",195042,196728,1686
"4898","Ocbimv22039373m.g","KQ423634",135967,136541,574
"4899","Ocbimv22016938m.g","KQ430098",26801,27046,245
"4900","Ocbimv22032432m.g","KQ421539",1900,126401,124501
"4901","Ocbimv22030837m.g","KQ421109",70404,70577,173
"4902","Ocbimv22002199m.g","KQ416995",174278,180803,6525
"4903","Ocbimv22000584m.g","KQ424010",163882,179753,15871
"4904","Ocbimv22018271m.g","KQ418590",99800,102234,2434
"4905","Ocbimv22010394m.g","KQ417676",26523,99119,72596
"4906","Ocbimv22024050m.g","KQ419526",15416,15913,497
"4907","Ocbimv22010973m.g","KQ417729",1097227,1097562,335
"4908","Ocbimv22008510m.g","KQ417506",767735,775835,8100
"4909","Ocbimv22027760m.g","KQ420358",304618,305058,440
"4910","Ocbimv22028758m.g","KQ420579",304943,359828,54885
"4911","Ocbimv22024786m.g","KQ419631",93884,95524,1640
"4912","Ocbimv22015219m.g","LGKD01225584",162,1277,1115
"4913","Ocbimv22016505m.g","KQ429904",28642,29208,566
"4914","Ocbimv22002501m.g","KQ417011",101014,131174,30160
"4915","Ocbimv22005601m.g","KQ425671",17327,28788,11461
"4916","Ocbimv22002591m.g","KQ424712",86142,111122,24980
"4917","Ocbimv22002841m.g","KQ424801",123289,124602,1313
"4918","Ocbimv22033722m.g","KQ416495",66023,79372,13349
"4919","Ocbimv22032084m.g","KQ421430",142593,144751,2158
"4920","Ocbimv22029586m.g","KQ420779",187387,188874,1487
"4921","Ocbimv22010444m.g","KQ427389",230979,231413,434
"4922","Ocbimv22028947m.g","KQ420605",747946,752230,4284
"4923","Ocbimv22021825m.g","KQ415687",531341,531559,218
"4924","Ocbimv22006496m.g","KQ425957",2543,98001,95458
"4925","Ocbimv22027143m.g","LGKD01341056",144,407,263
"4926","Ocbimv22027807m.g","KQ416233",773990,790119,16129
"4927","Ocbimv22019265m.g","KQ418739",456605,460987,4382
"4928","Ocbimv22029368m.g","KQ420729",35347,68635,33288
"4929","Ocbimv22022785m.g","KQ419298",50282,81903,31621
"4930","Ocbimv22016704m.g","KQ429970",62076,62345,269
"4931","Ocbimv22028389m.g","KQ416257",595406,623083,27677
"4932","Ocbimv22038243m.g","KQ423246",124203,124394,191
"4933","Ocbimv22001317m.g","KQ424265",48216,51054,2838
"4934","Ocbimv22023678m.g","KQ419458",290771,355734,64963
"4935","Ocbimv22025434m.g","KQ419798",91253,91426,173
"4936","Ocbimv22020911m.g","KQ418974",853018,853665,647
"4937","Ocbimv22012333m.g","KQ415907",564074,585392,21318
"4938","Ocbimv22031936m.g","KQ421381",136572,137036,464
"4939","Ocbimv22032075m.g","KQ416417",227,3671,3444
"4940","Ocbimv22031049m.g","KQ421147",330420,330677,257
"4941","Ocbimv22013345m.g","KQ428455",12291,12465,174
"4942","Ocbimv22004373m.g","KQ415803",584582,587823,3241
"4943","Ocbimv22028461m.g","KQ420495",7666,78725,71059
"4944","Ocbimv22008461m.g","KQ415854",430413,432416,2003
"4945","Ocbimv22017550m.g","KQ415978",88409,90015,1606
"4946","Ocbimv22014300m.g","KQ418115",844289,845103,814
"4947","Ocbimv22035357m.g","KQ416582",168915,184223,15308
"4948","Ocbimv22026238m.g","KQ420017",1087928,1116088,28160
"4949","Ocbimv22008386m.g","KQ426624",14675,14866,191
"4950","Ocbimv22021545m.g","KQ419075",3074,4082,1008
"4951","Ocbimv22024884m.g","KQ419646",64882,78917,14035
"4952","Ocbimv22032119m.g","KQ421453",130658,132138,1480
"4953","Ocbimv22009011m.g","KQ426840",48380,52373,3993
"4954","Ocbimv22030430m.g","KQ420978",305861,306804,943
"4955","Ocbimv22031370m.g","KQ416393",299353,299559,206
"4956","Ocbimv22037803m.g","KQ423136",116448,116956,508
"4957","Ocbimv22001719m.g","KQ416957",5171,9761,4590
"4958","Ocbimv22017824m.g","KQ418551",101054,120569,19515
"4959","Ocbimv22022101m.g","KQ432566",13291,14101,810
"4960","Ocbimv22005857m.g","KQ417280",261022,265681,4659
"4961","Ocbimv22014293m.g","KQ418115",172757,216818,44061
"4962","Ocbimv22021889m.g","LGKD01672123",49,288,239
"4963","Ocbimv22017416m.g","KQ418493",90953,97110,6157
"4964","Ocbimv22013332m.g","KQ418012",375495,375707,212
"4965","Ocbimv22035217m.g","KQ422314",98130,99494,1364
"4966","Ocbimv22018740m.g","LGKD01645725",122,286,164
"4967","Ocbimv22013498m.g","KQ418031",502166,502738,572
"4968","Ocbimv22016647m.g","KQ429942",33,2482,2449
"4969","Ocbimv22031100m.g","KQ416385",49278,50314,1036
"4970","Ocbimv22019662m.g","KQ416016",43790,44059,269
"4971","Ocbimv22033239m.g","KQ421758",795569,797617,2048
"4972","Ocbimv22036982m.g","KQ422898",60843,91771,30928
"4973","Ocbimv22013702m.g","KQ418049",155959,161555,5596
"4974","Ocbimv22018242m.g","KQ430606",25067,51580,26513
"4975","Ocbimv22000292m.g","KQ423912",102105,103334,1229
"4976","Ocbimv22015167m.g","KQ418202",49931,73005,23074
"4977","Ocbimv22033844m.g","KQ421894",123474,135517,12043
"4978","Ocbimv22023900m.g","KQ419496",44776,45102,326
"4979","Ocbimv22007724m.g","KQ417446",326550,326771,221
"4980","Ocbimv22009633m.g","KQ427059",88749,89968,1219
"4981","Ocbimv22026916m.g","KQ416205",1585,25866,24281
"4982","Ocbimv22007897m.g","KQ426484",305721,354459,48738
"4983","Ocbimv22028287m.g","KQ420458",114885,126639,11754
"4984","Ocbimv22035079m.g","KQ422268",116211,163033,46822
"4985","Ocbimv22032037m.g","KQ421411",503684,505342,1658
"4986","Ocbimv22004984m.g","KQ417219",251653,251832,179
"4987","Ocbimv22038994m.g","KQ423506",55082,81138,26056
"4988","Ocbimv22026876m.g","KQ420132",934920,960503,25583
"4989","Ocbimv22034707m.g","KQ416547",299703,305765,6062
"4990","Ocbimv22035353m.g","KQ416582",66736,69456,2720
"4991","Ocbimv22030887m.g","KQ421117",82100,99052,16952
"4992","Ocbimv22010227m.g","KQ417658",67254,67451,197
"4993","Ocbimv22009392m.g","KQ426987",153193,154032,839
"4994","Ocbimv22010014m.g","KQ427205",166597,167443,846
"4995","Ocbimv22013224m.g","KQ418002",405112,412615,7503
"4996","Ocbimv22020313m.g","KQ418888",194135,207206,13071
"4997","Ocbimv22035894m.g","KQ422595",239007,239701,694
"4998","Ocbimv22006220m.g","KQ425846",38423,114920,76497
"4999","Ocbimv22036774m.g","KQ422857",215218,215478,260
"5000","Ocbimv22037109m.g","KQ422923",248422,271024,22602
"5001","Ocbimv22027537m.g","KQ420299",1130981,1170642,39661
"5002","Ocbimv22038556m.g","KQ416751",51669,51963,294
"5003","Ocbimv22009522m.g","KQ415865",767352,768781,1429
"5004","Ocbimv22024869m.g","KQ419644",13223,14321,1098
"5005","Ocbimv22026032m.g","KQ419959",4776,6484,1708
"5006","Ocbimv22024300m.g","KQ419563",111653,162824,51171
"5007","Ocbimv22019758m.g","KQ418811",677177,677635,458
"5008","Ocbimv22009898m.g","KQ417622",17444,17923,479
"5009","Ocbimv22006205m.g","KQ417304",117812,122721,4909
"5010","Ocbimv22030843m.g","KQ421110",176468,177658,1190
"5011","Ocbimv22009151m.g","KQ426899",3627,4991,1364
"5012","Ocbimv22023932m.g","KQ419500",873043,874377,1334
"5013","Ocbimv22013016m.g","KQ417972",424630,425791,1161
"5014","Ocbimv22011037m.g","KQ417740",72573,73533,960
"5015","Ocbimv22008063m.g","KQ426556",265084,266532,1448
"5016","Ocbimv22005485m.g","KQ425619",78458,83265,4807
"5017","Ocbimv22027058m.g","KQ420170",126861,127490,629
"5018","Ocbimv22025186m.g","KQ419726",26002,26592,590
"5019","Ocbimv22015006m.g","KQ418194",114532,123507,8975
"5020","Ocbimv22013360m.g","KQ428462",52591,99822,47231
"5021","Ocbimv22007807m.g","KQ426461",48831,65949,17118
"5022","Ocbimv22023446m.g","KQ433405",1085,1396,311
"5023","Ocbimv22028105m.g","KQ416249",341415,341827,412
"5024","Ocbimv22032139m.g","KQ421460",119073,136038,16965
"5025","Ocbimv22035306m.g","KQ422351",324196,359327,35131
"5026","Ocbimv22019881m.g","KQ431367",651,1461,810
"5027","Ocbimv22005801m.g","KQ415823",1134612,1138079,3467
"5028","Ocbimv22000841m.g","KQ415664",30110,30433,323
"5029","Ocbimv22003033m.g","KQ417055",1338390,1381234,42844
"5030","Ocbimv22009704m.g","KQ427095",68403,83385,14982
"5031","Ocbimv22022926m.g","KQ419326",606938,607123,185
"5032","Ocbimv22026014m.g","KQ419957",16877,17698,821
"5033","Ocbimv22019170m.g","KQ418727",7577,20882,13305
"5034","Ocbimv22038903m.g","KQ416771",922345,922692,347
"5035","Ocbimv22025171m.g","KQ416141",629315,703855,74540
"5036","Ocbimv22031888m.g","KQ421372",376426,377703,1277
"5037","Ocbimv22008154m.g","KQ417481",1005531,1007364,1833
"5038","Ocbimv22005097m.g","KQ417228",8683,9255,572
"5039","Ocbimv22009363m.g","KQ417587",134881,135627,746
"5040","Ocbimv22002312m.g","KQ424627",392149,414726,22577
"5041","Ocbimv22033983m.g","KQ421935",63709,64122,413
"5042","Ocbimv22027657m.g","KQ420333",7533,66803,59270
"5043","Ocbimv22026197m.g","KQ420016",241649,242041,392
"5044","Ocbimv22008876m.g","KQ426791",461743,530888,69145
"5045","Ocbimv22014596m.g","KQ418156",269024,275973,6949
"5046","Ocbimv22034554m.g","KQ416536",1255371,1256436,1065
"5047","Ocbimv22017549m.g","KQ415978",76326,108940,32614
"5048","Ocbimv22035512m.g","KQ422415",231189,247741,16552
"5049","Ocbimv22024837m.g","KQ419638",191026,203061,12035
"5050","Ocbimv22000899m.g","KQ415781",22832,23468,636
"5051","Ocbimv22016317m.g","KQ418338",316358,329615,13257
"5052","Ocbimv22035907m.g","KQ422598",478471,478992,521
"5053","Ocbimv22025201m.g","KQ419727",542428,545087,2659
"5054","Ocbimv22034117m.g","KQ416513",642988,643664,676
"5055","Ocbimv22009065m.g","KQ426855",45191,65884,20693
"5056","Ocbimv22029471m.g","KQ416308",515733,545646,29913
"5057","Ocbimv22021106m.g","KQ419007",50774,51010,236
"5058","Ocbimv22008278m.g","KQ417493",207388,207639,251
"5059","Ocbimv22027765m.g","KQ420361",9658,16931,7273
"5060","Ocbimv22033650m.g","KQ421858",7509,7853,344
"5061","Ocbimv22007873m.g","KQ426467",672,1225,553
"5062","Ocbimv22000312m.g","KQ415776",167685,217286,49601
"5063","Ocbimv22021918m.g","LGKD01672540",11,314,303
"5064","Ocbimv22011108m.g","KQ427639",19593,23760,4167
"5065","Ocbimv22033110m.g","KQ416467",16335,18817,2482
"5066","Ocbimv22024038m.g","KQ416109",1507567,1507854,287
"5067","Ocbimv22026967m.g","KQ420154",288110,305313,17203
"5068","Ocbimv22022907m.g","KQ419324",83600,200236,116636
"5069","Ocbimv22013436m.g","KQ428505",1244,1405,161
"5070","Ocbimv22034890m.g","KQ422208",331105,350191,19086
"5071","Ocbimv22024121m.g","KQ419535",855616,888935,33319
"5072","Ocbimv22025028m.g","KQ416136",394985,396392,1407
"5073","Ocbimv22031016m.g","KQ421144",2685,69405,66720
"5074","Ocbimv22034330m.g","KQ422016",129672,130925,1253
"5075","Ocbimv22023964m.g","KQ419508",512789,605814,93025
"5076","Ocbimv22012711m.g","KQ417929",67842,89882,22040
"5077","Ocbimv22020854m.g","KQ418970",2394653,2401644,6991
"5078","Ocbimv22022768m.g","KQ419290",74071,75574,1503
"5079","Ocbimv22001265m.g","KQ424244",361120,386539,25419
"5080","Ocbimv22026272m.g","KQ420022",517862,544900,27038
"5081","Ocbimv22035649m.g","KQ422492",39406,51618,12212
"5082","Ocbimv22009599m.g","KQ427045",168275,168508,233
"5083","Ocbimv22001415m.g","KQ424302",206666,233471,26805
"5084","Ocbimv22001084m.g","KQ416908",407194,423941,16747
"5085","Ocbimv22000978m.g","KQ424142",101766,104958,3192
"5086","Ocbimv22015438m.g","KQ418246",94782,100442,5660
"5087","Ocbimv22035284m.g","KQ422349",172347,174174,1827
"5088","Ocbimv22028607m.g","KQ416263",789773,790663,890
"5089","Ocbimv22006317m.g","KQ425873",330884,424746,93862
"5090","Ocbimv22023144m.g","LGKD01685930",141,1144,1003
"5091","Ocbimv22020010m.g","KQ418841",47928,86252,38324
"5092","Ocbimv22011749m.g","KQ417828",135131,151202,16071
"5093","Ocbimv22027022m.g","KQ420163",154262,201757,47495
"5094","Ocbimv22023818m.g","KQ419481",5355,6714,1359
"5095","Ocbimv22003693m.g","KQ425067",40568,53995,13427
"5096","Ocbimv22008101m.g","KQ426567",111118,111313,195
"5097","Ocbimv22034050m.g","KQ416508",567195,577602,10407
"5098","Ocbimv22024600m.g","KQ419601",1209146,1209686,540
"5099","Ocbimv22008455m.g","KQ415854",323623,335742,12119
"5100","Ocbimv22026899m.g","KQ420138",615721,637609,21888
"5101","Ocbimv22019578m.g","KQ418789",70120,85349,15229
"5102","Ocbimv22019064m.g","LGKD01647646",25,615,590
"5103","Ocbimv22030161m.g","KQ416336",7,503,496
"5104","Ocbimv22000698m.g","KQ416877",99718,99918,200
"5105","Ocbimv22013886m.g","KQ418070",11072,14140,3068
"5106","Ocbimv22009601m.g","KQ427052",14350,29153,14803
"5107","Ocbimv22002593m.g","KQ417020",132387,138227,5840
"5108","Ocbimv22022187m.g","KQ419180",915023,916225,1202
"5109","Ocbimv22032440m.g","KQ421542",24018,24527,509
"5110","Ocbimv22033800m.g","KQ421873",235388,236086,698
"5111","Ocbimv22011310m.g","KQ417780",131987,140129,8142
"5112","Ocbimv22020261m.g","KQ431563",52082,111553,59471
"5113","Ocbimv22028896m.g","KQ416274",629401,638948,9547
"5114","Ocbimv22035673m.g","KQ422501",1875,195336,193461
"5115","Ocbimv22017870m.g","KQ418552",555721,562344,6623
"5116","Ocbimv22012623m.g","KQ417921",1091726,1091983,257
"5117","Ocbimv22033526m.g","KQ421824",238088,239746,1658
"5118","Ocbimv22026537m.g","KQ420065",264827,294207,29380
"5119","Ocbimv22015789m.g","KQ418293",216411,234373,17962
"5120","Ocbimv22008184m.g","KQ417482",38630,79671,41041
"5121","Ocbimv22021886m.g","LGKD01671976",236,463,227
"5122","Ocbimv22017628m.g","KQ418516",55954,78011,22057
"5123","Ocbimv22030588m.g","KQ421031",264301,278571,14270
"5124","Ocbimv22027911m.g","KQ420397",112204,113286,1082
"5125","Ocbimv22015235m.g","KQ415940",620229,621382,1153
"5126","Ocbimv22003094m.g","KQ424880",77105,77293,188
"5127","Ocbimv22038056m.g","KQ423210",41751,58320,16569
"5128","Ocbimv22028556m.g","KQ416260",1717460,1717684,224
"5129","Ocbimv22005140m.g","KQ415813",1621935,1622186,251
"5130","Ocbimv22022493m.g","KQ419232",245489,350993,105504
"5131","Ocbimv22013892m.g","KQ428707",27397,30113,2716
"5132","Ocbimv22036231m.g","KQ416626",704264,705247,983
"5133","Ocbimv22031929m.g","KQ416413",1368213,1372831,4618
"5134","Ocbimv22026440m.g","KQ420052",54177,60609,6432
"5135","Ocbimv22000661m.g","KQ424045",3330,4316,986
"5136","Ocbimv22002232m.g","KQ416996",392385,393063,678
"5137","Ocbimv22020250m.g","KQ431557",419,16100,15681
"5138","Ocbimv22000685m.g","KQ424055",389730,483269,93539
"5139","Ocbimv22023245m.g","LGKD01686935",84,236,152
"5140","Ocbimv22017235m.g","KQ418469",566682,568553,1871
"5141","Ocbimv22027032m.g","KQ420166",556856,558346,1490
"5142","Ocbimv22037070m.g","KQ416671",157184,164138,6954
"5143","Ocbimv22015489m.g","KQ429393",8634,10056,1422
"5144","Ocbimv22012713m.g","KQ417929",148002,161754,13752
"5145","Ocbimv22018552m.g","KQ430743",11434,11634,200
"5146","Ocbimv22014517m.g","KQ415932",754940,776761,21821
"5147","Ocbimv22015062m.g","KQ418194",1092289,1093008,719
"5148","Ocbimv22006873m.g","KQ426130",32343,69078,36735
"5149","Ocbimv22013982m.g","KQ428717",47755,73435,25680
"5150","Ocbimv22007814m.g","KQ426461",242602,242802,200
"5151","Ocbimv22035836m.g","KQ422573",142843,143334,491
"5152","Ocbimv22016360m.g","KQ429828",4774,6145,1371
"5153","Ocbimv22034362m.g","KQ422020",12778,20842,8064
"5154","Ocbimv22010414m.g","KQ427377",14,1479,1465
"5155","Ocbimv22020472m.g","KQ418919",38098,42176,4078
"5156","Ocbimv22014166m.g","KQ418096",508650,508943,293
"5157","Ocbimv22029409m.g","KQ420742",167207,170121,2914
"5158","Ocbimv22006864m.g","KQ417358",803797,849679,45882
"5159","Ocbimv22026433m.g","KQ420048",102797,106692,3895
"5160","Ocbimv22036124m.g","KQ422647",168796,169191,395
"5161","Ocbimv22002180m.g","KQ424568",45866,74788,28922
"5162","Ocbimv22026336m.g","KQ420029",211621,213604,1983
"5163","Ocbimv22011243m.g","KQ417769",1709,32017,30308
"5164","Ocbimv22025253m.g","KQ419748",307639,308445,806
"5165","Ocbimv22013376m.g","KQ418018",660895,661095,200
"5166","Ocbimv22036943m.g","KQ416666",998754,1000563,1809
"5167","Ocbimv22010878m.g","KQ417722",28513,41183,12670
"5168","Ocbimv22032678m.g","KQ416444",158445,164740,6295
"5169","Ocbimv22003663m.g","KQ417100",31505,31657,152
"5170","Ocbimv22011592m.g","KQ417807",168608,173678,5070
"5171","Ocbimv22007634m.g","KQ415845",225920,227944,2024
"5172","Ocbimv22014190m.g","KQ418098",733195,734996,1801
"5173","Ocbimv22022550m.g","KQ432841",733,1897,1164
"5174","Ocbimv22012208m.g","KQ417890",23162,25638,2476
"5175","Ocbimv22006972m.g","KQ417369",69218,69496,278
"5176","Ocbimv22009181m.g","KQ426911",131941,142622,10681
"5177","Ocbimv22009442m.g","KQ426997",29241,32270,3029
"5178","Ocbimv22017793m.g","KQ418545",489905,491596,1691
"5179","Ocbimv22025744m.g","KQ415694",283946,285310,1364
"5180","Ocbimv22008375m.g","KQ417498",940297,940500,203
"5181","Ocbimv22024550m.g","KQ419593",107270,111036,3766
"5182","Ocbimv22022224m.g","KQ432632",19372,19897,525
"5183","Ocbimv22038155m.g","KQ415763",282533,282922,389
"5184","Ocbimv22005401m.g","KQ417249",2161137,2161352,215
"5185","Ocbimv22026539m.g","KQ420065",348569,431139,82570
"5186","Ocbimv22020059m.g","KQ418847",230364,232041,1677
"5187","Ocbimv22035441m.g","KQ422383",1,709,708
"5188","Ocbimv22031578m.g","KQ416401",40384,40792,408
"5189","Ocbimv22002520m.g","KQ417012",295352,374949,79597
"5190","Ocbimv22007991m.g","KQ417469",20612,21626,1014
"5191","Ocbimv22022830m.g","KQ419305",344519,344731,212
"5192","Ocbimv22007423m.g","KQ426339",11902,37932,26030
"5193","Ocbimv22013622m.g","KQ418039",754096,756953,2857
"5194","Ocbimv22008824m.g","KQ426776",1589,24067,22478
"5195","Ocbimv22008062m.g","KQ426556",257145,262293,5148
"5196","Ocbimv22003725m.g","KQ425076",170984,200095,29111
"5197","Ocbimv22027574m.g","KQ420308",37933,59408,21475
"5198","Ocbimv22023959m.g","KQ419507",218926,312449,93523
"5199","Ocbimv22019251m.g","KQ431068",198380,199731,1351
"5200","Ocbimv22029061m.g","KQ420639",530328,532793,2465
"5201","Ocbimv22019444m.g","KQ418767",361439,379165,17726
"5202","Ocbimv22022185m.g","KQ419180",860228,870188,9960
"5203","Ocbimv22022991m.g","KQ419334",288923,289216,293
"5204","Ocbimv22015940m.g","KQ418303",1405788,1406573,785
"5205","Ocbimv22002479m.g","KQ417010",678692,679911,1219
"5206","Ocbimv22002325m.g","KQ424629",109864,122582,12718
"5207","Ocbimv22025078m.g","KQ416137",286087,317249,31162
"5208","Ocbimv22011274m.g","KQ417772",116556,117209,653
"5209","Ocbimv22028990m.g","KQ416279",35,1777,1742
"5210","Ocbimv22016200m.g","KQ418327",1341,5174,3833
"5211","Ocbimv22005483m.g","KQ417255",205061,205848,787
"5212","Ocbimv22028099m.g","KQ416249",42619,80875,38256
"5213","Ocbimv22021399m.g","KQ432116",61285,68051,6766
"5214","Ocbimv22003087m.g","KQ424877",492939,500420,7481
"5215","Ocbimv22034709m.g","LGKD01430518",58,399,341
"5216","Ocbimv22028011m.g","KQ416243",1356835,1357911,1076
"5217","Ocbimv22013713m.g","KQ418052",73862,74380,518
"5218","Ocbimv22031095m.g","KQ421160",14006,17928,3922
"5219","Ocbimv22039212m.g","KQ423576",388121,391939,3818
"5220","Ocbimv22035644m.g","KQ422489",93173,99340,6167
"5221","Ocbimv22005202m.g","KQ417232",383291,395606,12315
"5222","Ocbimv22029423m.g","KQ420747",445476,445811,335
"5223","Ocbimv22020395m.g","KQ418904",423441,423950,509
"5224","Ocbimv22037900m.g","KQ423154",60135,106705,46570
"5225","Ocbimv22016967m.g","KQ418431",77,54762,54685
"5226","Ocbimv22033125m.g","KQ421731",362169,362719,550
"5227","Ocbimv22009952m.g","KQ427178",17587,30116,12529
"5228","Ocbimv22001467m.g","KQ424308",37018,37333,315
"5229","Ocbimv22000242m.g","KQ423905",32098,46349,14251
"5230","Ocbimv22025033m.g","KQ416136",469658,499175,29517
"5231","Ocbimv22039159m.g","KQ423555",383103,458608,75505
"5232","Ocbimv22023214m.g","KQ419373",5477,87110,81633
"5233","Ocbimv22036722m.g","KQ416655",99080,114813,15733
"5234","Ocbimv22002300m.g","KQ424627",42063,55682,13619
"5235","Ocbimv22024472m.g","KQ419584",110535,116732,6197
"5236","Ocbimv22020914m.g","KQ418974",1221567,1223511,1944
"5237","Ocbimv22005596m.g","KQ425667",40291,40690,399
"5238","Ocbimv22000796m.g","KQ424071",12324,79343,67019
"5239","Ocbimv22022644m.g","KQ419277",37659,60742,23083
"5240","Ocbimv22033163m.g","KQ421737",552769,570336,17567
"5241","Ocbimv22011624m.g","KQ427818",48789,102739,53950
"5242","Ocbimv22009371m.g","KQ426978",56820,57035,215
"5243","Ocbimv22010087m.g","KQ417641",279036,281330,2294
"5244","Ocbimv22022839m.g","LGKD01683122",167,592,425
"5245","Ocbimv22005052m.g","KQ425507",107579,136311,28732
"5246","Ocbimv22026039m.g","KQ419966",4420,18830,14410
"5247","Ocbimv22009302m.g","KQ417581",149638,151087,1449
"5248","Ocbimv22027326m.g","KQ420260",572296,572538,242
"5249","Ocbimv22004989m.g","KQ417220",56304,106452,50148
"5250","Ocbimv22006722m.g","KQ415834",207202,238743,31541
"5251","Ocbimv22024957m.g","KQ419666",243273,261528,18255
"5252","Ocbimv22016486m.g","KQ418360",137940,148393,10453
"5253","Ocbimv22027733m.g","KQ420350",170711,189632,18921
"5254","Ocbimv22002860m.g","LGKD01516095",35,1240,1205
"5255","Ocbimv22021059m.g","KQ431974",85891,107313,21422
"5256","Ocbimv22002544m.g","KQ424680",100587,150802,50215
"5257","Ocbimv22016119m.g","KQ418320",466830,473259,6429
"5258","Ocbimv22025211m.g","KQ419735",5107,39172,34065
"5259","Ocbimv22028558m.g","KQ420521",5072,5899,827
"5260","Ocbimv22037332m.g","KQ423002",48243,48948,705
"5261","Ocbimv22015653m.g","KQ418272",122698,123372,674
"5262","Ocbimv22021955m.g","KQ419138",89799,90717,918
"5263","Ocbimv22003315m.g","KQ424969",984,1280,296
"5264","Ocbimv22025415m.g","KQ419794",109546,110566,1020
"5265","Ocbimv22017388m.g","KQ430272",376462,389809,13347
"5266","Ocbimv22018555m.g","KQ418635",34417,34767,350
"5267","Ocbimv22013575m.g","KQ418038",270495,276897,6402
"5268","Ocbimv22017768m.g","KQ418543",442760,445948,3188
"5269","Ocbimv22035911m.g","KQ422600",32774,35434,2660
"5270","Ocbimv22032713m.g","KQ421639",113233,114324,1091
"5271","Ocbimv22017529m.g","KQ430338",8,460,452
"5272","Ocbimv22001898m.g","KQ424463",21923,27612,5689
"5273","Ocbimv22019207m.g","KQ418734",49469,56784,7315
"5274","Ocbimv22017170m.g","KQ418459",316537,333361,16824
"5275","Ocbimv22030604m.g","KQ416359",23167,82974,59807
"5276","Ocbimv22013298m.g","KQ418007",711131,793717,82586
"5277","Ocbimv22019173m.g","LGKD01648941",66,185,119
"5278","Ocbimv22031558m.g","KQ421275",6981,7394,413
"5279","Ocbimv22017358m.g","KQ418484",67213,69290,2077
"5280","Ocbimv22006875m.g","KQ426130",155902,156881,979
"5281","Ocbimv22029939m.g","KQ416325",80772,81362,590
"5282","Ocbimv22027134m.g","KQ420198",29352,143002,113650
"5283","Ocbimv22028550m.g","KQ416260",713893,714426,533
"5284","Ocbimv22017530m.g","KQ430340",12106,19620,7514
"5285","Ocbimv22031879m.g","KQ421370",117984,168503,50519
"5286","Ocbimv22029623m.g","KQ420787",658712,670451,11739
"5287","Ocbimv22009054m.g","KQ415859",797344,797667,323
"5288","Ocbimv22032957m.g","KQ421695",1353,9627,8274
"5289","Ocbimv22024976m.g","KQ419670",278500,280487,1987
"5290","Ocbimv22032209m.g","KQ416425",426859,437580,10721
"5291","Ocbimv22011636m.g","KQ427828",13798,34740,20942
"5292","Ocbimv22036701m.g","KQ422841",36601,37773,1172
"5293","Ocbimv22002298m.g","KQ424627",2316,38086,35770
"5294","Ocbimv22037790m.g","LGKD01463998",180,593,413
"5295","Ocbimv22011873m.g","KQ417844",420911,421063,152
"5296","Ocbimv22025825m.g","KQ419909",346636,348448,1812
"5297","Ocbimv22004906m.g","KQ417213",533784,565484,31700
"5298","Ocbimv22010459m.g","KQ417678",425618,434151,8533
"5299","Ocbimv22024744m.g","KQ419623",36434,37110,676
"5300","Ocbimv22036313m.g","KQ422711",522992,709205,186213
"5301","Ocbimv22020555m.g","KQ431722",7055,47961,40906
"5302","Ocbimv22019510m.g","KQ431173",12772,14303,1531
"5303","Ocbimv22029658m.g","KQ416315",331252,331763,511
"5304","Ocbimv22007880m.g","KQ426479",1322,1675,353
"5305","Ocbimv22004362m.g","KQ425275",22668,22898,230
"5306","Ocbimv22022628m.g","KQ432932",253162,259569,6407
"5307","Ocbimv22034053m.g","KQ416508",593676,595090,1414
"5308","Ocbimv22005024m.g","KQ417224",251801,261158,9357
"5309","Ocbimv22035302m.g","KQ422351",284248,286223,1975
"5310","Ocbimv22028987m.g","KQ420622",89611,89898,287
"5311","Ocbimv22036584m.g","KQ422794",212963,239908,26945
"5312","Ocbimv22006036m.g","KQ417290",38652,41565,2913
"5313","Ocbimv22006118m.g","KQ417299",57352,57564,212
"5314","Ocbimv22033073m.g","KQ421721",957476,971546,14070
"5315","Ocbimv22008301m.g","KQ417496",244699,245160,461
"5316","Ocbimv22037873m.g","KQ423141",123226,135141,11915
"5317","Ocbimv22011590m.g","KQ417807",140645,147547,6902
"5318","Ocbimv22026738m.g","KQ416198",342091,344916,2825
"5319","Ocbimv22005194m.g","KQ425540",135641,136027,386
"5320","Ocbimv22009719m.g","KQ427096",216544,227964,11420
"5321","Ocbimv22031678m.g","KQ421308",400587,428755,28168
"5322","Ocbimv22038227m.g","KQ416731",706028,708173,2145
"5323","Ocbimv22034502m.g","KQ422062",404594,407134,2540
"5324","Ocbimv22015804m.g","KQ418294",48790,50826,2036
"5325","Ocbimv22017567m.g","KQ418506",454819,455066,247
"5326","Ocbimv22006957m.g","KQ417367",222712,222999,287
"5327","Ocbimv22024221m.g","KQ419550",236204,237415,1211
"5328","Ocbimv22027099m.g","KQ420181",698082,698312,230
"5329","Ocbimv22037667m.g","KQ416705",2171372,2171656,284
"5330","Ocbimv22015107m.g","KQ429157",213305,333649,120344
"5331","Ocbimv22009123m.g","KQ426892",35715,44715,9000
"5332","Ocbimv22012783m.g","KQ428240",58785,62490,3705
"5333","Ocbimv22038645m.g","KQ423430",715530,715832,302
"5334","Ocbimv22011232m.g","KQ427681",17279,17697,418
"5335","Ocbimv22005203m.g","KQ417232",779374,790155,10781
"5336","Ocbimv22015187m.g","KQ418204",22257,22779,522
"5337","Ocbimv22030401m.g","KQ420971",65510,66268,758
"5338","Ocbimv22024664m.g","KQ419607",710817,724142,13325
"5339","Ocbimv22010111m.g","KQ427263",74781,111108,36327
"5340","Ocbimv22035223m.g","KQ416578",733454,733848,394
"5341","Ocbimv22015500m.g","KQ418263",728400,729053,653
"5342","Ocbimv22030827m.g","KQ421100",48318,53091,4773
"5343","Ocbimv22028431m.g","KQ420486",35379,42824,7445
"5344","Ocbimv22035027m.g","KQ416568",1071823,1072419,596
"5345","Ocbimv22016525m.g","KQ418364",386438,404714,18276
"5346","Ocbimv22017702m.g","KQ430419",159175,159390,215
"5347","Ocbimv22003930m.g","LGKD01526019",44,226,182
"5348","Ocbimv22037537m.g","KQ423058",389770,454266,64496
"5349","Ocbimv22006428m.g","KQ425920",10181,12309,2128
"5350","Ocbimv22002819m.g","KQ424789",37809,94040,56231
"5351","Ocbimv22017381m.g","KQ430272",87444,87962,518
"5352","Ocbimv22037293m.g","KQ422996",196872,197742,870
"5353","Ocbimv22037042m.g","KQ422909",674322,674510,188
"5354","Ocbimv22029140m.g","KQ420662",877433,904752,27319
"5355","Ocbimv22033487m.g","KQ421821",187031,187591,560
"5356","Ocbimv22008376m.g","KQ417498",974217,974459,242
"5357","Ocbimv22015266m.g","KQ418216",662096,684192,22096
"5358","Ocbimv22012510m.g","KQ417917",362938,365213,2275
"5359","Ocbimv22014370m.g","KQ428888",3844,9341,5497
"5360","Ocbimv22014282m.g","KQ415926",138559,184432,45873
"5361","Ocbimv22032251m.g","KQ421502",283800,334824,51024
"5362","Ocbimv22015026m.g","KQ418194",426714,439497,12783
"5363","Ocbimv22028711m.g","KQ420563",49,1113,1064
"5364","Ocbimv22015492m.g","KQ418263",115824,116045,221
"5365","Ocbimv22033716m.g","KQ416493",338953,339204,251
"5366","Ocbimv22023801m.g","KQ419478",397696,397869,173
"5367","Ocbimv22007773m.g","KQ426456",124541,124831,290
"5368","Ocbimv22037524m.g","KQ423057",171235,172118,883
"5369","Ocbimv22008399m.g","KQ426629",147900,148742,842
"5370","Ocbimv22019096m.g","KQ430963",236175,236608,433
"5371","Ocbimv22032490m.g","KQ416434",181423,187402,5979
"5372","Ocbimv22026606m.g","KQ420078",537906,539340,1434
"5373","Ocbimv22030637m.g","KQ421039",389348,392269,2921
"5374","Ocbimv22004200m.g","KQ425223",54644,55009,365
"5375","Ocbimv22005965m.g","KQ425764",58913,61668,2755
"5376","Ocbimv22037531m.g","KQ423058",80555,126216,45661
"5377","Ocbimv22011326m.g","KQ417780",728118,730715,2597
"5378","Ocbimv22010239m.g","KQ427326",27153,27374,221
"5379","Ocbimv22009072m.g","KQ426859",5846,16913,11067
"5380","Ocbimv22013026m.g","KQ417975",1019834,1020830,996
"5381","Ocbimv22031122m.g","KQ421170",667795,669359,1564
"5382","Ocbimv22014261m.g","KQ428825",929,62305,61376
"5383","Ocbimv22010325m.g","KQ427354",150761,157016,6255
"5384","Ocbimv22038891m.g","KQ416771",355620,359414,3794
"5385","Ocbimv22005746m.g","KQ425733",31599,139235,107636
"5386","Ocbimv22023896m.g","KQ433690",2915,25038,22123
"5387","Ocbimv22038318m.g","KQ423280",85123,86050,927
"5388","Ocbimv22030120m.g","KQ420901",62923,64067,1144
"5389","Ocbimv22033050m.g","KQ421721",479434,482411,2977
"5390","Ocbimv22025169m.g","KQ416141",575424,585119,9695
"5391","Ocbimv22016101m.g","KQ429708",214901,216775,1874
"5392","Ocbimv22029173m.g","KQ420672",445470,457743,12273
"5393","Ocbimv22033588m.g","KQ421839",334440,337781,3341
"5394","Ocbimv22003963m.g","KQ425160",505427,551172,45745
"5395","Ocbimv22002210m.g","KQ416995",263438,269203,5765
"5396","Ocbimv22024611m.g","KQ416126",82404,82622,218
"5397","Ocbimv22028893m.g","KQ416274",494748,497844,3096
"5398","Ocbimv22034375m.g","KQ422021",211554,254251,42697
"5399","Ocbimv22011046m.g","KQ417740",222566,262288,39722
"5400","Ocbimv22036078m.g","KQ416616",1063089,1099157,36068
"5401","Ocbimv22016337m.g","KQ429822",7407,26969,19562
"5402","Ocbimv22024226m.g","KQ419550",318593,319758,1165
"5403","Ocbimv22019735m.g","LGKD01653340",13,285,272
"5404","Ocbimv22024651m.g","KQ419607",109733,109951,218
"5405","Ocbimv22008631m.g","KQ426714",115543,119342,3799
"5406","Ocbimv22038199m.g","KQ416731",188885,189280,395
"5407","Ocbimv22037047m.g","KQ422909",1093724,1093936,212
"5408","Ocbimv22027891m.g","KQ420390",11156,11512,356
"5409","Ocbimv22033029m.g","KQ421720",238712,303582,64870
"5410","Ocbimv22035928m.g","KQ416610",83938,108358,24420
"5411","Ocbimv22019046m.g","KQ418711",1197745,1218516,20771
"5412","Ocbimv22007887m.g","KQ417458",264206,264616,410
"5413","Ocbimv22022956m.g","KQ416079",663,5541,4878
"5414","Ocbimv22034659m.g","KQ416544",267192,296728,29536
"5415","Ocbimv22028305m.g","KQ420464",865407,866070,663
"5416","Ocbimv22030267m.g","KQ416339",308968,309735,767
"5417","Ocbimv22036875m.g","KQ422887",187238,187417,179
"5418","Ocbimv22019083m.g","KQ418715",696483,697414,931
"5419","Ocbimv22031584m.g","KQ416401",282316,285303,2987
"5420","Ocbimv22036520m.g","KQ422783",118595,122427,3832
"5421","Ocbimv22020712m.g","KQ416032",467394,467662,268
"5422","Ocbimv22037019m.g","KQ422909",107106,114126,7020
"5423","Ocbimv22007382m.g","KQ426315",18437,38139,19702
"5424","Ocbimv22004292m.g","KQ417146",123278,141532,18254
"5425","Ocbimv22029052m.g","KQ420635",21679,23017,1338
"5426","Ocbimv22011721m.g","KQ417826",34046,35210,1164
"5427","Ocbimv22000040m.g","KQ423834",45279,56202,10923
"5428","Ocbimv22006055m.g","KQ417293",123292,161317,38025
"5429","Ocbimv22014428m.g","KQ418133",363797,364123,326
"5430","Ocbimv22032196m.g","KQ421476",260734,260958,224
"5431","Ocbimv22033785m.g","KQ421871",370633,371304,671
"5432","Ocbimv22020682m.g","KQ418952",28584,28820,236
"5433","Ocbimv22014080m.g","KQ415924",11489,11734,245
"5434","Ocbimv22031802m.g","KQ421353",32760,46614,13854
"5435","Ocbimv22000670m.g","KQ424048",279,74387,74108
"5436","Ocbimv22036298m.g","KQ416631",142578,150088,7510
"5437","Ocbimv22029814m.g","KQ420828",730333,743932,13599
"5438","Ocbimv22025020m.g","KQ416136",182818,183072,254
"5439","Ocbimv22039350m.g","KQ423630",4669,8051,3382
"5440","Ocbimv22024764m.g","KQ419623",178792,180233,1441
"5441","Ocbimv22016538m.g","KQ418365",747171,747993,822
"5442","Ocbimv22026689m.g","KQ416197",30922,84158,53236
"5443","Ocbimv22022544m.g","KQ419245",9722,10072,350
"5444","Ocbimv22009574m.g","KQ427028",447673,449559,1886
"5445","Ocbimv22015643m.g","KQ418271",275419,284457,9038
"5446","Ocbimv22022641m.g","KQ419277",15689,26556,10867
"5447","Ocbimv22029442m.g","KQ416306",1632165,1633194,1029
"5448","Ocbimv22006774m.g","KQ426101",145170,145322,152
"5449","Ocbimv22016249m.g","KQ429777",35511,35666,155
"5450","Ocbimv22022459m.g","KQ419220",474046,474405,359
"5451","Ocbimv22003535m.g","KQ417090",609660,609911,251
"5452","Ocbimv22033279m.g","KQ421759",620703,621065,362
"5453","Ocbimv22024253m.g","KQ416118",66371,66565,194
"5454","Ocbimv22023647m.g","KQ433538",76536,78223,1687
"5455","Ocbimv22005478m.g","KQ425611",688231,721385,33154
"5456","Ocbimv22021841m.g","KQ415687",1091808,1111815,20007
"5457","Ocbimv22016107m.g","KQ429708",312188,351087,38899
"5458","Ocbimv22039383m.g","KQ423638",4015,64182,60167
"5459","Ocbimv22039455m.g","KQ423671",142827,144466,1639
"5460","Ocbimv22016150m.g","KQ418322",541190,621778,80588
"5461","Ocbimv22037740m.g","KQ416708",362825,388434,25609
"5462","Ocbimv22034396m.g","KQ422028",179741,197188,17447
"5463","Ocbimv22038784m.g","KQ423464",129943,130254,311
"5464","Ocbimv22034465m.g","KQ422050",728105,728422,317
"5465","Ocbimv22010023m.g","LGKD01575814",128,361,233
"5466","Ocbimv22030987m.g","KQ416380",114999,128700,13701
"5467","Ocbimv22006392m.g","KQ417318",179625,208135,28510
"5468","Ocbimv22001413m.g","KQ424302",142009,160037,18028
"5469","Ocbimv22035521m.g","KQ422418",1768,12919,11151
"5470","Ocbimv22004705m.g","KQ425422",44792,45112,320
"5471","Ocbimv22009390m.g","KQ426987",119676,120000,324
"5472","Ocbimv22015937m.g","KQ418303",1257614,1259310,1696
"5473","Ocbimv22013626m.g","KQ418039",790658,832285,41627
"5474","Ocbimv22024788m.g","KQ419631",144375,148255,3880
"5475","Ocbimv22002838m.g","KQ424798",1839,2135,296
"5476","Ocbimv22018393m.g","KQ430678",63465,104064,40599
"5477","Ocbimv22033629m.g","KQ421853",53335,55049,1714
"5478","Ocbimv22011307m.g","KQ417780",2016,12003,9987
"5479","Ocbimv22032734m.g","KQ416449",290528,290782,254
"5480","Ocbimv22000659m.g","KQ424043",1995,3014,1019
"5481","Ocbimv22001441m.g","KQ416933",299695,300233,538
"5482","Ocbimv22005255m.g","KQ417236",39670,40749,1079
"5483","Ocbimv22024367m.g","KQ419574",858787,872331,13544
"5484","Ocbimv22004652m.g","KQ425409",33965,34504,539
"5485","Ocbimv22032676m.g","KQ416444",126608,146129,19521
"5486","Ocbimv22006409m.g","KQ425905",55707,56229,522
"5487","Ocbimv22017250m.g","KQ418469",822838,823238,400
"5488","Ocbimv22003879m.g","KQ425134",23274,94895,71621
"5489","Ocbimv22034858m.g","KQ416560",33559,34666,1107
"5490","Ocbimv22013996m.g","KQ428719",45103,51539,6436
"5491","Ocbimv22002478m.g","KQ417010",671702,677067,5365
"5492","Ocbimv22024267m.g","KQ433917",9685,27127,17442
"5493","Ocbimv22034169m.g","KQ416518",282641,282865,224
"5494","Ocbimv22022718m.g","KQ419287",60545,63229,2684
"5495","Ocbimv22009698m.g","KQ427088",18861,45129,26268
"5496","Ocbimv22016418m.g","KQ418350",292902,317654,24752
"5497","Ocbimv22020771m.g","KQ431852",38906,39747,841
"5498","Ocbimv22021367m.g","KQ432093",4626,27534,22908
"5499","Ocbimv22035300m.g","KQ422351",210876,217314,6438
"5500","Ocbimv22027990m.g","KQ420415",223343,223747,404
"5501","Ocbimv22028229m.g","KQ420450",189850,190227,377
"5502","Ocbimv22027811m.g","KQ416233",1143407,1176508,33101
"5503","Ocbimv22035382m.g","KQ422366",65773,66693,920
"5504","Ocbimv22007198m.g","KQ426235",61388,62078,690
"5505","Ocbimv22033750m.g","KQ421864",199699,202651,2952
"5506","Ocbimv22022204m.g","KQ419184",316403,317156,753
"5507","Ocbimv22012078m.g","KQ428013",9009,58229,49220
"5508","Ocbimv22025480m.g","KQ419817",129114,129569,455
"5509","Ocbimv22019152m.g","KQ418723",273216,284408,11192
"5510","Ocbimv22026020m.g","KQ419957",268326,269127,801
"5511","Ocbimv22015972m.g","KQ415949",137791,148279,10488
"5512","Ocbimv22037969m.g","KQ423187",2120,7505,5385
"5513","Ocbimv22014844m.g","KQ415935",156029,160385,4356
"5514","Ocbimv22027568m.g","KQ420308",17930,21621,3691
"5515","Ocbimv22036806m.g","KQ422860",2215,9426,7211
"5516","Ocbimv22006319m.g","KQ417313",2807,3584,777
"5517","Ocbimv22009417m.g","KQ417591",1192083,1219157,27074
"5518","Ocbimv22010004m.g","LGKD01575408",8,824,816
"5519","Ocbimv22004607m.g","KQ417183",136354,136518,164
"5520","Ocbimv22028277m.g","KQ415659",2341280,2341477,197
"5521","Ocbimv22019000m.g","KQ418710",416759,417208,449
"5522","Ocbimv22003944m.g","KQ417128",103570,111721,8151
"5523","Ocbimv22028252m.g","KQ415659",376006,390006,14000
"5524","Ocbimv22027299m.g","KQ420247",92774,120736,27962
"5525","Ocbimv22030393m.g","KQ420971",4976,8916,3940
"5526","Ocbimv22008964m.g","KQ417544",88146,88361,215
"5527","Ocbimv22019685m.g","KQ431257",9329,24405,15076
"5528","Ocbimv22031433m.g","KQ421241",583340,583667,327
"5529","Ocbimv22015949m.g","KQ418303",1596146,1617992,21846
"5530","Ocbimv22007421m.g","KQ426338",94176,94442,266
"5531","Ocbimv22009882m.g","KQ417621",349564,360016,10452
"5532","Ocbimv22034976m.g","KQ422233",317641,368859,51218
"5533","Ocbimv22000635m.g","KQ416870",438508,439248,740
"5534","Ocbimv22020967m.g","KQ418983",119988,154153,34165
"5535","Ocbimv22006652m.g","LGKD01548767",2,196,194
"5536","Ocbimv22031989m.g","KQ421396",411543,412049,506
"5537","Ocbimv22018892m.g","KQ430918",67796,103164,35368
"5538","Ocbimv22017693m.g","KQ430417",224356,225222,866
"5539","Ocbimv22023640m.g","KQ419448",254285,254595,310
"5540","Ocbimv22026971m.g","KQ416207",119644,123178,3534
"5541","Ocbimv22024046m.g","KQ433769",139830,148728,8898
"5542","Ocbimv22029461m.g","KQ420757",77346,77531,185
"5543","Ocbimv22010251m.g","KQ415873",121409,122167,758
"5544","Ocbimv22008716m.g","KQ426745",3675,14398,10723
"5545","Ocbimv22037428m.g","KQ416694",2811895,2813982,2087
"5546","Ocbimv22020918m.g","KQ418974",1771928,1773007,1079
"5547","Ocbimv22005962m.g","KQ417286",214789,214977,188
"5548","Ocbimv22000320m.g","KQ415776",912998,960162,47164
"5549","Ocbimv22034751m.g","KQ422145",161358,161864,506
"5550","Ocbimv22021026m.g","KQ418994",269479,303515,34036
"5551","Ocbimv22002420m.g","KQ417009",1185561,1186242,681
"5552","Ocbimv22016539m.g","KQ418365",759750,760955,1205
"5553","Ocbimv22004502m.g","KQ417173",1216524,1216961,437
"5554","Ocbimv22032313m.g","KQ421523",172599,175086,2487
"5555","Ocbimv22032764m.g","KQ421655",501049,501222,173
"5556","Ocbimv22039320m.g","KQ416788",111582,117846,6264
"5557","Ocbimv22032968m.g","KQ421702",506598,554903,48305
"5558","Ocbimv22036144m.g","KQ422658",163132,187144,24012
"5559","Ocbimv22014071m.g","KQ418086",336279,336503,224
"5560","Ocbimv22004327m.g","KQ417149",75942,83865,7923
"5561","Ocbimv22010035m.g","KQ417632",136860,137081,221
"5562","Ocbimv22024187m.g","KQ433852",117827,120251,2424
"5563","Ocbimv22036160m.g","KQ422660",78545,78793,248
"5564","Ocbimv22008636m.g","KQ417515",74918,75166,248
"5565","Ocbimv22009630m.g","KQ427059",36560,48447,11887
"5566","Ocbimv22013490m.g","KQ428533",69615,72071,2456
"5567","Ocbimv22031591m.g","KQ421283",60315,80490,20175
"5568","Ocbimv22016773m.g","KQ430008",63969,64312,343
"5569","Ocbimv22034649m.g","KQ416544",25590,36910,11320
"5570","Ocbimv22023568m.g","KQ419433",28338,66629,38291
"5571","Ocbimv22038769m.g","KQ416765",431093,475497,44404
"5572","Ocbimv22007017m.g","KQ417370",502501,502863,362
"5573","Ocbimv22029252m.g","KQ420694",77055,88344,11289
"5574","Ocbimv22014726m.g","LGKD01612124",38,160,122
"5575","Ocbimv22033020m.g","KQ416464",309993,333238,23245
"5576","Ocbimv22018276m.g","KQ418590",353180,372205,19025
"5577","Ocbimv22027712m.g","KQ420347",152293,156218,3925
"5578","Ocbimv22025779m.g","KQ415695",14093,14512,419
"5579","Ocbimv22023305m.g","KQ416087",640085,640543,458
"5580","Ocbimv22015954m.g","KQ418303",1694475,1696282,1807
"5581","Ocbimv22032584m.g","KQ421602",136932,146014,9082
"5582","Ocbimv22034557m.g","KQ422077",47611,52030,4419
"5583","Ocbimv22004127m.g","KQ425213",95079,123565,28486
"5584","Ocbimv22029219m.g","KQ416292",7974,11886,3912
"5585","Ocbimv22021117m.g","KQ432015",13090,23758,10668
"5586","Ocbimv22012002m.g","KQ417853",99427,100318,891
"5587","Ocbimv22005362m.g","KQ425596",273883,274245,362
"5588","Ocbimv22035622m.g","KQ422479",730,2049,1319
"5589","Ocbimv22006892m.g","KQ426135",305512,318522,13010
"5590","Ocbimv22037315m.g","KQ416685",375938,377356,1418
"5591","Ocbimv22036409m.g","KQ416641",145537,150242,4705
"5592","Ocbimv22036081m.g","KQ416616",1105366,1231963,126597
"5593","Ocbimv22030994m.g","LGKD01386736",488,784,296
"5594","Ocbimv22009087m.g","KQ426870",10201,23421,13220
"5595","Ocbimv22017695m.g","KQ430417",242965,246697,3732
"5596","Ocbimv22037845m.g","KQ423139",528236,540724,12488
"5597","Ocbimv22015534m.g","KQ429401",48649,49025,376
"5598","Ocbimv22034246m.g","KQ422015",62913,71622,8709
"5599","Ocbimv22035310m.g","KQ422351",410976,421031,10055
"5600","Ocbimv22012209m.g","KQ417890",61889,63357,1468
"5601","Ocbimv22011287m.g","KQ417776",3170,14308,11138
"5602","Ocbimv22024067m.g","KQ433795",631,3698,3067
"5603","Ocbimv22024274m.g","KQ419562",190090,190371,281
"5604","Ocbimv22023192m.g","KQ419368",482733,510928,28195
"5605","Ocbimv22004780m.g","KQ417205",167266,184562,17296
"5606","Ocbimv22007935m.g","KQ426499",55146,67086,11940
"5607","Ocbimv22019491m.g","KQ416012",85730,88358,2628
"5608","Ocbimv22031444m.g","KQ421244",176489,177590,1101
"5609","Ocbimv22010715m.g","KQ427476",68464,68652,188
"5610","Ocbimv22028652m.g","KQ420545",146465,149953,3488
"5611","Ocbimv22037688m.g","KQ423101",54054,55474,1420
"5612","Ocbimv22009020m.g","KQ426844",11264,12114,850
"5613","Ocbimv22034558m.g","KQ422077",104319,104489,170
"5614","Ocbimv22011658m.g","KQ427833",604789,604947,158
"5615","Ocbimv22036858m.g","KQ416662",131474,154922,23448
"5616","Ocbimv22036270m.g","KQ416628",613063,613967,904
"5617","Ocbimv22008380m.g","KQ426621",225,26591,26366
"5618","Ocbimv22011409m.g","KQ417791",1186535,1186849,314
"5619","Ocbimv22028234m.g","KQ420454",165531,184261,18730
"5620","Ocbimv22006458m.g","KQ425932",126,1549,1423
"5621","Ocbimv22032131m.g","KQ421454",284507,294290,9783
"5622","Ocbimv22027540m.g","KQ420299",1350365,1350562,197
"5623","Ocbimv22025493m.g","KQ419820",41854,51859,10005
"5624","Ocbimv22031339m.g","KQ421219",78682,79164,482
"5625","Ocbimv22033744m.g","KQ421864",116745,128358,11613
"5626","Ocbimv22023181m.g","KQ419368",211833,213668,1835
"5627","Ocbimv22038048m.g","KQ416723",603990,604704,714
"5628","Ocbimv22026217m.g","KQ420017",494994,532331,37337
"5629","Ocbimv22009858m.g","KQ417620",1318443,1325066,6623
"5630","Ocbimv22039485m.g","KQ423675",452669,522522,69853
"5631","Ocbimv22005671m.g","KQ417272",141254,221219,79965
"5632","Ocbimv22006749m.g","LGKD01159371",38,271,233
"5633","Ocbimv22039465m.g","KQ423675",15750,18073,2323
"5634","Ocbimv22029325m.g","KQ416297",138963,150868,11905
"5635","Ocbimv22015227m.g","KQ429223",1726,2127,401
"5636","Ocbimv22008905m.g","KQ417538",196048,196534,486
"5637","Ocbimv22019558m.g","KQ418783",619801,666148,46347
"5638","Ocbimv22039814m.g","KQ423766",64590,153350,88760
"5639","Ocbimv22027250m.g","KQ420230",47818,76305,28487
"5640","Ocbimv22021381m.g","KQ419039",27095,36505,9410
"5641","Ocbimv22021471m.g","KQ416046",2022793,2023110,317
"5642","Ocbimv22025149m.g","KQ419709",215971,217853,1882
"5643","Ocbimv22024879m.g","KQ419645",176967,177134,167
"5644","Ocbimv22039058m.g","KQ423531",199673,202531,2858
"5645","Ocbimv22030580m.g","KQ416357",489766,503692,13926
"5646","Ocbimv22017017m.g","KQ430123",134751,135702,951
"5647","Ocbimv22010458m.g","KQ417678",398033,425326,27293
"5648","Ocbimv22031820m.g","KQ415726",953150,953652,502
"5649","Ocbimv22017212m.g","KQ430210",68536,79168,10632
"5650","Ocbimv22004457m.g","KQ417164",29298,29705,407
"5651","Ocbimv22034764m.g","KQ422162",509124,509453,329
"5652","Ocbimv22023945m.g","KQ433721",5613,7733,2120
"5653","Ocbimv22027459m.g","KQ416225",19989,49685,29696
"5654","Ocbimv22009687m.g","KQ427082",42774,43214,440
"5655","Ocbimv22020413m.g","KQ418908",563988,565147,1159
"5656","Ocbimv22009939m.g","KQ417624",329242,340568,11326
"5657","Ocbimv22030020m.g","KQ420885",47200,60794,13594
"5658","Ocbimv22021608m.g","KQ432245",125156,126721,1565
"5659","Ocbimv22024955m.g","KQ419666",91244,91486,242
"5660","Ocbimv22023785m.g","KQ416096",1425269,1494043,68774
"5661","Ocbimv22002428m.g","KQ417009",1334130,1365973,31843
"5662","Ocbimv22014900m.g","KQ418187",199568,215530,15962
"5663","Ocbimv22017716m.g","KQ418530",225211,225563,352
"5664","Ocbimv22017082m.g","KQ430161",15572,62140,46568
"5665","Ocbimv22019339m.g","KQ418751",143043,143249,206
"5666","Ocbimv22030008m.g","KQ416330",13451,40905,27454
"5667","Ocbimv22037965m.g","KQ416716",340497,418715,78218
"5668","Ocbimv22030702m.g","KQ421074",200413,202138,1725
"5669","Ocbimv22026651m.g","KQ420085",462931,506034,43103
"5670","Ocbimv22011632m.g","KQ417812",595094,595816,722
"5671","Ocbimv22025927m.g","KQ419930",13769,13984,215
"5672","Ocbimv22033964m.g","KQ421929",55811,55966,155
"5673","Ocbimv22036944m.g","KQ416666",1005111,1005845,734
"5674","Ocbimv22016977m.g","KQ418431",418889,423061,4172
"5675","Ocbimv22012515m.g","KQ417917",412870,414072,1202
"5676","Ocbimv22029648m.g","KQ416314",114767,115899,1132
"5677","Ocbimv22008639m.g","KQ417515",103971,104273,302
"5678","Ocbimv22020051m.g","KQ431421",12410,12772,362
"5679","Ocbimv22038333m.g","KQ423285",75374,75640,266
"5680","Ocbimv22008694m.g","KQ426737",24013,30442,6429
"5681","Ocbimv22000100m.g","KQ423859",26934,27094,160
"5682","Ocbimv22017730m.g","KQ415982",147953,148210,257
"5683","Ocbimv22034095m.g","KQ421974",41282,42021,739
"5684","Ocbimv22003791m.g","KQ417112",889430,914986,25556
"5685","Ocbimv22029486m.g","KQ420759",8507,8761,254
"5686","Ocbimv22020795m.g","KQ418966",24725,25441,716
"5687","Ocbimv22023665m.g","LGKD01691713",6,221,215
"5688","Ocbimv22010264m.g","KQ427337",277,549,272
"5689","Ocbimv22014018m.g","KQ418079",83185,84861,1676
"5690","Ocbimv22010996m.g","KQ427580",134535,135074,539
"5691","Ocbimv22003066m.g","KQ424877",76876,77130,254
"5692","Ocbimv22021153m.g","KQ419009",545448,546152,704
"5693","Ocbimv22006626m.g","KQ417337",221832,227375,5543
"5694","Ocbimv22016543m.g","KQ418367",205463,235600,30137
"5695","Ocbimv22018732m.g","KQ415998",116982,132244,15262
"5696","Ocbimv22026769m.g","KQ420112",182726,220534,37808
"5697","Ocbimv22033587m.g","KQ421839",316245,316957,712
"5698","Ocbimv22010572m.g","KQ417691",483030,512501,29471
"5699","Ocbimv22006543m.g","LGKD01547360",26,358,332
"5700","Ocbimv22023223m.g","KQ419376",597552,619381,21829
"5701","Ocbimv22013659m.g","KQ428587",3,8945,8942
"5702","Ocbimv22006737m.g","KQ417345",315623,315879,256
"5703","Ocbimv22025886m.g","KQ416175",451786,452639,853
"5704","Ocbimv22034655m.g","KQ416544",212558,213097,539
"5705","Ocbimv22012158m.g","KQ428049",2585,2791,206
"5706","Ocbimv22021319m.g","KQ419029",59262,61185,1923
"5707","Ocbimv22033735m.g","KQ416495",572715,644611,71896
"5708","Ocbimv22018468m.g","KQ415993",380220,380581,361
"5709","Ocbimv22003039m.g","KQ417055",1663103,1675397,12294
"5710","Ocbimv22030769m.g","KQ421085",162879,212562,49683
"5711","Ocbimv22035102m.g","KQ416572",301772,302032,260
"5712","Ocbimv22005106m.g","KQ415813",129482,146679,17197
"5713","Ocbimv22019370m.g","LGKD01650198",12,173,161
"5714","Ocbimv22016718m.g","KQ418389",41562,99974,58412
"5715","Ocbimv22001293m.g","KQ424254",83247,96854,13607
"5716","Ocbimv22028852m.g","KQ420593",234299,234910,611
"5717","Ocbimv22037942m.g","KQ423175",250511,252969,2458
"5718","Ocbimv22030620m.g","KQ416359",1160882,1208528,47646
"5719","Ocbimv22011524m.g","KQ427769",24019,30086,6067
"5720","Ocbimv22025882m.g","KQ416175",404383,424308,19925
"5721","Ocbimv22004819m.g","KQ417208",404604,405607,1003
"5722","Ocbimv22028419m.g","KQ420483",207270,214434,7164
"5723","Ocbimv22016924m.g","KQ418423",342674,365828,23154
"5724","Ocbimv22029538m.g","KQ420776",87925,111362,23437
"5725","Ocbimv22017690m.g","KQ430417",183405,183641,236
"5726","Ocbimv22020460m.g","LGKD01660846",81,230,149
"5727","Ocbimv22038720m.g","KQ423454",59316,60378,1062
"5728","Ocbimv22030002m.g","KQ420880",9603,9902,299
"5729","Ocbimv22012552m.g","KQ417917",1079250,1090297,11047
"5730","Ocbimv22003950m.g","KQ425159",27945,30325,2380
"5731","Ocbimv22028412m.g","KQ420483",26696,58470,31774
"5732","Ocbimv22002830m.g","KQ417040",203351,204277,926
"5733","Ocbimv22002857m.g","KQ424805",159982,160404,422
"5734","Ocbimv22002239m.g","KQ416999",199243,214113,14870
"5735","Ocbimv22009308m.g","KQ417581",379009,379874,865
"5736","Ocbimv22019021m.g","KQ418711",502577,503239,662
"5737","Ocbimv22037352m.g","KQ423013",3,6057,6054
"5738","Ocbimv22024156m.g","KQ419543",2399,14250,11851
"5739","Ocbimv22033399m.g","KQ416479",907156,919028,11872
"5740","Ocbimv22012879m.g","KQ428261",124710,130101,5391
"5741","Ocbimv22021717m.g","KQ419091",253058,253312,254
"5742","Ocbimv22012764m.g","LGKD01596588",1,159,158
"5743","Ocbimv22037404m.g","KQ416694",1946810,1947130,320
"5744","Ocbimv22008279m.g","KQ417493",208231,208701,470
"5745","Ocbimv22011125m.g","KQ427649",246423,246716,293
"5746","Ocbimv22039041m.g","KQ415769",314947,373484,58537
"5747","Ocbimv22001701m.g","KQ424387",367793,432342,64549
"5748","Ocbimv22033352m.g","KQ416476",13243,53738,40495
"5749","Ocbimv22018421m.g","KQ418614",310066,311095,1029
"5750","Ocbimv22003755m.g","KQ417105",1724754,1729181,4427
"5751","Ocbimv22006074m.g","KQ425807",164545,183724,19179
"5752","Ocbimv22020434m.g","KQ416027",305649,308434,2785
"5753","Ocbimv22020796m.g","KQ431857",18372,33922,15550
"5754","Ocbimv22022189m.g","KQ419180",938932,979445,40513
"5755","Ocbimv22025807m.g","KQ419907",111797,113453,1656
"5756","Ocbimv22012146m.g","KQ417877",913139,914271,1132
"5757","Ocbimv22014124m.g","KQ418092",156861,161211,4350
"5758","Ocbimv22039512m.g","KQ423680",239271,243861,4590
"5759","Ocbimv22017819m.g","KQ418549",887437,1048198,160761
"5760","Ocbimv22000199m.g","KQ423892",1,6278,6277
"5761","Ocbimv22033034m.g","KQ421720",309160,311526,2366
"5762","Ocbimv22018266m.g","KQ430613",45678,54582,8904
"5763","Ocbimv22013885m.g","KQ428701",168814,171139,2325
"5764","Ocbimv22016161m.g","KQ429719",35380,61406,26026
"5765","Ocbimv22009506m.g","KQ415865",554481,554866,385
"5766","Ocbimv22016723m.g","KQ429980",77554,123577,46023
"5767","Ocbimv22024044m.g","KQ433767",17286,35209,17923
"5768","Ocbimv22023825m.g","KQ419484",100289,102675,2386
"5769","Ocbimv22032170m.g","KQ421464",837189,838756,1567
"5770","Ocbimv22029115m.g","KQ416287",17790,18456,666
"5771","Ocbimv22020112m.g","KQ431456",11136,11819,683
"5772","Ocbimv22034343m.g","KQ422016",284245,298365,14120
"5773","Ocbimv22019659m.g","KQ431222",67944,69525,1581
"5774","Ocbimv22008485m.g","KQ426647",213792,214121,329
"5775","Ocbimv22020215m.g","KQ431541",3148,31344,28196
"5776","Ocbimv22011018m.g","KQ417735",33102,58024,24922
"5777","Ocbimv22006374m.g","LGKD01156944",157,303,146
"5778","Ocbimv22014162m.g","KQ418096",392223,393680,1457
"5779","Ocbimv22008337m.g","KQ417497",1210343,1235645,25302
"5780","Ocbimv22029211m.g","KQ416291",887486,887884,398
"5781","Ocbimv22033383m.g","KQ416479",504927,532728,27801
"5782","Ocbimv22030244m.g","KQ416338",501645,542030,40385
"5783","Ocbimv22003230m.g","KQ417066",386331,404965,18634
"5784","Ocbimv22036155m.g","KQ422659",187156,187607,451
"5785","Ocbimv22013229m.g","KQ418002",466232,468389,2157
"5786","Ocbimv22004753m.g","KQ425434",246806,265535,18729
"5787","Ocbimv22037048m.g","KQ422909",1094310,1094927,617
"5788","Ocbimv22031405m.g","KQ421232",95345,97132,1787
"5789","Ocbimv22001976m.g","KQ415787",216500,218334,1834
"5790","Ocbimv22008819m.g","KQ426774",275965,282538,6573
"5791","Ocbimv22036571m.g","KQ422794",33340,38316,4976
"5792","Ocbimv22000251m.g","KQ423905",176300,200520,24220
"5793","Ocbimv22027259m.g","KQ420239",336897,337160,263
"5794","Ocbimv22037477m.g","KQ423042",101837,102016,179
"5795","Ocbimv22002746m.g","KQ417032",126648,126954,306
"5796","Ocbimv22009637m.g","KQ427059",172755,173540,785
"5797","Ocbimv22037393m.g","KQ416694",1099511,1099700,189
"5798","Ocbimv22010556m.g","KQ417691",321640,339768,18128
"5799","Ocbimv22037475m.g","KQ423042",65706,78189,12483
"5800","Ocbimv22011321m.g","KQ417780",480839,485541,4702
"5801","Ocbimv22030717m.g","KQ421078",221391,254491,33100
"5802","Ocbimv22028632m.g","KQ420538",9230,19823,10593
"5803","Ocbimv22022229m.g","LGKD01676159",5961,9065,3104
"5804","Ocbimv22003932m.g","KQ425151",27715,41187,13472
"5805","Ocbimv22014390m.g","KQ418125",228612,229381,769
"5806","Ocbimv22001949m.g","KQ424486",722628,723381,753
"5807","Ocbimv22025178m.g","KQ419721",435002,435862,860
"5808","Ocbimv22036808m.g","KQ416658",592046,592450,404
"5809","Ocbimv22005690m.g","KQ417274",11671,11940,269
"5810","Ocbimv22032538m.g","KQ421579",27837,29832,1995
"5811","Ocbimv22038124m.g","KQ423217",170844,171982,1138
"5812","Ocbimv22017023m.g","LGKD01632287",9,365,356
"5813","Ocbimv22014340m.g","KQ418120",205355,205666,311
"5814","Ocbimv22008008m.g","KQ415849",238254,238619,365
"5815","Ocbimv22023406m.g","KQ419402",74554,75117,563
"5816","Ocbimv22031830m.g","KQ421356",214764,249999,35235
"5817","Ocbimv22003400m.g","KQ417086",172075,275853,103778
"5818","Ocbimv22011227m.g","KQ417763",760206,761843,1637
"5819","Ocbimv22013629m.g","KQ418040",93506,94612,1106
"5820","Ocbimv22008842m.g","KQ417537",177767,178138,371
"5821","Ocbimv22030241m.g","KQ416338",176337,176543,206
"5822","Ocbimv22023239m.g","KQ433284",55592,118871,63279
"5823","Ocbimv22024342m.g","KQ419574",258884,264487,5603
"5824","Ocbimv22035207m.g","KQ422311",50120,55307,5187
"5825","Ocbimv22029946m.g","KQ416325",121186,121749,563
"5826","Ocbimv22008882m.g","KQ426791",657147,664020,6873
"5827","Ocbimv22033570m.g","KQ421836",44134,95034,50900
"5828","Ocbimv22035327m.g","KQ422353",22,858,836
"5829","Ocbimv22017547m.g","KQ430353",21590,22950,1360
"5830","Ocbimv22027945m.g","KQ420408",38591,38944,353
"5831","Ocbimv22006784m.g","KQ426104",26416,56289,29873
"5832","Ocbimv22027515m.g","KQ420295",47837,48184,347
"5833","Ocbimv22016516m.g","KQ429907",9541,25288,15747
"5834","Ocbimv22004513m.g","KQ417173",3974648,4021356,46708
"5835","Ocbimv22019490m.g","KQ416012",28060,29771,1711
"5836","Ocbimv22037808m.g","KQ423139",33161,47620,14459
"5837","Ocbimv22030411m.g","KQ420971",156276,157147,871
"5838","Ocbimv22006854m.g","KQ417358",720000,731534,11534
"5839","Ocbimv22020529m.g","KQ418922",408377,415574,7197
"5840","Ocbimv22005449m.g","KQ417252",1846065,1846345,280
"5841","Ocbimv22014474m.g","KQ428956",2568,2839,271
"5842","Ocbimv22030656m.g","KQ421050",7184,7351,167
"5843","Ocbimv22014866m.g","KQ418184",304169,304528,359
"5844","Ocbimv22027077m.g","KQ420175",183537,184037,500
"5845","Ocbimv22008237m.g","KQ417490",464805,465350,545
"5846","Ocbimv22035499m.g","KQ422411",139433,142697,3264
"5847","Ocbimv22031938m.g","KQ421385",141216,191970,50754
"5848","Ocbimv22010147m.g","LGKD01577188",7,517,510
"5849","Ocbimv22021978m.g","KQ419141",87498,121540,34042
"5850","Ocbimv22007592m.g","LGKD01557047",62,337,275
"5851","Ocbimv22036173m.g","KQ422664",43557,50350,6793
"5852","Ocbimv22027561m.g","KQ420305",79576,80208,632
"5853","Ocbimv22020394m.g","KQ418904",152853,153128,275
"5854","Ocbimv22015139m.g","KQ429168",1436,7786,6350
"5855","Ocbimv22020082m.g","KQ418849",515256,515587,331
"5856","Ocbimv22005768m.g","LGKD01541300",2,277,275
"5857","Ocbimv22019126m.g","KQ418719",2255,4521,2266
"5858","Ocbimv22013390m.g","KQ418018",1065444,1066666,1222
"5859","Ocbimv22019408m.g","KQ418760",504054,519780,15726
"5860","Ocbimv22025565m.g","KQ419844",29893,32074,2181
"5861","Ocbimv22033975m.g","KQ421934",62718,69561,6843
"5862","Ocbimv22016427m.g","KQ418351",125612,131649,6037
"5863","Ocbimv22025267m.g","KQ419753",35636,37726,2090
"5864","Ocbimv22012522m.g","KQ417917",548216,583293,35077
"5865","Ocbimv22009399m.g","KQ417591",35407,36530,1123
"5866","Ocbimv22026487m.g","KQ420055",928743,934241,5498
"5867","Ocbimv22028736m.g","KQ420566",9016,9243,227
"5868","Ocbimv22027321m.g","KQ420260",337630,339405,1775
"5869","Ocbimv22013639m.g","KQ428581",64631,74143,9512
"5870","Ocbimv22001574m.g","KQ416945",370,33912,33542
"5871","Ocbimv22027912m.g","KQ420397",244248,247062,2814
"5872","Ocbimv22002940m.g","KQ424851",214713,215045,332
"5873","Ocbimv22012872m.g","KQ417946",111178,111378,200
"5874","Ocbimv22012490m.g","KQ417917",147845,159510,11665
"5875","Ocbimv22009488m.g","KQ415865",310630,312144,1514
"5876","Ocbimv22011970m.g","KQ415895",514311,514636,325
"5877","Ocbimv22039170m.g","KQ423559",47156,48595,1439
"5878","Ocbimv22034438m.g","KQ422036",1057925,1059040,1115
"5879","Ocbimv22034107m.g","KQ421978",21125,24256,3131
"5880","Ocbimv22002650m.g","KQ417023",1533097,1533388,291
"5881","Ocbimv22006134m.g","KQ417300",599292,606613,7321
"5882","Ocbimv22014346m.g","KQ418120",461150,481663,20513
"5883","Ocbimv22026905m.g","KQ420140",69711,86123,16412
"5884","Ocbimv22001867m.g","KQ416971",516755,561370,44615
"5885","Ocbimv22026054m.g","KQ415697",241536,241709,173
"5886","Ocbimv22015322m.g","KQ418220",108902,109177,275
"5887","Ocbimv22028255m.g","KQ415659",451560,530522,78962
"5888","Ocbimv22012584m.g","KQ417917",1736724,1758400,21676
"5889","Ocbimv22014254m.g","KQ428821",136817,146478,9661
"5890","Ocbimv22032118m.g","KQ421453",127230,128413,1183
"5891","Ocbimv22020594m.g","KQ418930",269442,269612,170
"5892","Ocbimv22011059m.g","KQ417741",1012539,1040050,27511
"5893","Ocbimv22025708m.g","KQ419887",812977,814079,1102
"5894","Ocbimv22022982m.g","KQ419333",273200,273661,461
"5895","Ocbimv22006723m.g","KQ415834",245172,265567,20395
"5896","Ocbimv22016667m.g","KQ418376",307059,341996,34937
"5897","Ocbimv22032618m.g","KQ421607",373680,373990,310
"5898","Ocbimv22023685m.g","KQ433567",32,265,233
"5899","Ocbimv22013425m.g","KQ428503",35783,87257,51474
"5900","Ocbimv22005664m.g","KQ417272",13131,35858,22727
"5901","Ocbimv22015152m.g","KQ418200",504946,505560,614
"5902","Ocbimv22033560m.g","KQ421832",46386,48424,2038
"5903","Ocbimv22018670m.g","KQ430794",877,42535,41658
"5904","Ocbimv22038302m.g","KQ423274",139912,172696,32784
"5905","Ocbimv22026750m.g","KQ420109",33886,34390,504
"5906","Ocbimv22019367m.g","KQ416009",382414,382788,374
"5907","Ocbimv22032682m.g","KQ416444",185670,186958,1288
"5908","Ocbimv22000398m.g","KQ423953",505,32582,32077
"5909","Ocbimv22015119m.g","KQ418196",130597,131530,933
"5910","Ocbimv22033012m.g","KQ421718",116530,161904,45374
"5911","Ocbimv22026055m.g","KQ415697",426499,427532,1033
"5912","Ocbimv22015708m.g","LGKD01620919",151,489,338
"5913","Ocbimv22001448m.g","KQ416933",572734,582248,9514
"5914","Ocbimv22017356m.g","KQ430255",65334,88896,23562
"5915","Ocbimv22020173m.g","KQ431506",214,846,632
"5916","Ocbimv22034784m.g","KQ422172",187039,187212,173
"5917","Ocbimv22026982m.g","KQ420157",228413,229112,699
"5918","Ocbimv22034676m.g","KQ416547",16584,16811,227
"5919","Ocbimv22017612m.g","KQ430378",127929,128249,320
"5920","Ocbimv22022150m.g","KQ419176",497436,497771,335
"5921","Ocbimv22022232m.g","KQ432638",1538,2425,887
"5922","Ocbimv22005259m.g","KQ417237",295921,313409,17488
"5923","Ocbimv22010999m.g","KQ427586",196,40938,40742
"5924","Ocbimv22021898m.g","KQ419124",20062,95038,74976
"5925","Ocbimv22032710m.g","KQ421638",491297,537487,46190
"5926","Ocbimv22039061m.g","KQ423531",281538,292875,11337
"5927","Ocbimv22020374m.g","KQ418900",560756,564961,4205
"5928","Ocbimv22012686m.g","KQ417925",93407,96700,3293
"5929","Ocbimv22003367m.g","KQ424996",34684,116634,81950
"5930","Ocbimv22039206m.g","KQ423576",137184,137994,810
"5931","Ocbimv22018683m.g","KQ415684",1842159,1843342,1183
"5932","Ocbimv22006561m.g","KQ417336",95478,98305,2827
"5933","Ocbimv22028338m.g","KQ420477",6314,8085,1771
"5934","Ocbimv22006459m.g","LGKD01545850",21,338,317
"5935","Ocbimv22018367m.g","KQ418610",140375,142425,2050
"5936","Ocbimv22007262m.g","KQ417395",253815,300195,46380
"5937","Ocbimv22033025m.g","KQ421720",87961,103682,15721
"5938","Ocbimv22009741m.g","KQ417609",356417,357223,806
"5939","Ocbimv22029120m.g","KQ420660",73225,77076,3851
"5940","Ocbimv22037120m.g","KQ416673",427215,431470,4255
"5941","Ocbimv22014605m.g","KQ429000",28452,30515,2063
"5942","Ocbimv22007860m.g","KQ417455",351713,360910,9197
"5943","Ocbimv22027187m.g","KQ420215",5416,15820,10404
"5944","Ocbimv22002235m.g","KQ416997",68962,69234,272
"5945","Ocbimv22009514m.g","KQ415865",718077,718247,170
"5946","Ocbimv22037241m.g","KQ422973",37330,37578,248
"5947","Ocbimv22023968m.g","KQ419510",90807,90965,158
"5948","Ocbimv22002964m.g","KQ417051",1755131,1764530,9399
"5949","Ocbimv22004132m.g","KQ417138",491934,492173,239
"5950","Ocbimv22020328m.g","KQ418895",117133,118510,1377
"5951","Ocbimv22031324m.g","KQ421218",185276,216020,30744
"5952","Ocbimv22033771m.g","KQ421866",313309,314702,1393
"5953","Ocbimv22020569m.g","KQ418926",141162,141885,723
"5954","Ocbimv22001659m.g","KQ416951",380585,401712,21127
"5955","Ocbimv22031586m.g","LGKD01393664",51,543,492
"5956","Ocbimv22007543m.g","KQ426371",131404,136381,4977
"5957","Ocbimv22026821m.g","KQ420120",217613,221832,4219
"5958","Ocbimv22017005m.g","KQ430115",1457,5344,3887
"5959","Ocbimv22006139m.g","KQ417300",649234,649565,331
"5960","Ocbimv22005294m.g","KQ425571",191137,191478,341
"5961","Ocbimv22024115m.g","KQ416110",87864,88816,952
"5962","Ocbimv22024009m.g","KQ419520",195809,196099,290
"5963","Ocbimv22003970m.g","KQ425162",2969,19595,16626
"5964","Ocbimv22025936m.g","KQ419930",548007,619159,71152
"5965","Ocbimv22007537m.g","KQ426370",21566,22908,1342
"5966","Ocbimv22003867m.g","KQ417118",236667,237113,446
"5967","Ocbimv22027308m.g","KQ416221",107604,108404,800
"5968","Ocbimv22020805m.g","KQ416034",40343,53039,12696
"5969","Ocbimv22022952m.g","KQ433154",26187,26399,212
"5970","Ocbimv22038870m.g","KQ423480",349165,358831,9666
"5971","Ocbimv22033508m.g","KQ421821",576734,577362,628
"5972","Ocbimv22016491m.g","KQ429895",20761,22341,1580
"5973","Ocbimv22006368m.g","KQ425894",115719,132627,16908
"5974","Ocbimv22024409m.g","KQ419577",93078,93299,221
"5975","Ocbimv22037513m.g","KQ423056",77257,77562,305
"5976","Ocbimv22003434m.g","KQ417087",1001760,1003301,1541
"5977","Ocbimv22011002m.g","KQ427587",42515,42667,152
"5978","Ocbimv22014872m.g","LGKD01223534",5,235,230
"5979","Ocbimv22032358m.g","KQ421523",1516139,1522207,6068
"5980","Ocbimv22031825m.g","KQ421356",110760,146476,35716
"5981","Ocbimv22022427m.g","KQ419216",79723,82151,2428
"5982","Ocbimv22039032m.g","KQ423516",35143,53159,18016
"5983","Ocbimv22012996m.g","KQ428333",41400,124587,83187
"5984","Ocbimv22020701m.g","KQ416032",132957,238752,105795
"5985","Ocbimv22013810m.g","KQ428677",118225,120338,2113
"5986","Ocbimv22015826m.g","KQ418295",178183,179082,899
"5987","Ocbimv22018673m.g","KQ415684",241172,307452,66280
"5988","Ocbimv22011236m.g","KQ427683",2803,4793,1990
"5989","Ocbimv22039004m.g","KQ416777",53586,55062,1476
"5990","Ocbimv22016176m.g","KQ429730",168434,169945,1511
"5991","Ocbimv22026189m.g","KQ420015",183439,183660,221
"5992","Ocbimv22027358m.g","KQ420265",32933,33235,302
"5993","Ocbimv22020822m.g","KQ418970",889619,900889,11270
"5994","Ocbimv22030812m.g","KQ421092",187417,188320,903
"5995","Ocbimv22004205m.g","KQ415801",1539,41832,40293
"5996","Ocbimv22036865m.g","KQ416663",8251,8998,747
"5997","Ocbimv22024549m.g","KQ419593",101174,101944,770
"5998","Ocbimv22022542m.g","LGKD01679375",3029,3190,161
"5999","Ocbimv22018643m.g","KQ418649",395120,474774,79654
"6000","Ocbimv22030001m.g","KQ420880",21,10711,10690
"6001","Ocbimv22033519m.g","KQ421823",375499,388669,13170
"6002","Ocbimv22037951m.g","KQ423179",36362,36829,467
"6003","Ocbimv22000185m.g","KQ423889",18662,33063,14401
"6004","Ocbimv22039024m.g","KQ423513",178354,205868,27514
"6005","Ocbimv22039431m.g","KQ423659",24957,25711,754
"6006","Ocbimv22036780m.g","KQ422859",152470,183008,30538
"6007","Ocbimv22030256m.g","KQ420929",15601,15859,258
"6008","Ocbimv22003272m.g","KQ424932",360337,376468,16131
"6009","Ocbimv22010074m.g","LGKD01576546",178,408,230
"6010","Ocbimv22034266m.g","KQ422015",334347,336475,2128
"6011","Ocbimv22004554m.g","KQ425361",25062,167284,142222
"6012","Ocbimv22038434m.g","KQ423338",206063,207043,980
"6013","Ocbimv22037401m.g","KQ416694",1696682,1707973,11291
"6014","Ocbimv22028590m.g","KQ416263",25042,25278,236
"6015","Ocbimv22009918m.g","KQ417623",280,2096,1816
"6016","Ocbimv22018301m.g","KQ418598",416568,421104,4536
"6017","Ocbimv22003380m.g","KQ424999",148550,157314,8764
"6018","Ocbimv22038757m.g","KQ416765",93760,94815,1055
"6019","Ocbimv22038291m.g","KQ423260",497508,541563,44055
"6020","Ocbimv22025258m.g","KQ419750",62237,65708,3471
"6021","Ocbimv22017366m.g","KQ418485",123113,123286,173
"6022","Ocbimv22022469m.g","KQ416069",174173,174739,566
"6023","Ocbimv22015115m.g","KQ429161",55011,61608,6597
"6024","Ocbimv22039008m.g","KQ416777",204270,204598,328
"6025","Ocbimv22012264m.g","KQ417896",114910,117942,3032
"6026","Ocbimv22006633m.g","KQ426043",86662,86973,311
"6027","Ocbimv22005038m.g","KQ417226",6147,44124,37977
"6028","Ocbimv22021077m.g","KQ418998",1159122,1163004,3882
"6029","Ocbimv22026137m.g","KQ416184",62412,71407,8995
"6030","Ocbimv22020770m.g","KQ431852",14235,24895,10660
"6031","Ocbimv22003797m.g","KQ425104",353097,354101,1004
"6032","Ocbimv22023618m.g","LGKD01299215",27,128,101
"6033","Ocbimv22007080m.g","KQ417377",383741,441150,57409
"6034","Ocbimv22029596m.g","KQ420779",445504,447856,2352
"6035","Ocbimv22002105m.g","KQ416986",221089,270020,48931
"6036","Ocbimv22024956m.g","KQ419666",135226,135459,233
"6037","Ocbimv22018834m.g","KQ430896",62,526,464
"6038","Ocbimv22026891m.g","KQ420137",118392,120903,2511
"6039","Ocbimv22012302m.g","KQ428115",175226,197780,22554
"6040","Ocbimv22038107m.g","KQ423217",2027,4121,2094
"6041","Ocbimv22002715m.g","KQ424757",28474,28740,266
"6042","Ocbimv22016929m.g","KQ430089",36457,80851,44394
"6043","Ocbimv22037878m.g","KQ423141",323578,324944,1366
"6044","Ocbimv22014435m.g","KQ418134",64966,106295,41329
"6045","Ocbimv22036233m.g","KQ416626",908333,908509,176
"6046","Ocbimv22021279m.g","KQ416041",811344,864259,52915
"6047","Ocbimv22011418m.g","KQ415885",1327563,1327967,404
"6048","Ocbimv22013346m.g","LGKD01210498",59,349,290
"6049","Ocbimv22012742m.g","KQ417934",860394,912588,52194
"6050","Ocbimv22039534m.g","KQ423697",69934,95212,25278
"6051","Ocbimv22022088m.g","KQ416059",354754,355031,277
"6052","Ocbimv22019776m.g","KQ418812",304238,304504,266
"6053","Ocbimv22012262m.g","KQ417896",90556,91560,1004
"6054","Ocbimv22022217m.g","KQ416062",118062,121643,3581
"6055","Ocbimv22034630m.g","KQ422094",126195,126857,662
"6056","Ocbimv22013715m.g","KQ428621",10114,60902,50788
"6057","Ocbimv22039191m.g","KQ416784",514005,528874,14869
"6058","Ocbimv22016046m.g","KQ429675",38510,60613,22103
"6059","Ocbimv22030212m.g","KQ420924",204223,243723,39500
"6060","Ocbimv22032505m.g","KQ421565",63562,63924,362
"6061","Ocbimv22029742m.g","KQ420815",26007,27614,1607
"6062","Ocbimv22018331m.g","KQ418607",108219,109034,815
"6063","Ocbimv22025309m.g","KQ419766",212989,213189,200
"6064","Ocbimv22029967m.g","KQ420863",199847,201597,1750
"6065","Ocbimv22018814m.g","KQ418683",7832,70966,63134
"6066","Ocbimv22026310m.g","KQ420023",561376,561720,344
"6067","Ocbimv22014006m.g","KQ418075",884787,884999,212
"6068","Ocbimv22004031m.g","KQ425190",34462,38318,3856
"6069","Ocbimv22007719m.g","KQ417446",209687,211905,2218
"6070","Ocbimv22011126m.g","KQ427649",260329,260649,320
"6071","Ocbimv22037857m.g","KQ423139",864435,868557,4122
"6072","Ocbimv22027770m.g","KQ420365",235362,240784,5422
"6073","Ocbimv22024378m.g","KQ433971",6591,8908,2317
"6074","Ocbimv22032998m.g","KQ421712",582352,582948,596
"6075","Ocbimv22039154m.g","KQ423555",246949,247849,900
"6076","Ocbimv22005844m.g","KQ417280",154196,154450,254
"6077","Ocbimv22003451m.g","KQ425015",70744,84356,13612
"6078","Ocbimv22033016m.g","KQ421718",313161,361707,48546
"6079","Ocbimv22004281m.g","KQ425255",309613,311622,2009
"6080","Ocbimv22021822m.g","KQ415687",315378,329946,14568
"6081","Ocbimv22018189m.g","KQ415990",159172,165021,5849
"6082","Ocbimv22002458m.g","KQ424660",30208,30435,227
"6083","Ocbimv22007622m.g","KQ417438",581888,607145,25257
"6084","Ocbimv22013085m.g","KQ428368",99088,191665,92577
"6085","Ocbimv22021021m.g","KQ418994",88393,89907,1514
"6086","Ocbimv22031371m.g","KQ416393",326544,329098,2554
"6087","Ocbimv22002979m.g","KQ417051",2462392,2462592,200
"6088","Ocbimv22010481m.g","KQ417681",805230,819146,13916
"6089","Ocbimv22037789m.g","KQ416711",363388,365165,1777
"6090","Ocbimv22027225m.g","KQ420222",123783,124223,440
"6091","Ocbimv22016902m.g","KQ430077",1927,2961,1034
"6092","Ocbimv22021056m.g","KQ431974",23863,46175,22312
"6093","Ocbimv22022686m.g","KQ419281",523852,525264,1412
"6094","Ocbimv22028039m.g","KQ416244",159759,160777,1018
"6095","Ocbimv22031060m.g","KQ421150",83073,96274,13201
"6096","Ocbimv22038592m.g","KQ423414",10905,75507,64602
"6097","Ocbimv22016422m.g","KQ418351",14578,16119,1541
"6098","Ocbimv22001595m.g","KQ424367",35025,35390,365
"6099","Ocbimv22015592m.g","KQ415946",232350,233357,1007
"6100","Ocbimv22039567m.g","KQ423703",197995,198274,279
"6101","Ocbimv22001973m.g","KQ424508",19287,19633,346
"6102","Ocbimv22005400m.g","KQ417249",2090556,2090948,392
"6103","Ocbimv22017812m.g","KQ418549",685782,694942,9160
"6104","Ocbimv22033738m.g","KQ421864",51720,52199,479
"6105","Ocbimv22003298m.g","KQ424944",13656,14213,557
"6106","Ocbimv22026615m.g","KQ420080",175052,175291,239
"6107","Ocbimv22025160m.g","KQ419714",56792,57166,374
"6108","Ocbimv22003615m.g","KQ425044",111326,158847,47521
"6109","Ocbimv22019201m.g","KQ418733",55794,93327,37533
"6110","Ocbimv22003943m.g","KQ417128",93411,93563,152
"6111","Ocbimv22037503m.g","KQ423053",7355,26029,18674
"6112","Ocbimv22030486m.g","KQ420997",103551,104303,752
"6113","Ocbimv22022535m.g","KQ419242",1413,2091,678
"6114","Ocbimv22009088m.g","KQ426870",27806,52614,24808
"6115","Ocbimv22022987m.g","KQ419334",68859,69393,534
"6116","Ocbimv22010093m.g","KQ417641",380935,381096,161
"6117","Ocbimv22037001m.g","KQ422903",415884,433948,18064
"6118","Ocbimv22022515m.g","KQ432817",7491,7787,296
"6119","Ocbimv22003064m.g","KQ424873",108021,108263,242
"6120","Ocbimv22014486m.g","KQ428963",12388,45989,33601
"6121","Ocbimv22001320m.g","KQ424265",175851,185625,9774
"6122","Ocbimv22005047m.g","KQ425504",177905,215624,37719
"6123","Ocbimv22010261m.g","KQ415873",442239,443811,1572
"6124","Ocbimv22019228m.g","KQ418737",108,2159,2051
"6125","Ocbimv22000623m.g","KQ416870",64418,77067,12649
"6126","Ocbimv22021318m.g","KQ419029",55725,59065,3340
"6127","Ocbimv22039316m.g","KQ416788",58008,68036,10028
"6128","Ocbimv22012850m.g","KQ417945",632151,705892,73741
"6129","Ocbimv22017745m.g","KQ418537",222926,223381,455
"6130","Ocbimv22011748m.g","KQ417828",122390,131089,8699
"6131","Ocbimv22020867m.g","KQ418971",188404,223004,34600
"6132","Ocbimv22010729m.g","KQ417706",183396,183560,164
"6133","Ocbimv22004385m.g","KQ425289",25916,26086,170
"6134","Ocbimv22019159m.g","KQ431024",2539,10607,8068
"6135","Ocbimv22021320m.g","KQ419029",61369,103116,41747
"6136","Ocbimv22027711m.g","KQ420347",144369,148377,4008
"6137","Ocbimv22006087m.g","KQ417294",190455,201926,11471
"6138","Ocbimv22005940m.g","KQ417285",97477,113314,15837
"6139","Ocbimv22030981m.g","KQ421139",75121,90191,15070
"6140","Ocbimv22014465m.g","KQ428943",2597,42239,39642
"6141","Ocbimv22027722m.g","KQ420347",354172,355220,1048
"6142","Ocbimv22018625m.g","KQ430774",3965,22254,18289
"6143","Ocbimv22015260m.g","KQ418216",529093,535979,6886
"6144","Ocbimv22020573m.g","KQ418926",168479,189097,20618
"6145","Ocbimv22004905m.g","KQ417213",507184,522626,15442
"6146","Ocbimv22007038m.g","KQ417370",644801,650999,6198
"6147","Ocbimv22036671m.g","KQ422824",93567,102652,9085
"6148","Ocbimv22000789m.g","KQ424066",58310,61955,3645
"6149","Ocbimv22038349m.g","KQ416737",1347206,1347370,164
"6150","Ocbimv22034145m.g","KQ421987",68073,68606,533
"6151","Ocbimv22035796m.g","KQ422556",13048,13407,359
"6152","Ocbimv22000518m.g","KQ416865",5973,21185,15212
"6153","Ocbimv22013646m.g","KQ418042",216978,285987,69009
"6154","Ocbimv22020546m.g","LGKD01661093",70,285,215
"6155","Ocbimv22009081m.g","KQ426865",47291,59584,12293
"6156","Ocbimv22036240m.g","KQ416627",29366,29905,539
"6157","Ocbimv22006680m.g","KQ417343",51483,52396,913
"6158","Ocbimv22003991m.g","KQ425171",12725,13276,551
"6159","Ocbimv22032352m.g","KQ421523",1382549,1412905,30356
"6160","Ocbimv22006267m.g","KQ417305",612518,614092,1574
"6161","Ocbimv22011607m.g","KQ427797",71787,76746,4959
"6162","Ocbimv22000758m.g","KQ424061",106146,114979,8833
"6163","Ocbimv22032357m.g","KQ421523",1444343,1450579,6236
"6164","Ocbimv22015770m.g","KQ415676",375664,415116,39452
"6165","Ocbimv22005774m.g","KQ417278",17123,54933,37810
"6166","Ocbimv22018274m.g","KQ418590",125578,126273,695
"6167","Ocbimv22011206m.g","KQ427679",116869,118722,1853
"6168","Ocbimv22025751m.g","KQ419903",148437,148823,386
"6169","Ocbimv22013556m.g","KQ428572",20081,21338,1257
"6170","Ocbimv22039562m.g","KQ416802",589498,590069,571
"6171","Ocbimv22028911m.g","KQ416274",1703453,1710927,7474
"6172","Ocbimv22007769m.g","KQ426453",152823,153834,1011
"6173","Ocbimv22012362m.g","KQ428130",196525,210883,14358
"6174","Ocbimv22024877m.g","KQ419644",380777,381151,374
"6175","Ocbimv22020000m.g","KQ418840",1841599,1896151,54552
"6176","Ocbimv22007562m.g","KQ417429",53599,61394,7795
"6177","Ocbimv22034584m.g","KQ416537",398028,398612,584
"6178","Ocbimv22029226m.g","KQ416294",98193,98567,374
"6179","Ocbimv22022196m.g","KQ419184",114359,134040,19681
"6180","Ocbimv22004449m.g","KQ425308",140,1873,1733
"6181","Ocbimv22028771m.g","KQ420579",615199,615480,281
"6182","Ocbimv22027256m.g","KQ420237",9214,9387,173
"6183","Ocbimv22000349m.g","KQ423930",62060,83687,21627
"6184","Ocbimv22012350m.g","KQ428125",14071,21567,7496
"6185","Ocbimv22023031m.g","KQ419340",51114,53027,1913
"6186","Ocbimv22037520m.g","KQ423056",513041,513573,532
"6187","Ocbimv22023990m.g","KQ419514",562204,562976,772
"6188","Ocbimv22028251m.g","KQ415659",320203,321113,910
"6189","Ocbimv22008288m.g","KQ426610",193016,221672,28656
"6190","Ocbimv22025285m.g","KQ419759",621806,770529,148723
"6191","Ocbimv22028158m.g","KQ420439",234713,236003,1290
"6192","Ocbimv22018979m.g","KQ418705",99266,99520,254
"6193","Ocbimv22013027m.g","KQ417975",1034928,1037638,2710
"6194","Ocbimv22012529m.g","KQ417917",718552,722544,3992
"6195","Ocbimv22000057m.g","KQ423837",1,31730,31729
"6196","Ocbimv22011023m.g","KQ427597",5497,5662,165
"6197","Ocbimv22017495m.g","KQ418502",186088,187071,983
"6198","Ocbimv22018787m.g","KQ418680",10973,11185,212
"6199","Ocbimv22016458m.g","KQ418358",8439,14872,6433
"6200","Ocbimv22037363m.g","KQ423016",477651,478217,566
"6201","Ocbimv22031423m.g","KQ421241",299037,312110,13073
"6202","Ocbimv22004875m.g","KQ417211",430557,433084,2527
"6203","Ocbimv22020739m.g","KQ418957",915869,916063,194
"6204","Ocbimv22013395m.g","KQ418018",1208267,1273500,65233
"6205","Ocbimv22018992m.g","KQ418708",543413,543649,236
"6206","Ocbimv22008305m.g","KQ417496",258287,320605,62318
"6207","Ocbimv22029088m.g","KQ420643",17636,21315,3679
"6208","Ocbimv22026700m.g","KQ420095",48690,49292,602
"6209","Ocbimv22032859m.g","KQ416453",220686,234130,13444
"6210","Ocbimv22021505m.g","KQ419061",59944,103995,44051
"6211","Ocbimv22022068m.g","LGKD01674758",4,300,296
"6212","Ocbimv22000076m.g","KQ423848",21839,22147,308
"6213","Ocbimv22020225m.g","KQ431541",99152,127100,27948
"6214","Ocbimv22036957m.g","KQ416666",1795640,1796778,1138
"6215","Ocbimv22014400m.g","KQ428905",100933,109909,8976
"6216","Ocbimv22017042m.g","KQ418444",68798,70253,1455
"6217","Ocbimv22018168m.g","KQ418582",42188,49640,7452
"6218","Ocbimv22000401m.g","KQ423954",265647,266027,380
"6219","Ocbimv22039782m.g","KQ416822",153428,154476,1048
"6220","Ocbimv22024732m.g","KQ416128",789036,805160,16124
"6221","Ocbimv22035802m.g","KQ422556",326251,326837,586
"6222","Ocbimv22024755m.g","KQ419623",104291,117947,13656
"6223","Ocbimv22037621m.g","KQ415761",315138,364099,48961
"6224","Ocbimv22007179m.g","KQ426224",86206,86376,170
"6225","Ocbimv22038736m.g","KQ416764",242715,293513,50798
"6226","Ocbimv22027789m.g","KQ416233",401152,404958,3806
"6227","Ocbimv22037081m.g","KQ422919",931594,944368,12774
"6228","Ocbimv22036359m.g","KQ422722",66905,67945,1040
"6229","Ocbimv22028293m.g","KQ420462",173290,174493,1203
"6230","Ocbimv22012875m.g","KQ428260",25091,57881,32790
"6231","Ocbimv22008965m.g","KQ417544",286617,301290,14673
"6232","Ocbimv22011900m.g","KQ427949",46,1268,1222
"6233","Ocbimv22010805m.g","KQ417715",391501,392059,558
"6234","Ocbimv22017909m.g","KQ418560",185161,185325,164
"6235","Ocbimv22001583m.g","KQ416946",1234,1498,264
"6236","Ocbimv22030262m.g","KQ420932",23457,86825,63368
"6237","Ocbimv22003459m.g","KQ425015",312896,321624,8728
"6238","Ocbimv22035737m.g","KQ422521",365710,366090,380
"6239","Ocbimv22014877m.g","KQ415936",237097,257626,20529
"6240","Ocbimv22012488m.g","KQ417917",115211,126878,11667
"6241","Ocbimv22022410m.g","KQ416068",30163,43602,13439
"6242","Ocbimv22036051m.g","KQ422639",77668,78020,352
"6243","Ocbimv22012138m.g","KQ415902",389477,396642,7165
"6244","Ocbimv22021291m.g","KQ419026",28498,30513,2015
"6245","Ocbimv22024348m.g","KQ419574",362351,390777,28426
"6246","Ocbimv22003559m.g","KQ417090",1811950,1813116,1166
"6247","Ocbimv22012528m.g","KQ417917",699143,713142,13999
"6248","Ocbimv22030691m.g","KQ421067",61574,82448,20874
"6249","Ocbimv22020336m.g","LGKD01659295",539,709,170
"6250","Ocbimv22018447m.g","KQ415992",499454,571523,72069
"6251","Ocbimv22013551m.g","KQ418036",43423,78665,35242
"6252","Ocbimv22027339m.g","KQ420261",1175051,1176115,1064
"6253","Ocbimv22021607m.g","KQ432245",110046,111900,1854
"6254","Ocbimv22035881m.g","KQ422595",74795,97022,22227
"6255","Ocbimv22003452m.g","KQ425015",90717,157687,66970
"6256","Ocbimv22009169m.g","KQ415862",67778,68332,554
"6257","Ocbimv22017448m.g","KQ418497",31073,31372,299
"6258","Ocbimv22038726m.g","KQ423457",38340,38807,467
"6259","Ocbimv22017715m.g","KQ418530",173161,173451,290
"6260","Ocbimv22036570m.g","KQ422794",17526,26110,8584
"6261","Ocbimv22036117m.g","KQ416618",174064,174672,608
"6262","Ocbimv22001387m.g","KQ416930",194235,196888,2653
"6263","Ocbimv22021426m.g","KQ416045",391204,476338,85134
"6264","Ocbimv22002262m.g","KQ424593",3099,30872,27773
"6265","Ocbimv22027961m.g","KQ416242",17034,23272,6238
"6266","Ocbimv22011485m.g","KQ417795",313001,313944,943
"6267","Ocbimv22001057m.g","KQ424168",358247,362676,4429
"6268","Ocbimv22031803m.g","KQ415726",6801,7199,398
"6269","Ocbimv22002679m.g","KQ424738",41105,41762,657
"6270","Ocbimv22001462m.g","KQ416934",214732,216461,1729
"6271","Ocbimv22038697m.g","KQ423444",284733,316114,31381
"6272","Ocbimv22028132m.g","KQ416251",718607,718879,272
"6273","Ocbimv22031681m.g","KQ421308",511220,512320,1100
"6274","Ocbimv22008087m.g","KQ426561",229514,229708,194
"6275","Ocbimv22027983m.g","KQ420415",107269,112267,4998
"6276","Ocbimv22005029m.g","KQ417224",306611,334810,28199
"6277","Ocbimv22038638m.g","KQ423430",70278,71068,790
"6278","Ocbimv22000602m.g","KQ424015",425283,425602,319
"6279","Ocbimv22005683m.g","KQ417272",271243,289921,18678
"6280","Ocbimv22015696m.g","KQ429479",21660,35446,13786
"6281","Ocbimv22027557m.g","KQ420302",172946,173620,674
"6282","Ocbimv22008253m.g","KQ426605",3280,3539,259
"6283","Ocbimv22035121m.g","KQ422284",76132,78667,2535
"6284","Ocbimv22004631m.g","KQ425397",1029,196424,195395
"6285","Ocbimv22011789m.g","KQ417832",920216,920858,642
"6286","Ocbimv22020823m.g","KQ418970",1014820,1053323,38503
"6287","Ocbimv22004092m.g","KQ425196",27610,31837,4227
"6288","Ocbimv22028679m.g","KQ420551",1956,37039,35083
"6289","Ocbimv22009680m.g","KQ415866",2719,3721,1002
"6290","Ocbimv22039516m.g","KQ423680",270873,290934,20061
"6291","Ocbimv22028404m.g","KQ416257",1107480,1114243,6763
"6292","Ocbimv22016947m.g","KQ430102",204807,205100,293
"6293","Ocbimv22005128m.g","KQ415813",1148918,1149917,999
"6294","Ocbimv22028733m.g","KQ416270",1819931,1820349,418
"6295","Ocbimv22036521m.g","KQ422783",123906,125264,1358
"6296","Ocbimv22006140m.g","KQ417300",653870,655702,1832
"6297","Ocbimv22022646m.g","KQ419277",72158,72577,419
"6298","Ocbimv22039963m.g","KQ423813",25795,26001,206
"6299","Ocbimv22025357m.g","KQ419781",86149,93769,7620
"6300","Ocbimv22029298m.g","KQ420700",321040,321252,212
"6301","Ocbimv22039234m.g","KQ423591",157873,158802,929
"6302","Ocbimv22028615m.g","KQ416264",326259,326751,492
"6303","Ocbimv22006748m.g","KQ426095",222314,229913,7599
"6304","Ocbimv22028612m.g","KQ416264",314896,315471,575
"6305","Ocbimv22024362m.g","KQ419574",720770,721076,306
"6306","Ocbimv22018257m.g","KQ418587",750573,756293,5720
"6307","Ocbimv22014049m.g","KQ428735",227092,248967,21875
"6308","Ocbimv22034124m.g","KQ421984",27042,51616,24574
"6309","Ocbimv22012275m.g","KQ417898",114582,118378,3796
"6310","Ocbimv22007870m.g","KQ417455",465954,481442,15488
"6311","Ocbimv22020422m.g","LGKD01660230",622,798,176
"6312","Ocbimv22012579m.g","KQ417917",1679795,1685606,5811
"6313","Ocbimv22016779m.g","LGKD01630501",14,190,176
"6314","Ocbimv22000590m.g","KQ424015",130599,149784,19185
"6315","Ocbimv22024328m.g","LGKD01698057",62,322,260
"6316","Ocbimv22020753m.g","KQ431836",5404,15747,10343
"6317","Ocbimv22004330m.g","KQ417149",295982,296316,334
"6318","Ocbimv22011753m.g","KQ427890",821,5662,4841
"6319","Ocbimv22007000m.g","KQ417370",165230,180142,14912
"6320","Ocbimv22008042m.g","KQ417475",283145,295513,12368
"6321","Ocbimv22006035m.g","KQ417290",16356,17409,1053
"6322","Ocbimv22000560m.g","KQ423995",524539,609510,84971
"6323","Ocbimv22018093m.g","KQ418571",509924,529610,19686
"6324","Ocbimv22033108m.g","KQ416467",11800,12644,844
"6325","Ocbimv22038005m.g","KQ416719",248347,340813,92466
"6326","Ocbimv22012070m.g","KQ428000",41763,56153,14390
"6327","Ocbimv22019432m.g","KQ431127",62577,62903,326
"6328","Ocbimv22037413m.g","KQ416694",2513675,2514035,360
"6329","Ocbimv22000774m.g","KQ416879",470774,481422,10648
"6330","Ocbimv22025442m.g","KQ419801",195459,201554,6095
"6331","Ocbimv22023562m.g","KQ419432",161011,167505,6494
"6332","Ocbimv22011297m.g","KQ417777",151267,157514,6247
"6333","Ocbimv22006510m.g","KQ425966",230859,231839,980
"6334","Ocbimv22019263m.g","KQ418739",308791,315152,6361
"6335","Ocbimv22022647m.g","KQ419277",93555,108296,14741
"6336","Ocbimv22014363m.g","KQ428883",205181,217692,12511
"6337","Ocbimv22015233m.g","KQ415940",108612,109491,879
"6338","Ocbimv22006310m.g","KQ425873",80189,80449,260
"6339","Ocbimv22039552m.g","KQ416802",387017,460836,73819
"6340","Ocbimv22024006m.g","KQ419520",120286,132236,11950
"6341","Ocbimv22016836m.g","KQ418410",52284,58274,5990
"6342","Ocbimv22016166m.g","KQ429720",71728,104964,33236
"6343","Ocbimv22027402m.g","KQ416223",350590,351252,662
"6344","Ocbimv22022431m.g","KQ419216",111943,117526,5583
"6345","Ocbimv22034744m.g","KQ422141",36833,40087,3254
"6346","Ocbimv22034947m.g","KQ422223",24788,25316,528
"6347","Ocbimv22014632m.g","KQ418159",444247,474852,30605
"6348","Ocbimv22002437m.g","KQ424659",5914,6918,1004
"6349","Ocbimv22020016m.g","LGKD01655730",3,495,492
"6350","Ocbimv22024471m.g","KQ419584",83596,85932,2336
"6351","Ocbimv22012442m.g","KQ417911",1034229,1089655,55426
"6352","Ocbimv22014502m.g","KQ418144",85289,85831,542
"6353","Ocbimv22007982m.g","KQ426517",174,27699,27525
"6354","Ocbimv22035375m.g","KQ422366",2471,7089,4618
"6355","Ocbimv22032123m.g","KQ421454",40515,40991,476
"6356","Ocbimv22009374m.g","KQ417588",261028,262638,1610
"6357","Ocbimv22025370m.g","KQ416152",342447,349170,6723
"6358","Ocbimv22025126m.g","KQ419697",127355,138276,10921
"6359","Ocbimv22022083m.g","KQ419158",1905733,1905888,155
"6360","Ocbimv22000957m.g","KQ415782",429322,429849,527
"6361","Ocbimv22007435m.g","KQ417413",37511,70043,32532
"6362","Ocbimv22030919m.g","KQ421117",1840506,1842264,1758
"6363","Ocbimv22023001m.g","KQ419337",195852,211233,15381
"6364","Ocbimv22020417m.g","KQ431670",67224,74196,6972
"6365","Ocbimv22001593m.g","KQ424367",1128,26934,25806
"6366","Ocbimv22029657m.g","KQ416315",316783,330975,14192
"6367","Ocbimv22026094m.g","KQ419989",208828,228218,19390
"6368","Ocbimv22010186m.g","KQ417653",688725,714006,25281
"6369","Ocbimv22013884m.g","KQ428701",161264,168257,6993
"6370","Ocbimv22018804m.g","KQ416002",173224,175051,1827
"6371","Ocbimv22001376m.g","KQ416929",314241,314452,211
"6372","Ocbimv22007523m.g","KQ426360",119332,119520,188
"6373","Ocbimv22015424m.g","KQ429328",31956,32387,431
"6374","Ocbimv22033802m.g","KQ421873",247297,247552,255
"6375","Ocbimv22012354m.g","KQ428130",21149,21364,215
"6376","Ocbimv22016193m.g","KQ429742",39907,40425,518
"6377","Ocbimv22018844m.g","KQ416003",1019237,1019779,542
"6378","Ocbimv22009482m.g","KQ415865",7518,22940,15422
"6379","Ocbimv22009193m.g","KQ417569",84018,84793,775
"6380","Ocbimv22029649m.g","KQ420796",186988,187665,677
"6381","Ocbimv22035715m.g","KQ422521",171091,176088,4997
"6382","Ocbimv22006505m.g","KQ425963",67274,67459,185
"6383","Ocbimv22007577m.g","KQ417431",52854,91777,38923
"6384","Ocbimv22037670m.g","KQ416705",2727793,2729973,2180
"6385","Ocbimv22038193m.g","KQ423231",272533,273430,897
"6386","Ocbimv22039637m.g","KQ416810",1226566,1249818,23252
"6387","Ocbimv22023347m.g","KQ419395",131120,132289,1169
"6388","Ocbimv22035758m.g","KQ422527",187633,189842,2209
"6389","Ocbimv22024723m.g","KQ419621",883116,884953,1837
"6390","Ocbimv22010247m.g","LGKD01578210",142,541,399
"6391","Ocbimv22008755m.g","KQ426760",140176,149303,9127
"6392","Ocbimv22007803m.g","KQ417453",211158,211739,581
"6393","Ocbimv22004099m.g","KQ425202",91194,94860,3666
"6394","Ocbimv22024737m.g","KQ419622",36265,49246,12981
"6395","Ocbimv22002950m.g","KQ424852",3333,11608,8275
"6396","Ocbimv22007290m.g","KQ417399",94298,96530,2232
"6397","Ocbimv22004259m.g","KQ425245",129808,130530,722
"6398","Ocbimv22027145m.g","KQ420203",162921,164024,1103
"6399","Ocbimv22039770m.g","KQ423744",470090,470764,674
"6400","Ocbimv22033539m.g","KQ421825",111727,113426,1699
"6401","Ocbimv22011778m.g","KQ415891",1339170,1344761,5591
"6402","Ocbimv22038430m.g","KQ423338",103249,136000,32751
"6403","Ocbimv22022698m.g","KQ432958",752,22297,21545
"6404","Ocbimv22036551m.g","KQ422791",12611,17099,4488
"6405","Ocbimv22018672m.g","KQ415684",170971,171177,206
"6406","Ocbimv22000708m.g","KQ416877",318691,354914,36223
"6407","Ocbimv22037924m.g","KQ423169",161827,162269,442
"6408","Ocbimv22029898m.g","KQ416321",45504,46001,497
"6409","Ocbimv22032155m.g","KQ421461",40279,46676,6397
"6410","Ocbimv22006841m.g","KQ417358",256991,284382,27391
"6411","Ocbimv22023174m.g","KQ419367",35775,45383,9608
"6412","Ocbimv22018891m.g","KQ430918",33247,45106,11859
"6413","Ocbimv22014382m.g","KQ418125",18638,21394,2756
"6414","Ocbimv22008359m.g","KQ417498",341385,341630,245
"6415","Ocbimv22007875m.g","KQ426474",1075,32255,31180
"6416","Ocbimv22034503m.g","KQ422062",419033,456061,37028
"6417","Ocbimv22024703m.g","KQ419616",326896,382042,55146
"6418","Ocbimv22036416m.g","KQ416641",367590,402835,35245
"6419","Ocbimv22026885m.g","KQ420133",245929,263015,17086
"6420","Ocbimv22037251m.g","KQ422977",292208,292994,786
"6421","Ocbimv22034898m.g","KQ422209",81192,81895,703
"6422","Ocbimv22034708m.g","KQ416547",322431,341700,19269
"6423","Ocbimv22031105m.g","KQ416385",412328,439222,26894
"6424","Ocbimv22033314m.g","KQ421769",132211,133768,1557
"6425","Ocbimv22025140m.g","KQ419706",177311,177574,263
"6426","Ocbimv22028275m.g","KQ415659",2048013,2125288,77275
"6427","Ocbimv22028349m.g","KQ420477",168199,177897,9698
"6428","Ocbimv22023431m.g","KQ419409",254608,255397,789
"6429","Ocbimv22019244m.g","KQ418738",204224,273252,69028
"6430","Ocbimv22017728m.g","KQ418532",160217,161457,1240
"6431","Ocbimv22023824m.g","KQ419484",99981,117098,17117
"6432","Ocbimv22003305m.g","KQ417078",165981,166169,188
"6433","Ocbimv22020562m.g","KQ418926",70150,78251,8101
"6434","Ocbimv22021035m.g","LGKD01664868",3,164,161
"6435","Ocbimv22013517m.g","KQ418031",1119226,1121511,2285
"6436","Ocbimv22013358m.g","KQ428462",50211,50468,257
"6437","Ocbimv22014369m.g","KQ428883",260491,262074,1583
"6438","Ocbimv22028048m.g","KQ416244",220885,222540,1655
"6439","Ocbimv22005568m.g","KQ425655",23571,57776,34205
"6440","Ocbimv22026502m.g","KQ420059",557462,557773,311
"6441","Ocbimv22001587m.g","KQ416946",123990,125939,1949
"6442","Ocbimv22011056m.g","KQ417741",541674,542057,383
"6443","Ocbimv22017891m.g","KQ418555",73741,85824,12083
"6444","Ocbimv22036053m.g","KQ416615",28428,44689,16261
"6445","Ocbimv22007850m.g","KQ417455",166682,168132,1450
"6446","Ocbimv22014837m.g","KQ415935",8691,14692,6001
"6447","Ocbimv22019457m.g","KQ431142",43438,43869,431
"6448","Ocbimv22008010m.g","KQ415849",276454,306307,29853
"6449","Ocbimv22037469m.g","KQ415759",580851,581210,359
"6450","Ocbimv22002906m.g","KQ424815",350783,354219,3436
"6451","Ocbimv22013136m.g","KQ417985",635650,636814,1164
"6452","Ocbimv22025002m.g","KQ419680",17485,18069,584
"6453","Ocbimv22034765m.g","KQ422163",86270,86497,227
"6454","Ocbimv22026353m.g","KQ420032",264311,264547,236
"6455","Ocbimv22012051m.g","KQ427991",93908,126489,32581
"6456","Ocbimv22025446m.g","KQ419803",9099,9503,404
"6457","Ocbimv22011402m.g","KQ417791",1088499,1096955,8456
"6458","Ocbimv22024479m.g","KQ416124",284100,325505,41405
"6459","Ocbimv22027702m.g","KQ420346",198255,228864,30609
"6460","Ocbimv22031216m.g","KQ421200",334297,342834,8537
"6461","Ocbimv22036333m.g","KQ422714",20197,65987,45790
"6462","Ocbimv22005861m.g","KQ417280",297554,302434,4880
"6463","Ocbimv22016080m.g","KQ429694",41599,57629,16030
"6464","Ocbimv22039023m.g","KQ423513",170445,176997,6552
"6465","Ocbimv22005733m.g","KQ425732",33847,98557,64710
"6466","Ocbimv22024151m.g","KQ419541",17363,17674,311
"6467","Ocbimv22027654m.g","KQ420330",580869,581162,293
"6468","Ocbimv22022813m.g","KQ433029",9708,61720,52012
"6469","Ocbimv22035816m.g","KQ422558",121120,121539,419
"6470","Ocbimv22013769m.g","KQ418059",562838,564748,1910
"6471","Ocbimv22017735m.g","KQ430455",1915,16021,14106
"6472","Ocbimv22016209m.g","KQ429753",99550,116136,16586
"6473","Ocbimv22014354m.g","KQ418120",612969,624570,11601
"6474","Ocbimv22019694m.g","KQ418800",51313,53439,2126
"6475","Ocbimv22032255m.g","KQ421505",248344,249291,947
"6476","Ocbimv22035717m.g","KQ422521",202531,204933,2402
"6477","Ocbimv22021778m.g","KQ419099",41914,42429,515
"6478","Ocbimv22032264m.g","KQ421507",30946,36966,6020
"6479","Ocbimv22002583m.g","KQ424708",54458,54637,179
"6480","Ocbimv22024321m.g","KQ419568",51756,54724,2968
"6481","Ocbimv22015380m.g","KQ429304",14992,80822,65830
"6482","Ocbimv22019336m.g","KQ418751",27300,27773,473
"6483","Ocbimv22038768m.g","KQ416765",346828,384424,37596
"6484","Ocbimv22034140m.g","KQ421985",309453,309866,413
"6485","Ocbimv22022520m.g","KQ419239",650122,651073,951
"6486","Ocbimv22034958m.g","KQ422228",9008,30522,21514
"6487","Ocbimv22033630m.g","KQ421853",130815,154283,23468
"6488","Ocbimv22035304m.g","KQ422351",302692,320749,18057
"6489","Ocbimv22029286m.g","KQ420697",131406,134472,3066
"6490","Ocbimv22030172m.g","KQ420915",712328,714142,1814
"6491","Ocbimv22039487m.g","KQ423675",561783,618009,56226
"6492","Ocbimv22015209m.g","KQ429207",20856,22393,1537
"6493","Ocbimv22035793m.g","KQ422548",11563,29540,17977
"6494","Ocbimv22002274m.g","KQ424608",74186,74707,521
"6495","Ocbimv22015458m.g","KQ429360",62424,76908,14484
"6496","Ocbimv22021116m.g","KQ432015",944,6328,5384
"6497","Ocbimv22028753m.g","KQ420579",176701,224995,48294
"6498","Ocbimv22027219m.g","KQ416214",207632,209103,1471
"6499","Ocbimv22022920m.g","KQ419326",367067,422957,55890
"6500","Ocbimv22004717m.g","KQ417199",291322,350024,58702
"6501","Ocbimv22006856m.g","KQ417358",742332,743548,1216
"6502","Ocbimv22012963m.g","KQ417963",18447,19136,689
"6503","Ocbimv22027587m.g","KQ420311",80346,84502,4156
"6504","Ocbimv22001365m.g","KQ416925",310421,310795,374
"6505","Ocbimv22000678m.g","KQ424055",166775,203805,37030
"6506","Ocbimv22009386m.g","KQ426987",22623,26151,3528
"6507","Ocbimv22036906m.g","KQ422894",320102,332232,12130
"6508","Ocbimv22016314m.g","KQ418338",282236,282587,351
"6509","Ocbimv22012695m.g","KQ417927",66029,66244,215
"6510","Ocbimv22011856m.g","KQ427927",66914,86031,19117
"6511","Ocbimv22005429m.g","KQ425603",53184,53348,164
"6512","Ocbimv22017447m.g","KQ418497",24845,25427,582
"6513","Ocbimv22001766m.g","KQ416962",55083,59930,4847
"6514","Ocbimv22023497m.g","KQ419417",167979,169849,1870
"6515","Ocbimv22032654m.g","KQ421628",85784,89880,4096
"6516","Ocbimv22025577m.g","KQ419849",169590,183619,14029
"6517","Ocbimv22025424m.g","KQ419796",67262,67462,200
"6518","Ocbimv22021816m.g","KQ419108",402499,402861,362
"6519","Ocbimv22014967m.g","KQ418188",359502,369753,10251
"6520","Ocbimv22008947m.g","KQ426816",192368,194556,2188
"6521","Ocbimv22039939m.g","KQ423801",206928,208064,1136
"6522","Ocbimv22001849m.g","KQ424450",2,22608,22606
"6523","Ocbimv22005349m.g","KQ417247",128987,129193,206
"6524","Ocbimv22020817m.g","KQ418970",481046,481729,683
"6525","Ocbimv22036633m.g","KQ416651",1615810,1637115,21305
"6526","Ocbimv22007031m.g","KQ417370",605610,610546,4936
"6527","Ocbimv22038646m.g","KQ423430",716445,757318,40873
"6528","Ocbimv22032954m.g","KQ421694",68788,101240,32452
"6529","Ocbimv22019344m.g","KQ418753",27531,27746,215
"6530","Ocbimv22000516m.g","KQ423986",159101,159271,170
"6531","Ocbimv22028093m.g","KQ420429",13,514,501
"6532","Ocbimv22037635m.g","KQ423084",44098,99890,55792
"6533","Ocbimv22018052m.g","KQ430541",44376,49093,4717
"6534","Ocbimv22023131m.g","KQ419354",54365,93653,39288
"6535","Ocbimv22004681m.g","KQ417198",1470,92702,91232
"6536","Ocbimv22000497m.g","KQ415777",111598,138788,27190
"6537","Ocbimv22019949m.g","KQ418838",609064,609303,239
"6538","Ocbimv22030746m.g","KQ421083",369961,400114,30153
"6539","Ocbimv22032902m.g","KQ416458",51914,52072,158
"6540","Ocbimv22009223m.g","KQ417575",263820,274517,10697
"6541","Ocbimv22017602m.g","KQ415979",148714,149727,1013
"6542","Ocbimv22033003m.g","KQ421715",21301,21925,624
"6543","Ocbimv22036244m.g","KQ416627",220314,233242,12928
"6544","Ocbimv22037182m.g","KQ416680",748717,748995,278
"6545","Ocbimv22011599m.g","KQ427795",3581,5983,2402
"6546","Ocbimv22024330m.g","KQ419574",1367,2545,1178
"6547","Ocbimv22029887m.g","KQ420830",384217,410731,26514
"6548","Ocbimv22027922m.g","KQ420404",321545,321877,332
"6549","Ocbimv22023581m.g","KQ419435",28001,57414,29413
"6550","Ocbimv22019826m.g","KQ431332",299400,299723,323
"6551","Ocbimv22014013m.g","KQ428720",66522,108860,42338
"6552","Ocbimv22015968m.g","KQ415949",26250,88474,62224
"6553","Ocbimv22032660m.g","KQ421628",229252,254179,24927
"6554","Ocbimv22038251m.g","KQ423250",329406,329897,491
"6555","Ocbimv22012560m.g","KQ417917",1215643,1233514,17871
"6556","Ocbimv22033820m.g","KQ421885",10298,21668,11370
"6557","Ocbimv22005201m.g","KQ417232",324127,360163,36036
"6558","Ocbimv22031814m.g","KQ415726",299533,299853,320
"6559","Ocbimv22037801m.g","KQ423136",84447,85706,1259
"6560","Ocbimv22016467m.g","KQ418359",426771,427502,731
"6561","Ocbimv22000896m.g","KQ424106",155472,156077,605
"6562","Ocbimv22024640m.g","KQ419605",439192,439698,506
"6563","Ocbimv22004470m.g","KQ425325",5535,8430,2895
"6564","Ocbimv22031404m.g","KQ421232",8451,39004,30553
"6565","Ocbimv22012559m.g","KQ417917",1201978,1211846,9868
"6566","Ocbimv22037124m.g","KQ422926",14827,55267,40440
"6567","Ocbimv22034306m.g","KQ422015",1231702,1233602,1900
"6568","Ocbimv22011314m.g","KQ417780",292760,301913,9153
"6569","Ocbimv22039101m.g","KQ416779",123066,123796,730
"6570","Ocbimv22008938m.g","KQ426815",86748,88435,1687
"6571","Ocbimv22007028m.g","KQ417370",579459,583589,4130
"6572","Ocbimv22037632m.g","KQ415761",1064601,1065302,701
"6573","Ocbimv22027954m.g","KQ420409",381994,382343,349
"6574","Ocbimv22012172m.g","KQ417880",422842,423222,380
"6575","Ocbimv22007498m.g","KQ417417",150,9730,9580
"6576","Ocbimv22028492m.g","KQ420512",14702,16068,1366
"6577","Ocbimv22011347m.g","KQ427732",1249,23387,22138
"6578","Ocbimv22033488m.g","KQ421821",199596,201336,1740
"6579","Ocbimv22014201m.g","KQ428798",1816,2381,565
"6580","Ocbimv22024529m.g","KQ419593",7294,11274,3980
"6581","Ocbimv22039503m.g","KQ423680",126955,127131,176
"6582","Ocbimv22038083m.g","KQ423213",129685,130276,591
"6583","Ocbimv22020297m.g","KQ418886",235192,235362,170
"6584","Ocbimv22027233m.g","KQ420223",419106,419303,197
"6585","Ocbimv22019298m.g","KQ418743",98416,98751,335
"6586","Ocbimv22038216m.g","KQ416731",637279,642401,5122
"6587","Ocbimv22015761m.g","KQ418290",114694,114915,221
"6588","Ocbimv22034722m.g","KQ416548",334073,335728,1655
"6589","Ocbimv22008946m.g","KQ426816",191727,192266,539
"6590","Ocbimv22009261m.g","KQ417578",900592,938199,37607
"6591","Ocbimv22014757m.g","KQ418175",715104,723270,8166
"6592","Ocbimv22030543m.g","KQ421018",160465,179326,18861
"6593","Ocbimv22017545m.g","KQ430351",20653,20856,203
"6594","Ocbimv22003845m.g","KQ425130",104341,113556,9215
"6595","Ocbimv22012860m.g","KQ417945",877417,877867,450
"6596","Ocbimv22007695m.g","KQ415846",1191472,1191624,152
"6597","Ocbimv22019509m.g","KQ431173",6713,8984,2271
"6598","Ocbimv22006894m.g","KQ415836",75223,75465,242
"6599","Ocbimv22036456m.g","KQ422770",107823,114369,6546
"6600","Ocbimv22033423m.g","KQ421809",106557,106823,266
"6601","Ocbimv22002566m.g","KQ424693",2271,14946,12675
"6602","Ocbimv22039167m.g","KQ423559",3931,4813,882
"6603","Ocbimv22001842m.g","KQ416969",1135717,1136190,473
"6604","Ocbimv22034716m.g","KQ422124",4174,4395,221
"6605","Ocbimv22025214m.g","LGKD01315013",2,556,554
"6606","Ocbimv22001038m.g","KQ424157",735535,774586,39051
"6607","Ocbimv22019496m.g","KQ418776",29149,31401,2252
"6608","Ocbimv22028051m.g","KQ416245",111825,112481,656
"6609","Ocbimv22029106m.g","KQ420650",220449,222265,1816
"6610","Ocbimv22007402m.g","KQ417411",68758,109189,40431
"6611","Ocbimv22019728m.g","KQ431280",149666,150633,967
"6612","Ocbimv22025589m.g","KQ419857",118455,168429,49974
"6613","Ocbimv22030882m.g","KQ421116",212305,214361,2056
"6614","Ocbimv22027783m.g","KQ420370",642340,663258,20918
"6615","Ocbimv22035706m.g","KQ416599",96393,96778,385
"6616","Ocbimv22021961m.g","KQ432471",89018,89242,224
"6617","Ocbimv22026395m.g","KQ420036",29747,61880,32133
"6618","Ocbimv22014566m.g","KQ428991",2518,3249,731
"6619","Ocbimv22033692m.g","KQ416491",320279,338343,18064
"6620","Ocbimv22009491m.g","KQ415865",389315,390013,698
"6621","Ocbimv22017165m.g","KQ415974",188628,194378,5750
"6622","Ocbimv22000829m.g","KQ424085",143004,143482,478
"6623","Ocbimv22003825m.g","KQ425124",16,764,748
"6624","Ocbimv22023725m.g","KQ416095",18100,65140,47040
"6625","Ocbimv22009002m.g","KQ417549",279996,338057,58061
"6626","Ocbimv22007959m.g","KQ426505",64995,88355,23360
"6627","Ocbimv22037243m.g","KQ422973",39005,39588,583
"6628","Ocbimv22014361m.g","KQ428883",49214,161264,112050
"6629","Ocbimv22008437m.g","KQ426638",1797,20078,18281
"6630","Ocbimv22023384m.g","KQ433349",28682,30492,1810
"6631","Ocbimv22001708m.g","KQ424391",1165,8590,7425
"6632","Ocbimv22010117m.g","KQ427263",633716,634357,641
"6633","Ocbimv22025003m.g","KQ419680",19995,21972,1977
"6634","Ocbimv22012232m.g","KQ417892",99775,145575,45800
"6635","Ocbimv22000159m.g","KQ423878",4207,22349,18142
"6636","Ocbimv22038565m.g","KQ423405",18755,21123,2368
"6637","Ocbimv22028587m.g","KQ416263",17655,20352,2697
"6638","Ocbimv22027135m.g","KQ420199",159,20975,20816
"6639","Ocbimv22012493m.g","KQ417917",174527,203364,28837
"6640","Ocbimv22018659m.g","KQ418651",165151,180235,15084
"6641","Ocbimv22031280m.g","KQ421217",53838,57594,3756
"6642","Ocbimv22003421m.g","KQ425007",175299,175583,284
"6643","Ocbimv22026693m.g","KQ416197",96575,103982,7407
"6644","Ocbimv22003801m.g","KQ425111",12071,12475,404
"6645","Ocbimv22031984m.g","KQ421395",14739,15350,611
"6646","Ocbimv22012596m.g","KQ428185",89074,90446,1372
"6647","Ocbimv22017368m.g","KQ418486",35655,37509,1854
"6648","Ocbimv22026095m.g","KQ419989",236365,236720,355
"6649","Ocbimv22032210m.g","KQ416425",632154,632550,396
"6650","Ocbimv22031118m.g","KQ421170",543606,543998,392
"6651","Ocbimv22004053m.g","KQ425191",3078,3389,311
"6652","Ocbimv22016991m.g","KQ418431",870286,890478,20192
"6653","Ocbimv22015636m.g","KQ418269",1171155,1202332,31177
"6654","Ocbimv22020189m.g","KQ418873",62070,62381,311
"6655","Ocbimv22011202m.g","KQ417762",127467,128195,728
"6656","Ocbimv22012918m.g","KQ417953",389565,415223,25658
"6657","Ocbimv22037681m.g","KQ423100",125065,178102,53037
"6658","Ocbimv22011691m.g","LGKD01589326",42,194,152
"6659","Ocbimv22013829m.g","KQ418064",20253,21164,911
"6660","Ocbimv22029902m.g","KQ420841",26387,45620,19233
"6661","Ocbimv22016372m.g","KQ415962",987596,987836,240
"6662","Ocbimv22022419m.g","KQ419216",8874,10697,1823
"6663","Ocbimv22036327m.g","KQ415755",182795,196331,13536
"6664","Ocbimv22031569m.g","KQ421281",239840,240136,296
"6665","Ocbimv22030259m.g","KQ420929",77320,77930,610
"6666","Ocbimv22029262m.g","KQ420695",436415,444832,8417
"6667","Ocbimv22024263m.g","KQ419558",63152,63918,766
"6668","Ocbimv22001646m.g","KQ416950",1982743,1991624,8881
"6669","Ocbimv22018279m.g","KQ418590",391484,433291,41807
"6670","Ocbimv22033795m.g","KQ421873",21688,84196,62508
"6671","Ocbimv22037481m.g","KQ423045",32720,106293,73573
"6672","Ocbimv22026423m.g","KQ420047",375738,376577,839
"6673","Ocbimv22003077m.g","KQ424877",253528,260760,7232
"6674","Ocbimv22024081m.g","KQ419533",304081,308060,3979
"6675","Ocbimv22000853m.g","KQ424093",881109,898371,17262
"6676","Ocbimv22020936m.g","KQ418980",104815,104994,179
"6677","Ocbimv22004909m.g","KQ417213",618496,625863,7367
"6678","Ocbimv22032704m.g","KQ421638",133762,134040,278
"6679","Ocbimv22007628m.g","KQ415845",27932,28850,918
"6680","Ocbimv22032278m.g","KQ421510",41721,42258,537
"6681","Ocbimv22022390m.g","KQ419215",47994,49823,1829
"6682","Ocbimv22024514m.g","KQ416125",45850,46221,371
"6683","Ocbimv22031792m.g","KQ416408",74724,76952,2228
"6684","Ocbimv22026977m.g","KQ420157",106292,107175,883
"6685","Ocbimv22032250m.g","KQ421502",173122,173820,698
"6686","Ocbimv22036548m.g","KQ416644",641965,643171,1206
"6687","Ocbimv22039022m.g","KQ423513",98269,151154,52885
"6688","Ocbimv22015948m.g","KQ418303",1573644,1591105,17461
"6689","Ocbimv22014848m.g","KQ415935",212445,250676,38231
"6690","Ocbimv22004678m.g","KQ425419",20490,20690,200
"6691","Ocbimv22035526m.g","KQ422420",31326,117082,85756
"6692","Ocbimv22038070m.g","KQ416724",393872,394499,627
"6693","Ocbimv22004642m.g","KQ417191",36556,52612,16056
"6694","Ocbimv22021286m.g","KQ419024",151698,152027,329
"6695","Ocbimv22019376m.g","KQ418758",142108,144161,2053
"6696","Ocbimv22013762m.g","KQ418059",274199,279797,5598
"6697","Ocbimv22014528m.g","KQ428978",14325,16538,2213
"6698","Ocbimv22032699m.g","KQ421638",35521,36676,1155
"6699","Ocbimv22014623m.g","KQ429015",11539,26914,15375
"6700","Ocbimv22003235m.g","KQ424913",116748,120065,3317
"6701","Ocbimv22006071m.g","KQ425805",590325,590567,242
"6702","Ocbimv22004891m.g","KQ425467",9670,13723,4053
"6703","Ocbimv22002584m.g","KQ424708",110959,198246,87287
"6704","Ocbimv22015823m.g","KQ418295",159889,161552,1663
"6705","Ocbimv22021789m.g","KQ419102",137849,184900,47051
"6706","Ocbimv22014821m.g","KQ429096",477903,486310,8407
"6707","Ocbimv22017003m.g","KQ418431",1036315,1066631,30316
"6708","Ocbimv22018194m.g","KQ415990",614585,615109,524
"6709","Ocbimv22017573m.g","KQ418507",4253,14660,10407
"6710","Ocbimv22019497m.g","KQ418776",99980,100404,424
"6711","Ocbimv22039716m.g","KQ416816",72445,72954,509
"6712","Ocbimv22019184m.g","KQ418729",489954,490148,194
"6713","Ocbimv22031788m.g","KQ421346",194195,209895,15700
"6714","Ocbimv22009511m.g","KQ415865",682894,691765,8871
"6715","Ocbimv22027743m.g","KQ420356",8196,8667,471
"6716","Ocbimv22031478m.g","KQ416400",60784,149598,88814
"6717","Ocbimv22004671m.g","KQ417195",196825,218084,21259
"6718","Ocbimv22037185m.g","KQ416681",95618,98205,2587
"6719","Ocbimv22000615m.g","KQ416869",15764,48234,32470
"6720","Ocbimv22000192m.g","KQ423889",111315,132001,20686
"6721","Ocbimv22028345m.g","KQ420477",52189,62351,10162
"6722","Ocbimv22027518m.g","KQ420297",180372,181383,1011
"6723","Ocbimv22002941m.g","KQ424851",251097,268948,17851
"6724","Ocbimv22014419m.g","KQ428909",33249,33500,251
"6725","Ocbimv22030566m.g","KQ421022",406610,406780,170
"6726","Ocbimv22002853m.g","KQ424805",399,8696,8297
"6727","Ocbimv22028190m.g","KQ420442",43517,47552,4035
"6728","Ocbimv22018172m.g","KQ430593",23546,33000,9454
"6729","Ocbimv22013788m.g","KQ428671",22334,22639,305
"6730","Ocbimv22006908m.g","KQ426140",72944,73864,920
"6731","Ocbimv22038412m.g","KQ423329",24357,31586,7229
"6732","Ocbimv22038322m.g","KQ416736",110369,110743,374
"6733","Ocbimv22023032m.g","KQ419340",126027,126299,272
"6734","Ocbimv22012998m.g","KQ428334",5793,22053,16260
"6735","Ocbimv22018390m.g","KQ430678",30290,51280,20990
"6736","Ocbimv22018630m.g","LGKD01644552",11,157,146
"6737","Ocbimv22004048m.g","KQ425190",126648,127511,863
"6738","Ocbimv22009205m.g","KQ417574",36875,37054,179
"6739","Ocbimv22001797m.g","KQ424420",340993,342658,1665
"6740","Ocbimv22037602m.g","KQ423077",668834,675292,6458
"6741","Ocbimv22006470m.g","KQ417324",615953,616393,440
"6742","Ocbimv22020135m.g","KQ418859",245622,295487,49865
"6743","Ocbimv22010553m.g","KQ417691",229922,243042,13120
"6744","Ocbimv22005508m.g","KQ417258",109,7490,7381
"6745","Ocbimv22031791m.g","KQ416408",48287,51864,3577
"6746","Ocbimv22023452m.g","KQ419414",330442,332530,2088
"6747","Ocbimv22031796m.g","KQ421349",59143,59310,167
"6748","Ocbimv22024768m.g","KQ419625",102318,140977,38659
"6749","Ocbimv22030481m.g","KQ420994",2075,15672,13597
"6750","Ocbimv22035206m.g","KQ422311",23311,23490,179
"6751","Ocbimv22038153m.g","KQ423220",435347,441614,6267
"6752","Ocbimv22026231m.g","KQ420017",895168,904560,9392
"6753","Ocbimv22023854m.g","KQ416102",106586,106921,335
"6754","Ocbimv22036222m.g","KQ416626",267258,273552,6294
"6755","Ocbimv22033917m.g","KQ421906",555749,557105,1356
"6756","Ocbimv22035172m.g","KQ422294",13490,13735,245
"6757","Ocbimv22018262m.g","KQ430613",14648,23831,9183
"6758","Ocbimv22001735m.g","KQ416958",128426,129135,709
"6759","Ocbimv22012737m.g","KQ417934",106743,110755,4012
"6760","Ocbimv22037173m.g","KQ422952",7081,7535,454
"6761","Ocbimv22015553m.g","KQ429416",196310,197074,764
"6762","Ocbimv22039789m.g","KQ416823",154502,154666,164
"6763","Ocbimv22028689m.g","KQ420555",112943,143933,30990
"6764","Ocbimv22014531m.g","LGKD01610597",895,1755,860
"6765","Ocbimv22017267m.g","KQ430232",119065,132693,13628
"6766","Ocbimv22035165m.g","KQ422291",305201,309683,4482
"6767","Ocbimv22019456m.g","KQ431142",3384,4946,1562
"6768","Ocbimv22019223m.g","KQ431061",4668,5240,572
"6769","Ocbimv22005287m.g","KQ425571",1561,5097,3536
"6770","Ocbimv22023255m.g","KQ419380",542158,543299,1141
"6771","Ocbimv22022131m.g","KQ419175",450700,478931,28231
"6772","Ocbimv22009916m.g","KQ427158",61078,94360,33282
"6773","Ocbimv22030880m.g","KQ421116",195961,200032,4071
"6774","Ocbimv22028159m.g","KQ420439",236237,236673,436
"6775","Ocbimv22022121m.g","KQ419175",168105,169328,1223
"6776","Ocbimv22012830m.g","KQ428255",106514,113554,7040
"6777","Ocbimv22017222m.g","KQ418469",82044,83621,1577
"6778","Ocbimv22025465m.g","KQ419808",86326,99706,13380
"6779","Ocbimv22036861m.g","KQ416662",738492,776040,37548
"6780","Ocbimv22035620m.g","KQ422475",108341,108784,443
"6781","Ocbimv22018199m.g","KQ415990",1159093,1159795,702
"6782","Ocbimv22028611m.g","KQ420533",1549,1863,314
"6783","Ocbimv22011736m.g","KQ427886",6563,12249,5686
"6784","Ocbimv22011395m.g","KQ417791",976563,1008430,31867
"6785","Ocbimv22034530m.g","KQ422073",126364,143318,16954
"6786","Ocbimv22012796m.g","KQ415910",144081,144445,364
"6787","Ocbimv22010667m.g","KQ427465",4529,13476,8947
"6788","Ocbimv22021781m.g","KQ419101",11358,12256,898
"6789","Ocbimv22033307m.g","KQ421769",96059,97309,1250
"6790","Ocbimv22015313m.g","KQ418219",129009,131168,2159
"6791","Ocbimv22011256m.g","KQ417771",375515,376755,1240
"6792","Ocbimv22006746m.g","KQ426095",185500,219423,33923
"6793","Ocbimv22028460m.g","KQ416258",106860,108761,1901
"6794","Ocbimv22019516m.g","LGKD01651627",320,481,161
"6795","Ocbimv22001530m.g","KQ424349",72556,107696,35140
"6796","Ocbimv22025089m.g","KQ416137",450844,453069,2225
"6797","Ocbimv22018801m.g","KQ416002",70038,73850,3812
"6798","Ocbimv22018845m.g","KQ416003",1089639,1091826,2187
"6799","Ocbimv22039964m.g","KQ423813",71509,75496,3987
"6800","Ocbimv22002833m.g","KQ417040",236988,240638,3650
"6801","Ocbimv22007194m.g","KQ417391",36092,40639,4547
"6802","Ocbimv22006124m.g","KQ417300",141899,143432,1533
"6803","Ocbimv22022596m.g","KQ419269",43649,44368,719
"6804","Ocbimv22031867m.g","KQ421365",60421,60798,377
"6805","Ocbimv22004856m.g","KQ415809",300158,360716,60558
"6806","Ocbimv22001709m.g","KQ424391",21365,24839,3474
"6807","Ocbimv22007725m.g","KQ417446",334460,342068,7608
"6808","Ocbimv22020508m.g","KQ418919",724668,726813,2145
"6809","Ocbimv22039415m.g","KQ423652",7285,121594,114309
"6810","Ocbimv22016211m.g","KQ429753",129570,130128,558
"6811","Ocbimv22038220m.g","KQ416731",660825,664088,3263
"6812","Ocbimv22021732m.g","KQ419092",110062,151598,41536
"6813","Ocbimv22034987m.g","KQ422234",34675,35736,1061
"6814","Ocbimv22010197m.g","KQ417655",134873,135145,272
"6815","Ocbimv22035026m.g","KQ416568",1070850,1071377,527
"6816","Ocbimv22028230m.g","KQ416253",15942,16148,206
"6817","Ocbimv22022563m.g","KQ432866",79064,121130,42066
"6818","Ocbimv22013413m.g","KQ418021",78189,95834,17645
"6819","Ocbimv22013725m.g","LGKD01603680",148,381,233
"6820","Ocbimv22018389m.g","KQ430678",2181,2636,455
"6821","Ocbimv22029457m.g","KQ420753",113452,120673,7221
"6822","Ocbimv22018285m.g","KQ430627",9819,10296,477
"6823","Ocbimv22025106m.g","KQ419694",95055,112248,17193
"6824","Ocbimv22035500m.g","KQ422411",199010,202840,3830
"6825","Ocbimv22026509m.g","KQ420060",33103,33865,762
"6826","Ocbimv22008457m.g","KQ415854",353840,354819,979
"6827","Ocbimv22002491m.g","KQ424671",257485,286588,29103
"6828","Ocbimv22004928m.g","KQ425475",4651,4830,179
"6829","Ocbimv22002464m.g","KQ424662",42799,43314,515
"6830","Ocbimv22013104m.g","KQ417982",94574,165411,70837
"6831","Ocbimv22002829m.g","KQ417040",139181,198927,59746
"6832","Ocbimv22004669m.g","KQ425412",288968,289126,158
"6833","Ocbimv22017435m.g","KQ418496",32032,34802,2770
"6834","Ocbimv22027380m.g","KQ420268",323314,324786,1472
"6835","Ocbimv22006078m.g","KQ417294",62886,74329,11443
"6836","Ocbimv22012443m.g","KQ417911",1074249,1078824,4575
"6837","Ocbimv22015217m.g","KQ429209",71635,72412,777
"6838","Ocbimv22037000m.g","KQ422903",286373,316552,30179
"6839","Ocbimv22005742m.g","KQ425732",227362,228750,1388
"6840","Ocbimv22016593m.g","KQ418368",811115,833779,22664
"6841","Ocbimv22023652m.g","KQ433556",12414,12641,227
"6842","Ocbimv22035341m.g","KQ422362",147715,147990,275
"6843","Ocbimv22037580m.g","KQ415760",190,2008,1818
"6844","Ocbimv22039011m.g","KQ416777",266326,363947,97621
"6845","Ocbimv22017739m.g","KQ418536",20666,23209,2543
"6846","Ocbimv22005713m.g","KQ425728",15973,18107,2134
"6847","Ocbimv22034759m.g","LGKD01431676",2,244,242
"6848","Ocbimv22001398m.g","KQ416930",534800,535129,329
"6849","Ocbimv22001087m.g","KQ416908",587143,588888,1745
"6850","Ocbimv22001076m.g","KQ424172",133374,191034,57660
"6851","Ocbimv22000231m.g","KQ423903",84861,90906,6045
"6852","Ocbimv22002986m.g","KQ424856",162564,162722,158
"6853","Ocbimv22033377m.g","KQ416479",302310,319397,17087
"6854","Ocbimv22006798m.g","KQ417350",272,18382,18110
"6855","Ocbimv22015503m.g","KQ418263",911231,911476,245
"6856","Ocbimv22022651m.g","KQ419277",148868,154979,6111
"6857","Ocbimv22036134m.g","KQ416620",57670,102404,44734
"6858","Ocbimv22019499m.g","KQ416013",1694,6354,4660
"6859","Ocbimv22022346m.g","KQ419202",169833,171385,1552
"6860","Ocbimv22023275m.g","KQ419390",177670,202309,24639
"6861","Ocbimv22028774m.g","KQ420579",746437,751161,4724
"6862","Ocbimv22036220m.g","KQ416626",181110,244465,63355
"6863","Ocbimv22038170m.g","KQ423223",233151,233660,509
"6864","Ocbimv22035590m.g","KQ422450",28764,28992,228
"6865","Ocbimv22014496m.g","KQ418142",146249,168065,21816
"6866","Ocbimv22033600m.g","KQ421843",138352,139269,917
"6867","Ocbimv22008251m.g","KQ426603",1347,14424,13077
"6868","Ocbimv22004371m.g","KQ415803",570283,576885,6602
"6869","Ocbimv22030154m.g","KQ420911",614,20476,19862
"6870","Ocbimv22006930m.g","KQ426154",131682,132700,1018
"6871","Ocbimv22015574m.g","KQ418267",617304,671041,53737
"6872","Ocbimv22012215m.g","KQ415904",423363,425644,2281
"6873","Ocbimv22034934m.g","KQ416562",349950,350180,230
"6874","Ocbimv22037134m.g","KQ422938",67571,89514,21943
"6875","Ocbimv22033063m.g","KQ421721",706550,733955,27405
"6876","Ocbimv22032147m.g","KQ421460",214000,219202,5202
"6877","Ocbimv22024516m.g","KQ416125",301230,301427,197
"6878","Ocbimv22038031m.g","KQ423199",28,1137,1109
"6879","Ocbimv22037106m.g","KQ422923",144846,145082,236
"6880","Ocbimv22013220m.g","KQ418002",362367,373223,10856
"6881","Ocbimv22028856m.g","KQ420593",327693,328049,356
"6882","Ocbimv22013314m.g","LGKD01600511",105,308,203
"6883","Ocbimv22014094m.g","KQ418088",136536,137087,551
"6884","Ocbimv22001099m.g","KQ424180",111446,111838,392
"6885","Ocbimv22009078m.g","KQ426863",12221,12684,463
"6886","Ocbimv22032576m.g","KQ421600",32136,32432,296
"6887","Ocbimv22030337m.g","KQ420952",124428,125186,758
"6888","Ocbimv22017803m.g","KQ418549",43828,76078,32250
"6889","Ocbimv22004016m.g","KQ425188",154967,155269,302
"6890","Ocbimv22004798m.g","KQ417208",119800,120542,742
"6891","Ocbimv22022407m.g","KQ416068",89,9326,9237
"6892","Ocbimv22011026m.g","KQ427597",66689,67363,674
"6893","Ocbimv22026940m.g","KQ420146",217631,219120,1489
"6894","Ocbimv22008312m.g","KQ426613",86407,103715,17308
"6895","Ocbimv22036198m.g","KQ416625",146214,146417,203
"6896","Ocbimv22032012m.g","KQ421409",1067160,1095599,28439
"6897","Ocbimv22009850m.g","KQ417620",842428,847275,4847
"6898","Ocbimv22031486m.g","KQ421261",31838,70126,38288
"6899","Ocbimv22034747m.g","KQ422141",85136,85992,856
"6900","Ocbimv22017636m.g","KQ418520",123212,123544,332
"6901","Ocbimv22011952m.g","KQ417847",1235502,1236519,1017
"6902","Ocbimv22026959m.g","KQ420153",23665,34463,10798
"6903","Ocbimv22025166m.g","KQ416141",441346,441534,188
"6904","Ocbimv22028620m.g","KQ416264",863042,897594,34552
"6905","Ocbimv22002647m.g","KQ417023",1453561,1455128,1567
"6906","Ocbimv22018996m.g","KQ418708",704660,705297,637
"6907","Ocbimv22034845m.g","KQ422191",104139,122885,18746
"6908","Ocbimv22004463m.g","KQ425323",5303,5479,176
"6909","Ocbimv22036472m.g","KQ416642",69512,69664,152
"6910","Ocbimv22000311m.g","KQ415776",61332,61490,158
"6911","Ocbimv22025812m.g","KQ419908",72248,73069,821
"6912","Ocbimv22022828m.g","KQ419305",90560,99338,8778
"6913","Ocbimv22018652m.g","KQ430782",4357,14001,9644
"6914","Ocbimv22027788m.g","KQ416233",355432,356026,594
"6915","Ocbimv22003028m.g","KQ417055",1178348,1180102,1754
"6916","Ocbimv22033247m.g","KQ421758",1319183,1369805,50622
"6917","Ocbimv22012841m.g","KQ417945",451205,498333,47128
"6918","Ocbimv22027683m.g","KQ420338",45578,52907,7329
"6919","Ocbimv22029308m.g","KQ420704",365,649,284
"6920","Ocbimv22006384m.g","KQ417316",428800,429276,476
"6921","Ocbimv22011305m.g","KQ417779",10854,11297,443
"6922","Ocbimv22035507m.g","KQ422411",533781,535190,1409
"6923","Ocbimv22013712m.g","KQ418051",319712,323603,3891
"6924","Ocbimv22008838m.g","KQ417537",161747,165061,3314
"6925","Ocbimv22002695m.g","KQ424745",83769,85945,2176
"6926","Ocbimv22030014m.g","KQ416330",133767,148611,14844
"6927","Ocbimv22008250m.g","KQ426602",179872,180219,347
"6928","Ocbimv22003003m.g","KQ424863",295376,313396,18020
"6929","Ocbimv22037078m.g","KQ422919",794360,848942,54582
"6930","Ocbimv22025934m.g","KQ419930",529539,530775,1236
"6931","Ocbimv22022353m.g","KQ416066",104818,105483,665
"6932","Ocbimv22027495m.g","KQ416226",84706,86427,1721
"6933","Ocbimv22038747m.g","KQ416765",37930,72921,34991
"6934","Ocbimv22016000m.g","KQ418309",207847,209022,1175
"6935","Ocbimv22032931m.g","KQ421685",197694,197985,291
"6936","Ocbimv22026081m.g","KQ419989",112614,121066,8452
"6937","Ocbimv22010778m.g","KQ427517",5669,51578,45909
"6938","Ocbimv22023368m.g","KQ419395",273432,278122,4690
"6939","Ocbimv22010594m.g","KQ427450",2736,3726,990
"6940","Ocbimv22037233m.g","KQ422973",18580,20070,1490
"6941","Ocbimv22012992m.g","KQ428332",25771,28969,3198
"6942","Ocbimv22034594m.g","KQ422081",364098,364327,229
"6943","Ocbimv22031663m.g","KQ421308",135,620,485
"6944","Ocbimv22015546m.g","KQ429413",8558,8977,419
"6945","Ocbimv22021254m.g","KQ419020",201108,203462,2354
"6946","Ocbimv22024526m.g","KQ434034",39479,44132,4653
"6947","Ocbimv22023078m.g","KQ419344",92296,164969,72673
"6948","Ocbimv22009066m.g","KQ417558",15994,17160,1166
"6949","Ocbimv22010374m.g","KQ415876",405261,406792,1531
"6950","Ocbimv22028362m.g","KQ420477",415894,422479,6585
"6951","Ocbimv22016429m.g","KQ418351",343891,344595,704
"6952","Ocbimv22005168m.g","KQ425537",210520,212601,2081
"6953","Ocbimv22018497m.g","LGKD01250489",8353,9889,1536
"6954","Ocbimv22034126m.g","KQ421984",78209,97616,19407
"6955","Ocbimv22001480m.g","KQ415785",163845,164189,344
"6956","Ocbimv22018060m.g","KQ418561",159581,159946,365
"6957","Ocbimv22029656m.g","KQ416315",167607,167921,314
"6958","Ocbimv22002044m.g","KQ424530",138164,139390,1226
"6959","Ocbimv22026715m.g","KQ420099",7069,47534,40465
"6960","Ocbimv22034064m.g","KQ416508",848088,887792,39704
"6961","Ocbimv22001982m.g","KQ415787",1055882,1056088,206
"6962","Ocbimv22024862m.g","KQ419643",285596,285817,221
"6963","Ocbimv22039209m.g","KQ423576",318518,343960,25442
"6964","Ocbimv22038030m.g","KQ416719",1123554,1133688,10134
"6965","Ocbimv22012048m.g","KQ427991",11923,57349,45426
"6966","Ocbimv22037950m.g","KQ423179",15538,16743,1205
"6967","Ocbimv22010823m.g","KQ427527",142242,163756,21514
"6968","Ocbimv22034872m.g","KQ422198",115453,115605,152
"6969","Ocbimv22020986m.g","KQ418989",9804,11971,2167
"6970","Ocbimv22013542m.g","KQ418034",69851,71396,1545
"6971","Ocbimv22034441m.g","KQ422039",97815,98009,194
"6972","Ocbimv22027782m.g","KQ420370",254103,254636,533
"6973","Ocbimv22038869m.g","KQ423480",326714,341793,15079
"6974","Ocbimv22034340m.g","KQ422016",249196,276843,27647
"6975","Ocbimv22013210m.g","KQ418002",241250,243926,2676
"6976","Ocbimv22036518m.g","KQ422783",103875,107300,3425
"6977","Ocbimv22031949m.g","KQ421389",77160,104191,27031
"6978","Ocbimv22026740m.g","KQ416198",350277,350532,255
"6979","Ocbimv22002957m.g","KQ424852",226161,229039,2878
"6980","Ocbimv22014943m.g","KQ429139",428681,434644,5963
"6981","Ocbimv22037949m.g","KQ423179",14944,15415,471
"6982","Ocbimv22011271m.g","KQ417771",1657048,1668175,11127
"6983","Ocbimv22019897m.g","KQ418832",639025,640473,1448
"6984","Ocbimv22013714m.g","LGKD01603582",117,503,386
"6985","Ocbimv22006407m.g","KQ425905",2362,30520,28158
"6986","Ocbimv22024242m.g","KQ433876",128553,130388,1835
"6987","Ocbimv22004957m.g","KQ425479",5169,5707,538
"6988","Ocbimv22007626m.g","KQ415845",14944,32877,17933
"6989","Ocbimv22028314m.g","KQ420471",110840,122384,11544
"6990","Ocbimv22020705m.g","KQ416032",228469,228717,248
"6991","Ocbimv22037675m.g","KQ423093",12347,14295,1948
"6992","Ocbimv22028126m.g","KQ416251",240440,295182,54742
"6993","Ocbimv22020200m.g","KQ418873",377747,391289,13542
"6994","Ocbimv22013493m.g","KQ418029",403642,493252,89610
"6995","Ocbimv22019131m.g","KQ418719",94474,96730,2256
"6996","Ocbimv22031398m.g","KQ416395",206629,240605,33976
"6997","Ocbimv22032421m.g","KQ421533",466858,480800,13942
"6998","Ocbimv22022026m.g","KQ419149",159396,246891,87495
"6999","Ocbimv22027917m.g","KQ420404",223521,224680,1159
"7000","Ocbimv22003673m.g","KQ417100",515520,542990,27470
"7001","Ocbimv22032783m.g","KQ421658",300376,300630,254
"7002","Ocbimv22002918m.g","KQ424834",10334,10645,311
"7003","Ocbimv22002617m.g","KQ417023",480031,480703,672
"7004","Ocbimv22003085m.g","KQ424877",456934,490884,33950
"7005","Ocbimv22008919m.g","KQ426806",95855,118346,22491
"7006","Ocbimv22010252m.g","KQ415873",146392,167313,20921
"7007","Ocbimv22039425m.g","KQ423655",46174,88143,41969
"7008","Ocbimv22009562m.g","KQ427019",30877,31078,201
"7009","Ocbimv22005687m.g","KQ417273",6295,12518,6223
"7010","Ocbimv22022843m.g","KQ416076",147141,182901,35760
"7011","Ocbimv22030232m.g","KQ420925",34183,38996,4813
"7012","Ocbimv22001510m.g","KQ424337",331222,344112,12890
"7013","Ocbimv22030893m.g","KQ421117",493344,494134,790
"7014","Ocbimv22026068m.g","KQ419981",112045,125113,13068
"7015","Ocbimv22003110m.g","KQ417059",17600,18028,428
"7016","Ocbimv22027774m.g","LGKD01349765",1,551,550
"7017","Ocbimv22007253m.g","KQ426265",51131,52687,1556
"7018","Ocbimv22025162m.g","KQ416140",56681,58799,2118
"7019","Ocbimv22017688m.g","KQ430417",109772,110169,397
"7020","Ocbimv22002656m.g","KQ417023",1622042,1622939,897
"7021","Ocbimv22031302m.g","KQ421217",493712,494083,371
"7022","Ocbimv22011616m.g","KQ417811",282,1561,1279
"7023","Ocbimv22033981m.g","KQ421935",35026,35766,740
"7024","Ocbimv22030005m.g","KQ420882",25294,28561,3267
"7025","Ocbimv22025909m.g","KQ419924",44200,150619,106419
"7026","Ocbimv22008285m.g","KQ426610",1318,29597,28279
"7027","Ocbimv22035016m.g","KQ416568",13,1215,1202
"7028","Ocbimv22000063m.g","KQ423839",245235,304672,59437
"7029","Ocbimv22028708m.g","KQ420562",119595,120270,675
"7030","Ocbimv22020243m.g","KQ431554",32784,50048,17264
"7031","Ocbimv22018835m.g","KQ430899",66917,67331,414
"7032","Ocbimv22037037m.g","KQ422909",478925,558451,79526
"7033","Ocbimv22013573m.g","KQ418038",253436,256227,2791
"7034","Ocbimv22005836m.g","KQ417280",122874,140745,17871
"7035","Ocbimv22027215m.g","KQ420220",180623,182363,1740
"7036","Ocbimv22011020m.g","KQ427595",2109,19059,16950
"7037","Ocbimv22015090m.g","KQ418194",2092768,2092968,200
"7038","Ocbimv22023623m.g","KQ419445",138878,141598,2720
"7039","Ocbimv22026331m.g","KQ420027",196356,246008,49652
"7040","Ocbimv22001402m.g","KQ424300",60309,61157,848
"7041","Ocbimv22002309m.g","KQ424627",220664,220840,176
"7042","Ocbimv22023745m.g","KQ419471",8481,9558,1077
"7043","Ocbimv22030349m.g","KQ416344",146797,147229,432
"7044","Ocbimv22014069m.g","KQ415923",67900,68301,401
"7045","Ocbimv22038952m.g","KQ423493",897708,903241,5533
"7046","Ocbimv22026875m.g","KQ420132",915026,916098,1072
"7047","Ocbimv22001590m.g","KQ424366",32987,33511,524
"7048","Ocbimv22009186m.g","KQ426911",280914,281192,278
"7049","Ocbimv22019371m.g","KQ431102",1067,1809,742
"7050","Ocbimv22022093m.g","KQ419159",1728,3173,1445
"7051","Ocbimv22009278m.g","KQ426944",382468,383443,975
"7052","Ocbimv22033827m.g","KQ421891",200605,200895,290
"7053","Ocbimv22000438m.g","KQ423963",246931,293012,46081
"7054","Ocbimv22035534m.g","KQ422422",619904,620098,194
"7055","Ocbimv22027994m.g","KQ420415",386531,391198,4667
"7056","Ocbimv22001175m.g","KQ424212",134288,134641,353
"7057","Ocbimv22018586m.g","KQ418642",393668,438137,44469
"7058","Ocbimv22003179m.g","KQ424901",20855,21107,252
"7059","Ocbimv22018940m.g","KQ418701",91626,91886,260
"7060","Ocbimv22025510m.g","KQ419829",1443,3469,2026
"7061","Ocbimv22018352m.g","KQ418610",47573,61490,13917
"7062","Ocbimv22011779m.g","KQ417831",416340,416732,392
"7063","Ocbimv22010365m.g","LGKD01578940",1028,2495,1467
"7064","Ocbimv22024055m.g","KQ433771",100722,159668,58946
"7065","Ocbimv22010904m.g","KQ427565",230332,230712,380
"7066","Ocbimv22023040m.g","KQ433192",91745,92073,328
"7067","Ocbimv22012863m.g","KQ417945",938333,951848,13515
"7068","Ocbimv22032316m.g","KQ421523",220616,234122,13506
"7069","Ocbimv22023954m.g","KQ419507",17506,17658,152
"7070","Ocbimv22000641m.g","KQ424026",221242,222521,1279
"7071","Ocbimv22026735m.g","KQ416198",306573,330571,23998
"7072","Ocbimv22014399m.g","KQ428905",69679,94235,24556
"7073","Ocbimv22014989m.g","KQ418193",20263,20823,560
"7074","Ocbimv22031287m.g","KQ421217",102007,114261,12254
"7075","Ocbimv22021751m.g","KQ419094",252736,261385,8649
"7076","Ocbimv22006352m.g","KQ417315",28727,30043,1316
"7077","Ocbimv22027718m.g","KQ420347",179367,242806,63439
"7078","Ocbimv22023965m.g","KQ433729",3397,58564,55167
"7079","Ocbimv22006992m.g","KQ417370",77029,81173,4144
"7080","Ocbimv22030301m.g","KQ420942",120906,133095,12189
"7081","Ocbimv22035265m.g","KQ422348",33811,35199,1388
"7082","Ocbimv22021950m.g","KQ419137",266493,266693,200
"7083","Ocbimv22037057m.g","KQ422913",30482,41062,10580
"7084","Ocbimv22036067m.g","KQ416616",882663,929277,46614
"7085","Ocbimv22001227m.g","KQ416917",139000,139380,380
"7086","Ocbimv22018164m.g","KQ430591",1,1108,1107
"7087","Ocbimv22022259m.g","KQ419190",447241,447447,206
"7088","Ocbimv22014244m.g","KQ428818",10501,10743,242
"7089","Ocbimv22012633m.g","KQ417921",1519158,1550688,31530
"7090","Ocbimv22024789m.g","KQ419631",150912,155716,4804
"7091","Ocbimv22013230m.g","KQ418002",467334,489900,22566
"7092","Ocbimv22013554m.g","KQ418037",27692,29212,1520
"7093","Ocbimv22027947m.g","KQ420409",12227,18325,6098
"7094","Ocbimv22011400m.g","KQ417791",1074875,1075798,923
"7095","Ocbimv22028756m.g","KQ420579",250394,253277,2883
"7096","Ocbimv22021701m.g","KQ419087",15461,61262,45801
"7097","Ocbimv22033644m.g","KQ421854",501571,547855,46284
"7098","Ocbimv22014089m.g","KQ415924",572103,574376,2273
"7099","Ocbimv22023935m.g","LGKD01694205",27,131,104
"7100","Ocbimv22001627m.g","KQ416950",480201,532155,51954
"7101","Ocbimv22016471m.g","KQ415966",180300,180611,311
"7102","Ocbimv22007012m.g","KQ417370",387732,400783,13051
"7103","Ocbimv22036837m.g","KQ422871",46955,83059,36104
"7104","Ocbimv22027991m.g","KQ420415",346236,347156,920
"7105","Ocbimv22022326m.g","KQ419199",4070,27440,23370
"7106","Ocbimv22038309m.g","KQ423275",233533,256080,22547
"7107","Ocbimv22017418m.g","KQ418493",105295,110531,5236
"7108","Ocbimv22017155m.g","KQ418457",19111,19698,587
"7109","Ocbimv22024964m.g","KQ419670",27672,64772,37100
"7110","Ocbimv22005652m.g","KQ425702",202881,204497,1616
"7111","Ocbimv22039746m.g","KQ416818",81247,84255,3008
"7112","Ocbimv22006421m.g","KQ425915",1,3423,3422
"7113","Ocbimv22021740m.g","KQ419093",453207,453569,362
"7114","Ocbimv22001951m.g","KQ424494",51174,65262,14088
"7115","Ocbimv22016706m.g","KQ429970",257397,269002,11605
"7116","Ocbimv22014451m.g","KQ415930",356089,395135,39046
"7117","Ocbimv22015554m.g","KQ429416",198812,236899,38087
"7118","Ocbimv22006831m.g","KQ417358",87469,104212,16743
"7119","Ocbimv22016974m.g","KQ418431",189720,210506,20786
"7120","Ocbimv22039810m.g","KQ423766",15,5226,5211
"7121","Ocbimv22022601m.g","KQ432900",1048,1431,383
"7122","Ocbimv22026420m.g","KQ420047",311181,311452,271
"7123","Ocbimv22030908m.g","KQ421117",1628011,1638260,10249
"7124","Ocbimv22024534m.g","KQ419593",27711,29739,2028
"7125","Ocbimv22006583m.g","KQ426026",208991,223107,14116
"7126","Ocbimv22036726m.g","KQ416655",145831,189924,44093
"7127","Ocbimv22009413m.g","KQ417591",980429,982037,1608
"7128","Ocbimv22011099m.g","KQ417747",733733,733903,170
"7129","Ocbimv22007095m.g","KQ417377",947991,1010968,62977
"7130","Ocbimv22006916m.g","KQ426142",17731,19348,1617
"7131","Ocbimv22003058m.g","KQ424867",320715,322913,2198
"7132","Ocbimv22012594m.g","KQ428185",70326,99969,29643
"7133","Ocbimv22002067m.g","KQ424530",835905,871198,35293
"7134","Ocbimv22008908m.g","KQ417538",199197,199721,524
"7135","Ocbimv22010588m.g","KQ427440",119328,119816,488
"7136","Ocbimv22007114m.g","KQ417380",38652,41844,3192
"7137","Ocbimv22003140m.g","KQ417061",755453,757088,1635
"7138","Ocbimv22020872m.g","KQ418971",390383,401999,11616
"7139","Ocbimv22016230m.g","KQ429762",31084,31443,359
"7140","Ocbimv22024568m.g","KQ434061",22823,24187,1364
"7141","Ocbimv22011920m.g","KQ427949",344272,353869,9597
"7142","Ocbimv22020904m.g","KQ418974",295494,305910,10416
"7143","Ocbimv22030471m.g","KQ420992",203903,204845,942
"7144","Ocbimv22020044m.g","KQ431412",36797,44951,8154
"7145","Ocbimv22023608m.g","KQ433503",111764,113081,1317
"7146","Ocbimv22011950m.g","KQ417847",1100627,1101940,1313
"7147","Ocbimv22011710m.g","KQ417824",505312,568784,63472
"7148","Ocbimv22036801m.g","KQ416657",593468,680591,87123
"7149","Ocbimv22007294m.g","KQ417401",5595,59368,53773
"7150","Ocbimv22019254m.g","KQ431068",515932,516318,386
"7151","Ocbimv22036295m.g","KQ422707",13301,51736,38435
"7152","Ocbimv22007329m.g","LGKD01554235",1,1126,1125
"7153","Ocbimv22012190m.g","KQ428067",638,1117,479
"7154","Ocbimv22013147m.g","KQ417988",55350,61518,6168
"7155","Ocbimv22013464m.g","KQ418025",97186,115131,17945
"7156","Ocbimv22020855m.g","KQ418970",2404728,2409984,5256
"7157","Ocbimv22011404m.g","KQ417791",1121621,1123623,2002
"7158","Ocbimv22031939m.g","KQ421385",214009,215169,1160
"7159","Ocbimv22011906m.g","KQ427949",70406,70991,585
"7160","Ocbimv22020397m.g","KQ431650",40,1894,1854
"7161","Ocbimv22038687m.g","KQ423444",25143,35948,10805
"7162","Ocbimv22032040m.g","KQ421412",143197,145740,2543
"7163","Ocbimv22000172m.g","KQ416847",414779,414985,206
"7164","Ocbimv22017553m.g","KQ415978",182055,205996,23941
"7165","Ocbimv22002609m.g","KQ417023",161029,177389,16360
"7166","Ocbimv22013977m.g","KQ428716",29186,45672,16486
"7167","Ocbimv22019313m.g","KQ418749",7710,69852,62142
"7168","Ocbimv22002923m.g","KQ424838",94985,96839,1854
"7169","Ocbimv22012654m.g","KQ417923",545010,592970,47960
"7170","Ocbimv22011432m.g","KQ427746",183221,183454,233
"7171","Ocbimv22014702m.g","KQ418168",592589,593021,432
"7172","Ocbimv22015927m.g","KQ418303",953942,955120,1178
"7173","Ocbimv22008502m.g","KQ417506",419450,441382,21932
"7174","Ocbimv22022500m.g","KQ419233",434742,434939,197
"7175","Ocbimv22001514m.g","KQ424339",6155,25463,19308
"7176","Ocbimv22007510m.g","KQ426358",10066,11508,1442
"7177","Ocbimv22015298m.g","KQ418217",13,1147,1134
"7178","Ocbimv22007203m.g","LGKD01553160",51,392,341
"7179","Ocbimv22037810m.g","KQ423139",65851,66371,520
"7180","Ocbimv22027307m.g","KQ416221",107162,107554,392
"7181","Ocbimv22012306m.g","KQ428118",5479,6140,661
"7182","Ocbimv22004276m.g","KQ425255",199668,199910,242
"7183","Ocbimv22027074m.g","KQ420175",126351,136772,10421
"7184","Ocbimv22007474m.g","KQ426357",5483,25078,19595
"7185","Ocbimv22014988m.g","LGKD01614523",1,177,176
"7186","Ocbimv22027411m.g","KQ420269",187892,277798,89906
"7187","Ocbimv22029401m.g","KQ420741",1396173,1462272,66099
"7188","Ocbimv22031728m.g","KQ421328",412268,412564,296
"7189","Ocbimv22012066m.g","KQ417860",148509,158716,10207
"7190","Ocbimv22014676m.g","KQ418168",214024,215558,1534
"7191","Ocbimv22035623m.g","KQ422479",23190,58056,34866
"7192","Ocbimv22023359m.g","KQ419395",211780,212181,401
"7193","Ocbimv22013391m.g","KQ418018",1095670,1112244,16574
"7194","Ocbimv22025539m.g","KQ419832",32544,35759,3215
"7195","Ocbimv22017821m.g","KQ430482",55,207,152
"7196","Ocbimv22006258m.g","KQ417305",525493,540793,15300
"7197","Ocbimv22025840m.g","KQ419911",7794,16907,9113
"7198","Ocbimv22007733m.g","KQ417447",764327,768891,4564
"7199","Ocbimv22008129m.g","KQ417481",156495,198058,41563
"7200","Ocbimv22008724m.g","KQ417527",239920,245788,5868
"7201","Ocbimv22000126m.g","KQ416841",802668,817237,14569
"7202","Ocbimv22019729m.g","KQ431280",155584,158667,3083
"7203","Ocbimv22032180m.g","KQ421469",70372,81783,11411
"7204","Ocbimv22012171m.g","KQ428057",52614,74236,21622
"7205","Ocbimv22026169m.g","KQ420009",112313,112644,331
"7206","Ocbimv22029895m.g","KQ420840",448775,448948,173
"7207","Ocbimv22039509m.g","KQ423680",217995,228274,10279
"7208","Ocbimv22032519m.g","KQ421573",159188,194423,35235
"7209","Ocbimv22038072m.g","KQ416725",12200,13506,1306
"7210","Ocbimv22018503m.g","KQ430724",140460,140927,467
"7211","Ocbimv22016700m.g","KQ429968",133086,178384,45298
"7212","Ocbimv22002117m.g","KQ424550",4989,6451,1462
"7213","Ocbimv22008135m.g","KQ417481",209304,215904,6600
"7214","Ocbimv22039095m.g","KQ416779",4693,9641,4948
"7215","Ocbimv22017354m.g","KQ418483",417612,421494,3882
"7216","Ocbimv22014918m.g","KQ418187",470080,498394,28314
"7217","Ocbimv22033430m.g","KQ421810",144969,159013,14044
"7218","Ocbimv22026511m.g","KQ420060",131543,132423,880
"7219","Ocbimv22024184m.g","KQ433848",995,5811,4816
"7220","Ocbimv22014860m.g","KQ429117",41433,70096,28663
"7221","Ocbimv22035328m.g","KQ422353",6439,20336,13897
"7222","Ocbimv22018568m.g","KQ418638",170769,171041,272
"7223","Ocbimv22019384m.g","KQ431108",69408,81870,12462
"7224","Ocbimv22030315m.g","KQ420945",31244,34223,2979
"7225","Ocbimv22030961m.g","KQ421138",106072,106320,248
"7226","Ocbimv22030828m.g","KQ421100",64211,66923,2712
"7227","Ocbimv22035818m.g","KQ422561",1293,4757,3464
"7228","Ocbimv22031420m.g","KQ421236",132314,132515,201
"7229","Ocbimv22034842m.g","KQ422191",68211,78845,10634
"7230","Ocbimv22008870m.g","KQ426791",397219,400110,2891
"7231","Ocbimv22027265m.g","KQ420240",140587,151381,10794
"7232","Ocbimv22028511m.g","KQ420516",475809,478557,2748
"7233","Ocbimv22018505m.g","KQ430730",29116,30829,1713
"7234","Ocbimv22026687m.g","KQ416196",1238865,1239067,202
"7235","Ocbimv22030247m.g","KQ416338",656089,658983,2894
"7236","Ocbimv22025992m.g","KQ419946",81713,82201,488
"7237","Ocbimv22011668m.g","KQ415889",675096,675341,245
"7238","Ocbimv22010003m.g","KQ427203",22798,32790,9992
"7239","Ocbimv22029393m.g","KQ420738",51701,59123,7422
"7240","Ocbimv22034194m.g","KQ422000",82916,83629,713
"7241","Ocbimv22000309m.g","KQ415776",32100,87382,55282
"7242","Ocbimv22016932m.g","KQ430089",132092,132522,430
"7243","Ocbimv22033311m.g","KQ421769",121380,122842,1462
"7244","Ocbimv22038255m.g","KQ423250",670668,671407,739
"7245","Ocbimv22037023m.g","KQ422909",197076,250719,53643
"7246","Ocbimv22015910m.g","KQ418303",122066,137323,15257
"7247","Ocbimv22015680m.g","KQ429470",156126,170746,14620
"7248","Ocbimv22034056m.g","KQ416508",646959,648689,1730
"7249","Ocbimv22004089m.g","KQ425196",365,7235,6870
"7250","Ocbimv22029815m.g","KQ420828",763988,764482,494
"7251","Ocbimv22021143m.g","KQ419009",204581,221649,17068
"7252","Ocbimv22034012m.g","KQ421946",238535,238923,388
"7253","Ocbimv22006397m.g","KQ417318",375425,377300,1875
"7254","Ocbimv22013043m.g","KQ415671",41592,50731,9139
"7255","Ocbimv22017726m.g","LGKD01638390",1703,2227,524
"7256","Ocbimv22037994m.g","KQ416719",178283,179194,911
"7257","Ocbimv22037349m.g","KQ423009",407854,410166,2312
"7258","Ocbimv22025158m.g","KQ419713",206425,206827,402
"7259","Ocbimv22004202m.g","KQ425223",55922,57753,1831
"7260","Ocbimv22017460m.g","KQ418498",316165,316810,645
"7261","Ocbimv22004885m.g","KQ417211",508193,508618,425
"7262","Ocbimv22032127m.g","KQ421454",209360,212355,2995
"7263","Ocbimv22000569m.g","KQ423998",199436,210706,11270
"7264","Ocbimv22008898m.g","KQ417538",22760,77790,55030
"7265","Ocbimv22009160m.g","KQ426906",164638,164877,239
"7266","Ocbimv22013838m.g","KQ418068",20701,21216,515
"7267","Ocbimv22003297m.g","KQ424942",247347,247496,149
"7268","Ocbimv22035799m.g","KQ422556",207760,234266,26506
"7269","Ocbimv22003936m.g","KQ425151",102999,104355,1356
"7270","Ocbimv22004296m.g","KQ417146",181421,191009,9588
"7271","Ocbimv22028209m.g","KQ420444",305382,332566,27184
"7272","Ocbimv22037149m.g","KQ416677",573109,610796,37687
"7273","Ocbimv22031745m.g","KQ421337",33194,65408,32214
"7274","Ocbimv22013893m.g","KQ428707",31679,65933,34254
"7275","Ocbimv22024954m.g","KQ419666",20648,22009,1361
"7276","Ocbimv22027330m.g","KQ420261",52439,53032,593
"7277","Ocbimv22038829m.g","KQ416768",41932,43811,1879
"7278","Ocbimv22020851m.g","KQ418970",2353101,2358424,5323
"7279","Ocbimv22036639m.g","KQ422816",28605,28895,290
"7280","Ocbimv22029901m.g","KQ420841",482,6066,5584
"7281","Ocbimv22005738m.g","KQ425732",190007,200374,10367
"7282","Ocbimv22021038m.g","KQ418995",27285,81497,54212
"7283","Ocbimv22026850m.g","KQ420130",652223,655236,3013
"7284","Ocbimv22010248m.g","KQ415873",3451,77612,74161
"7285","Ocbimv22038624m.g","KQ423422",544592,549345,4753
"7286","Ocbimv22004601m.g","KQ417182",756152,763359,7207
"7287","Ocbimv22021871m.g","KQ419115",22903,24969,2066
"7288","Ocbimv22039549m.g","KQ416802",309070,310715,1645
"7289","Ocbimv22014654m.g","KQ429026",421034,421339,305
"7290","Ocbimv22005873m.g","KQ417280",360285,361316,1031
"7291","Ocbimv22017654m.g","KQ418525",3434,12567,9133
"7292","Ocbimv22011496m.g","KQ417796",210242,211170,928
"7293","Ocbimv22036566m.g","KQ416645",297251,298009,758
"7294","Ocbimv22025567m.g","KQ419844",51575,63095,11520
"7295","Ocbimv22020157m.g","KQ418863",429843,449236,19393
"7296","Ocbimv22020958m.g","KQ416036",123335,160416,37081
"7297","Ocbimv22009388m.g","KQ426987",47207,47644,437
"7298","Ocbimv22036707m.g","KQ416654",216996,228221,11225
"7299","Ocbimv22027674m.g","KQ416230",591008,591454,446
"7300","Ocbimv22022564m.g","LGKD01680159",102,579,477
"7301","Ocbimv22033831m.g","KQ421891",256192,301543,45351
"7302","Ocbimv22000932m.g","KQ424120",18312,129489,111177
"7303","Ocbimv22032508m.g","KQ416435",84440,84742,302
"7304","Ocbimv22003898m.g","KQ425138",33148,34414,1266
"7305","Ocbimv22021756m.g","KQ419094",341865,363707,21842
"7306","Ocbimv22025437m.g","KQ419801",48841,84312,35471
"7307","Ocbimv22030461m.g","KQ420992",44872,45383,511
"7308","Ocbimv22029548m.g","KQ420776",257525,378088,120563
"7309","Ocbimv22035317m.g","KQ422351",587972,588286,314
"7310","Ocbimv22015522m.g","KQ415945",831372,833324,1952
"7311","Ocbimv22000844m.g","KQ415664",255700,255879,179
"7312","Ocbimv22021163m.g","KQ415686",39862,40705,843
"7313","Ocbimv22020429m.g","KQ416027",139157,152411,13254
"7314","Ocbimv22036423m.g","KQ422761",19189,54457,35268
"7315","Ocbimv22038763m.g","KQ416765",166048,286013,119965
"7316","Ocbimv22039547m.g","KQ416802",229460,240453,10993
"7317","Ocbimv22016487m.g","KQ418360",251721,252179,458
"7318","Ocbimv22015827m.g","KQ418295",181064,186654,5590
"7319","Ocbimv22002282m.g","KQ424615",139300,145763,6463
"7320","Ocbimv22007301m.g","KQ426287",53119,188556,135437
"7321","Ocbimv22000253m.g","KQ423906",42781,42990,209
"7322","Ocbimv22035718m.g","KQ422521",205092,206423,1331
"7323","Ocbimv22002334m.g","KQ424632",106528,106710,182
"7324","Ocbimv22006174m.g","KQ417300",2432011,2432374,363
"7325","Ocbimv22027331m.g","KQ420261",72039,72453,414
"7326","Ocbimv22037056m.g","KQ422913",11538,30191,18653
"7327","Ocbimv22035904m.g","KQ422595",490851,524419,33568
"7328","Ocbimv22017112m.g","KQ418451",50622,102365,51743
"7329","Ocbimv22039489m.g","KQ423675",656124,657003,879
"7330","Ocbimv22013618m.g","KQ418039",614026,639791,25765
"7331","Ocbimv22011763m.g","KQ417830",318793,320635,1842
"7332","Ocbimv22006318m.g","KQ425873",422481,422733,252
"7333","Ocbimv22037756m.g","KQ423127",8305,31699,23394
"7334","Ocbimv22012382m.g","KQ417908",68957,101390,32433
"7335","Ocbimv22038520m.g","KQ423384",199789,260448,60659
"7336","Ocbimv22006480m.g","KQ425940",14297,14593,296
"7337","Ocbimv22009381m.g","KQ426986",70277,70555,278
"7338","Ocbimv22038173m.g","KQ423223",400822,419744,18922
"7339","Ocbimv22013591m.g","KQ418038",569844,570398,554
"7340","Ocbimv22021434m.g","KQ419049",28339,30239,1900
"7341","Ocbimv22034628m.g","KQ415738",154463,156710,2247
"7342","Ocbimv22022237m.g","LGKD01676206",53,199,146
"7343","Ocbimv22016162m.g","KQ429719",63448,87673,24225
"7344","Ocbimv22039403m.g","KQ423651",601958,602377,419
"7345","Ocbimv22019808m.g","LGKD01654271",222,521,299
"7346","Ocbimv22009042m.g","KQ415859",553086,553851,765
"7347","Ocbimv22020360m.g","KQ418900",353432,355629,2197
"7348","Ocbimv22010597m.g","KQ427456",35667,37189,1522
"7349","Ocbimv22000467m.g","KQ416861",793936,847333,53397
"7350","Ocbimv22032816m.g","LGKD01408934",86,349,263
"7351","Ocbimv22009161m.g","KQ426906",390982,391227,245
"7352","Ocbimv22029029m.g","KQ416281",28351,28521,170
"7353","Ocbimv22002301m.g","KQ424627",62588,94029,31441
"7354","Ocbimv22014205m.g","KQ428800",90521,90694,173
"7355","Ocbimv22019899m.g","KQ418832",773789,775594,1805
"7356","Ocbimv22036492m.g","KQ422777",133674,134414,740
"7357","Ocbimv22018161m.g","KQ418580",713864,714298,434
"7358","Ocbimv22029930m.g","KQ420851",62628,74434,11806
"7359","Ocbimv22029465m.g","KQ416308",206206,259894,53688
"7360","Ocbimv22039802m.g","KQ423759",28026,60393,32367
"7361","Ocbimv22003620m.g","KQ417095",9924,12133,2209
"7362","Ocbimv22000267m.g","KQ423910",98525,113334,14809
"7363","Ocbimv22004151m.g","KQ425219",53375,53617,242
"7364","Ocbimv22009286m.g","KQ417579",74650,74961,311
"7365","Ocbimv22023423m.g","KQ433386",38079,42581,4502
"7366","Ocbimv22024303m.g","KQ419564",107884,109605,1721
"7367","Ocbimv22024548m.g","KQ419593",99172,100014,842
"7368","Ocbimv22015383m.g","KQ429305",66121,66408,287
"7369","Ocbimv22005739m.g","KQ425732",198736,199038,302
"7370","Ocbimv22035838m.g","KQ422574",167106,169534,2428
"7371","Ocbimv22037278m.g","KQ422989",4971,14500,9529
"7372","Ocbimv22022831m.g","KQ419305",344786,345083,297
"7373","Ocbimv22013800m.g","KQ418061",304198,326039,21841
"7374","Ocbimv22023737m.g","KQ419470",448442,448636,194
"7375","Ocbimv22030663m.g","KQ421053",132773,196809,64036
"7376","Ocbimv22020924m.g","KQ418974",2200265,2202579,2314
"7377","Ocbimv22037355m.g","KQ423013",27615,38803,11188
"7378","Ocbimv22005725m.g","KQ425730",14584,14886,302
"7379","Ocbimv22031119m.g","KQ421170",552499,553563,1064
"7380","Ocbimv22010461m.g","KQ417679",23599,24964,1365
"7381","Ocbimv22025928m.g","KQ419930",224154,224393,239
"7382","Ocbimv22025591m.g","KQ419857",198948,199889,941
"7383","Ocbimv22000429m.g","KQ416857",20386,21411,1025
"7384","Ocbimv22023197m.g","KQ419368",728296,730342,2046
"7385","Ocbimv22013217m.g","KQ418002",326046,330125,4079
"7386","Ocbimv22018784m.g","LGKD01646127",836,2297,1461
"7387","Ocbimv22017410m.g","KQ418493",44951,50799,5848
"7388","Ocbimv22026632m.g","KQ420083",15455,15865,410
"7389","Ocbimv22013914m.g","KQ418071",472875,473078,203
"7390","Ocbimv22032768m.g","KQ421655",727577,727843,266
"7391","Ocbimv22016838m.g","KQ418411",12938,30743,17805
"7392","Ocbimv22017136m.g","KQ418453",120470,148619,28149
"7393","Ocbimv22002350m.g","LGKD01129924",238,530,292
"7394","Ocbimv22038476m.g","KQ416745",296635,296872,237
"7395","Ocbimv22020007m.g","KQ418841",2667,10770,8103
"7396","Ocbimv22004818m.g","KQ417208",315967,324026,8059
"7397","Ocbimv22022816m.g","KQ433029",80267,80806,539
"7398","Ocbimv22022347m.g","KQ419202",447240,447461,221
"7399","Ocbimv22029030m.g","KQ416281",136186,185470,49284
"7400","Ocbimv22011075m.g","KQ427619",100336,100614,278
"7401","Ocbimv22021885m.g","LGKD01671954",33,407,374
"7402","Ocbimv22008831m.g","KQ417537",95,51096,51001
"7403","Ocbimv22033759m.g","KQ421866",36785,39404,2619
"7404","Ocbimv22020017m.g","KQ431402",20770,46515,25745
"7405","Ocbimv22036871m.g","KQ422887",7911,68659,60748
"7406","Ocbimv22001133m.g","KQ424203",35916,63210,27294
"7407","Ocbimv22027500m.g","KQ416226",208437,210298,1861
"7408","Ocbimv22003758m.g","KQ417106",20002,22452,2450
"7409","Ocbimv22010954m.g","KQ417726",514234,555958,41724
"7410","Ocbimv22029519m.g","KQ416311",666353,666826,473
"7411","Ocbimv22024494m.g","LGKD01699131",1,303,302
"7412","Ocbimv22030942m.g","KQ416376",344337,344513,176
"7413","Ocbimv22023129m.g","KQ419353",701760,701951,191
"7414","Ocbimv22006439m.g","KQ417319",38411,50194,11783
"7415","Ocbimv22018252m.g","KQ418587",295851,304222,8371
"7416","Ocbimv22039941m.g","KQ423805",5106,11458,6352
"7417","Ocbimv22026565m.g","KQ416193",324651,325684,1033
"7418","Ocbimv22016362m.g","KQ415962",398648,398944,296
"7419","Ocbimv22023003m.g","KQ419337",263058,267150,4092
"7420","Ocbimv22016683m.g","KQ418382",2494,10004,7510
"7421","Ocbimv22002509m.g","KQ417012",5297,47506,42209
"7422","Ocbimv22039862m.g","KQ423780",945564,946282,718
"7423","Ocbimv22002439m.g","KQ424659",11643,12306,663
"7424","Ocbimv22035093m.g","KQ416571",447290,447769,479
"7425","Ocbimv22000375m.g","KQ423941",430840,446922,16082
"7426","Ocbimv22017342m.g","KQ418483",285060,297580,12520
"7427","Ocbimv22021110m.g","LGKD01665669",4648,5659,1011
"7428","Ocbimv22025542m.g","KQ419834",78743,79644,901
"7429","Ocbimv22014887m.g","KQ429131",148724,149999,1275
"7430","Ocbimv22023204m.g","KQ419368",980695,981442,747
"7431","Ocbimv22009019m.g","KQ426844",8608,9308,700
"7432","Ocbimv22035231m.g","KQ422328",2075,7454,5379
"7433","Ocbimv22006632m.g","KQ426043",30659,31027,368
"7434","Ocbimv22003533m.g","KQ425024",141248,143695,2447
"7435","Ocbimv22010078m.g","KQ417641",100535,101733,1198
"7436","Ocbimv22016986m.g","KQ418431",747493,761098,13605
"7437","Ocbimv22016044m.g","KQ418312",494456,494854,398
"7438","Ocbimv22016412m.g","KQ415964",29629,38292,8663
"7439","Ocbimv22018962m.g","KQ418702",640151,640439,288
"7440","Ocbimv22001437m.g","KQ416933",184147,220050,35903
"7441","Ocbimv22035997m.g","KQ422629",542722,556057,13335
"7442","Ocbimv22003531m.g","KQ425022",50880,51035,155
"7443","Ocbimv22015888m.g","KQ418299",229668,230791,1123
"7444","Ocbimv22008802m.g","KQ426774",143343,143507,164
"7445","Ocbimv22029362m.g","KQ420721",104285,104476,191
"7446","Ocbimv22036647m.g","KQ422818",127362,210634,83272
"7447","Ocbimv22035386m.g","KQ422366",85576,99617,14041
"7448","Ocbimv22019875m.g","KQ431351",4154,4662,508
"7449","Ocbimv22034593m.g","KQ422081",169311,289349,120038
"7450","Ocbimv22035458m.g","KQ416587",103311,103673,362
"7451","Ocbimv22010163m.g","KQ427290",242643,260651,18008
"7452","Ocbimv22002561m.g","KQ415793",1404355,1445291,40936
"7453","Ocbimv22017610m.g","KQ430378",98366,98566,200
"7454","Ocbimv22035134m.g","KQ422286",117258,121613,4355
"7455","Ocbimv22015537m.g","KQ429407",6800,42918,36118
"7456","Ocbimv22014433m.g","KQ428916",291,3898,3607
"7457","Ocbimv22021587m.g","KQ432245",9036,12011,2975
"7458","Ocbimv22014323m.g","KQ428867",989,4786,3797
"7459","Ocbimv22009347m.g","KQ417585",22061,23230,1169
"7460","Ocbimv22032652m.g","KQ421627",119139,119696,557
"7461","Ocbimv22005015m.g","KQ417224",39511,58663,19152
"7462","Ocbimv22004937m.g","KQ425476",41274,41593,319
"7463","Ocbimv22034553m.g","KQ416536",1136851,1137774,923
"7464","Ocbimv22008974m.g","KQ417544",731176,732937,1761
"7465","Ocbimv22018294m.g","KQ418597",18550,19250,700
"7466","Ocbimv22020402m.g","KQ431659",40120,40626,506
"7467","Ocbimv22031300m.g","KQ421217",435642,471976,36334
"7468","Ocbimv22024572m.g","KQ419600",68916,69418,502
"7469","Ocbimv22005019m.g","KQ417224",193715,195374,1659
"7470","Ocbimv22038025m.g","KQ416719",918279,920309,2030
"7471","Ocbimv22029918m.g","KQ420845",308871,310042,1171
"7472","Ocbimv22013473m.g","KQ428524",171399,172010,611
"7473","Ocbimv22022316m.g","KQ432673",15162,15353,191
"7474","Ocbimv22026980m.g","KQ420157",205729,206025,296
"7475","Ocbimv22007238m.g","KQ426259",54551,55083,532
"7476","Ocbimv22028102m.g","KQ416249",152985,153149,164
"7477","Ocbimv22006146m.g","KQ417300",783697,795090,11393
"7478","Ocbimv22000764m.g","KQ416879",192621,201872,9251
"7479","Ocbimv22012459m.g","KQ428165",122218,124245,2027
"7480","Ocbimv22019092m.g","KQ430963",151176,164460,13284
"7481","Ocbimv22004896m.g","KQ417213",166923,168531,1608
"7482","Ocbimv22000804m.g","KQ424075",18199,22501,4302
"7483","Ocbimv22021428m.g","KQ432146",889,6637,5748
"7484","Ocbimv22026723m.g","KQ420104",34463,80441,45978
"7485","Ocbimv22038076m.g","KQ423213",924,12678,11754
"7486","Ocbimv22026507m.g","KQ420059",918172,918747,575
"7487","Ocbimv22016052m.g","KQ415951",75339,107044,31705
"7488","Ocbimv22011843m.g","KQ427917",173465,177925,4460
"7489","Ocbimv22023905m.g","KQ419497",151798,152793,995
"7490","Ocbimv22035563m.g","KQ422438",44065,55218,11153
"7491","Ocbimv22028748m.g","KQ420576",128071,129841,1770
"7492","Ocbimv22018978m.g","KQ418705",76613,76822,209
"7493","Ocbimv22009421m.g","KQ417591",1275573,1280194,4621
"7494","Ocbimv22019989m.g","KQ418840",1310467,1315987,5520
"7495","Ocbimv22034598m.g","KQ422084",196030,197015,985
"7496","Ocbimv22027353m.g","KQ420264",13434,21649,8215
"7497","Ocbimv22026087m.g","KQ419989",150893,153306,2413
"7498","Ocbimv22002370m.g","KQ415792",42303,44400,2097
"7499","Ocbimv22006602m.g","KQ426027",163746,164903,1157
"7500","Ocbimv22009753m.g","KQ427110",57750,65714,7964
"7501","Ocbimv22015998m.g","KQ429647",87358,96617,9259
"7502","Ocbimv22027107m.g","KQ420185",189543,189776,233
"7503","Ocbimv22036977m.g","KQ422897",127336,185802,58466
"7504","Ocbimv22011964m.g","KQ427953",18598,47287,28689
"7505","Ocbimv22021782m.g","KQ419101",32941,33099,158
"7506","Ocbimv22034204m.g","KQ416523",406787,408840,2053
"7507","Ocbimv22032721m.g","KQ421646",9612,10758,1146
"7508","Ocbimv22029500m.g","KQ420766",35718,36425,707
"7509","Ocbimv22002709m.g","KQ424755",153269,197483,44214
"7510","Ocbimv22023090m.g","KQ419346",26877,82762,55885
"7511","Ocbimv22003382m.g","KQ424999",297389,299687,2298
"7512","Ocbimv22012128m.g","KQ415902",141773,142602,829
"7513","Ocbimv22035470m.g","KQ422393",21693,45386,23693
"7514","Ocbimv22027740m.g","KQ416232",126765,127234,469
"7515","Ocbimv22001371m.g","KQ416927",4126,4296,170
"7516","Ocbimv22023973m.g","KQ419513",11163,13647,2484
"7517","Ocbimv22014417m.g","KQ418131",414589,466632,52043
"7518","Ocbimv22015777m.g","KQ418292",56106,56390,284
"7519","Ocbimv22006667m.g","KQ417342",313185,316040,2855
"7520","Ocbimv22031978m.g","KQ416415",100654,101630,976
"7521","Ocbimv22032950m.g","KQ421693",228519,229281,762
"7522","Ocbimv22018818m.g","KQ418683",329384,330414,1030
"7523","Ocbimv22025491m.g","KQ419819",12251,21304,9053
"7524","Ocbimv22002916m.g","KQ424828",66855,69472,2617
"7525","Ocbimv22009309m.g","KQ417581",381878,382489,611
"7526","Ocbimv22021053m.g","KQ431971",15160,19591,4431
"7527","Ocbimv22005930m.g","KQ425756",3868,4484,616
"7528","Ocbimv22000424m.g","KQ423959",33989,34399,410
"7529","Ocbimv22033400m.g","KQ416479",919127,931771,12644
"7530","Ocbimv22024511m.g","KQ419590",1878301,1878489,188
"7531","Ocbimv22018039m.g","KQ418560",627730,631320,3590
"7532","Ocbimv22028828m.g","KQ420590",146980,147613,633
"7533","Ocbimv22011708m.g","KQ417824",475341,504020,28679
"7534","Ocbimv22026358m.g","KQ420033",25761,43154,17393
"7535","Ocbimv22017666m.g","KQ418525",272952,273209,257
"7536","Ocbimv22025283m.g","KQ419759",399888,413385,13497
"7537","Ocbimv22014816m.g","KQ429096",397634,398287,653
"7538","Ocbimv22015934m.g","KQ418303",1184780,1186476,1696
"7539","Ocbimv22032254m.g","KQ421505",247072,247542,470
"7540","Ocbimv22020651m.g","KQ418945",918706,935931,17225
"7541","Ocbimv22000085m.g","KQ416839",52001,52522,521
"7542","Ocbimv22028915m.g","KQ416274",1939952,1940800,848
"7543","Ocbimv22019179m.g","KQ418729",42327,62881,20554
"7544","Ocbimv22033857m.g","KQ421896",223010,226348,3338
"7545","Ocbimv22009117m.g","LGKD01568145",313,462,149
"7546","Ocbimv22016342m.g","KQ429822",62610,63981,1371
"7547","Ocbimv22035490m.g","KQ416588",25603,34933,9330
"7548","Ocbimv22010480m.g","KQ417681",647886,692327,44441
"7549","Ocbimv22011520m.g","KQ417796",830031,837390,7359
"7550","Ocbimv22020265m.g","KQ431563",135095,135542,447
"7551","Ocbimv22032113m.g","KQ421451",287928,291210,3282
"7552","Ocbimv22001796m.g","KQ424420",237876,286369,48493
"7553","Ocbimv22021884m.g","KQ432383",340,1460,1120
"7554","Ocbimv22034875m.g","LGKD01433965",1,153,152
"7555","Ocbimv22002302m.g","KQ424627",103793,105020,1227
"7556","Ocbimv22028194m.g","KQ420442",76765,91460,14695
"7557","Ocbimv22039266m.g","KQ423598",240054,244277,4223
"7558","Ocbimv22008808m.g","KQ426774",197119,201823,4704
"7559","Ocbimv22033095m.g","KQ421725",45935,57053,11118
"7560","Ocbimv22021521m.g","KQ419066",112201,207622,95421
"7561","Ocbimv22000412m.g","KQ423958",230817,231378,561
"7562","Ocbimv22011229m.g","KQ417763",872245,873251,1006
"7563","Ocbimv22039513m.g","KQ423680",240228,240416,188
"7564","Ocbimv22031579m.g","KQ416401",65771,66955,1184
"7565","Ocbimv22037492m.g","KQ423047",80823,81888,1065
"7566","Ocbimv22035837m.g","KQ422574",75005,75178,173
"7567","Ocbimv22030629m.g","KQ421036",47007,47209,202
"7568","Ocbimv22008608m.g","KQ417510",797679,799769,2090
"7569","Ocbimv22001357m.g","KQ424287",2163,63902,61739
"7570","Ocbimv22036086m.g","KQ416616",1786456,1795310,8854
"7571","Ocbimv22018404m.g","KQ430684",577461,594960,17499
"7572","Ocbimv22029022m.g","KQ420626",1044982,1047107,2125
"7573","Ocbimv22014945m.g","KQ429139",460070,465545,5475
"7574","Ocbimv22022819m.g","KQ433031",69018,79806,10788
"7575","Ocbimv22024486m.g","KQ416124",616685,616894,209
"7576","Ocbimv22027996m.g","KQ420415",527374,547088,19714
"7577","Ocbimv22018999m.g","KQ418710",82142,82519,377
"7578","Ocbimv22009965m.g","KQ427186",131507,133144,1637
"7579","Ocbimv22021467m.g","KQ416046",1813792,1814163,371
"7580","Ocbimv22010411m.g","KQ417676",1101526,1103303,1777
"7581","Ocbimv22001449m.g","KQ416933",606238,636997,30759
"7582","Ocbimv22030245m.g","KQ416338",559366,559851,485
"7583","Ocbimv22001788m.g","KQ424420",100685,174966,74281
"7584","Ocbimv22006474m.g","KQ417326",876132,877878,1746
"7585","Ocbimv22023661m.g","KQ419456",685980,723227,37247
"7586","Ocbimv22001234m.g","KQ424231",65531,65887,356
"7587","Ocbimv22001041m.g","KQ424160",181,21092,20911
"7588","Ocbimv22015194m.g","KQ415938",19988,44019,24031
"7589","Ocbimv22001528m.g","KQ424347",109100,109526,426
"7590","Ocbimv22017858m.g","KQ418552",294718,295088,370
"7591","Ocbimv22035721m.g","KQ422521",236050,244783,8733
"7592","Ocbimv22038501m.g","KQ423382",186637,186870,233
"7593","Ocbimv22031995m.g","KQ421407",183030,183263,233
"7594","Ocbimv22005781m.g","KQ415823",291641,295618,3977
"7595","Ocbimv22029709m.g","KQ420813",43982,44413,431
"7596","Ocbimv22019343m.g","LGKD01650146",60,296,236
"7597","Ocbimv22022494m.g","KQ419232",351180,352446,1266
"7598","Ocbimv22013228m.g","KQ418002",445738,447605,1867
"7599","Ocbimv22006965m.g","KQ417368",104840,127317,22477
"7600","Ocbimv22034826m.g","KQ422187",502643,563699,61056
"7601","Ocbimv22018508m.g","KQ430732",11482,14924,3442
"7602","Ocbimv22031871m.g","KQ421368",30985,85294,54309
"7603","Ocbimv22037710m.g","KQ423107",26555,26776,221
"7604","Ocbimv22015615m.g","KQ418269",49554,50070,516
"7605","Ocbimv22019753m.g","KQ431294",319738,320385,647
"7606","Ocbimv22019353m.g","KQ418754",75911,76129,218
"7607","Ocbimv22003524m.g","KQ425021",323068,323756,688
"7608","Ocbimv22025897m.g","KQ416175",694270,694539,269
"7609","Ocbimv22017310m.g","KQ415681",1332512,1379135,46623
"7610","Ocbimv22030015m.g","KQ416330",152681,214213,61532
"7611","Ocbimv22029746m.g","KQ415712",157140,157743,603
"7612","Ocbimv22004378m.g","KQ415803",751637,752176,539
"7613","Ocbimv22008162m.g","KQ417481",1340429,1342009,1580
"7614","Ocbimv22011893m.g","KQ415894",13841,22434,8593
"7615","Ocbimv22018090m.g","KQ418571",341294,361391,20097
"7616","Ocbimv22032962m.g","KQ421695",90437,93583,3146
"7617","Ocbimv22031866m.g","KQ421365",28764,45286,16522
"7618","Ocbimv22008998m.g","KQ417549",241152,257643,16491
"7619","Ocbimv22025540m.g","KQ419832",37282,41124,3842
"7620","Ocbimv22033533m.g","KQ421824",671785,677614,5829
"7621","Ocbimv22002191m.g","KQ415790",1170,31142,29972
"7622","Ocbimv22015464m.g","KQ418255",1270,1932,662
"7623","Ocbimv22006826m.g","KQ417358",31922,32434,512
"7624","Ocbimv22026006m.g","KQ419952",359647,360138,491
"7625","Ocbimv22032531m.g","KQ421578",123342,123680,338
"7626","Ocbimv22018681m.g","KQ415684",1771585,1772457,872
"7627","Ocbimv22012817m.g","KQ417942",1424742,1447670,22928
"7628","Ocbimv22023478m.g","KQ433417",302797,314740,11943
"7629","Ocbimv22027693m.g","KQ416231",40410,40802,392
"7630","Ocbimv22018104m.g","KQ430572",228552,229643,1091
"7631","Ocbimv22006990m.g","KQ417370",67673,71699,4026
"7632","Ocbimv22020840m.g","KQ418970",2289583,2299507,9924
"7633","Ocbimv22012776m.g","KQ417939",483939,492410,8471
"7634","Ocbimv22004153m.g","LGKD01527764",3,185,182
"7635","Ocbimv22011247m.g","LGKD01586093",224,406,182
"7636","Ocbimv22007443m.g","KQ417416",55084,82935,27851
"7637","Ocbimv22004004m.g","KQ417132",18825,59010,40185
"7638","Ocbimv22012547m.g","KQ417917",988021,996404,8383
"7639","Ocbimv22020255m.g","KQ431560",36791,82022,45231
"7640","Ocbimv22019669m.g","KQ431226",51779,54141,2362
"7641","Ocbimv22000119m.g","KQ416841",372271,500199,127928
"7642","Ocbimv22011865m.g","KQ427941",60513,60683,170
"7643","Ocbimv22035000m.g","KQ422241",32708,33137,429
"7644","Ocbimv22037317m.g","KQ416686",4856,5721,865
"7645","Ocbimv22001715m.g","KQ424391",47051,47844,793
"7646","Ocbimv22031916m.g","KQ421376",1137475,1167336,29861
"7647","Ocbimv22018378m.g","KQ418610",276646,286531,9885
"7648","Ocbimv22007751m.g","KQ415847",698631,702366,3735
"7649","Ocbimv22033540m.g","KQ416484",9277,15011,5734
"7650","Ocbimv22021187m.g","KQ416040",129122,155865,26743
"7651","Ocbimv22028422m.g","KQ420483",247140,254692,7552
"7652","Ocbimv22012386m.g","KQ417908",173672,174663,991
"7653","Ocbimv22039407m.g","KQ423651",1376056,1401846,25790
"7654","Ocbimv22014985m.g","KQ418192",7,3554,3547
"7655","Ocbimv22026267m.g","KQ420022",478728,496140,17412
"7656","Ocbimv22021600m.g","KQ432245",68250,74810,6560
"7657","Ocbimv22019068m.g","KQ416006",183927,222053,38126
"7658","Ocbimv22024751m.g","KQ419623",87247,87432,185
"7659","Ocbimv22001994m.g","KQ416979",1004869,1005683,814
"7660","Ocbimv22034172m.g","KQ416518",338278,357742,19464
"7661","Ocbimv22016628m.g","KQ415967",343788,343970,182
"7662","Ocbimv22038045m.g","KQ416722",32802,45534,12732
"7663","Ocbimv22003528m.g","KQ425022",21048,25432,4384
"7664","Ocbimv22027456m.g","KQ420287",693061,748453,55392
"7665","Ocbimv22031755m.g","KQ421338",351397,351561,164
"7666","Ocbimv22024365m.g","KQ419574",776853,814766,37913
"7667","Ocbimv22010523m.g","KQ417687",486253,486516,263
"7668","Ocbimv22000565m.g","KQ423998",9399,66891,57492
"7669","Ocbimv22028610m.g","KQ416263",806576,809216,2640
"7670","Ocbimv22029932m.g","KQ420854",266075,266628,553
"7671","Ocbimv22036249m.g","KQ416627",331073,333739,2666
"7672","Ocbimv22022854m.g","KQ433069",22632,23210,578
"7673","Ocbimv22033530m.g","KQ421824",531086,662284,131198
"7674","Ocbimv22017225m.g","KQ418469",268718,269629,911
"7675","Ocbimv22003138m.g","KQ417061",557732,558115,383
"7676","Ocbimv22003354m.g","KQ424993",192989,194544,1555
"7677","Ocbimv22034946m.g","KQ422223",24141,24554,413
"7678","Ocbimv22024814m.g","KQ419631",640148,640817,669
"7679","Ocbimv22008292m.g","KQ426610",341444,352514,11070
"7680","Ocbimv22001012m.g","KQ424151",253772,254197,425
"7681","Ocbimv22037855m.g","KQ423139",756509,757711,1202
"7682","Ocbimv22019519m.g","KQ431191",19878,20196,318
"7683","Ocbimv22007310m.g","KQ426287",276394,277436,1042
"7684","Ocbimv22039629m.g","KQ416810",998516,1006185,7669
"7685","Ocbimv22014624m.g","KQ418158",231049,234007,2958
"7686","Ocbimv22016726m.g","KQ429984",216,25841,25625
"7687","Ocbimv22019422m.g","KQ418762",44417,48599,4182
"7688","Ocbimv22002938m.g","KQ424851",23756,38516,14760
"7689","Ocbimv22033974m.g","KQ421934",37391,40920,3529
"7690","Ocbimv22004318m.g","KQ425262",8371,24518,16147
"7691","Ocbimv22024836m.g","KQ419638",184093,184317,224
"7692","Ocbimv22024099m.g","KQ419533",557147,557416,269
"7693","Ocbimv22013564m.g","KQ418038",50771,121403,70632
"7694","Ocbimv22034617m.g","KQ416540",348031,348441,410
"7695","Ocbimv22023621m.g","KQ419445",95981,106210,10229
"7696","Ocbimv22027223m.g","KQ420221",53823,54047,224
"7697","Ocbimv22009343m.g","KQ417584",361804,362058,254
"7698","Ocbimv22036531m.g","KQ422784",342174,343416,1242
"7699","Ocbimv22005127m.g","KQ415813",1131992,1132195,203
"7700","Ocbimv22031614m.g","KQ421296",223645,224575,930
"7701","Ocbimv22032722m.g","KQ421646",13600,22454,8854
"7702","Ocbimv22035436m.g","LGKD01439348",76,729,653
"7703","Ocbimv22011951m.g","KQ417847",1105401,1117938,12537
"7704","Ocbimv22007318m.g","KQ417403",102699,186586,83887
"7705","Ocbimv22030130m.g","KQ420902",171873,208125,36252
"7706","Ocbimv22037132m.g","KQ422938",8218,19599,11381
"7707","Ocbimv22007408m.g","KQ417412",93687,130647,36960
"7708","Ocbimv22020388m.g","KQ431643",28875,29589,714
"7709","Ocbimv22024895m.g","KQ416131",72808,88938,16130
"7710","Ocbimv22005559m.g","KQ425654",59532,78941,19409
"7711","Ocbimv22032921m.g","KQ421685",10741,11669,928
"7712","Ocbimv22029035m.g","KQ420630",250160,272651,22491
"7713","Ocbimv22020391m.g","KQ431646",26927,126793,99866
"7714","Ocbimv22015782m.g","KQ429566",135913,138828,2915
"7715","Ocbimv22032427m.g","KQ421533",595684,600116,4432
"7716","Ocbimv22023083m.g","KQ419345",132847,169353,36506
"7717","Ocbimv22005994m.g","KQ425779",39197,40226,1029
"7718","Ocbimv22035786m.g","LGKD01444452",16,168,152
"7719","Ocbimv22004720m.g","KQ417201",21934,59410,37476
"7720","Ocbimv22026771m.g","KQ420113",605,13961,13356
"7721","Ocbimv22002077m.g","KQ424537",32917,52333,19416
"7722","Ocbimv22014727m.g","KQ429048",100,525,425
"7723","Ocbimv22003178m.g","KQ424901",3553,3945,392
"7724","Ocbimv22028392m.g","KQ416257",672547,723325,50778
"7725","Ocbimv22026767m.g","KQ420112",146397,148931,2534
"7726","Ocbimv22030296m.g","KQ420942",9343,9697,354
"7727","Ocbimv22028296m.g","KQ420462",207846,226045,18199
"7728","Ocbimv22002693m.g","KQ424745",20883,26572,5689
"7729","Ocbimv22004090m.g","KQ425196",15984,23364,7380
"7730","Ocbimv22035538m.g","KQ422423",184793,186893,2100
"7731","Ocbimv22012196m.g","KQ417887",90438,90599,161
"7732","Ocbimv22038122m.g","KQ423217",156920,169668,12748
"7733","Ocbimv22017444m.g","KQ418496",499270,501144,1874
"7734","Ocbimv22000816m.g","KQ424081",89003,89275,272
"7735","Ocbimv22001470m.g","KQ416935",329798,332531,2733
"7736","Ocbimv22038050m.g","KQ423209",65568,65846,278
"7737","Ocbimv22007848m.g","KQ417455",130543,165836,35293
"7738","Ocbimv22027342m.g","KQ420261",1211694,1253710,42016
"7739","Ocbimv22009324m.g","KQ415863",174031,174423,392
"7740","Ocbimv22039296m.g","KQ423609",756560,756721,161
"7741","Ocbimv22028656m.g","KQ420545",169382,169708,326
"7742","Ocbimv22024134m.g","KQ419538",188851,189234,383
"7743","Ocbimv22028629m.g","KQ420537",35504,36341,837
"7744","Ocbimv22002073m.g","LGKD01015449",195,533,338
"7745","Ocbimv22029979m.g","KQ420866",41979,42826,847
"7746","Ocbimv22017535m.g","KQ430344",37162,39054,1892
"7747","Ocbimv22025069m.g","LGKD01313143",3,296,293
"7748","Ocbimv22033545m.g","KQ421827",79905,117696,37791
"7749","Ocbimv22004871m.g","KQ417211",278216,290545,12329
"7750","Ocbimv22021734m.g","KQ419092",246157,248935,2778
"7751","Ocbimv22034717m.g","KQ422124",71111,72648,1537
"7752","Ocbimv22033522m.g","KQ421824",20477,83862,63385
"7753","Ocbimv22003259m.g","KQ417073",59228,61526,2298
"7754","Ocbimv22039248m.g","KQ423592",34644,35918,1274
"7755","Ocbimv22009676m.g","KQ417601",306786,349327,42541
"7756","Ocbimv22018371m.g","KQ418610",204530,213086,8556
"7757","Ocbimv22039033m.g","KQ423517",6950,34408,27458
"7758","Ocbimv22020620m.g","KQ418942",907,2011,1104
"7759","Ocbimv22024631m.g","KQ419605",272721,306150,33429
"7760","Ocbimv22014883m.g","KQ415936",352149,373394,21245
"7761","Ocbimv22021401m.g","KQ432116",115588,115897,309
"7762","Ocbimv22015624m.g","KQ418269",446699,458831,12132
"7763","Ocbimv22020769m.g","KQ431848",1683,3661,1978
"7764","Ocbimv22012115m.g","KQ417875",8062,8286,224
"7765","Ocbimv22012037m.g","KQ415898",399183,399617,434
"7766","Ocbimv22032620m.g","KQ416442",55276,61141,5865
"7767","Ocbimv22001489m.g","KQ424321",84664,85301,637
"7768","Ocbimv22006642m.g","KQ426045",242800,255023,12223
"7769","Ocbimv22007862m.g","KQ417455",364276,374574,10298
"7770","Ocbimv22003300m.g","KQ417077",47968,48228,260
"7771","Ocbimv22026371m.g","KQ416188",132868,133906,1038
"7772","Ocbimv22026207m.g","KQ420017",59150,67915,8765
"7773","Ocbimv22032366m.g","KQ421524",57999,59797,1798
"7774","Ocbimv22014088m.g","KQ415924",499441,500182,741
"7775","Ocbimv22029824m.g","KQ420828",892708,954556,61848
"7776","Ocbimv22009022m.g","KQ426845",176,1141,965
"7777","Ocbimv22009696m.g","KQ417604",624210,624755,545
"7778","Ocbimv22000971m.g","KQ424141",15652,16902,1250
"7779","Ocbimv22001121m.g","KQ424186",240398,240712,314
"7780","Ocbimv22026656m.g","KQ420085",682658,700427,17769
"7781","Ocbimv22002816m.g","KQ424788",66707,67105,398
"7782","Ocbimv22028888m.g","KQ416274",288835,290113,1278
"7783","Ocbimv22028451m.g","KQ420490",216196,216468,272
"7784","Ocbimv22006126m.g","KQ417300",162271,179969,17698
"7785","Ocbimv22001109m.g","KQ424182",217031,238495,21464
"7786","Ocbimv22018596m.g","KQ418644",597367,600544,3177
"7787","Ocbimv22002634m.g","KQ417023",1056668,1064363,7695
"7788","Ocbimv22031703m.g","KQ421324",39047,74642,35595
"7789","Ocbimv22032675m.g","KQ416444",118307,126461,8154
"7790","Ocbimv22030523m.g","KQ421009",1929403,1929561,158
"7791","Ocbimv22000027m.g","KQ423826",74749,75114,365
"7792","Ocbimv22001914m.g","KQ424474",105,49766,49661
"7793","Ocbimv22016123m.g","KQ418320",582330,592682,10352
"7794","Ocbimv22020062m.g","KQ418849",1,358,357
"7795","Ocbimv22001249m.g","KQ424239",327143,327598,455
"7796","Ocbimv22018132m.g","LGKD01641069",2,247,245
"7797","Ocbimv22029851m.g","KQ420828",1510781,1573885,63104
"7798","Ocbimv22019142m.g","KQ418721",235834,235992,158
"7799","Ocbimv22024015m.g","KQ433752",9458,12144,2686
"7800","Ocbimv22016167m.g","KQ429720",121396,164718,43322
"7801","Ocbimv22002109m.g","KQ424545",23709,24024,315
"7802","Ocbimv22008677m.g","KQ417519",1610454,1610822,368
"7803","Ocbimv22000291m.g","KQ423912",74214,86739,12525
"7804","Ocbimv22007521m.g","KQ417420",262347,268449,6102
"7805","Ocbimv22013567m.g","KQ418038",129041,135017,5976
"7806","Ocbimv22013751m.g","KQ428650",45675,67488,21813
"7807","Ocbimv22032790m.g","KQ421658",545816,546408,592
"7808","Ocbimv22031928m.g","KQ416413",1352073,1352504,431
"7809","Ocbimv22028405m.g","KQ416257",1159327,1170072,10745
"7810","Ocbimv22027245m.g","KQ420227",465872,466967,1095
"7811","Ocbimv22019267m.g","KQ418739",519635,520886,1251
"7812","Ocbimv22003532m.g","KQ425024",123464,126975,3511
"7813","Ocbimv22031359m.g","KQ421221",365517,366659,1142
"7814","Ocbimv22030499m.g","KQ416353",183455,228923,45468
"7815","Ocbimv22029284m.g","KQ420696",629905,654374,24469
"7816","Ocbimv22019099m.g","KQ416007",96969,97394,425
"7817","Ocbimv22007974m.g","KQ417466",1983375,1984919,1544
"7818","Ocbimv22032339m.g","KQ421523",962119,963209,1090
"7819","Ocbimv22039539m.g","KQ423702",10765,14300,3535
"7820","Ocbimv22039028m.g","KQ423515",158048,158521,473
"7821","Ocbimv22005206m.g","KQ417232",1202382,1215651,13269
"7822","Ocbimv22001458m.g","KQ416933",790438,790860,422
"7823","Ocbimv22000600m.g","KQ424015",412449,415696,3247
"7824","Ocbimv22030826m.g","KQ421100",24159,37845,13686
"7825","Ocbimv22038867m.g","KQ416769",711179,711640,461
"7826","Ocbimv22024179m.g","KQ419545",14631,20286,5655
"7827","Ocbimv22008689m.g","KQ426733",6253,16002,9749
"7828","Ocbimv22031426m.g","KQ421241",396912,415694,18782
"7829","Ocbimv22009040m.g","KQ415859",546465,547278,813
"7830","Ocbimv22030500m.g","KQ416353",235543,243376,7833
"7831","Ocbimv22000650m.g","KQ424028",6973,12318,5345
"7832","Ocbimv22036684m.g","KQ422834",59098,60011,913
"7833","Ocbimv22015732m.g","KQ418286",57104,57367,263
"7834","Ocbimv22037299m.g","KQ422997",181191,209037,27846
"7835","Ocbimv22025718m.g","KQ419887",1096110,1104480,8370
"7836","Ocbimv22009229m.g","KQ426935",5041,45848,40807
"7837","Ocbimv22005310m.g","KQ425580",5453,17538,12085
"7838","Ocbimv22021216m.g","KQ419013",205574,205889,315
"7839","Ocbimv22018705m.g","KQ430810",2063,3632,1569
"7840","Ocbimv22010129m.g","LGKD01181461",3,692,689
"7841","Ocbimv22010327m.g","KQ417670",106178,106947,769
"7842","Ocbimv22026107m.g","KQ419989",482085,491502,9417
"7843","Ocbimv22002826m.g","KQ417040",116429,117434,1005
"7844","Ocbimv22000920m.g","KQ424114",106835,136214,29379
"7845","Ocbimv22039122m.g","KQ416779",828871,838919,10048
"7846","Ocbimv22032144m.g","KQ421460",183304,189991,6687
"7847","Ocbimv22034065m.g","KQ416508",855988,859641,3653
"7848","Ocbimv22032133m.g","KQ421454",325578,367321,41743
"7849","Ocbimv22014219m.g","KQ418103",142209,142442,233
"7850","Ocbimv22037609m.g","KQ423077",902592,908120,5528
"7851","Ocbimv22016148m.g","KQ418322",472561,506464,33903
"7852","Ocbimv22039735m.g","KQ423737",69235,73563,4328
"7853","Ocbimv22038061m.g","KQ423210",79712,85989,6277
"7854","Ocbimv22035115m.g","KQ416574",93147,93398,251
"7855","Ocbimv22025702m.g","KQ419887",213488,214893,1405
"7856","Ocbimv22001440m.g","KQ416933",266891,287660,20769
"7857","Ocbimv22015817m.g","KQ418295",142768,143178,410
"7858","Ocbimv22035039m.g","LGKD01435865",407,613,206
"7859","Ocbimv22036054m.g","KQ416615",47505,63426,15921
"7860","Ocbimv22007893m.g","KQ426484",148372,192910,44538
"7861","Ocbimv22004833m.g","KQ417209",133966,135927,1961
"7862","Ocbimv22009563m.g","KQ427022",12624,12986,362
"7863","Ocbimv22034647m.g","KQ422103",385212,385385,173
"7864","Ocbimv22011972m.g","KQ415895",553707,584596,30889
"7865","Ocbimv22013407m.g","KQ428500",6284,8622,2338
"7866","Ocbimv22009665m.g","KQ427059",805653,833871,28218
"7867","Ocbimv22034451m.g","KQ416533",34920,53869,18949
"7868","Ocbimv22001765m.g","KQ416962",21230,33291,12061
"7869","Ocbimv22023416m.g","LGKD01688249",71,247,176
"7870","Ocbimv22004504m.g","KQ417173",2227170,2227424,254
"7871","Ocbimv22024108m.g","KQ419534",170844,192523,21679
"7872","Ocbimv22005338m.g","KQ417245",357278,358184,906
"7873","Ocbimv22000188m.g","KQ423889",85846,87729,1883
"7874","Ocbimv22035820m.g","KQ415753",263248,263550,302
"7875","Ocbimv22024840m.g","KQ419640",3222,24452,21230
"7876","Ocbimv22025533m.g","KQ419831",582708,605297,22589
"7877","Ocbimv22011121m.g","KQ417751",78081,80624,2543
"7878","Ocbimv22016588m.g","KQ418368",474816,475503,687
"7879","Ocbimv22028563m.g","KQ420522",206346,219637,13291
"7880","Ocbimv22011911m.g","KQ427949",139612,152978,13366
"7881","Ocbimv22014536m.g","KQ428981",15527,21122,5595
"7882","Ocbimv22025781m.g","KQ415695",71584,71853,269
"7883","Ocbimv22028432m.g","KQ420486",44087,50300,6213
"7884","Ocbimv22037150m.g","KQ416677",600688,600876,188
"7885","Ocbimv22026992m.g","KQ420159",189624,205915,16291
"7886","Ocbimv22012164m.g","KQ428053",12927,14212,1285
"7887","Ocbimv22008534m.g","KQ426670",5981,27288,21307
"7888","Ocbimv22008570m.g","KQ417510",41661,82302,40641
"7889","Ocbimv22017302m.g","KQ430253",7036,38388,31352
"7890","Ocbimv22036511m.g","KQ422783",56098,69638,13540
"7891","Ocbimv22020688m.g","KQ418954",90691,90945,254
"7892","Ocbimv22007694m.g","KQ415846",1083873,1084091,218
"7893","Ocbimv22018226m.g","KQ415990",2018725,2072906,54181
"7894","Ocbimv22020772m.g","KQ418964",256,41824,41568
"7895","Ocbimv22007747m.g","KQ415847",587223,610053,22830
"7896","Ocbimv22035594m.g","KQ416594",33543,49407,15864
"7897","Ocbimv22005354m.g","KQ425593",18443,30345,11902
"7898","Ocbimv22004970m.g","KQ425490",160174,161730,1556
"7899","Ocbimv22022394m.g","KQ419215",114091,172361,58270
"7900","Ocbimv22002898m.g","KQ424814",563427,564867,1440
"7901","Ocbimv22030444m.g","KQ416350",87521,88350,829
"7902","Ocbimv22023777m.g","KQ416096",1272762,1275658,2896
"7903","Ocbimv22019884m.g","KQ418832",219584,227212,7628
"7904","Ocbimv22024035m.g","KQ416109",612037,612198,161
"7905","Ocbimv22039882m.g","KQ416833",36446,37233,787
"7906","Ocbimv22029773m.g","KQ420820",876306,876740,434
"7907","Ocbimv22009145m.g","KQ415861",276337,277212,875
"7908","Ocbimv22023567m.g","KQ419432",247015,247323,308
"7909","Ocbimv22021343m.g","KQ416042",143782,144075,293
"7910","Ocbimv22035087m.g","KQ422274",114823,132747,17924
"7911","Ocbimv22016091m.g","KQ415954",387621,388067,446
"7912","Ocbimv22035180m.g","KQ422295",150497,267373,116876
"7913","Ocbimv22033326m.g","KQ421780",125488,136607,11119
"7914","Ocbimv22037400m.g","KQ416694",1589312,1590734,1422
"7915","Ocbimv22003474m.g","KQ425015",666575,667670,1095
"7916","Ocbimv22015916m.g","KQ418303",206150,237020,30870
"7917","Ocbimv22034816m.g","KQ422183",701,66333,65632
"7918","Ocbimv22011904m.g","KQ427949",46850,60163,13313
"7919","Ocbimv22038034m.g","KQ415762",340870,341058,188
"7920","Ocbimv22036037m.g","KQ416614",888120,889046,926
"7921","Ocbimv22027507m.g","KQ420294",172239,214231,41992
"7922","Ocbimv22034807m.g","KQ422178",283920,287582,3662
"7923","Ocbimv22034112m.g","KQ421978",270580,272386,1806
"7924","Ocbimv22023087m.g","KQ433206",19537,67400,47863
"7925","Ocbimv22011403m.g","KQ417791",1108769,1109692,923
"7926","Ocbimv22010836m.g","KQ427538",33242,34652,1410
"7927","Ocbimv22019648m.g","KQ431217",22254,84181,61927
"7928","Ocbimv22025193m.g","KQ419727",279266,323485,44219
"7929","Ocbimv22023626m.g","KQ433524",604,15721,15117
"7930","Ocbimv22002638m.g","KQ417023",1229213,1245118,15905
"7931","Ocbimv22029639m.g","KQ420791",5846,6187,341
"7932","Ocbimv22000173m.g","LGKD01489467",654,803,149
"7933","Ocbimv22023113m.g","KQ419350",686210,689689,3479
"7934","Ocbimv22039312m.g","KQ416788",34508,37795,3287
"7935","Ocbimv22011898m.g","KQ415894",157331,157606,275
"7936","Ocbimv22033130m.g","KQ416468",171,49441,49270
"7937","Ocbimv22014603m.g","KQ429000",4643,6877,2234
"7938","Ocbimv22008257m.g","KQ417492",130910,168495,37585
"7939","Ocbimv22030665m.g","KQ421054",19877,24149,4272
"7940","Ocbimv22014661m.g","LGKD01611840",32,250,218
"7941","Ocbimv22019697m.g","KQ418800",96788,97771,983
"7942","Ocbimv22039125m.g","KQ416779",888285,904699,16414
"7943","Ocbimv22038511m.g","KQ423384",22999,26291,3292
"7944","Ocbimv22035875m.g","KQ416608",654264,654434,170
"7945","Ocbimv22003875m.g","KQ417118",466051,466561,510
"7946","Ocbimv22015638m.g","KQ418271",113926,132283,18357
"7947","Ocbimv22008906m.g","KQ417538",196717,197451,734
"7948","Ocbimv22017065m.g","KQ430152",42725,61898,19173
"7949","Ocbimv22018926m.g","KQ418698",26418,34227,7809
"7950","Ocbimv22029974m.g","KQ415714",59079,119018,59939
"7951","Ocbimv22010793m.g","KQ417715",3646,3981,335
"7952","Ocbimv22018482m.g","KQ430708",30673,39053,8380
"7953","Ocbimv22013921m.g","KQ418071",613379,613946,567
"7954","Ocbimv22021532m.g","KQ419071",131713,149520,17807
"7955","Ocbimv22006566m.g","KQ417336",751694,752806,1112
"7956","Ocbimv22017203m.g","KQ430209",60239,60592,353
"7957","Ocbimv22019754m.g","KQ431294",325126,341523,16397
"7958","Ocbimv22020056m.g","KQ431437",3745,3918,173
"7959","Ocbimv22011293m.g","KQ417777",36001,124211,88210
"7960","Ocbimv22031422m.g","KQ421240",82826,85831,3005
"7961","Ocbimv22022425m.g","KQ419216",66613,73980,7367
"7962","Ocbimv22026852m.g","KQ420130",766833,815854,49021
"7963","Ocbimv22012708m.g","KQ417929",9872,37134,27262
"7964","Ocbimv22028570m.g","KQ420524",191441,206827,15386
"7965","Ocbimv22014790m.g","KQ429073",12174,12914,740
"7966","Ocbimv22034234m.g","KQ416526",353764,387076,33312
"7967","Ocbimv22016777m.g","KQ430015",2528,22479,19951
"7968","Ocbimv22016956m.g","KQ418429",224293,245724,21431
"7969","Ocbimv22039729m.g","KQ423737",23612,25504,1892
"7970","Ocbimv22024112m.g","KQ433800",552,949,397
"7971","Ocbimv22003564m.g","KQ417090",2021362,2022181,819
"7972","Ocbimv22026786m.g","KQ420117",137240,143435,6195
"7973","Ocbimv22012274m.g","KQ417898",92842,93108,266
"7974","Ocbimv22033998m.g","KQ416507",166774,167031,257
"7975","Ocbimv22016474m.g","KQ415966",212634,213032,398
"7976","Ocbimv22024885m.g","KQ419647",1033,4468,3435
"7977","Ocbimv22004511m.g","KQ417173",3137667,3138743,1076
"7978","Ocbimv22028851m.g","KQ420593",154631,155999,1368
"7979","Ocbimv22005065m.g","KQ425510",275528,276742,1214
"7980","Ocbimv22015793m.g","KQ418293",497580,497735,155
"7981","Ocbimv22031154m.g","KQ421177",54699,71279,16580
"7982","Ocbimv22002767m.g","KQ424777",49483,78474,28991
"7983","Ocbimv22030984m.g","KQ416380",67304,78963,11659
"7984","Ocbimv22024180m.g","KQ419545",29258,35160,5902
"7985","Ocbimv22016677m.g","KQ418380",37233,37469,236
"7986","Ocbimv22033763m.g","KQ421866",46301,98936,52635
"7987","Ocbimv22037217m.g","KQ422970",37297,41908,4611
"7988","Ocbimv22001494m.g","KQ416938",159978,160277,299
"7989","Ocbimv22007676m.g","KQ415846",1254,11885,10631
"7990","Ocbimv22026035m.g","KQ419960",60305,69541,9236
"7991","Ocbimv22012287m.g","KQ428101",143066,164586,21520
"7992","Ocbimv22015666m.g","LGKD01620326",738,1235,497
"7993","Ocbimv22034141m.g","KQ416514",32290,32730,440
"7994","Ocbimv22017428m.g","KQ418495",363879,416295,52416
"7995","Ocbimv22000944m.g","KQ424129",546399,546755,356
"7996","Ocbimv22022180m.g","KQ419180",571734,748298,176564
"7997","Ocbimv22010614m.g","KQ415669",547224,549171,1947
"7998","Ocbimv22003995m.g","KQ417129",68117,68371,254
"7999","Ocbimv22006502m.g","KQ425962",3974,62872,58898
"8000","Ocbimv22036694m.g","KQ422839",196101,226061,29960
"8001","Ocbimv22023375m.g","KQ419395",288398,291313,2915
"8002","Ocbimv22034761m.g","KQ422161",45742,46221,479
"8003","Ocbimv22026535m.g","KQ420065",210456,261629,51173
"8004","Ocbimv22029800m.g","KQ420826",163389,165959,2570
"8005","Ocbimv22033916m.g","KQ421906",548983,550126,1143
"8006","Ocbimv22026363m.g","KQ416188",19267,19718,451
"8007","Ocbimv22024898m.g","KQ416131",214568,214753,185
"8008","Ocbimv22029928m.g","KQ420850",102471,102807,336
"8009","Ocbimv22032909m.g","KQ421683",156022,156834,812
"8010","Ocbimv22008255m.g","KQ426605",10987,23976,12989
"8011","Ocbimv22005792m.g","KQ415823",705401,718160,12759
"8012","Ocbimv22011861m.g","LGKD01591000",1108,1692,584
"8013","Ocbimv22026524m.g","KQ416191",15682,16027,345
"8014","Ocbimv22003769m.g","KQ417110",100323,109368,9045
"8015","Ocbimv22007668m.g","KQ426419",44817,132618,87801
"8016","Ocbimv22000642m.g","KQ424026",259065,289956,30891
"8017","Ocbimv22017076m.g","KQ430159",60031,60306,275
"8018","Ocbimv22022566m.g","KQ419260",408171,408374,203
"8019","Ocbimv22000946m.g","KQ424131",25552,25842,290
"8020","Ocbimv22000997m.g","KQ416902",286502,287029,527
"8021","Ocbimv22026928m.g","KQ416205",598395,601339,2944
"8022","Ocbimv22007110m.g","KQ417379",132272,132658,386
"8023","Ocbimv22010838m.g","KQ417719",12343,82105,69762
"8024","Ocbimv22020697m.g","KQ416032",90536,90877,341
"8025","Ocbimv22024235m.g","KQ419551",146737,147233,496
"8026","Ocbimv22011719m.g","KQ417826",10757,11097,340
"8027","Ocbimv22001872m.g","KQ424457",121263,159965,38702
"8028","Ocbimv22034791m.g","KQ416555",296919,297652,733
"8029","Ocbimv22036565m.g","KQ416645",294303,299166,4863
"8030","Ocbimv22028636m.g","KQ415707",102298,102447,149
"8031","Ocbimv22012219m.g","KQ415905",199306,199791,485
"8032","Ocbimv22009422m.g","KQ417591",1286150,1352560,66410
"8033","Ocbimv22007378m.g","KQ426313",477140,501830,24690
"8034","Ocbimv22010833m.g","KQ417718",805,44791,43986
"8035","Ocbimv22018565m.g","KQ418637",182550,221339,38789
"8036","Ocbimv22026516m.g","KQ416190",344789,344980,191
"8037","Ocbimv22008705m.g","KQ426740",323259,324393,1134
"8038","Ocbimv22017762m.g","KQ418538",10477,11250,773
"8039","Ocbimv22026542m.g","KQ420068",39419,45812,6393
"8040","Ocbimv22007180m.g","KQ426224",153168,153365,197
"8041","Ocbimv22002405m.g","KQ424658",4830,29568,24738
"8042","Ocbimv22015198m.g","KQ418205",236736,244067,7331
"8043","Ocbimv22006031m.g","KQ425784",4283,52441,48158
"8044","Ocbimv22039410m.g","KQ423651",1483335,1489640,6305
"8045","Ocbimv22029794m.g","KQ420825",2663,98830,96167
"8046","Ocbimv22011772m.g","KQ415891",371900,372299,399
"8047","Ocbimv22028674m.g","KQ420549",542105,545806,3701
"8048","Ocbimv22031103m.g","KQ416385",229782,230063,281
"8049","Ocbimv22025916m.g","KQ419926",83279,132413,49134
"8050","Ocbimv22037736m.g","KQ416708",61663,281849,220186
"8051","Ocbimv22019814m.g","KQ418820",68734,69817,1083
"8052","Ocbimv22029796m.g","KQ420825",429119,429520,401
"8053","Ocbimv22003352m.g","KQ424993",187636,252502,64866
"8054","Ocbimv22009480m.g","LGKD01570937",28,285,257
"8055","Ocbimv22018873m.g","KQ418693",543242,543775,533
"8056","Ocbimv22036209m.g","KQ422680",77416,80416,3000
"8057","Ocbimv22029297m.g","KQ420700",125149,125848,699
"8058","Ocbimv22036315m.g","KQ422711",711296,712470,1174
"8059","Ocbimv22034919m.g","KQ415742",406239,406794,555
"8060","Ocbimv22016297m.g","KQ429801",512,4591,4079
"8061","Ocbimv22006289m.g","KQ417312",40791,54796,14005
"8062","Ocbimv22039222m.g","KQ423587",175890,176075,185
"8063","Ocbimv22011183m.g","KQ427664",16080,81764,65684
"8064","Ocbimv22018213m.g","KQ415990",1714313,1714939,626
"8065","Ocbimv22032457m.g","KQ421549",105209,106339,1130
"8066","Ocbimv22035839m.g","KQ416604",26882,97238,70356
"8067","Ocbimv22014259m.g","KQ418108",80540,88570,8030
"8068","Ocbimv22009738m.g","KQ417609",334962,336731,1769
"8069","Ocbimv22029387m.g","KQ416303",432008,432373,365
"8070","Ocbimv22021491m.g","KQ432177",13,9937,9924
"8071","Ocbimv22020332m.g","KQ418895",151942,152634,692
"8072","Ocbimv22032849m.g","KQ421665",256539,293814,37275
"8073","Ocbimv22026592m.g","KQ416194",156852,157316,464
"8074","Ocbimv22021678m.g","KQ416051",255169,270414,15245
"8075","Ocbimv22014979m.g","KQ418190",105218,105520,302
"8076","Ocbimv22011443m.g","KQ427749",7991,22107,14116
"8077","Ocbimv22003139m.g","KQ417061",567188,568933,1745
"8078","Ocbimv22005894m.g","KQ425751",107304,114142,6838
"8079","Ocbimv22012518m.g","KQ417917",483767,497416,13649
"8080","Ocbimv22020049m.g","KQ418845",110,51876,51766
"8081","Ocbimv22028486m.g","KQ420502",247943,252698,4755
"8082","Ocbimv22022508m.g","KQ419238",4004,11070,7066
"8083","Ocbimv22016976m.g","KQ418431",347651,396070,48419
"8084","Ocbimv22006767m.g","KQ426101",20531,21047,516
"8085","Ocbimv22014952m.g","KQ418188",14017,15042,1025
"8086","Ocbimv22024071m.g","KQ419532",45859,46851,992
"8087","Ocbimv22030531m.g","KQ421014",89732,98499,8767
"8088","Ocbimv22039339m.g","KQ416789",140806,147441,6635
"8089","Ocbimv22035769m.g","KQ416600",107845,123305,15460
"8090","Ocbimv22023943m.g","KQ416106",435988,437144,1156
"8091","Ocbimv22035124m.g","KQ422284",96925,97086,161
"8092","Ocbimv22007715m.g","KQ417446",92240,113853,21613
"8093","Ocbimv22001303m.g","KQ424264",70283,70603,320
"8094","Ocbimv22005366m.g","KQ425599",4177,25107,20930
"8095","Ocbimv22017644m.g","KQ430408",11833,13029,1196
"8096","Ocbimv22035909m.g","KQ422600",1010,5127,4117
"8097","Ocbimv22024740m.g","KQ419622",57968,61571,3603
"8098","Ocbimv22007780m.g","KQ426456",195552,208872,13320
"8099","Ocbimv22035509m.g","KQ422415",65944,161719,95775
"8100","Ocbimv22008540m.g","KQ426670",107734,131080,23346
"8101","Ocbimv22014646m.g","KQ418162",10296,17177,6881
"8102","Ocbimv22011650m.g","KQ427833",49374,49871,497
"8103","Ocbimv22005754m.g","KQ425734",4612,4821,209
"8104","Ocbimv22029351m.g","KQ420715",182217,187198,4981
"8105","Ocbimv22033116m.g","KQ421731",131183,131443,260
"8106","Ocbimv22022281m.g","KQ419192",408056,410472,2416
"8107","Ocbimv22036825m.g","KQ422866",11567,47498,35931
"8108","Ocbimv22008982m.g","KQ417547",34972,106044,71072
"8109","Ocbimv22013632m.g","KQ418040",269317,270329,1012
"8110","Ocbimv22039194m.g","KQ416784",617886,622719,4833
"8111","Ocbimv22029446m.g","KQ416306",1910789,1911514,725
"8112","Ocbimv22027068m.g","KQ420174",122100,122489,389
"8113","Ocbimv22027303m.g","KQ420250",26656,41624,14968
"8114","Ocbimv22011689m.g","KQ417821",6430,46574,40144
"8115","Ocbimv22022771m.g","KQ419292",393605,394752,1147
"8116","Ocbimv22020873m.g","KQ418971",404089,424847,20758
"8117","Ocbimv22022521m.g","KQ432825",1075,3694,2619
"8118","Ocbimv22037719m.g","KQ423115",96,1714,1618
"8119","Ocbimv22012140m.g","KQ415902",649946,651293,1347
"8120","Ocbimv22009932m.g","KQ417623",358800,367944,9144
"8121","Ocbimv22011775m.g","KQ415891",433090,433527,437
"8122","Ocbimv22017880m.g","KQ418552",780794,801834,21040
"8123","Ocbimv22006285m.g","KQ425853",2,447,445
"8124","Ocbimv22007792m.g","KQ426456",418932,474253,55321
"8125","Ocbimv22011993m.g","KQ417851",699693,701721,2028
"8126","Ocbimv22023177m.g","KQ419368",63057,123862,60805
"8127","Ocbimv22035291m.g","KQ422349",228510,229757,1247
"8128","Ocbimv22014964m.g","KQ418188",229610,229903,293
"8129","Ocbimv22024343m.g","KQ419574",264498,264961,463
"8130","Ocbimv22035633m.g","KQ422481",217014,241353,24339
"8131","Ocbimv22010113m.g","KQ427263",151828,163745,11917
"8132","Ocbimv22014530m.g","KQ428979",53875,65214,11339
"8133","Ocbimv22026998m.g","KQ420160",167881,168135,254
"8134","Ocbimv22005326m.g","KQ417240",507440,507673,233
"8135","Ocbimv22025076m.g","KQ416137",262601,263053,452
"8136","Ocbimv22026664m.g","KQ416196",285581,319129,33548
"8137","Ocbimv22006128m.g","KQ417300",256290,256473,183
"8138","Ocbimv22004187m.g","KQ425220",370956,410891,39935
"8139","Ocbimv22013313m.g","KQ418009",683609,683875,266
"8140","Ocbimv22028715m.g","KQ416268",209814,223666,13852
"8141","Ocbimv22007661m.g","LGKD01557346",4,153,149
"8142","Ocbimv22005963m.g","KQ417286",293361,293867,506
"8143","Ocbimv22029258m.g","KQ420694",130439,131343,904
"8144","Ocbimv22017769m.g","KQ418543",447738,448355,617
"8145","Ocbimv22022313m.g","KQ432663",1873,152153,150280
"8146","Ocbimv22038788m.g","KQ423464",731127,732704,1577
"8147","Ocbimv22026858m.g","KQ420131",5893,93035,87142
"8148","Ocbimv22035224m.g","KQ422321",166068,166253,185
"8149","Ocbimv22011742m.g","KQ427887",67677,68798,1121
"8150","Ocbimv22021012m.g","KQ418991",6775,23891,17116
"8151","Ocbimv22039064m.g","KQ423531",336623,356860,20237
"8152","Ocbimv22016157m.g","KQ429717",3615,10804,7189
"8153","Ocbimv22036989m.g","KQ422901",31813,33319,1506
"8154","Ocbimv22028330m.g","KQ420475",488682,506633,17951
"8155","Ocbimv22021134m.g","KQ419009",94218,201184,106966
"8156","Ocbimv22002523m.g","KQ417012",382084,383476,1392
"8157","Ocbimv22039218m.g","KQ423586",13470,122806,109336
"8158","Ocbimv22027576m.g","KQ420308",56150,64740,8590
"8159","Ocbimv22000096m.g","KQ423852",14935,17045,2110
"8160","Ocbimv22009393m.g","KQ426988",10947,12646,1699
"8161","Ocbimv22030222m.g","KQ420924",382157,398168,16011
"8162","Ocbimv22033914m.g","KQ421906",485735,515991,30256
"8163","Ocbimv22013294m.g","KQ418007",554645,560282,5637
"8164","Ocbimv22000101m.g","KQ423859",27113,27803,690
"8165","Ocbimv22020040m.g","KQ418844",124230,155748,31518
"8166","Ocbimv22013352m.g","KQ428460",48152,48571,419
"8167","Ocbimv22006612m.g","KQ426030",89152,89730,578
"8168","Ocbimv22017884m.g","KQ430502",6827,8178,1351
"8169","Ocbimv22009519m.g","KQ415865",749518,750155,637
"8170","Ocbimv22003071m.g","KQ424877",143678,143872,194
"8171","Ocbimv22036269m.g","KQ416628",506611,546028,39417
"8172","Ocbimv22025665m.g","KQ419879",21484,22515,1031
"8173","Ocbimv22034811m.g","KQ422178",325511,326041,530
"8174","Ocbimv22032169m.g","KQ421464",674904,697613,22709
"8175","Ocbimv22029355m.g","KQ420718",147935,149389,1454
"8176","Ocbimv22013162m.g","KQ417995",757146,758845,1699
"8177","Ocbimv22021872m.g","KQ419115",27176,50501,23325
"8178","Ocbimv22011740m.g","KQ427887",22759,30705,7946
"8179","Ocbimv22033555m.g","KQ421830",98602,105575,6973
"8180","Ocbimv22029169m.g","KQ420672",393250,408865,15615
"8181","Ocbimv22036369m.g","KQ422728",6042,6560,518
"8182","Ocbimv22017564m.g","KQ418506",346927,347532,605
"8183","Ocbimv22002963m.g","KQ417051",1452353,1452653,300
"8184","Ocbimv22006524m.g","KQ425982",147293,147466,173
"8185","Ocbimv22028919m.g","KQ416274",2016618,2017988,1370
"8186","Ocbimv22039795m.g","KQ423753",3686,4742,1056
"8187","Ocbimv22027808m.g","KQ416233",1059610,1059938,328
"8188","Ocbimv22008531m.g","LGKD01563341",44,340,296
"8189","Ocbimv22035943m.g","KQ416612",339022,339189,167
"8190","Ocbimv22027690m.g","KQ420342",35149,36045,896
"8191","Ocbimv22009260m.g","KQ417578",898880,905065,6185
"8192","Ocbimv22007603m.g","KQ415844",146428,146976,548
"8193","Ocbimv22030643m.g","KQ421042",315,728,413
"8194","Ocbimv22008262m.g","KQ417492",274930,289084,14154
"8195","Ocbimv22015141m.g","KQ418200",16477,61215,44738
"8196","Ocbimv22037798m.g","KQ423136",55486,62011,6525
"8197","Ocbimv22028189m.g","KQ420442",31323,34482,3159
"8198","Ocbimv22024001m.g","KQ419518",9639,10897,1258
"8199","Ocbimv22014093m.g","KQ418088",95924,96685,761
"8200","Ocbimv22015633m.g","KQ418269",1085359,1096987,11628
"8201","Ocbimv22026030m.g","KQ419959",880,1294,414
"8202","Ocbimv22009494m.g","KQ415865",426617,428953,2336
"8203","Ocbimv22006446m.g","KQ417320",106786,107306,520
"8204","Ocbimv22028865m.g","KQ420595",260650,324591,63941
"8205","Ocbimv22029444m.g","KQ416306",1880325,1880717,392
"8206","Ocbimv22033035m.g","KQ416466",85511,85984,473
"8207","Ocbimv22003075m.g","KQ424877",212813,220008,7195
"8208","Ocbimv22024803m.g","KQ419631",208258,211692,3434
"8209","Ocbimv22031730m.g","KQ421331",7,1139,1132
"8210","Ocbimv22030311m.g","KQ420942",535283,554831,19548
"8211","Ocbimv22031837m.g","KQ421356",674417,677002,2585
"8212","Ocbimv22005606m.g","KQ417266",42062,43387,1325
"8213","Ocbimv22034421m.g","KQ416530",343018,343347,329
"8214","Ocbimv22011530m.g","KQ417798",137234,139142,1908
"8215","Ocbimv22037429m.g","KQ416694",2894445,2894873,428
"8216","Ocbimv22033233m.g","KQ421758",554041,577386,23345
"8217","Ocbimv22007688m.g","KQ415846",218239,226869,8630
"8218","Ocbimv22008131m.g","KQ417481",180181,180773,592
"8219","Ocbimv22025448m.g","KQ419803",26561,42606,16045
"8220","Ocbimv22013816m.g","KQ428678",34051,34362,311
"8221","Ocbimv22037113m.g","KQ422923",326834,332332,5498
"8222","Ocbimv22029977m.g","KQ420866",8274,13343,5069
"8223","Ocbimv22027458m.g","KQ416225",12409,15497,3088
"8224","Ocbimv22022042m.g","KQ419152",63719,72006,8287
"8225","Ocbimv22035700m.g","LGKD01443723",111,266,155
"8226","Ocbimv22022123m.g","KQ419175",355775,360117,4342
"8227","Ocbimv22036561m.g","KQ416645",82761,133488,50727
"8228","Ocbimv22035775m.g","KQ416600",416083,496318,80235
"8229","Ocbimv22008133m.g","KQ417481",204462,205934,1472
"8230","Ocbimv22030898m.g","KQ421117",1269388,1270036,648
"8231","Ocbimv22037050m.g","KQ422909",1103033,1133422,30389
"8232","Ocbimv22031536m.g","KQ421269",21544,23108,1564
"8233","Ocbimv22034758m.g","KQ422146",115165,115362,197
"8234","Ocbimv22007794m.g","KQ426456",597472,598344,872
"8235","Ocbimv22030277m.g","KQ416340",180563,182844,2281
"8236","Ocbimv22018686m.g","KQ418653",26858,498248,471390
"8237","Ocbimv22029645m.g","KQ416314",96974,137082,40108
"8238","Ocbimv22009236m.g","LGKD01569140",22,153,131
"8239","Ocbimv22006852m.g","KQ417358",602184,616046,13862
"8240","Ocbimv22024174m.g","KQ419543",742348,793107,50759
"8241","Ocbimv22028309m.g","KQ420468",92459,94498,2039
"8242","Ocbimv22014123m.g","KQ418092",154957,155993,1036
"8243","Ocbimv22030128m.g","KQ420902",158005,158713,708
"8244","Ocbimv22007207m.g","KQ426242",83645,121940,38295
"8245","Ocbimv22008209m.g","KQ426582",80446,80871,425
"8246","Ocbimv22039254m.g","KQ423593",61547,63895,2348
"8247","Ocbimv22007548m.g","KQ426371",333559,334104,545
"8248","Ocbimv22034419m.g","KQ416530",110179,116877,6698
"8249","Ocbimv22002344m.g","KQ417003",292604,292801,197
"8250","Ocbimv22000026m.g","KQ423826",74057,74332,275
"8251","Ocbimv22030205m.g","KQ420924",134243,136739,2496
"8252","Ocbimv22022522m.g","KQ419241",70344,70841,497
"8253","Ocbimv22023164m.g","KQ419366",111773,116845,5072
"8254","Ocbimv22016070m.g","KQ418317",26661,26810,149
"8255","Ocbimv22010740m.g","LGKD01581963",35,376,341
"8256","Ocbimv22006195m.g","KQ417301",174989,181133,6144
"8257","Ocbimv22019076m.g","KQ418715",78019,92154,14135
"8258","Ocbimv22016569m.g","KQ418368",100679,105358,4679
"8259","Ocbimv22024370m.g","KQ419574",931805,954235,22430
"8260","Ocbimv22020726m.g","KQ418956",635795,636037,242
"8261","Ocbimv22014533m.g","KQ428980",8082,8657,575
"8262","Ocbimv22007530m.g","KQ417421",480825,481217,392
"8263","Ocbimv22030286m.g","KQ420939",225720,316483,90763
"8264","Ocbimv22000529m.g","KQ423988",28030,57788,29758
"8265","Ocbimv22000583m.g","KQ415778",288901,291249,2348
"8266","Ocbimv22025276m.g","KQ419758",12620,87575,74955
"8267","Ocbimv22002252m.g","KQ424585",66670,127108,60438
"8268","Ocbimv22037126m.g","KQ422927",106051,106443,392
"8269","Ocbimv22021513m.g","KQ432202",48589,50835,2246
"8270","Ocbimv22009420m.g","KQ417591",1235856,1271177,35321
"8271","Ocbimv22018346m.g","KQ418609",808724,809596,872
"8272","Ocbimv22036135m.g","KQ416620",139541,204756,65215
"8273","Ocbimv22001006m.g","LGKD01122047",151,339,188
"8274","Ocbimv22029275m.g","KQ420696",372376,373357,981
"8275","Ocbimv22010821m.g","KQ427527",132994,140266,7272
"8276","Ocbimv22033840m.g","KQ421894",14422,17626,3204
"8277","Ocbimv22017729m.g","KQ430446",7442,9526,2084
"8278","Ocbimv22028153m.g","KQ420439",108471,108953,482
"8279","Ocbimv22018813m.g","KQ416002",1179708,1180007,299
"8280","Ocbimv22023381m.g","KQ419395",347807,352548,4741
"8281","Ocbimv22032483m.g","KQ416432",102184,132099,29915
"8282","Ocbimv22005396m.g","KQ417249",1335210,1338690,3480
"8283","Ocbimv22030204m.g","KQ420924",109253,127062,17809
"8284","Ocbimv22010214m.g","KQ427311",82628,119299,36671
"8285","Ocbimv22036522m.g","KQ422783",126970,127557,587
"8286","Ocbimv22008586m.g","KQ417510",349733,367929,18196
"8287","Ocbimv22028630m.g","KQ420537",212149,230561,18412
"8288","Ocbimv22027514m.g","KQ420295",10174,10398,224
"8289","Ocbimv22034706m.g","KQ416547",263671,292308,28637
"8290","Ocbimv22039940m.g","KQ423805",2971,4875,1904
"8291","Ocbimv22022037m.g","KQ432523",1788,3769,1981
"8292","Ocbimv22005593m.g","KQ425659",78603,79464,861
"8293","Ocbimv22014332m.g","KQ418119",32297,37287,4990
"8294","Ocbimv22011510m.g","KQ417796",600544,704097,103553
"8295","Ocbimv22008659m.g","KQ426725",575,9033,8458
"8296","Ocbimv22008607m.g","KQ417510",697226,698559,1333
"8297","Ocbimv22004812m.g","KQ417208",203294,219640,16346
"8298","Ocbimv22009432m.g","KQ426995",3725,4257,532
"8299","Ocbimv22023821m.g","KQ419484",52413,53016,603
"8300","Ocbimv22016756m.g","KQ418393",49350,73928,24578
"8301","Ocbimv22009172m.g","KQ415862",283651,305321,21670
"8302","Ocbimv22002003m.g","KQ416979",1499240,1512155,12915
"8303","Ocbimv22018368m.g","KQ418610",173850,186181,12331
"8304","Ocbimv22038618m.g","KQ423419",23448,25269,1821
"8305","Ocbimv22024961m.g","KQ419667",15286,81941,66655
"8306","Ocbimv22029050m.g","KQ420635",1249,36562,35313
"8307","Ocbimv22023469m.g","KQ419414",439654,440939,1285
"8308","Ocbimv22039354m.g","KQ423631",30555,31041,486
"8309","Ocbimv22017228m.g","KQ418469",449252,483562,34310
"8310","Ocbimv22038332m.g","KQ423285",48680,49352,672
"8311","Ocbimv22008591m.g","KQ417510",458912,479201,20289
"8312","Ocbimv22031955m.g","KQ421389",332032,344582,12550
"8313","Ocbimv22034869m.g","KQ416560",118912,119232,320
"8314","Ocbimv22026822m.g","KQ420123",185124,186045,921
"8315","Ocbimv22005949m.g","KQ417285",139930,161366,21436
"8316","Ocbimv22037859m.g","KQ423139",901288,918342,17054
"8317","Ocbimv22007671m.g","KQ426421",15201,16731,1530
"8318","Ocbimv22032961m.g","KQ421695",83022,83525,503
"8319","Ocbimv22010686m.g","KQ417701",510171,525557,15386
"8320","Ocbimv22039722m.g","KQ416816",298922,333522,34600
"8321","Ocbimv22026377m.g","KQ416188",331941,358452,26511
"8322","Ocbimv22025870m.g","KQ419917",128368,128667,299
"8323","Ocbimv22016132m.g","KQ429712",114,16494,16380
"8324","Ocbimv22030152m.g","KQ420910",375857,376518,661
"8325","Ocbimv22006321m.g","KQ425876",546,30216,29670
"8326","Ocbimv22023613m.g","KQ419441",95601,109759,14158
"8327","Ocbimv22000773m.g","KQ416879",456418,462423,6005
"8328","Ocbimv22004149m.g","KQ417141",358104,358540,436
"8329","Ocbimv22010323m.g","KQ427354",137100,139242,2142
"8330","Ocbimv22013300m.g","KQ418008",68253,68783,530
"8331","Ocbimv22026547m.g","KQ416192",1521,61252,59731
"8332","Ocbimv22038489m.g","KQ423370",162191,162953,762
"8333","Ocbimv22033076m.g","KQ421724",175254,223793,48539
"8334","Ocbimv22022624m.g","KQ432932",32305,37098,4793
"8335","Ocbimv22029161m.g","KQ420672",160701,192132,31431
"8336","Ocbimv22031304m.g","KQ421217",719279,767176,47897
"8337","Ocbimv22027404m.g","KQ416223",445758,446178,420
"8338","Ocbimv22037504m.g","KQ423053",19422,28783,9361
"8339","Ocbimv22038460m.g","KQ416743",41416,42475,1059
"8340","Ocbimv22002163m.g","KQ424564",43748,59345,15597
"8341","Ocbimv22031436m.g","KQ421244",29324,59498,30174
"8342","Ocbimv22013853m.g","KQ415921",227640,277324,49684
"8343","Ocbimv22038402m.g","KQ423326",7371,36267,28896
"8344","Ocbimv22002519m.g","KQ417012",282681,295319,12638
"8345","Ocbimv22008826m.g","KQ426780",1983,2826,843
"8346","Ocbimv22031958m.g","KQ421389",372126,498403,126277
"8347","Ocbimv22022695m.g","KQ419281",604510,614330,9820
"8348","Ocbimv22026034m.g","KQ419960",186,18140,17954
"8349","Ocbimv22029577m.g","KQ420777",222245,252364,30119
"8350","Ocbimv22034139m.g","KQ421984",310314,314098,3784
"8351","Ocbimv22013453m.g","KQ428518",125048,125833,785
"8352","Ocbimv22003847m.g","KQ415798",15454,20548,5094
"8353","Ocbimv22036736m.g","KQ422842",38863,39378,515
"8354","Ocbimv22018250m.g","KQ418587",168480,217016,48536
"8355","Ocbimv22036851m.g","KQ416662",3064,13376,10312
"8356","Ocbimv22039456m.g","KQ423671",147843,149093,1250
"8357","Ocbimv22023221m.g","KQ419376",478574,478750,176
"8358","Ocbimv22026720m.g","KQ420102",62892,63041,149
"8359","Ocbimv22009046m.g","KQ415859",676430,712617,36187
"8360","Ocbimv22016261m.g","KQ418333",383399,384314,915
"8361","Ocbimv22037556m.g","KQ416701",16220,52791,36571
"8362","Ocbimv22038533m.g","KQ416750",577884,590119,12235
"8363","Ocbimv22000393m.g","KQ416856",29407,39239,9832
"8364","Ocbimv22028950m.g","KQ420605",802161,803544,1383
"8365","Ocbimv22012628m.g","KQ417921",1277926,1310756,32830
"8366","Ocbimv22022585m.g","KQ416072",468188,517627,49439
"8367","Ocbimv22034075m.g","KQ416508",1027144,1032221,5077
"8368","Ocbimv22013183m.g","KQ428420",24698,27509,2811
"8369","Ocbimv22005173m.g","KQ425538",17794,18074,280
"8370","Ocbimv22001251m.g","KQ424243",25172,93806,68634
"8371","Ocbimv22028082m.g","KQ420428",58710,59204,494
"8372","Ocbimv22008856m.g","KQ426791",238528,238898,370
"8373","Ocbimv22038352m.g","KQ416737",1488947,1500506,11559
"8374","Ocbimv22002807m.g","KQ417037",402179,413045,10866
"8375","Ocbimv22039476m.g","KQ423675",196378,225415,29037
"8376","Ocbimv22027999m.g","KQ420415",568827,575050,6223
"8377","Ocbimv22024952m.g","KQ419663",80717,81121,404
"8378","Ocbimv22014493m.g","KQ418142",54252,57370,3118
"8379","Ocbimv22029254m.g","KQ420694",102242,105277,3035
"8380","Ocbimv22039886m.g","KQ416833",598054,598485,431
"8381","Ocbimv22014146m.g","KQ418094",133125,159648,26523
"8382","Ocbimv22009828m.g","KQ417620",391362,394673,3311
"8383","Ocbimv22009322m.g","KQ415863",120697,139105,18408
"8384","Ocbimv22008159m.g","KQ417481",1116556,1117219,663
"8385","Ocbimv22008650m.g","KQ417518",404283,404468,185
"8386","Ocbimv22001479m.g","KQ424316",1845,7290,5445
"8387","Ocbimv22021758m.g","KQ432306",26437,26625,188
"8388","Ocbimv22022325m.g","KQ419197",738719,739060,341
"8389","Ocbimv22015221m.g","KQ415939",104364,104603,239
"8390","Ocbimv22004748m.g","KQ425434",26981,27218,237
"8391","Ocbimv22015245m.g","KQ418214",205050,205601,551
"8392","Ocbimv22012587m.g","KQ417917",1786991,1808531,21540
"8393","Ocbimv22015207m.g","KQ429203",102089,203238,101149
"8394","Ocbimv22020462m.g","LGKD01660875",240,392,152
"8395","Ocbimv22009249m.g","KQ417578",502984,503363,379
"8396","Ocbimv22037337m.g","LGKD01459807",1,570,569
"8397","Ocbimv22001971m.g","KQ424507",3030,3344,314
"8398","Ocbimv22018234m.g","KQ415990",2237165,2239030,1865
"8399","Ocbimv22015757m.g","KQ429539",57935,59912,1977
"8400","Ocbimv22004724m.g","KQ425427",200608,200862,254
"8401","Ocbimv22038561m.g","KQ416751",382921,383212,291
"8402","Ocbimv22021324m.g","KQ419029",192734,192895,161
"8403","Ocbimv22039443m.g","KQ416799",1218188,1219119,931
"8404","Ocbimv22038554m.g","KQ423398",218189,218524,335
"8405","Ocbimv22010527m.g","KQ417687",732684,732872,188
"8406","Ocbimv22037275m.g","KQ422987",639725,639958,233
"8407","Ocbimv22038221m.g","KQ416731",665815,670215,4400
"8408","Ocbimv22027523m.g","KQ420299",3642,12862,9220
"8409","Ocbimv22011767m.g","KQ415891",66688,94003,27315
"8410","Ocbimv22035270m.g","KQ422349",21992,30428,8436
"8411","Ocbimv22004293m.g","KQ417146",149439,164319,14880
"8412","Ocbimv22026515m.g","KQ416190",314467,314771,304
"8413","Ocbimv22018112m.g","KQ430572",385549,408907,23358
"8414","Ocbimv22027501m.g","KQ416226",257205,299046,41841
"8415","Ocbimv22018177m.g","KQ430594",121851,127645,5794
"8416","Ocbimv22007978m.g","KQ426514",180073,186593,6520
"8417","Ocbimv22039879m.g","KQ416832",327726,344928,17202
"8418","Ocbimv22039869m.g","KQ416832",82721,84933,2212
"8419","Ocbimv22004791m.g","KQ417206",155626,161749,6123
"8420","Ocbimv22008234m.g","KQ426596",280645,280863,218
"8421","Ocbimv22014444m.g","LGKD01609491",186,563,377
"8422","Ocbimv22011933m.g","KQ427950",12224,43454,31230
"8423","Ocbimv22039334m.g","KQ416788",411296,426217,14921
"8424","Ocbimv22034063m.g","KQ416508",839349,847914,8565
"8425","Ocbimv22014516m.g","KQ415932",754170,754858,688
"8426","Ocbimv22027555m.g","KQ420302",45677,46586,909
"8427","Ocbimv22021679m.g","KQ416051",274546,278971,4425
"8428","Ocbimv22037908m.g","KQ416715",244991,247189,2198
"8429","Ocbimv22003359m.g","KQ424993",488621,696042,207421
"8430","Ocbimv22018134m.g","LGKD01641120",188,1396,1208
"8431","Ocbimv22023835m.g","KQ416099",877970,888241,10271
"8432","Ocbimv22027103m.g","KQ420181",1322109,1322647,538
"8433","Ocbimv22000148m.g","KQ423870",58765,59204,439
"8434","Ocbimv22015558m.g","KQ429416",293754,294973,1219
"8435","Ocbimv22012375m.g","KQ417907",6610,19842,13232
"8436","Ocbimv22004158m.g","KQ425220",94145,101566,7421
"8437","Ocbimv22028171m.g","KQ420439",568671,592947,24276
"8438","Ocbimv22013012m.g","KQ417972",203877,204035,158
"8439","Ocbimv22010567m.g","KQ417691",438996,450913,11917
"8440","Ocbimv22012462m.g","KQ428165",165407,168751,3344
"8441","Ocbimv22002005m.g","KQ416979",1552715,1574523,21808
"8442","Ocbimv22013447m.g","LGKD01601846",1,168,167
"8443","Ocbimv22009798m.g","KQ427137",205338,205589,251
"8444","Ocbimv22007729m.g","KQ417447",253121,253391,270
"8445","Ocbimv22012573m.g","KQ417917",1488418,1489604,1186
"8446","Ocbimv22022190m.g","KQ419180",1002117,1006360,4243
"8447","Ocbimv22030313m.g","KQ420944",35695,49128,13433
"8448","Ocbimv22025394m.g","KQ419788",205807,206193,386
"8449","Ocbimv22016253m.g","KQ418333",70380,78331,7951
"8450","Ocbimv22018833m.g","KQ418686",50664,50861,197
"8451","Ocbimv22022737m.g","KQ416074",528636,529217,581
"8452","Ocbimv22037326m.g","KQ423001",471669,473223,1554
"8453","Ocbimv22005728m.g","KQ425731",1736,21888,20152
"8454","Ocbimv22036680m.g","KQ415756",92256,92663,407
"8455","Ocbimv22000384m.g","KQ423941",539470,540507,1037
"8456","Ocbimv22005860m.g","KQ417280",293805,298048,4243
"8457","Ocbimv22026421m.g","KQ420047",348392,383339,34947
"8458","Ocbimv22038466m.g","KQ423354",145817,146239,422
"8459","Ocbimv22039490m.g","KQ423675",658974,701802,42828
"8460","Ocbimv22028964m.g","KQ420618",67541,87303,19762
"8461","Ocbimv22005266m.g","KQ425562",27890,28234,344
"8462","Ocbimv22029554m.g","KQ420776",380870,410420,29550
"8463","Ocbimv22000622m.g","KQ416870",56693,64288,7595
"8464","Ocbimv22004922m.g","KQ425468",55856,56050,194
"8465","Ocbimv22006006m.g","KQ425779",257043,265032,7989
"8466","Ocbimv22005868m.g","KQ417280",337137,338650,1513
"8467","Ocbimv22005592m.g","KQ425658",351,587,236
"8468","Ocbimv22007166m.g","KQ417386",1307875,1342760,34885
"8469","Ocbimv22037653m.g","KQ416705",862344,862715,371
"8470","Ocbimv22026062m.g","KQ419975",104386,176762,72376
"8471","Ocbimv22008299m.g","KQ417496",153478,209169,55691
"8472","Ocbimv22020773m.g","KQ418964",51700,98431,46731
"8473","Ocbimv22039522m.g","KQ423686",175956,256009,80053
"8474","Ocbimv22021785m.g","KQ419102",50214,51323,1109
"8475","Ocbimv22033511m.g","KQ421821",915422,917288,1866
"8476","Ocbimv22026472m.g","KQ420054",9222,17227,8005
"8477","Ocbimv22032203m.g","KQ421479",393485,394057,572
"8478","Ocbimv22022879m.g","KQ419318",341482,341804,322
"8479","Ocbimv22033992m.g","KQ416504",23592,24484,892
"8480","Ocbimv22021463m.g","KQ416046",1003628,1055170,51542
"8481","Ocbimv22031776m.g","KQ421343",30913,32297,1384
"8482","Ocbimv22015990m.g","KQ418307",48264,81102,32838
"8483","Ocbimv22005780m.g","KQ415823",289564,290808,1244
"8484","Ocbimv22012751m.g","KQ415909",90461,94390,3929
"8485","Ocbimv22036956m.g","KQ416666",1772811,1780270,7459
"8486","Ocbimv22033101m.g","KQ421727",114455,115096,641
"8487","Ocbimv22016716m.g","KQ418389",15778,18618,2840
"8488","Ocbimv22007518m.g","KQ426359",40165,40386,221
"8489","Ocbimv22003483m.g","KQ425015",830804,831904,1100
"8490","Ocbimv22016095m.g","KQ429708",247,7957,7710
"8491","Ocbimv22002870m.g","KQ424812",198154,198330,176
"8492","Ocbimv22030527m.g","KQ421010",479641,479874,233
"8493","Ocbimv22029198m.g","KQ420675",145520,145681,161
"8494","Ocbimv22032335m.g","KQ421523",791415,804302,12887
"8495","Ocbimv22031453m.g","KQ421252",15758,18525,2767
"8496","Ocbimv22001014m.g","KQ424157",25099,80855,55756
"8497","Ocbimv22000507m.g","KQ415777",332588,333069,481
"8498","Ocbimv22018425m.g","KQ430690",1487,3616,2129
"8499","Ocbimv22030354m.g","KQ420960",2141,3328,1187
"8500","Ocbimv22038188m.g","KQ423231",228245,236903,8658
"8501","Ocbimv22023186m.g","KQ419368",301864,307410,5546
"8502","Ocbimv22020793m.g","KQ418966",5053,9132,4079
"8503","Ocbimv22022320m.g","KQ419197",362742,363362,620
"8504","Ocbimv22024706m.g","KQ419618",5850,9612,3762
"8505","Ocbimv22024676m.g","KQ419614",29108,29290,182
"8506","Ocbimv22033324m.g","KQ421779",130610,130819,209
"8507","Ocbimv22001547m.g","KQ424353",192185,215139,22954
"8508","Ocbimv22029242m.g","KQ420690",356984,358215,1231
"8509","Ocbimv22007293m.g","KQ417400",25990,26901,911
"8510","Ocbimv22013528m.g","KQ428547",609,1156,547
"8511","Ocbimv22011438m.g","KQ427746",431853,432038,185
"8512","Ocbimv22026923m.g","KQ416205",302255,302521,266
"8513","Ocbimv22004936m.g","KQ425476",20375,39821,19446
"8514","Ocbimv22026993m.g","KQ420159",194917,195801,884
"8515","Ocbimv22016833m.g","KQ418409",85389,85550,161
"8516","Ocbimv22013243m.g","KQ418003",386583,387168,585
"8517","Ocbimv22017648m.g","KQ418523",61846,64383,2537
"8518","Ocbimv22028035m.g","KQ416244",119408,121738,2330
"8519","Ocbimv22008346m.g","KQ417497",1918786,1963659,44873
"8520","Ocbimv22025340m.g","KQ419776",60309,60512,203
"8521","Ocbimv22032750m.g","KQ421655",7869,23597,15728
"8522","Ocbimv22014026m.g","KQ418079",386325,391254,4929
"8523","Ocbimv22038055m.g","KQ423210",34619,38514,3895
"8524","Ocbimv22003555m.g","KQ417090",1788969,1789121,152
"8525","Ocbimv22010027m.g","KQ415869",140414,141075,661
"8526","Ocbimv22001642m.g","KQ416950",1626040,1641231,15191
"8527","Ocbimv22028583m.g","KQ420525",360775,361068,293
"8528","Ocbimv22034560m.g","KQ422077",122789,125683,2894
"8529","Ocbimv22022126m.g","KQ419175",392358,393130,772
"8530","Ocbimv22016201m.g","KQ418327",12056,47868,35812
"8531","Ocbimv22017883m.g","KQ430502",1967,6527,4560
"8532","Ocbimv22022214m.g","KQ416062",41659,56277,14618
"8533","Ocbimv22028853m.g","KQ420593",234928,279984,45056
"8534","Ocbimv22023104m.g","KQ433220",1765,3915,2150
"8535","Ocbimv22015630m.g","KQ418269",808028,809218,1190
"8536","Ocbimv22009155m.g","KQ426902",43321,44214,893
"8537","Ocbimv22036907m.g","KQ422894",333362,340068,6706
"8538","Ocbimv22001940m.g","KQ424482",47167,50248,3081
"8539","Ocbimv22029440m.g","KQ416306",1423867,1424016,149
"8540","Ocbimv22022634m.g","KQ432932",377996,379447,1451
"8541","Ocbimv22001974m.g","KQ415787",44452,44973,521
"8542","Ocbimv22007569m.g","KQ417430",201478,202726,1248
"8543","Ocbimv22007819m.g","KQ426461",375400,490730,115330
"8544","Ocbimv22014585m.g","KQ428994",225923,228504,2581
"8545","Ocbimv22038211m.g","KQ416731",608799,609498,699
"8546","Ocbimv22039083m.g","KQ423541",31039,35997,4958
"8547","Ocbimv22031543m.g","KQ421273",117722,119015,1293
"8548","Ocbimv22003275m.g","KQ424932",435466,454416,18950
"8549","Ocbimv22015372m.g","KQ418232",601384,601560,176
"8550","Ocbimv22025048m.g","KQ416136",790415,809859,19444
"8551","Ocbimv22027636m.g","KQ415703",176177,176347,170
"8552","Ocbimv22007461m.g","KQ426348",8874,11219,2345
"8553","Ocbimv22027753m.g","KQ420358",2150,18225,16075
"8554","Ocbimv22032840m.g","KQ421664",1625483,1625683,200
"8555","Ocbimv22039778m.g","KQ423748",40750,43309,2559
"8556","Ocbimv22008450m.g","KQ415854",121360,126110,4750
"8557","Ocbimv22029008m.g","KQ416279",616780,627895,11115
"8558","Ocbimv22003002m.g","KQ417053",449,598,149
"8559","Ocbimv22014240m.g","KQ428817",1118,2395,1277
"8560","Ocbimv22029698m.g","KQ420807",40789,41298,509
"8561","Ocbimv22003152m.g","KQ424899",1358,17735,16377
"8562","Ocbimv22039366m.g","KQ423632",49077,50756,1679
"8563","Ocbimv22035655m.g","KQ422493",306237,331904,25667
"8564","Ocbimv22035482m.g","KQ422401",168772,178935,10163
"8565","Ocbimv22024848m.g","KQ419640",119308,125366,6058
"8566","Ocbimv22006917m.g","KQ417362",80816,81038,222
"8567","Ocbimv22019360m.g","KQ418755",136269,172171,35902
"8568","Ocbimv22032230m.g","KQ421487",90190,111654,21464
"8569","Ocbimv22001177m.g","KQ424217",10472,70554,60082
"8570","Ocbimv22014607m.g","KQ429003",6820,17179,10359
"8571","Ocbimv22002271m.g","KQ424608",39554,39990,436
"8572","Ocbimv22001542m.g","KQ424353",116312,116764,452
"8573","Ocbimv22003102m.g","KQ415796",379112,383008,3896
"8574","Ocbimv22015582m.g","KQ429429",19132,49559,30427
"8575","Ocbimv22005819m.g","KQ417280",50178,53433,3255
"8576","Ocbimv22032182m.g","KQ421471",78936,81092,2156
"8577","Ocbimv22008951m.g","KQ426818",21894,24325,2431
"8578","Ocbimv22026994m.g","KQ420159",238806,239301,495
"8579","Ocbimv22031737m.g","KQ421336",16599,16853,254
"8580","Ocbimv22023091m.g","KQ419346",76814,77166,352
"8581","Ocbimv22016315m.g","KQ418338",283014,286330,3316
"8582","Ocbimv22021066m.g","KQ431974",141526,223411,81885
"8583","Ocbimv22027286m.g","KQ420243",28500,29492,992
"8584","Ocbimv22036508m.g","KQ422783",12792,13079,287
"8585","Ocbimv22039609m.g","KQ423717",77202,78623,1421
"8586","Ocbimv22011376m.g","KQ417791",354697,479708,125011
"8587","Ocbimv22013644m.g","KQ418042",85149,148179,63030
"8588","Ocbimv22024268m.g","KQ433917",65356,66914,1558
"8589","Ocbimv22008780m.g","KQ426774",47247,47599,352
"8590","Ocbimv22035175m.g","KQ422295",28048,29475,1427
"8591","Ocbimv22017083m.g","KQ430161",134150,135026,876
"8592","Ocbimv22019074m.g","KQ418715",45405,54496,9091
"8593","Ocbimv22029421m.g","KQ415710",47790,75514,27724
"8594","Ocbimv22008052m.g","KQ426550",71095,71538,443
"8595","Ocbimv22007035m.g","KQ417370",628435,629070,635
"8596","Ocbimv22024345m.g","KQ419574",308088,309049,961
"8597","Ocbimv22008743m.g","KQ417528",489834,490396,562
"8598","Ocbimv22025996m.g","KQ419947",37532,37741,209
"8599","Ocbimv22038879m.g","KQ423484",337449,337892,443
"8600","Ocbimv22017844m.g","KQ418552",124024,125790,1766
"8601","Ocbimv22014598m.g","KQ418156",293448,303345,9897
"8602","Ocbimv22037064m.g","KQ422913",112409,113892,1483
"8603","Ocbimv22027234m.g","KQ416215",74298,76791,2493
"8604","Ocbimv22030888m.g","KQ421117",111312,145415,34103
"8605","Ocbimv22008962m.g","KQ426820",86159,86413,254
"8606","Ocbimv22024509m.g","KQ419590",847657,848567,910
"8607","Ocbimv22023249m.g","KQ419380",267918,268133,215
"8608","Ocbimv22020419m.g","KQ431671",15169,69888,54719
"8609","Ocbimv22034418m.g","KQ422035",192180,192842,662
"8610","Ocbimv22030059m.g","KQ420886",62492,174845,112353
"8611","Ocbimv22019128m.g","KQ418719",20231,20752,521
"8612","Ocbimv22032926m.g","KQ421685",177036,178415,1379
"8613","Ocbimv22024246m.g","KQ419552",77711,89531,11820
"8614","Ocbimv22004056m.g","KQ425191",76975,77487,512
"8615","Ocbimv22035484m.g","KQ422401",181009,223367,42358
"8616","Ocbimv22006891m.g","KQ426135",266970,267452,482
"8617","Ocbimv22023284m.g","KQ419392",18497,41317,22820
"8618","Ocbimv22028684m.g","KQ420555",39819,40178,359
"8619","Ocbimv22038355m.g","KQ423290",74560,118608,44048
"8620","Ocbimv22021139m.g","KQ419009",180511,181086,575
"8621","Ocbimv22036224m.g","KQ416626",302635,302978,343
"8622","Ocbimv22006340m.g","KQ425879",209164,209729,565
"8623","Ocbimv22032650m.g","KQ421627",2357,60707,58350
"8624","Ocbimv22021773m.g","KQ419098",807037,807842,805
"8625","Ocbimv22000295m.g","KQ415775",345570,346366,796
"8626","Ocbimv22015737m.g","KQ429530",129925,161564,31639
"8627","Ocbimv22026722m.g","KQ420102",131116,132438,1322
"8628","Ocbimv22035491m.g","KQ422405",62597,62776,179
"8629","Ocbimv22018490m.g","KQ418626",64040,64687,647
"8630","Ocbimv22014191m.g","KQ418098",755069,772891,17822
"8631","Ocbimv22007333m.g","KQ417405",217181,218599,1418
"8632","Ocbimv22016784m.g","KQ430029",6501,13749,7248
"8633","Ocbimv22029806m.g","KQ420828",41857,51539,9682
"8634","Ocbimv22022714m.g","LGKD01681898",5,2154,2149
"8635","Ocbimv22015571m.g","KQ418267",589475,612174,22699
"8636","Ocbimv22006422m.g","KQ425915",11725,41406,29681
"8637","Ocbimv22015892m.g","KQ429618",209,1415,1206
"8638","Ocbimv22032627m.g","KQ421619",6378,16239,9861
"8639","Ocbimv22012374m.g","KQ428141",163,3133,2970
"8640","Ocbimv22016406m.g","KQ429842",19427,20324,897
"8641","Ocbimv22032836m.g","KQ421664",1363355,1363471,116
"8642","Ocbimv22021015m.g","LGKD01664692",308,887,579
"8643","Ocbimv22025725m.g","KQ416165",4166,28722,24556
"8644","Ocbimv22027002m.g","KQ420161",203074,203247,173
"8645","Ocbimv22023726m.g","KQ416095",65363,68144,2781
"8646","Ocbimv22030003m.g","KQ420880",52420,54584,2164
"8647","Ocbimv22029994m.g","KQ420877",6033,6656,623
"8648","Ocbimv22020420m.g","KQ431672",1451,2388,937
"8649","Ocbimv22018862m.g","KQ418693",335858,336916,1058
"8650","Ocbimv22013744m.g","KQ428640",64777,66219,1442
"8651","Ocbimv22038145m.g","KQ423217",683088,683246,158
"8652","Ocbimv22002226m.g","KQ416996",258355,258651,296
"8653","Ocbimv22009377m.g","KQ417588",337174,337879,705
"8654","Ocbimv22009294m.g","KQ417580",17093,32165,15072
"8655","Ocbimv22019475m.g","KQ416011",311826,410626,98800
"8656","Ocbimv22010267m.g","KQ427339",54854,94046,39192
"8657","Ocbimv22027812m.g","LGKD01350168",1690,1956,266
"8658","Ocbimv22010760m.g","KQ417713",946875,973902,27027
"8659","Ocbimv22010546m.g","KQ427431",38558,41805,3247
"8660","Ocbimv22017434m.g","KQ418496",26725,28270,1545
"8661","Ocbimv22036184m.g","KQ422667",161101,173994,12893
"8662","Ocbimv22002576m.g","KQ424701",15211,18389,3178
"8663","Ocbimv22007495m.g","KQ415843",236446,236833,387
"8664","Ocbimv22027962m.g","KQ416242",61843,91130,29287
"8665","Ocbimv22013617m.g","KQ418039",582861,604875,22014
"8666","Ocbimv22033578m.g","KQ421837",1488,30512,29024
"8667","Ocbimv22001936m.g","KQ416974",1043119,1043364,245
"8668","Ocbimv22005064m.g","KQ425510",112128,143220,31092
"8669","Ocbimv22000734m.g","KQ416877",1098447,1106357,7910
"8670","Ocbimv22028055m.g","KQ420424",96346,97884,1538
"8671","Ocbimv22030635m.g","KQ421039",242649,243561,912
"8672","Ocbimv22014855m.g","KQ418182",23042,73441,50399
"8673","Ocbimv22028978m.g","KQ416278",347831,348653,822
"8674","Ocbimv22028367m.g","KQ420477",468054,469281,1227
"8675","Ocbimv22036025m.g","KQ422633",219371,220444,1073
"8676","Ocbimv22016907m.g","KQ418422",233220,233476,256
"8677","Ocbimv22027118m.g","KQ420191",34604,36260,1656
"8678","Ocbimv22034696m.g","KQ416547",101656,104406,2750
"8679","Ocbimv22021160m.g","KQ432018",3,930,927
"8680","Ocbimv22004555m.g","KQ425361",165971,186027,20056
"8681","Ocbimv22023663m.g","KQ419456",750115,768707,18592
"8682","Ocbimv22036796m.g","KQ416657",515678,526858,11180
"8683","Ocbimv22025809m.g","KQ419907",127359,128896,1537
"8684","Ocbimv22005526m.g","KQ425647",18080,38461,20381
"8685","Ocbimv22017873m.g","KQ418552",631260,631838,578
"8686","Ocbimv22034230m.g","KQ416526",217299,230316,13017
"8687","Ocbimv22012243m.g","KQ428083",22517,22687,170
"8688","Ocbimv22018141m.g","KQ415987",341046,389158,48112
"8689","Ocbimv22016664m.g","KQ418376",217445,234123,16678
"8690","Ocbimv22021657m.g","KQ416049",122675,124999,2324
"8691","Ocbimv22003888m.g","KQ417119",6294,8213,1919
"8692","Ocbimv22017713m.g","KQ418530",2349,43764,41415
"8693","Ocbimv22013035m.g","KQ428349",245594,286966,41372
"8694","Ocbimv22027463m.g","KQ416225",41934,46595,4661
"8695","Ocbimv22017795m.g","KQ418547",163319,163606,287
"8696","Ocbimv22001923m.g","KQ416974",4453,5075,622
"8697","Ocbimv22025073m.g","KQ416137",176590,210679,34089
"8698","Ocbimv22007225m.g","KQ426253",68665,70063,1398
"8699","Ocbimv22015739m.g","KQ429530",190738,191016,278
"8700","Ocbimv22013972m.g","KQ428716",3892,7790,3898
"8701","Ocbimv22006198m.g","KQ417303",34106,34548,442
"8702","Ocbimv22026393m.g","KQ420036",21237,25573,4336
"8703","Ocbimv22038610m.g","KQ416754",414985,428348,13363
"8704","Ocbimv22030724m.g","KQ421079",147355,147549,194
"8705","Ocbimv22013832m.g","KQ418065",23794,26264,2470
"8706","Ocbimv22022208m.g","KQ416062",21286,22653,1367
"8707","Ocbimv22001313m.g","KQ416920",100360,100842,482
"8708","Ocbimv22013010m.g","KQ417972",174071,185155,11084
"8709","Ocbimv22015331m.g","KQ418223",214187,218174,3987
"8710","Ocbimv22022699m.g","KQ419282",9264,49024,39760
"8711","Ocbimv22039449m.g","KQ423671",96981,112608,15627
"8712","Ocbimv22000153m.g","KQ423871",49710,78995,29285
"8713","Ocbimv22027763m.g","KQ420358",384938,385276,338
"8714","Ocbimv22001412m.g","KQ424302",125643,139339,13696
"8715","Ocbimv22030557m.g","KQ421022",133852,134269,417
"8716","Ocbimv22037397m.g","KQ416694",1419190,1519355,100165
"8717","Ocbimv22034815m.g","KQ422179",176828,177759,931
"8718","Ocbimv22037755m.g","KQ416709",42076,43258,1182
"8719","Ocbimv22002832m.g","KQ417040",211698,235881,24183
"8720","Ocbimv22021215m.g","KQ419013",174841,175188,347
"8721","Ocbimv22031181m.g","KQ415722",44513,46737,2224
"8722","Ocbimv22019415m.g","KQ418761",47069,47260,191
"8723","Ocbimv22025596m.g","KQ419858",25013,53962,28949
"8724","Ocbimv22005917m.g","KQ417284",323720,324052,332
"8725","Ocbimv22017534m.g","KQ430344",5702,21658,15956
"8726","Ocbimv22020111m.g","KQ418855",698961,699371,410
"8727","Ocbimv22034767m.g","KQ422163",125871,126359,488
"8728","Ocbimv22028303m.g","KQ420464",424755,425243,488
"8729","Ocbimv22022794m.g","KQ416075",28671,89855,61184
"8730","Ocbimv22034585m.g","KQ416537",640105,640317,212
"8731","Ocbimv22012978m.g","KQ417965",53523,70520,16997
"8732","Ocbimv22033084m.g","KQ421724",655897,657804,1907
"8733","Ocbimv22021354m.g","KQ416042",1888417,1888623,206
"8734","Ocbimv22013635m.g","KQ418040",379276,382459,3183
"8735","Ocbimv22004156m.g","KQ425220",67957,76643,8686
"8736","Ocbimv22020447m.g","KQ416028",27840,28394,554
"8737","Ocbimv22009606m.g","KQ427052",49973,65939,15966
"8738","Ocbimv22007806m.g","LGKD01558402",294,798,504
"8739","Ocbimv22001196m.g","KQ424224",54942,55424,482
"8740","Ocbimv22014824m.g","KQ429096",501238,508850,7612
"8741","Ocbimv22007583m.g","KQ417432",94483,105520,11037
"8742","Ocbimv22013703m.g","KQ418049",171929,184411,12482
"8743","Ocbimv22019393m.g","KQ416010",245120,245491,371
"8744","Ocbimv22005118m.g","KQ415813",553393,557797,4404
"8745","Ocbimv22023450m.g","KQ419414",82846,98451,15605
"8746","Ocbimv22004792m.g","KQ417206",223229,226762,3533
"8747","Ocbimv22021893m.g","KQ419123",38193,38432,239
"8748","Ocbimv22014532m.g","LGKD01610606",19,642,623
"8749","Ocbimv22006060m.g","KQ417293",246376,310066,63690
"8750","Ocbimv22013095m.g","KQ417981",518072,527141,9069
"8751","Ocbimv22021726m.g","KQ416053",486096,487708,1612
"8752","Ocbimv22016780m.g","LGKD01630542",71,505,434
"8753","Ocbimv22031600m.g","KQ421289",41567,126085,84518
"8754","Ocbimv22000700m.g","KQ416877",152094,152408,314
"8755","Ocbimv22024309m.g","KQ419564",187771,210403,22632
"8756","Ocbimv22029257m.g","KQ420694",111472,125748,14276
"8757","Ocbimv22015880m.g","KQ429605",18013,33386,15373
"8758","Ocbimv22027369m.g","KQ420267",295586,296371,785
"8759","Ocbimv22006348m.g","KQ425887",58932,59120,188
"8760","Ocbimv22019468m.g","KQ418771",170863,180423,9560
"8761","Ocbimv22003158m.g","KQ417062",39967,40598,631
"8762","Ocbimv22035423m.g","KQ416584",151304,151513,209
"8763","Ocbimv22030721m.g","KQ421078",324468,357178,32710
"8764","Ocbimv22037273m.g","KQ422987",205180,205743,563
"8765","Ocbimv22001174m.g","KQ424212",126233,142391,16158
"8766","Ocbimv22011914m.g","KQ427949",233827,335439,101612
"8767","Ocbimv22022246m.g","KQ419189",43427,49510,6083
"8768","Ocbimv22005479m.g","KQ425612",2,151,149
"8769","Ocbimv22024590m.g","KQ419601",770597,777842,7245
"8770","Ocbimv22000083m.g","KQ416839",41727,45554,3827
"8771","Ocbimv22038053m.g","KQ423210",15087,17471,2384
"8772","Ocbimv22004914m.g","KQ417213",686349,686768,419
"8773","Ocbimv22036335m.g","KQ422714",66392,103775,37383
"8774","Ocbimv22012864m.g","KQ417945",971350,972306,956
"8775","Ocbimv22006202m.g","KQ417303",207308,275488,68180
"8776","Ocbimv22010773m.g","KQ427511",148471,149593,1122
"8777","Ocbimv22028228m.g","KQ420449",97897,155323,57426
"8778","Ocbimv22017725m.g","KQ430442",28134,29097,963
"8779","Ocbimv22003233m.g","KQ424913",82112,82444,332
"8780","Ocbimv22001363m.g","KQ416925",65913,121331,55418
"8781","Ocbimv22023226m.g","KQ419376",649370,667754,18384
"8782","Ocbimv22010624m.g","KQ415669",1547365,1664896,117531
"8783","Ocbimv22017419m.g","KQ418493",119863,143445,23582
"8784","Ocbimv22012943m.g","KQ428307",93614,97522,3908
"8785","Ocbimv22010226m.g","KQ417658",19885,45292,25407
"8786","Ocbimv22036064m.g","KQ416616",309386,310081,695
"8787","Ocbimv22025785m.g","KQ419904",38234,39105,871
"8788","Ocbimv22037494m.g","KQ423047",156604,157695,1091
"8789","Ocbimv22025854m.g","KQ419916",1303,6665,5362
"8790","Ocbimv22029670m.g","KQ420799",252940,253620,680
"8791","Ocbimv22038113m.g","KQ423217",37931,38275,344
"8792","Ocbimv22022821m.g","KQ433034",2660,3773,1113
"8793","Ocbimv22028765m.g","KQ420579",464709,465539,830
"8794","Ocbimv22035551m.g","KQ422436",51948,53264,1316
"8795","Ocbimv22013003m.g","KQ417972",1129,2273,1144
"8796","Ocbimv22026743m.g","KQ416198",428220,448157,19937
"8797","Ocbimv22014999m.g","KQ418194",35243,73964,38721
"8798","Ocbimv22032745m.g","KQ421651",75289,76977,1688
"8799","Ocbimv22029693m.g","KQ420806",10885,11979,1094
"8800","Ocbimv22031407m.g","KQ421232",97713,98370,657
"8801","Ocbimv22012085m.g","KQ428020",27246,27458,212
"8802","Ocbimv22021449m.g","KQ432154",22018,23065,1047
"8803","Ocbimv22024491m.g","KQ434014",10629,30386,19757
"8804","Ocbimv22030788m.g","KQ421086",326406,352928,26522
"8805","Ocbimv22016715m.g","KQ418389",11096,12642,1546
"8806","Ocbimv22023972m.g","KQ419512",106806,107494,688
"8807","Ocbimv22034892m.g","KQ422208",411104,427818,16714
"8808","Ocbimv22015588m.g","KQ415946",105731,122541,16810
"8809","Ocbimv22028064m.g","KQ420424",153270,160570,7300
"8810","Ocbimv22018809m.g","KQ416002",739099,765464,26365
"8811","Ocbimv22033660m.g","KQ421858",244374,246354,1980
"8812","Ocbimv22025764m.g","KQ416166",596075,596939,864
"8813","Ocbimv22020800m.g","KQ431862",1603,3331,1728
"8814","Ocbimv22010824m.g","KQ427527",166352,167416,1064
"8815","Ocbimv22010797m.g","KQ417715",112189,147989,35800
"8816","Ocbimv22015374m.g","KQ415674",866440,867054,614
"8817","Ocbimv22026025m.g","KQ419957",387095,389362,2267
"8818","Ocbimv22031151m.g","KQ421177",7776,14561,6785
"8819","Ocbimv22024381m.g","KQ433973",21681,45564,23883
"8820","Ocbimv22009564m.g","KQ427028",65561,167421,101860
"8821","Ocbimv22004473m.g","KQ417167",79467,79751,284
"8822","Ocbimv22010220m.g","LGKD01577842",3,344,341
"8823","Ocbimv22033845m.g","KQ421894",148928,149892,964
"8824","Ocbimv22015700m.g","KQ418278",99222,102416,3194
"8825","Ocbimv22022333m.g","KQ419199",353455,369126,15671
"8826","Ocbimv22032132m.g","KQ421454",295298,320933,25635
"8827","Ocbimv22017609m.g","KQ430378",79902,80713,811
"8828","Ocbimv22010891m.g","KQ417722",556085,567451,11366
"8829","Ocbimv22007586m.g","KQ426385",10022,125890,115868
"8830","Ocbimv22017408m.g","KQ418493",26464,41214,14750
"8831","Ocbimv22026554m.g","KQ416192",317177,340647,23470
"8832","Ocbimv22016739m.g","LGKD01629876",54,1106,1052
"8833","Ocbimv22031952m.g","KQ421389",166888,176104,9216
"8834","Ocbimv22002167m.g","KQ416992",14800,49576,34776
"8835","Ocbimv22000475m.g","KQ423977",25473,25899,426
"8836","Ocbimv22037514m.g","KQ423056",167028,173311,6283
"8837","Ocbimv22015441m.g","KQ429341",255,7220,6965
"8838","Ocbimv22024232m.g","KQ419551",28009,29395,1386
"8839","Ocbimv22014033m.g","KQ418080",339642,339947,305
"8840","Ocbimv22019751m.g","KQ431294",273865,291760,17895
"8841","Ocbimv22039656m.g","KQ423719",5584,9141,3557
"8842","Ocbimv22027123m.g","KQ420194",146567,232557,85990
"8843","Ocbimv22035851m.g","KQ416605",46004,47247,1243
"8844","Ocbimv22018302m.g","KQ418598",421738,422118,380
"8845","Ocbimv22033959m.g","KQ421920",106984,119360,12376
"8846","Ocbimv22001409m.g","KQ424302",39074,39421,347
"8847","Ocbimv22000855m.g","KQ424095",17812,18138,326
"8848","Ocbimv22039538m.g","KQ423702",9786,10462,676
"8849","Ocbimv22034588m.g","KQ422080",62755,63189,434
"8850","Ocbimv22028341m.g","KQ420477",24672,33879,9207
"8851","Ocbimv22011701m.g","KQ417824",375439,386266,10827
"8852","Ocbimv22015236m.g","KQ415940",766156,766371,215
"8853","Ocbimv22019271m.g","KQ418739",624387,721359,96972
"8854","Ocbimv22028207m.g","KQ420444",273041,283544,10503
"8855","Ocbimv22015694m.g","KQ418277",34210,35461,1251
"8856","Ocbimv22039128m.g","KQ416779",920937,997064,76127
"8857","Ocbimv22004286m.g","KQ425259",250115,250297,182
"8858","Ocbimv22021522m.g","KQ419066",154879,155839,960
"8859","Ocbimv22025778m.g","KQ415695",10445,10804,359
"8860","Ocbimv22026234m.g","KQ420017",950763,951501,738
"8861","Ocbimv22027151m.g","KQ420204",9591,9815,224
"8862","Ocbimv22002797m.g","KQ417037",169160,210543,41383
"8863","Ocbimv22008600m.g","KQ417510",564160,584471,20311
"8864","Ocbimv22025435m.g","KQ419801",282,26369,26087
"8865","Ocbimv22016171m.g","KQ429720",207709,260978,53269
"8866","Ocbimv22036202m.g","KQ422675",9244,13080,3836
"8867","Ocbimv22027222m.g","KQ416214",395309,395461,152
"8868","Ocbimv22002730m.g","KQ417030",649229,651020,1791
"8869","Ocbimv22005987m.g","KQ417288",455466,456471,1005
"8870","Ocbimv22027384m.g","KQ420268",509213,545852,36639
"8871","Ocbimv22018694m.g","KQ418653",483638,483811,173
"8872","Ocbimv22037476m.g","KQ423042",84787,90575,5788
"8873","Ocbimv22017494m.g","KQ418502",130058,133421,3363
"8874","Ocbimv22003306m.g","KQ417078",205761,257318,51557
"8875","Ocbimv22005448m.g","KQ417252",1778955,1829330,50375
"8876","Ocbimv22027713m.g","KQ420347",167085,167542,457
"8877","Ocbimv22036573m.g","KQ422794",58917,99060,40143
"8878","Ocbimv22024262m.g","KQ419558",3003,3376,373
"8879","Ocbimv22026053m.g","KQ415697",4052,10317,6265
"8880","Ocbimv22007306m.g","KQ426287",247060,260450,13390
"8881","Ocbimv22003278m.g","KQ424933",79949,86525,6576
"8882","Ocbimv22006601m.g","KQ426027",155494,162108,6614
"8883","Ocbimv22028121m.g","LGKD01353600",507,704,197
"8884","Ocbimv22018319m.g","KQ430646",90744,123917,33173
"8885","Ocbimv22017626m.g","KQ418514",21631,21912,281
"8886","Ocbimv22010136m.g","KQ427275",14085,14691,606
"8887","Ocbimv22020311m.g","KQ418888",183719,183961,242
"8888","Ocbimv22037222m.g","KQ416684",333569,354846,21277
"8889","Ocbimv22007011m.g","KQ417370",340520,383657,43137
"8890","Ocbimv22038990m.g","LGKD01477590",5,316,311
"8891","Ocbimv22001666m.g","KQ416951",655732,656499,767
"8892","Ocbimv22036191m.g","KQ422673",6302,6655,353
"8893","Ocbimv22033728m.g","KQ416495",201619,205502,3883
"8894","Ocbimv22025508m.g","KQ419828",151541,155129,3588
"8895","Ocbimv22029521m.g","KQ416311",845758,860693,14935
"8896","Ocbimv22033940m.g","KQ416499",364380,383832,19452
"8897","Ocbimv22016232m.g","KQ429763",15094,27594,12500
"8898","Ocbimv22021511m.g","KQ419063",303790,304116,326
"8899","Ocbimv22024650m.g","KQ419607",22503,32091,9588
"8900","Ocbimv22023684m.g","LGKD01691782",5,241,236
"8901","Ocbimv22016371m.g","KQ415962",871399,874524,3125
"8902","Ocbimv22032070m.g","KQ421422",1170,4529,3359
"8903","Ocbimv22039766m.g","KQ423744",36001,36381,380
"8904","Ocbimv22037718m.g","KQ423112",49074,49436,362
"8905","Ocbimv22024438m.g","KQ419577",737776,738972,1196
"8906","Ocbimv22005278m.g","KQ417238",541677,591265,49588
"8907","Ocbimv22034001m.g","KQ416507",310248,312231,1983
"8908","Ocbimv22019143m.g","KQ418721",431866,566610,134744
"8909","Ocbimv22024158m.g","KQ419543",53417,55296,1879
"8910","Ocbimv22037242m.g","KQ422973",37962,38556,594
"8911","Ocbimv22007787m.g","KQ426456",268645,280137,11492
"8912","Ocbimv22006788m.g","KQ426107",1898,55230,53332
"8913","Ocbimv22015565m.g","KQ418267",15138,17516,2378
"8914","Ocbimv22019992m.g","KQ418840",1560363,1647834,87471
"8915","Ocbimv22004328m.g","KQ417149",176541,177250,709
"8916","Ocbimv22030693m.g","KQ421067",115375,143518,28143
"8917","Ocbimv22011822m.g","KQ415893",623657,660014,36357
"8918","Ocbimv22023714m.g","KQ419463",56198,107437,51239
"8919","Ocbimv22023282m.g","KQ419392",12097,31807,19710
"8920","Ocbimv22020103m.g","KQ418855",97148,137923,40775
"8921","Ocbimv22026860m.g","KQ420132",155685,156158,473
"8922","Ocbimv22019882m.g","KQ418832",145602,145817,215
"8923","Ocbimv22032570m.g","KQ421593",190167,218404,28237
"8924","Ocbimv22014792m.g","KQ429073",26815,32866,6051
"8925","Ocbimv22020877m.g","KQ418971",438160,438729,569
"8926","Ocbimv22011790m.g","KQ417832",1027620,1077684,50064
"8927","Ocbimv22014899m.g","KQ418187",65486,184624,119138
"8928","Ocbimv22011325m.g","KQ417780",716265,719878,3613
"8929","Ocbimv22031153m.g","KQ421177",33045,53316,20271
"8930","Ocbimv22018146m.g","KQ418577",122853,130051,7198
"8931","Ocbimv22035804m.g","KQ422556",389346,395970,6624
"8932","Ocbimv22010707m.g","KQ417704",121649,122071,422
"8933","Ocbimv22012436m.g","KQ417911",886153,916477,30324
"8934","Ocbimv22032992m.g","KQ421710",101905,102240,335
"8935","Ocbimv22035468m.g","KQ422391",350175,411831,61656
"8936","Ocbimv22036575m.g","KQ422794",129944,137197,7253
"8937","Ocbimv22002598m.g","KQ424714",127242,167551,40309
"8938","Ocbimv22012739m.g","KQ417934",133965,134606,641
"8939","Ocbimv22010038m.g","KQ417633",70512,70661,149
"8940","Ocbimv22026494m.g","KQ420056",6286,6561,275
"8941","Ocbimv22029970m.g","KQ420865",134026,197790,63764
"8942","Ocbimv22020386m.g","KQ418902",81718,111302,29584
"8943","Ocbimv22010278m.g","KQ427344",106423,107199,776
"8944","Ocbimv22034226m.g","KQ422014",121339,127391,6052
"8945","Ocbimv22013140m.g","KQ417985",1202700,1202963,263
"8946","Ocbimv22020492m.g","KQ418919",512396,518388,5992
"8947","Ocbimv22023793m.g","KQ419477",16559,168653,152094
"8948","Ocbimv22012299m.g","KQ428115",104732,154784,50052
"8949","Ocbimv22018454m.g","KQ415992",624597,674206,49609
"8950","Ocbimv22033468m.g","KQ421819",348775,349011,236
"8951","Ocbimv22036035m.g","KQ416614",821967,822173,206
"8952","Ocbimv22014564m.g","KQ418153",366086,492071,125985
"8953","Ocbimv22004007m.g","KQ417132",81416,82225,809
"8954","Ocbimv22019766m.g","KQ418812",788,4187,3399
"8955","Ocbimv22039743m.g","KQ423737",114734,118216,3482
"8956","Ocbimv22021374m.g","KQ419038",53830,54105,275
"8957","Ocbimv22018267m.g","KQ430613",55706,56782,1076
"8958","Ocbimv22029492m.g","KQ420761",745385,745638,253
"8959","Ocbimv22015113m.g","KQ418195",114958,115107,149
"8960","Ocbimv22015358m.g","KQ429292",35049,42167,7118
"8961","Ocbimv22034016m.g","KQ421946",300434,300676,242
"8962","Ocbimv22012479m.g","KQ417916",3344,10450,7106
"8963","Ocbimv22011425m.g","KQ415885",1672126,1703248,31122
"8964","Ocbimv22015339m.g","KQ418224",57758,77825,20067
"8965","Ocbimv22032237m.g","KQ421487",220396,294146,73750
"8966","Ocbimv22015771m.g","KQ429551",626,5563,4937
"8967","Ocbimv22012022m.g","KQ427973",63001,132148,69147
"8968","Ocbimv22036263m.g","KQ416628",45655,87586,41931
"8969","Ocbimv22001941m.g","KQ424482",86179,106572,20393
"8970","Ocbimv22015164m.g","KQ418202",2056,3315,1259
"8971","Ocbimv22023401m.g","KQ419401",192105,203314,11209
"8972","Ocbimv22026373m.g","KQ416188",139399,172106,32707
"8973","Ocbimv22021897m.g","KQ432404",27945,28202,257
"8974","Ocbimv22003135m.g","KQ417061",112732,113071,339
"8975","Ocbimv22002945m.g","KQ424851",372829,426631,53802
"8976","Ocbimv22036887m.g","KQ416665",51909,52866,957
"8977","Ocbimv22029253m.g","KQ420694",89358,89666,308
"8978","Ocbimv22021283m.g","KQ419023",129753,147288,17535
"8979","Ocbimv22033112m.g","KQ421731",48661,55402,6741
"8980","Ocbimv22004578m.g","KQ425371",34394,64495,30101
"8981","Ocbimv22001554m.g","KQ424354",68095,68798,703
"8982","Ocbimv22035931m.g","KQ422612",15706,15927,221
"8983","Ocbimv22015102m.g","KQ418194",2756030,2775925,19895
"8984","Ocbimv22026818m.g","KQ420120",112535,159061,46526
"8985","Ocbimv22020115m.g","KQ418856",180258,184020,3762
"8986","Ocbimv22039073m.g","KQ423536",349386,350232,846
"8987","Ocbimv22005147m.g","KQ425522",10974,11774,800
"8988","Ocbimv22031784m.g","KQ421343",291667,292329,662
"8989","Ocbimv22011242m.g","KQ417767",21209,21556,347
"8990","Ocbimv22013843m.g","KQ418068",36774,37305,531
"8991","Ocbimv22021039m.g","KQ418995",28294,28536,242
"8992","Ocbimv22018230m.g","KQ415990",2197323,2197502,179
"8993","Ocbimv22020814m.g","KQ418970",369345,370188,843
"8994","Ocbimv22031966m.g","KQ421389",1169825,1182804,12979
"8995","Ocbimv22001247m.g","KQ424238",126305,142998,16693
"8996","Ocbimv22015617m.g","KQ418269",106095,142294,36199
"8997","Ocbimv22039231m.g","KQ423591",103494,112323,8829
"8998","Ocbimv22028044m.g","KQ416244",185260,190713,5453
"8999","Ocbimv22008930m.g","KQ417540",530827,532020,1193
"9000","Ocbimv22025643m.g","KQ419872",31731,32010,279
"9001","Ocbimv22010893m.g","KQ427562",11711,12844,1133
"9002","Ocbimv22010580m.g","KQ417692",161465,162196,731
"9003","Ocbimv22018987m.g","KQ418706",144938,145267,329
"9004","Ocbimv22011231m.g","KQ417763",1073463,1074243,780
"9005","Ocbimv22006531m.g","KQ425990",2471,3975,1504
"9006","Ocbimv22016597m.g","KQ418369",63841,64083,242
"9007","Ocbimv22029514m.g","KQ416311",533660,587807,54147
"9008","Ocbimv22038909m.g","KQ416771",1358196,1434391,76195
"9009","Ocbimv22031691m.g","KQ421308",789335,789997,662
"9010","Ocbimv22028368m.g","KQ420477",476980,477282,302
"9011","Ocbimv22020932m.g","KQ431889",20394,69283,48889
"9012","Ocbimv22029903m.g","KQ420841",45298,51612,6314
"9013","Ocbimv22039353m.g","KQ423631",1410,34445,33035
"9014","Ocbimv22014625m.g","KQ418158",234034,234283,249
"9015","Ocbimv22037162m.g","KQ416678",507444,517867,10423
"9016","Ocbimv22035380m.g","KQ422366",49385,56493,7108
"9017","Ocbimv22029956m.g","KQ420859",287611,289048,1437
"9018","Ocbimv22034745m.g","KQ422141",40789,44164,3375
"9019","Ocbimv22035002m.g","KQ422241",524265,524426,161
"9020","Ocbimv22027270m.g","KQ420240",534380,563518,29138
"9021","Ocbimv22031121m.g","KQ421170",560865,562260,1395
"9022","Ocbimv22035119m.g","KQ422284",14500,35647,21147
"9023","Ocbimv22017507m.g","KQ430326",52548,55064,2516
"9024","Ocbimv22013050m.g","KQ417977",93011,138918,45907
"9025","Ocbimv22010961m.g","KQ427571",13651,32190,18539
"9026","Ocbimv22010000m.g","KQ427202",172664,172876,212
"9027","Ocbimv22036028m.g","KQ416614",20193,21969,1776
"9028","Ocbimv22011245m.g","KQ417770",116569,117837,1268
"9029","Ocbimv22029397m.g","KQ420741",940299,940802,503
"9030","Ocbimv22015129m.g","KQ418196",445622,562178,116556
"9031","Ocbimv22031466m.g","KQ416399",307128,307683,555
"9032","Ocbimv22004540m.g","KQ425354",809,17723,16914
"9033","Ocbimv22002212m.g","KQ424575",14601,14759,158
"9034","Ocbimv22000902m.g","KQ415781",80741,80992,251
"9035","Ocbimv22009789m.g","KQ427132",426109,427553,1444
"9036","Ocbimv22024722m.g","KQ419621",834351,856821,22470
"9037","Ocbimv22023526m.g","KQ419425",361239,361388,149
"9038","Ocbimv22009632m.g","KQ427059",61722,82416,20694
"9039","Ocbimv22001453m.g","KQ416933",698325,729999,31674
"9040","Ocbimv22000255m.g","KQ423906",62261,74445,12184
"9041","Ocbimv22033737m.g","KQ416495",683073,697220,14147
"9042","Ocbimv22003014m.g","KQ417054",249725,251785,2060
"9043","Ocbimv22027667m.g","KQ416230",3003,3767,764
"9044","Ocbimv22035935m.g","KQ422613",90621,105582,14961
"9045","Ocbimv22006259m.g","KQ417305",541827,542479,652
"9046","Ocbimv22019067m.g","KQ416006",130632,130838,206
"9047","Ocbimv22028846m.g","KQ420593",11603,55456,43853
"9048","Ocbimv22033054m.g","KQ421721",577575,604621,27046
"9049","Ocbimv22039336m.g","KQ416788",452259,455541,3282
"9050","Ocbimv22037690m.g","KQ423101",63772,64068,296
"9051","Ocbimv22026707m.g","KQ420096",216036,266732,50696
"9052","Ocbimv22014362m.g","KQ428883",170342,171465,1123
"9053","Ocbimv22039119m.g","KQ416779",785552,809310,23758
"9054","Ocbimv22028982m.g","KQ420621",151452,152714,1262
"9055","Ocbimv22016652m.g","KQ418375",237563,240553,2990
"9056","Ocbimv22013452m.g","KQ428518",66648,66971,323
"9057","Ocbimv22005547m.g","KQ425650",28186,55260,27074
"9058","Ocbimv22021806m.g","KQ419107",948,51132,50184
"9059","Ocbimv22023097m.g","KQ419348",96134,111535,15401
"9060","Ocbimv22006226m.g","KQ425846",112473,113889,1416
"9061","Ocbimv22004995m.g","KQ415811",167991,169868,1877
"9062","Ocbimv22019105m.g","KQ430964",328631,335428,6797
"9063","Ocbimv22028340m.g","KQ420477",19354,24425,5071
"9064","Ocbimv22017319m.g","KQ418483",16339,20694,4355
"9065","Ocbimv22022726m.g","KQ416074",321084,321693,609
"9066","Ocbimv22034372m.g","KQ422021",166393,184122,17729
"9067","Ocbimv22011195m.g","KQ415884",751408,752108,700
"9068","Ocbimv22005451m.g","KQ417252",1960013,1960796,783
"9069","Ocbimv22029810m.g","KQ420828",176307,176696,389
"9070","Ocbimv22032438m.g","KQ421540",175517,176083,566
"9071","Ocbimv22018927m.g","KQ418698",49596,54712,5116
"9072","Ocbimv22024052m.g","KQ433771",14208,38996,24788
"9073","Ocbimv22015815m.g","KQ418295",129750,133469,3719
"9074","Ocbimv22015684m.g","KQ429470",273165,274982,1817
"9075","Ocbimv22010256m.g","KQ415873",266224,274936,8712
"9076","Ocbimv22005457m.g","KQ417253",63052,69273,6221
"9077","Ocbimv22023024m.g","KQ416080",455219,460423,5204
"9078","Ocbimv22019232m.g","KQ418737",41925,48208,6283
"9079","Ocbimv22005988m.g","KQ417288",682251,683207,956
"9080","Ocbimv22010669m.g","KQ417701",79796,80269,473
"9081","Ocbimv22009159m.g","KQ426905",200076,213564,13488
"9082","Ocbimv22027960m.g","KQ416242",5584,6973,1389
"9083","Ocbimv22010194m.g","KQ417654",308325,315328,7003
"9084","Ocbimv22036027m.g","KQ422634",29428,29670,242
"9085","Ocbimv22003890m.g","KQ417119",149588,174876,25288
"9086","Ocbimv22016750m.g","KQ415969",169458,169673,215
"9087","Ocbimv22009804m.g","KQ417617",303520,321668,18148
"9088","Ocbimv22022884m.g","KQ419318",478950,481193,2243
"9089","Ocbimv22034536m.g","KQ416536",204545,256969,52424
"9090","Ocbimv22014416m.g","KQ418131",263444,263620,176
"9091","Ocbimv22021083m.g","KQ419000",20528,35189,14661
"9092","Ocbimv22010808m.g","KQ427524",15749,16630,881
"9093","Ocbimv22010725m.g","KQ417705",86182,86574,392
"9094","Ocbimv22029638m.g","KQ420791",4094,5257,1163
"9095","Ocbimv22034966m.g","KQ422230",101030,107467,6437
"9096","Ocbimv22034819m.g","KQ422187",1626,62865,61239
"9097","Ocbimv22030849m.g","KQ421115",1794,2645,851
"9098","Ocbimv22022348m.g","KQ419202",657965,658829,864
"9099","Ocbimv22016984m.g","KQ418431",688548,688853,305
"9100","Ocbimv22024492m.g","KQ434016",2924,3437,513
"9101","Ocbimv22032577m.g","KQ421600",176254,178337,2083
"9102","Ocbimv22001588m.g","KQ416946",145226,219133,73907
"9103","Ocbimv22028417m.g","KQ420483",173830,176787,2957
"9104","Ocbimv22022135m.g","KQ419175",519049,519318,269
"9105","Ocbimv22034614m.g","KQ416540",178552,179450,898
"9106","Ocbimv22000880m.g","KQ416889",509210,509505,295
"9107","Ocbimv22027042m.g","KQ416209",72851,133625,60774
"9108","Ocbimv22010302m.g","KQ417666",528549,528863,314
"9109","Ocbimv22010994m.g","KQ417731",323705,332670,8965
"9110","Ocbimv22029475m.g","KQ416308",570997,586790,15793
"9111","Ocbimv22025788m.g","KQ419904",81223,81483,260
"9112","Ocbimv22020025m.g","KQ418843",111387,112821,1434
"9113","Ocbimv22027777m.g","KQ420369",83030,84307,1277
"9114","Ocbimv22023694m.g","KQ419460",207869,215879,8010
"9115","Ocbimv22001993m.g","KQ416979",981590,982037,447
"9116","Ocbimv22007575m.g","KQ426381",13702,26592,12890
"9117","Ocbimv22036489m.g","KQ422777",45320,60056,14736
"9118","Ocbimv22032705m.g","KQ421638",225075,226422,1347
"9119","Ocbimv22036293m.g","KQ422705",77537,79249,1712
"9120","Ocbimv22031909m.g","KQ421376",608534,608821,287
"9121","Ocbimv22008833m.g","KQ417537",61043,62431,1388
"9122","Ocbimv22020389m.g","LGKD01659687",6,638,632
"9123","Ocbimv22037551m.g","KQ423059",114256,116488,2232
"9124","Ocbimv22021451m.g","KQ419051",28580,28816,236
"9125","Ocbimv22029394m.g","KQ420740",42363,42647,284
"9126","Ocbimv22033839m.g","KQ421893",123850,126258,2408
"9127","Ocbimv22031656m.g","KQ421305",607696,619725,12029
"9128","Ocbimv22010108m.g","KQ427263",31577,41411,9834
"9129","Ocbimv22003439m.g","KQ417087",1112166,1112794,628
"9130","Ocbimv22037277m.g","KQ422988",188969,198252,9283
"9131","Ocbimv22006461m.g","KQ417324",4570,6555,1985
"9132","Ocbimv22008560m.g","KQ426701",32012,55719,23707
"9133","Ocbimv22022478m.g","KQ432769",20724,20939,215
"9134","Ocbimv22025647m.g","KQ419876",9830,10618,788
"9135","Ocbimv22022300m.g","KQ419193",69361,70046,685
"9136","Ocbimv22006335m.g","KQ425878",98301,98726,425
"9137","Ocbimv22031424m.g","KQ421241",336474,359104,22630
"9138","Ocbimv22030436m.g","KQ420988",51252,51455,203
"9139","Ocbimv22032943m.g","KQ421688",110737,124241,13504
"9140","Ocbimv22021226m.g","KQ432043",11287,15320,4033
"9141","Ocbimv22000132m.g","KQ416841",1486726,1487443,717
"9142","Ocbimv22016936m.g","KQ418426",8034,10225,2191
"9143","Ocbimv22003056m.g","KQ424867",124620,140953,16333
"9144","Ocbimv22034782m.g","KQ422172",27121,38119,10998
"9145","Ocbimv22003835m.g","KQ425128",226863,261900,35037
"9146","Ocbimv22022538m.g","KQ419243",62072,64587,2515
"9147","Ocbimv22026833m.g","KQ420126",379014,379199,185
"9148","Ocbimv22026185m.g","KQ420013",5637,6506,869
"9149","Ocbimv22001215m.g","KQ424229",290404,291479,1075
"9150","Ocbimv22022533m.g","KQ419241",432937,478866,45929
"9151","Ocbimv22012433m.g","KQ417911",483652,484523,871
"9152","Ocbimv22038971m.g","KQ423495",105480,227818,122338
"9153","Ocbimv22000912m.g","KQ424114",4291,10350,6059
"9154","Ocbimv22035611m.g","KQ422469",30673,79966,49293
"9155","Ocbimv22039649m.g","KQ416811",100127,101038,911
"9156","Ocbimv22030960m.g","KQ416378",529231,529644,413
"9157","Ocbimv22027572m.g","KQ420308",37933,41678,3745
"9158","Ocbimv22033509m.g","KQ421821",771615,771932,317
"9159","Ocbimv22033730m.g","KQ416495",221063,346090,125027
"9160","Ocbimv22034366m.g","KQ422020",189004,189243,239
"9161","Ocbimv22028634m.g","KQ420540",15446,45615,30169
"9162","Ocbimv22023715m.g","KQ419464",1978,2259,281
"9163","Ocbimv22030116m.g","KQ416332",3197,7175,3978
"9164","Ocbimv22022330m.g","KQ419199",263978,265916,1938
"9165","Ocbimv22009339m.g","KQ417584",41380,91615,50235
"9166","Ocbimv22014529m.g","KQ428978",18158,19263,1105
"9167","Ocbimv22006165m.g","KQ417300",1686612,1686971,359
"9168","Ocbimv22018627m.g","KQ418645",3822,20859,17037
"9169","Ocbimv22016084m.g","KQ429703",3293,13971,10678
"9170","Ocbimv22003394m.g","KQ425004",49446,72840,23394
"9171","Ocbimv22020273m.g","KQ416024",13034,14470,1436
"9172","Ocbimv22004232m.g","KQ417143",79323,79666,343
"9173","Ocbimv22016623m.g","KQ415967",173985,174188,203
"9174","Ocbimv22020901m.g","KQ418974",261682,263874,2192
"9175","Ocbimv22016814m.g","KQ415971",5126,21888,16762
"9176","Ocbimv22039714m.g","KQ416816",45345,46094,749
"9177","Ocbimv22014216m.g","KQ418101",239097,242821,3724
"9178","Ocbimv22026315m.g","KQ420025",61643,74230,12587
"9179","Ocbimv22022096m.g","KQ419162",121595,122256,661
"9180","Ocbimv22004499m.g","KQ417173",1026530,1026856,326
"9181","Ocbimv22006920m.g","KQ426143",48096,50590,2494
"9182","Ocbimv22024446m.g","KQ419580",280796,281275,479
"9183","Ocbimv22003444m.g","KQ417087",1485166,1486101,935
"9184","Ocbimv22029383m.g","KQ416303",86438,86731,293
"9185","Ocbimv22036935m.g","KQ416666",909987,938608,28621
"9186","Ocbimv22013154m.g","KQ417989",990330,990854,524
"9187","Ocbimv22022482m.g","KQ419230",274421,276552,2131
"9188","Ocbimv22033933m.g","KQ416499",227545,241129,13584
"9189","Ocbimv22010563m.g","KQ417691",375111,379150,4039
"9190","Ocbimv22009694m.g","KQ417604",308667,308879,212
"9191","Ocbimv22011783m.g","KQ417832",28480,44620,16140
"9192","Ocbimv22014720m.g","KQ418170",55466,67872,12406
"9193","Ocbimv22031388m.g","KQ421226",137826,154613,16787
"9194","Ocbimv22009881m.g","KQ417621",341898,348574,6676
"9195","Ocbimv22000835m.g","KQ424088",1050,20999,19949
"9196","Ocbimv22017714m.g","KQ418530",87567,87737,170
"9197","Ocbimv22003005m.g","KQ424863",326485,332518,6033
"9198","Ocbimv22022886m.g","LGKD01292607",57,656,599
"9199","Ocbimv22013045m.g","LGKD01028817",147,395,248
"9200","Ocbimv22025254m.g","KQ419748",466132,467327,1195
"9201","Ocbimv22008670m.g","KQ417519",841946,845751,3805
"9202","Ocbimv22023002m.g","KQ419337",237383,244608,7225
"9203","Ocbimv22000113m.g","KQ416840",244857,245258,401
"9204","Ocbimv22009116m.g","KQ415860",17675,18055,380
"9205","Ocbimv22029246m.g","KQ416295",19007,19298,291
"9206","Ocbimv22022286m.g","KQ419192",654169,673731,19562
"9207","Ocbimv22037122m.g","KQ422926",1157,3227,2070
"9208","Ocbimv22013394m.g","KQ418018",1144123,1155783,11660
"9209","Ocbimv22011635m.g","KQ427828",876,3558,2682
"9210","Ocbimv22020387m.g","KQ418902",133537,134094,557
"9211","Ocbimv22011385m.g","KQ417791",689794,696338,6544
"9212","Ocbimv22036745m.g","KQ422849",89338,95234,5896
"9213","Ocbimv22039044m.g","KQ415769",541811,542559,748
"9214","Ocbimv22000579m.g","KQ424003",9700,22458,12758
"9215","Ocbimv22012600m.g","LGKD01595903",8980,9630,650
"9216","Ocbimv22026791m.g","KQ420117",667405,667881,476
"9217","Ocbimv22000456m.g","KQ423968",225569,226443,874
"9218","Ocbimv22015603m.g","KQ415946",876488,877397,909
"9219","Ocbimv22020266m.g","KQ431563",146917,147141,224
"9220","Ocbimv22030193m.g","KQ420921",20249,43974,23725
"9221","Ocbimv22039268m.g","KQ423598",260725,270489,9764
"9222","Ocbimv22008443m.g","KQ426638",60062,62838,2776
"9223","Ocbimv22003770m.g","KQ417110",112845,144376,31531
"9224","Ocbimv22032558m.g","KQ421588",58061,63887,5826
"9225","Ocbimv22038212m.g","KQ416731",618311,621972,3661
"9226","Ocbimv22034461m.g","KQ422049",122532,123724,1192
"9227","Ocbimv22000396m.g","KQ416856",221029,221262,233
"9228","Ocbimv22023327m.g","KQ419394",51833,79604,27771
"9229","Ocbimv22028751m.g","KQ420578",62476,122288,59812
"9230","Ocbimv22003692m.g","KQ425067",1398,25640,24242
"9231","Ocbimv22000588m.g","KQ424015",124073,124808,735
"9232","Ocbimv22011109m.g","KQ427639",31099,32188,1089
"9233","Ocbimv22028685m.g","KQ420555",49333,51576,2243
"9234","Ocbimv22010008m.g","KQ427204",179458,191327,11869
"9235","Ocbimv22033323m.g","KQ421774",51505,54225,2720
"9236","Ocbimv22023409m.g","KQ419402",349884,364846,14962
"9237","Ocbimv22039617m.g","KQ416810",122675,124499,1824
"9238","Ocbimv22003843m.g","KQ425130",76778,77553,775
"9239","Ocbimv22039717m.g","KQ416816",147654,154682,7028
"9240","Ocbimv22018135m.g","KQ418576",116740,116961,221
"9241","Ocbimv22039880m.g","KQ416832",347860,373120,25260
"9242","Ocbimv22031159m.g","KQ421181",782427,783337,910
"9243","Ocbimv22019381m.g","KQ431105",33060,34348,1288
"9244","Ocbimv22008714m.g","KQ426741",16328,16579,251
"9245","Ocbimv22020939m.g","KQ418980",219552,233158,13606
"9246","Ocbimv22026161m.g","KQ420006",461311,462091,780
"9247","Ocbimv22005424m.g","KQ425601",296623,322542,25919
"9248","Ocbimv22033782m.g","KQ421871",268319,286908,18589
"9249","Ocbimv22008438m.g","KQ426638",21629,26075,4446
"9250","Ocbimv22009971m.g","KQ417629",87197,87558,361
"9251","Ocbimv22033180m.g","KQ421741",109460,120912,11452
"9252","Ocbimv22011537m.g","KQ427775",18769,57027,38258
"9253","Ocbimv22013848m.g","KQ418068",72283,73572,1289
"9254","Ocbimv22018254m.g","KQ418587",538312,586161,47849
"9255","Ocbimv22001541m.g","KQ424353",23733,24401,668
"9256","Ocbimv22003568m.g","KQ417091",66518,106217,39699
"9257","Ocbimv22011300m.g","KQ417777",171801,185868,14067
"9258","Ocbimv22018971m.g","KQ430934",107609,114248,6639
"9259","Ocbimv22019709m.g","KQ418804",689270,689661,391
"9260","Ocbimv22021123m.g","KQ416039",1051442,1051636,194
"9261","Ocbimv22029139m.g","KQ420662",686295,686791,496
"9262","Ocbimv22029186m.g","KQ420673",343708,369197,25489
"9263","Ocbimv22032882m.g","KQ416455",10501,13013,2512
"9264","Ocbimv22004319m.g","KQ425262",47897,56818,8921
"9265","Ocbimv22030776m.g","KQ421086",46831,48707,1876
"9266","Ocbimv22009272m.g","KQ426944",170370,178856,8486
"9267","Ocbimv22000073m.g","KQ423846",503494,504546,1052
"9268","Ocbimv22000078m.g","KQ423850",1302,1763,461
"9269","Ocbimv22016573m.g","KQ418368",121327,190784,69457
"9270","Ocbimv22004841m.g","KQ417209",215997,223727,7730
"9271","Ocbimv22036194m.g","KQ416625",77127,92474,15347
"9272","Ocbimv22019240m.g","KQ418738",95586,100952,5366
"9273","Ocbimv22006950m.g","KQ426164",63602,63895,293
"9274","Ocbimv22000374m.g","KQ423941",332182,428340,96158
"9275","Ocbimv22001356m.g","KQ416924",853029,853304,275
"9276","Ocbimv22012413m.g","KQ417911",64626,64988,362
"9277","Ocbimv22026289m.g","KQ420023",213531,213993,462
"9278","Ocbimv22013207m.g","KQ418002",189209,238848,49639
"9279","Ocbimv22030626m.g","KQ416359",1395212,1395625,413
"9280","Ocbimv22029300m.g","KQ420701",8627,9043,416
"9281","Ocbimv22007538m.g","KQ426370",41653,43194,1541
"9282","Ocbimv22022429m.g","KQ419216",94199,95803,1604
"9283","Ocbimv22012112m.g","KQ417874",400325,439016,38691
"9284","Ocbimv22026981m.g","KQ420157",225377,228155,2778
"9285","Ocbimv22014777m.g","KQ418176",1040064,1040387,323
"9286","Ocbimv22017872m.g","KQ418552",598618,617171,18553
"9287","Ocbimv22010844m.g","KQ417719",234557,259443,24886
"9288","Ocbimv22036794m.g","KQ416657",484610,491165,6555
"9289","Ocbimv22002297m.g","KQ424625",8,3886,3878
"9290","Ocbimv22000013m.g","KQ423821",222663,222902,239
"9291","Ocbimv22033576m.g","KQ421836",679642,680193,551
"9292","Ocbimv22038264m.g","KQ423254",256448,256693,245
"9293","Ocbimv22027257m.g","KQ420239",87071,113100,26029
"9294","Ocbimv22034559m.g","KQ422077",118981,119427,446
"9295","Ocbimv22016955m.g","KQ418429",147223,224038,76815
"9296","Ocbimv22021903m.g","KQ432412",7892,11713,3821
"9297","Ocbimv22012697m.g","KQ417928",99563,99760,197
"9298","Ocbimv22006424m.g","KQ425917",1865,2029,164
"9299","Ocbimv22021459m.g","KQ416046",74295,74963,668
"9300","Ocbimv22012577m.g","KQ417917",1635877,1648144,12267
"9301","Ocbimv22035262m.g","KQ416580",189607,189918,311
"9302","Ocbimv22034555m.g","KQ422077",3833,19739,15906
"9303","Ocbimv22026808m.g","KQ416203",563155,590932,27777
"9304","Ocbimv22030779m.g","KQ421086",87445,88739,1294
"9305","Ocbimv22006349m.g","KQ417315",24221,25413,1192
"9306","Ocbimv22029360m.g","KQ420720",210397,210669,272
"9307","Ocbimv22017683m.g","KQ430417",40015,40931,916
"9308","Ocbimv22002162m.g","KQ424564",20432,37975,17543
"9309","Ocbimv22028548m.g","KQ416260",680604,683199,2595
"9310","Ocbimv22020320m.g","KQ418892",45743,47051,1308
"9311","Ocbimv22036761m.g","KQ416656",24128,29189,5061
"9312","Ocbimv22024646m.g","KQ419605",1347031,1347327,296
"9313","Ocbimv22022502m.g","KQ432796",1,673,672
"9314","Ocbimv22012291m.g","KQ428108",2734,45438,42704
"9315","Ocbimv22035359m.g","KQ416582",210154,222230,12076
"9316","Ocbimv22024581m.g","KQ419601",567674,667627,99953
"9317","Ocbimv22031185m.g","KQ415722",113484,113675,191
"9318","Ocbimv22018432m.g","KQ415992",78317,87253,8936
"9319","Ocbimv22029329m.g","KQ416298",245681,280389,34708
"9320","Ocbimv22038860m.g","KQ415768",754180,770242,16062
"9321","Ocbimv22024027m.g","KQ419523",56005,64872,8867
"9322","Ocbimv22018461m.g","KQ418619",22254,23980,1726
"9323","Ocbimv22029799m.g","KQ420826",113299,114075,776
"9324","Ocbimv22023330m.g","KQ433345",3854,4342,488
"9325","Ocbimv22038817m.g","KQ416766",131763,133611,1848
"9326","Ocbimv22004068m.g","KQ425192",89424,91280,1856
"9327","Ocbimv22016329m.g","LGKD01233651",1160,2585,1425
"9328","Ocbimv22004225m.g","KQ417143",41401,41700,299
"9329","Ocbimv22006796m.g","KQ426112",287098,287396,298
"9330","Ocbimv22025841m.g","KQ419911",18678,25837,7159
"9331","Ocbimv22021599m.g","KQ432245",64552,65919,1367
"9332","Ocbimv22038734m.g","KQ416764",147851,192398,44547
"9333","Ocbimv22013247m.g","KQ418004",234356,235021,665
"9334","Ocbimv22002714m.g","KQ424755",321685,346112,24427
"9335","Ocbimv22017487m.g","KQ418501",30344,30726,382
"9336","Ocbimv22015239m.g","KQ415940",1371280,1382484,11204
"9337","Ocbimv22008535m.g","KQ426670",18732,19025,293
"9338","Ocbimv22016680m.g","KQ418380",63220,64014,794
"9339","Ocbimv22010322m.g","KQ427354",102733,135814,33081
"9340","Ocbimv22016180m.g","KQ418323",378781,379662,881
"9341","Ocbimv22011515m.g","KQ417796",743573,743833,260
"9342","Ocbimv22030615m.g","KQ416359",1132938,1151701,18763
"9343","Ocbimv22033982m.g","KQ421935",35967,37360,1393
"9344","Ocbimv22029094m.g","KQ420646",382714,382974,260
"9345","Ocbimv22036371m.g","KQ422730",10935,69245,58310
"9346","Ocbimv22029190m.g","KQ420673",411083,415017,3934
"9347","Ocbimv22027209m.g","KQ420220",48176,48873,697
"9348","Ocbimv22009060m.g","KQ417556",252794,253420,626
"9349","Ocbimv22031277m.g","LGKD01390611",3505,3933,428
"9350","Ocbimv22021907m.g","KQ432421",860,14442,13582
"9351","Ocbimv22011076m.g","KQ427619",126600,127094,494
"9352","Ocbimv22026239m.g","KQ420017",1125230,1158797,33567
"9353","Ocbimv22011014m.g","KQ427587",213513,218564,5051
"9354","Ocbimv22013028m.g","KQ428349",126403,181907,55504
"9355","Ocbimv22017893m.g","KQ418555",146210,148161,1951
"9356","Ocbimv22004155m.g","KQ425220",60330,63172,2842
"9357","Ocbimv22036925m.g","LGKD01455612",233,490,257
"9358","Ocbimv22037369m.g","KQ423021",12880,13560,680
"9359","Ocbimv22003473m.g","KQ425015",664525,666574,2049
"9360","Ocbimv22007234m.g","KQ426258",47608,52201,4593
"9361","Ocbimv22028311m.g","KQ420471",59778,65461,5683
"9362","Ocbimv22027649m.g","KQ420330",163302,163796,494
"9363","Ocbimv22012063m.g","KQ417858",258472,258780,308
"9364","Ocbimv22013316m.g","KQ418010",29010,30349,1339
"9365","Ocbimv22017669m.g","KQ418525",310305,310833,528
"9366","Ocbimv22024437m.g","KQ419577",730790,732478,1688
"9367","Ocbimv22019920m.g","KQ431376",167399,248396,80997
"9368","Ocbimv22029419m.g","KQ415710",840,18012,17172
"9369","Ocbimv22030504m.g","KQ421006",86147,93868,7721
"9370","Ocbimv22013834m.g","KQ418066",7317,25284,17967
"9371","Ocbimv22037028m.g","KQ422909",339813,360813,21000
"9372","Ocbimv22004395m.g","KQ425295",31142,31291,149
"9373","Ocbimv22022151m.g","KQ419176",541249,542695,1446
"9374","Ocbimv22008147m.g","KQ417481",556981,557283,302
"9375","Ocbimv22009401m.g","KQ417591",287514,287769,255
"9376","Ocbimv22028936m.g","KQ420605",14400,25904,11504
"9377","Ocbimv22011259m.g","KQ417771",501869,505764,3895
"9378","Ocbimv22028528m.g","KQ420517",297900,298079,179
"9379","Ocbimv22016842m.g","KQ418413",6160,14243,8083
"9380","Ocbimv22023864m.g","KQ419490",12046,15181,3135
"9381","Ocbimv22015398m.g","KQ429320",198510,201546,3036
"9382","Ocbimv22033301m.g","KQ421768",81531,82421,890
"9383","Ocbimv22021433m.g","KQ419049",26311,28324,2013
"9384","Ocbimv22004641m.g","KQ417191",30248,36100,5852
"9385","Ocbimv22038364m.g","LGKD01470026",73,240,167
"9386","Ocbimv22021664m.g","KQ416049",301741,343098,41357
"9387","Ocbimv22019227m.g","KQ431062",13626,13913,287
"9388","Ocbimv22009304m.g","KQ417581",171664,173026,1362
"9389","Ocbimv22007015m.g","KQ417370",444949,468891,23942
"9390","Ocbimv22017786m.g","KQ418545",24623,65654,41031
"9391","Ocbimv22024047m.g","KQ433769",150421,199193,48772
"9392","Ocbimv22001327m.g","KQ424266",9288,24694,15406
"9393","Ocbimv22000655m.g","KQ424040",1273,2399,1126
"9394","Ocbimv22036621m.g","KQ416651",556145,558183,2038
"9395","Ocbimv22011127m.g","KQ417752",53045,66827,13782
"9396","Ocbimv22000249m.g","KQ423905",167871,176098,8227
"9397","Ocbimv22005138m.g","KQ415813",1377636,1384033,6397
"9398","Ocbimv22006858m.g","KQ417358",771362,790463,19101
"9399","Ocbimv22032453m.g","KQ421549",32406,66469,34063
"9400","Ocbimv22004843m.g","KQ417209",344329,368564,24235
"9401","Ocbimv22009972m.g","KQ417629",143634,143828,194
"9402","Ocbimv22001483m.g","LGKD01502443",1,219,218
"9403","Ocbimv22010516m.g","KQ417685",37571,37741,170
"9404","Ocbimv22009111m.g","KQ417563",6691,6987,296
"9405","Ocbimv22033356m.g","KQ421798",18734,23541,4807
"9406","Ocbimv22011568m.g","KQ427785",22306,24108,1802
"9407","Ocbimv22025671m.g","KQ419883",184842,185096,254
"9408","Ocbimv22017031m.g","KQ418441",184061,221027,36966
"9409","Ocbimv22030694m.g","KQ421067",145120,149343,4223
"9410","Ocbimv22003886m.g","KQ415799",62865,79175,16310
"9411","Ocbimv22022950m.g","KQ419329",111058,111414,356
"9412","Ocbimv22006034m.g","KQ417290",12665,50176,37511
"9413","Ocbimv22016613m.g","KQ418370",208748,256097,47349
"9414","Ocbimv22013114m.g","KQ428371",71833,77916,6083
"9415","Ocbimv22007859m.g","KQ417455",329533,350297,20764
"9416","Ocbimv22012896m.g","KQ428273",19434,19628,194
"9417","Ocbimv22013338m.g","KQ428450",2228,11781,9553
"9418","Ocbimv22009816m.g","KQ417620",144549,159307,14758
"9419","Ocbimv22012599m.g","LGKD01595903",5370,8711,3341
"9420","Ocbimv22035730m.g","KQ422521",323589,326973,3384
"9421","Ocbimv22035591m.g","KQ422450",46687,47622,935
"9422","Ocbimv22038096m.g","KQ423214",50079,63960,13881
"9423","Ocbimv22023738m.g","KQ419470",499851,515984,16133
"9424","Ocbimv22026635m.g","KQ420083",76787,77658,871
"9425","Ocbimv22013782m.g","KQ428662",166770,168411,1641
"9426","Ocbimv22025246m.g","KQ419743",490825,511375,20550
"9427","Ocbimv22015798m.g","KQ429581",48520,101500,52980
"9428","Ocbimv22000937m.g","KQ424123",41788,72824,31036
"9429","Ocbimv22038864m.g","KQ416769",512933,513319,386
"9430","Ocbimv22008508m.g","KQ417506",666933,729503,62570
"9431","Ocbimv22028770m.g","KQ420579",547605,600663,53058
"9432","Ocbimv22031925m.g","KQ416413",784823,785110,287
"9433","Ocbimv22001883m.g","KQ424459",331805,336083,4278
"9434","Ocbimv22028339m.g","KQ420477",16355,19365,3010
"9435","Ocbimv22029104m.g","KQ420650",25943,26209,266
"9436","Ocbimv22008675m.g","KQ417519",1333402,1333608,206
"9437","Ocbimv22004920m.g","KQ417213",915079,915447,368
"9438","Ocbimv22035910m.g","KQ422600",24909,29894,4985
"9439","Ocbimv22021677m.g","KQ416051",183164,237677,54513
"9440","Ocbimv22008110m.g","KQ426567",208127,211641,3514
"9441","Ocbimv22002839m.g","KQ424801",3235,107799,104564
"9442","Ocbimv22028703m.g","KQ416267",71943,113751,41808
"9443","Ocbimv22015157m.g","KQ429170",2413,3036,623
"9444","Ocbimv22012046m.g","KQ427990",28047,28924,877
"9445","Ocbimv22006161m.g","KQ417300",1243474,1244092,618
"9446","Ocbimv22003742m.g","KQ425080",80482,80733,251
"9447","Ocbimv22022445m.g","KQ419216",308385,344966,36581
"9448","Ocbimv22020718m.g","KQ431809",55,417,362
"9449","Ocbimv22019650m.g","KQ431217",92248,92961,713
"9450","Ocbimv22029189m.g","KQ420673",402812,409381,6569
"9451","Ocbimv22004676m.g","KQ415808",2526,3995,1469
"9452","Ocbimv22033851m.g","KQ421896",9885,67320,57435
"9453","Ocbimv22039924m.g","KQ423797",188275,191155,2880
"9454","Ocbimv22024432m.g","KQ419577",570227,570898,671
"9455","Ocbimv22021966m.g","KQ432471",95861,227080,131219
"9456","Ocbimv22022582m.g","KQ416072",100310,100657,347
"9457","Ocbimv22013997m.g","KQ418075",457826,483194,25368
"9458","Ocbimv22014469m.g","KQ418139",106724,107421,697
"9459","Ocbimv22022221m.g","KQ416062",167153,186989,19836
"9460","Ocbimv22027590m.g","KQ420313",65040,65465,425
"9461","Ocbimv22030590m.g","KQ421032",128359,128937,578
"9462","Ocbimv22004993m.g","KQ415811",69111,70809,1698
"9463","Ocbimv22024259m.g","KQ433896",6265,73381,67116
"9464","Ocbimv22003933m.g","KQ425151",44290,44529,239
"9465","Ocbimv22028034m.g","KQ416244",102907,103305,398
"9466","Ocbimv22008482m.g","KQ426645",26728,28070,1342
"9467","Ocbimv22034499m.g","KQ422062",300899,310598,9699
"9468","Ocbimv22025498m.g","KQ419822",36235,105973,69738
"9469","Ocbimv22016891m.g","KQ418420",32431,59671,27240
"9470","Ocbimv22039250m.g","KQ423592",67901,81266,13365
"9471","Ocbimv22034651m.g","KQ416544",117530,121178,3648
"9472","Ocbimv22032140m.g","KQ421460",141425,147493,6068
"9473","Ocbimv22034474m.g","KQ422053",10406,11111,705
"9474","Ocbimv22035677m.g","KQ422505",2903,3079,176
"9475","Ocbimv22021798m.g","KQ419103",555420,555731,311
"9476","Ocbimv22009188m.g","KQ426913",54034,56292,2258
"9477","Ocbimv22002884m.g","KQ424814",164327,165106,779
"9478","Ocbimv22007731m.g","KQ417447",541594,547108,5514
"9479","Ocbimv22006177m.g","KQ417300",2913638,2915191,1553
"9480","Ocbimv22005051m.g","KQ425507",103064,105792,2728
"9481","Ocbimv22027025m.g","KQ420166",89933,90207,274
"9482","Ocbimv22027470m.g","KQ416225",83641,84101,460
"9483","Ocbimv22022212m.g","KQ416062",31132,31380,248
"9484","Ocbimv22001961m.g","KQ424499",29691,31607,1916
"9485","Ocbimv22000846m.g","KQ424093",10598,11245,647
"9486","Ocbimv22017826m.g","KQ430486",29465,29734,269
"9487","Ocbimv22037284m.g","KQ422989",258459,323842,65383
"9488","Ocbimv22005386m.g","KQ417249",699908,700454,546
"9489","Ocbimv22016896m.g","KQ418420",147096,147368,272
"9490","Ocbimv22027311m.g","KQ416221",482934,483470,536
"9491","Ocbimv22030460m.g","KQ420992",30928,31185,257
"9492","Ocbimv22032539m.g","KQ421579",35724,107245,71521
"9493","Ocbimv22007775m.g","KQ426456",157960,167107,9147
"9494","Ocbimv22010841m.g","KQ417719",212111,234529,22418
"9495","Ocbimv22026184m.g","KQ420013",2725,3068,343
"9496","Ocbimv22021813m.g","KQ432339",1311,2386,1075
"9497","Ocbimv22008793m.g","KQ426774",104116,111494,7378
"9498","Ocbimv22007714m.g","KQ417446",70537,89943,19406
"9499","Ocbimv22000945m.g","KQ424129",772846,773169,323
"9500","Ocbimv22010656m.g","KQ427464",198819,198977,158
"9501","Ocbimv22000014m.g","KQ423821",552051,556475,4424
"9502","Ocbimv22026753m.g","KQ420109",67640,70126,2486
"9503","Ocbimv22036816m.g","KQ416658",2015256,2016186,930
"9504","Ocbimv22026593m.g","KQ416194",284005,284274,269
"9505","Ocbimv22030196m.g","KQ420921",76713,84119,7406
"9506","Ocbimv22011766m.g","KQ415891",2354,2976,622
"9507","Ocbimv22013284m.g","KQ418007",242601,243303,702
"9508","Ocbimv22020600m.g","LGKD01661651",165,675,510
"9509","Ocbimv22031987m.g","KQ421396",167178,184105,16927
"9510","Ocbimv22011246m.g","KQ427690",3,976,973
"9511","Ocbimv22030096m.g","KQ416331",100008,100784,776
"9512","Ocbimv22033414m.g","KQ421806",167710,168057,347
"9513","Ocbimv22030990m.g","KQ416380",276115,283808,7693
"9514","Ocbimv22006104m.g","KQ425821",28084,46579,18495
"9515","Ocbimv22005205m.g","KQ417232",945342,946387,1045
"9516","Ocbimv22029073m.g","KQ420642",138527,141127,2600
"9517","Ocbimv22017662m.g","KQ418525",204277,204971,694
"9518","Ocbimv22002092m.g","KQ424538",215854,256067,40213
"9519","Ocbimv22001980m.g","KQ415787",962751,978439,15688
"9520","Ocbimv22010945m.g","KQ417726",37409,37904,495
"9521","Ocbimv22021684m.g","KQ416051",558832,650538,91706
"9522","Ocbimv22002275m.g","KQ424608",90763,95116,4353
"9523","Ocbimv22009389m.g","KQ426987",98974,99900,926
"9524","Ocbimv22025963m.g","KQ419936",196040,199541,3501
"9525","Ocbimv22027744m.g","KQ420356",12903,14497,1594
"9526","Ocbimv22031724m.g","KQ421325",267224,267478,254
"9527","Ocbimv22038843m.g","KQ416768",432559,445279,12720
"9528","Ocbimv22014732m.g","KQ418173",52519,55514,2995
"9529","Ocbimv22001095m.g","KQ424178",333807,334274,467
"9530","Ocbimv22002391m.g","KQ424656",10181,33436,23255
"9531","Ocbimv22008390m.g","KQ426626",4016,95905,91889
"9532","Ocbimv22003633m.g","KQ417097",65893,101235,35342
"9533","Ocbimv22012939m.g","KQ428307",1704,25260,23556
"9534","Ocbimv22039409m.g","KQ423651",1430818,1479465,48647
"9535","Ocbimv22026557m.g","KQ416193",40818,48341,7523
"9536","Ocbimv22022642m.g","KQ419277",26715,39531,12816
"9537","Ocbimv22039767m.g","KQ423744",52737,53165,428
"9538","Ocbimv22006411m.g","KQ425905",71082,73491,2409
"9539","Ocbimv22036133m.g","KQ422651",291997,292407,410
"9540","Ocbimv22016111m.g","KQ429709",1038,4757,3719
"9541","Ocbimv22028883m.g","KQ420601",162991,163743,752
"9542","Ocbimv22013781m.g","KQ428662",37919,38398,479
"9543","Ocbimv22011419m.g","KQ415885",1371144,1371296,152
"9544","Ocbimv22011613m.g","KQ427808",71743,72668,925
"9545","Ocbimv22039176m.g","LGKD01111490",150,353,203
"9546","Ocbimv22014134m.g","KQ428771",5161,6239,1078
"9547","Ocbimv22001312m.g","KQ424264",350539,356366,5827
"9548","Ocbimv22009418m.g","KQ417591",1223735,1231740,8005
"9549","Ocbimv22021441m.g","KQ419049",133659,135214,1555
"9550","Ocbimv22016631m.g","KQ415967",525430,525693,263
"9551","Ocbimv22027309m.g","KQ416221",114977,115744,767
"9552","Ocbimv22028930m.g","KQ416274",2141727,2144528,2801
"9553","Ocbimv22014314m.g","LGKD01608224",18,434,416
"9554","Ocbimv22006636m.g","KQ426043",258667,297244,38577
"9555","Ocbimv22020244m.g","KQ431554",43584,47272,3688
"9556","Ocbimv22022747m.g","KQ416074",799881,817541,17660
"9557","Ocbimv22020824m.g","KQ418970",1046330,1055887,9557
"9558","Ocbimv22026391m.g","KQ420036",8003,9934,1931
"9559","Ocbimv22008481m.g","KQ417503",93429,140663,47234
"9560","Ocbimv22012813m.g","KQ417942",909791,910126,335
"9561","Ocbimv22023236m.g","KQ433284",1490,11370,9880
"9562","Ocbimv22036692m.g","KQ422839",179345,180464,1119
"9563","Ocbimv22011939m.g","KQ417847",779996,787042,7046
"9564","Ocbimv22033892m.g","KQ421901",120272,120475,203
"9565","Ocbimv22038564m.g","KQ423404",5887,6821,934
"9566","Ocbimv22032031m.g","KQ421411",353004,370479,17475
"9567","Ocbimv22006851m.g","KQ417358",374115,382512,8397
"9568","Ocbimv22004679m.g","KQ425420",22352,22708,356
"9569","Ocbimv22022264m.g","KQ416064",2420802,2444225,23423
"9570","Ocbimv22004874m.g","KQ417211",419439,420553,1114
"9571","Ocbimv22037414m.g","KQ416694",2598591,2599279,688
"9572","Ocbimv22037673m.g","KQ416705",3068534,3074530,5996
"9573","Ocbimv22022974m.g","KQ419332",10051,10308,257
"9574","Ocbimv22029735m.g","KQ420814",95702,198652,102950
"9575","Ocbimv22023371m.g","KQ419395",284450,284611,161
"9576","Ocbimv22025006m.g","KQ419683",65,6387,6322
"9577","Ocbimv22033836m.g","KQ421893",72756,73517,761
"9578","Ocbimv22036822m.g","KQ422861",375003,375209,206
"9579","Ocbimv22013322m.g","KQ418012",97729,106713,8984
"9580","Ocbimv22034702m.g","KQ416547",151543,179609,28066
"9581","Ocbimv22023162m.g","KQ419366",72826,89650,16824
"9582","Ocbimv22031485m.g","KQ421261",18485,22042,3557
"9583","Ocbimv22030977m.g","KQ421139",4635,7589,2954
"9584","Ocbimv22039971m.g","KQ415773",194184,194770,586
"9585","Ocbimv22032548m.g","KQ416437",132035,133774,1739
"9586","Ocbimv22017230m.g","KQ418469",543821,554458,10637
"9587","Ocbimv22022611m.g","KQ419272",3498,19079,15581
"9588","Ocbimv22013819m.g","KQ418063",8318,22727,14409
"9589","Ocbimv22007872m.g","KQ417455",528538,532341,3803
"9590","Ocbimv22021376m.g","KQ432103",19771,24690,4919
"9591","Ocbimv22038750m.g","KQ416765",85232,86378,1146
"9592","Ocbimv22025570m.g","KQ419844",108553,117086,8533
"9593","Ocbimv22012030m.g","KQ427976",4578,7886,3308
"9594","Ocbimv22017052m.g","KQ418445",81658,92531,10873
"9595","Ocbimv22024575m.g","KQ419601",111616,112997,1381
"9596","Ocbimv22033068m.g","KQ421721",843938,859371,15433
"9597","Ocbimv22016336m.g","KQ429819",6891,7094,203
"9598","Ocbimv22036267m.g","KQ416628",463836,465874,2038
"9599","Ocbimv22003180m.g","KQ424901",24379,24848,469
"9600","Ocbimv22007987m.g","KQ426519",3928,42160,38232
"9601","Ocbimv22031798m.g","KQ421349",127858,128193,335
"9602","Ocbimv22007214m.g","KQ426253",2057,4175,2118
"9603","Ocbimv22032899m.g","KQ416458",31942,50813,18871
"9604","Ocbimv22014509m.g","KQ415932",20741,21115,374
"9605","Ocbimv22031087m.g","KQ421157",78048,78759,711
"9606","Ocbimv22005772m.g","KQ417278",10647,12493,1846
"9607","Ocbimv22031935m.g","KQ421381",84240,85367,1127
"9608","Ocbimv22000633m.g","KQ416870",396786,397284,498
"9609","Ocbimv22024331m.g","KQ419574",106904,120241,13337
"9610","Ocbimv22030470m.g","KQ420992",197092,197292,200
"9611","Ocbimv22006302m.g","KQ425868",63072,63756,684
"9612","Ocbimv22024483m.g","KQ416124",430293,432149,1856
"9613","Ocbimv22013831m.g","KQ418065",5570,6989,1419
"9614","Ocbimv22020042m.g","KQ431412",14586,35409,20823
"9615","Ocbimv22021563m.g","KQ419078",186774,197148,10374
"9616","Ocbimv22033702m.g","KQ416491",637298,670735,33437
"9617","Ocbimv22002029m.g","LGKD01508222",58,459,401
"9618","Ocbimv22024279m.g","KQ433929",3,291,288
"9619","Ocbimv22008715m.g","KQ426742",834,3674,2840
"9620","Ocbimv22037077m.g","KQ422919",774562,774777,215
"9621","Ocbimv22035138m.g","KQ416576",447,719,272
"9622","Ocbimv22017528m.g","KQ418504",366555,409472,42917
"9623","Ocbimv22026439m.g","KQ420052",50435,52314,1879
"9624","Ocbimv22011088m.g","KQ417747",186441,186680,239
"9625","Ocbimv22008102m.g","KQ426567",114249,142103,27854
"9626","Ocbimv22017765m.g","LGKD01638748",155,346,191
"9627","Ocbimv22026590m.g","KQ416194",61739,62008,269
"9628","Ocbimv22028286m.g","KQ420458",82055,83275,1220
"9629","Ocbimv22003168m.g","KQ417062",70629,72354,1725
"9630","Ocbimv22016568m.g","KQ418368",71841,91781,19940
"9631","Ocbimv22022172m.g","KQ419180",509774,519521,9747
"9632","Ocbimv22028940m.g","KQ420605",153443,154391,948
"9633","Ocbimv22001902m.g","KQ424463",191957,216073,24116
"9634","Ocbimv22006091m.g","KQ417294",498515,571024,72509
"9635","Ocbimv22002228m.g","KQ416996",261691,332338,70647
"9636","Ocbimv22028797m.g","KQ416272",543377,550881,7504
"9637","Ocbimv22009483m.g","KQ415865",28665,65354,36689
"9638","Ocbimv22006391m.g","KQ417318",174755,179218,4463
"9639","Ocbimv22039967m.g","KQ423813",319754,322605,2851
"9640","Ocbimv22014452m.g","KQ415930",395424,404778,9354
"9641","Ocbimv22011214m.g","KQ417763",136220,149414,13194
"9642","Ocbimv22006072m.g","KQ425805",891986,892147,161
"9643","Ocbimv22002943m.g","KQ424851",357815,367131,9316
"9644","Ocbimv22021161m.g","KQ419011",8892,60631,51739
"9645","Ocbimv22028202m.g","KQ420444",174080,184949,10869
"9646","Ocbimv22010085m.g","KQ417641",252244,275672,23428
"9647","Ocbimv22027046m.g","KQ416209",246522,253765,7243
"9648","Ocbimv22015091m.g","KQ418194",2311833,2321365,9532
"9649","Ocbimv22036498m.g","KQ422777",229754,230403,649
"9650","Ocbimv22011098m.g","KQ417747",643440,644110,670
"9651","Ocbimv22001517m.g","LGKD01125186",1,501,500
"9652","Ocbimv22019284m.g","KQ418741",68961,69305,344
"9653","Ocbimv22029959m.g","KQ420859",323822,324085,263
"9654","Ocbimv22023810m.g","KQ433641",52721,172135,119414
"9655","Ocbimv22017846m.g","KQ418552",138573,142354,3781
"9656","Ocbimv22005641m.g","KQ425692",265255,276764,11509
"9657","Ocbimv22007468m.g","KQ426355",9816,10318,502
"9658","Ocbimv22034680m.g","KQ416547",33490,35217,1727
"9659","Ocbimv22006345m.g","KQ425887",5460,21787,16327
"9660","Ocbimv22002587m.g","KQ424709",111168,112368,1200
"9661","Ocbimv22015946m.g","KQ418303",1523831,1572528,48697
"9662","Ocbimv22011946m.g","KQ417847",1085965,1087343,1378
"9663","Ocbimv22039805m.g","KQ423759",72032,73054,1022
"9664","Ocbimv22019936m.g","KQ418838",19252,25358,6106
"9665","Ocbimv22015474m.g","KQ429377",4403,5725,1322
"9666","Ocbimv22016710m.g","KQ418387",11383,171545,160162
"9667","Ocbimv22025787m.g","KQ419904",71056,158247,87191
"9668","Ocbimv22038328m.g","KQ423283",41753,64378,22625
"9669","Ocbimv22029791m.g","KQ420822",104735,120258,15523
"9670","Ocbimv22021840m.g","KQ415687",1076607,1094906,18299
"9671","Ocbimv22011371m.g","KQ417791",199708,202874,3166
"9672","Ocbimv22019868m.g","KQ431344",74,19585,19511
"9673","Ocbimv22012230m.g","KQ417892",44889,45210,321
"9674","Ocbimv22018715m.g","KQ418660",16499,16813,314
"9675","Ocbimv22008247m.g","KQ426602",151025,167404,16379
"9676","Ocbimv22014567m.g","KQ428991",3280,4406,1126
"9677","Ocbimv22010581m.g","KQ417693",61929,62363,434
"9678","Ocbimv22014371m.g","KQ415673",32880,60046,27166
"9679","Ocbimv22017656m.g","KQ418525",84827,89814,4987
"9680","Ocbimv22002397m.g","KQ424656",87156,94179,7023
"9681","Ocbimv22001516m.g","KQ424341",31846,38916,7070
"9682","Ocbimv22008232m.g","KQ426596",144069,144440,371
"9683","Ocbimv22015894m.g","KQ429620",95357,97798,2441
"9684","Ocbimv22034281m.g","KQ422015",771668,786595,14927
"9685","Ocbimv22012550m.g","KQ417917",1067832,1074836,7004
"9686","Ocbimv22027535m.g","KQ420299",1016027,1016364,337
"9687","Ocbimv22029276m.g","KQ420696",376183,377070,887
"9688","Ocbimv22029342m.g","KQ420714",2287,8064,5777
"9689","Ocbimv22033643m.g","KQ421854",461359,461697,338
"9690","Ocbimv22035113m.g","KQ422282",46909,56269,9360
"9691","Ocbimv22006145m.g","KQ417300",774494,781529,7035
"9692","Ocbimv22015650m.g","KQ429442",33184,43050,9866
"9693","Ocbimv22026866m.g","KQ420132",702911,713553,10642
"9694","Ocbimv22022405m.g","KQ419215",459055,459612,557
"9695","Ocbimv22028232m.g","KQ416253",44157,44330,173
"9696","Ocbimv22039526m.g","LGKD01483381",22,210,188
"9697","Ocbimv22032601m.g","KQ416441",448325,448534,209
"9698","Ocbimv22034327m.g","KQ422016",82764,91066,8302
"9699","Ocbimv22023341m.g","KQ419395",97430,101403,3973
"9700","Ocbimv22039382m.g","KQ423638",253,970,717
"9701","Ocbimv22014277m.g","KQ418112",256678,323643,66965
"9702","Ocbimv22001972m.g","KQ424507",54828,56180,1352
"9703","Ocbimv22009722m.g","KQ427097",13509,14090,581
"9704","Ocbimv22031188m.g","KQ416390",432481,432681,200
"9705","Ocbimv22021728m.g","KQ419092",7319,83354,76035
"9706","Ocbimv22015093m.g","KQ418194",2336367,2355612,19245
"9707","Ocbimv22006896m.g","KQ415837",102778,102993,215
"9708","Ocbimv22037578m.g","KQ423073",2891,4219,1328
"9709","Ocbimv22005093m.g","KQ425519",242204,242514,310
"9710","Ocbimv22006463m.g","KQ417324",97097,97349,252
"9711","Ocbimv22023687m.g","KQ433567",1606,1866,260
"9712","Ocbimv22000852m.g","KQ424093",751377,772388,21011
"9713","Ocbimv22028480m.g","KQ420501",78117,80312,2195
"9714","Ocbimv22030151m.g","KQ420910",305446,306891,1445
"9715","Ocbimv22033720m.g","KQ416494",56287,56499,212
"9716","Ocbimv22021703m.g","KQ419087",77466,110943,33477
"9717","Ocbimv22016815m.g","KQ415971",85666,94814,9148
"9718","Ocbimv22008223m.g","KQ415852",15372,16073,701
"9719","Ocbimv22012204m.g","KQ417888",278939,297637,18698
"9720","Ocbimv22029690m.g","KQ420805",109689,149362,39673
"9721","Ocbimv22003289m.g","KQ417076",262581,262810,229
"9722","Ocbimv22005926m.g","KQ417284",494404,496347,1943
"9723","Ocbimv22022414m.g","LGKD01677998",208,25898,25690
"9724","Ocbimv22036990m.g","KQ422901",40570,41337,767
"9725","Ocbimv22007732m.g","KQ417447",726569,727271,702
"9726","Ocbimv22006054m.g","KQ417293",102368,123215,20847
"9727","Ocbimv22031239m.g","KQ421206",23841,24123,282
"9728","Ocbimv22027289m.g","KQ420244",3608,3811,203
"9729","Ocbimv22020136m.g","KQ418859",326130,354230,28100
"9730","Ocbimv22006107m.g","KQ417297",218549,225517,6968
"9731","Ocbimv22035945m.g","KQ416612",996996,997892,896
"9732","Ocbimv22028322m.g","KQ420475",144980,147170,2190
"9733","Ocbimv22021788m.g","KQ419102",135199,136645,1446
"9734","Ocbimv22000135m.g","KQ416841",2142461,2143650,1189
"9735","Ocbimv22021032m.g","KQ431954",835,1068,233
"9736","Ocbimv22001942m.g","KQ424483",23918,24584,666
"9737","Ocbimv22030429m.g","KQ420978",288773,289264,491
"9738","Ocbimv22013167m.g","KQ417996",181329,229707,48378
"9739","Ocbimv22036458m.g","KQ422771",33555,36212,2657
"9740","Ocbimv22002436m.g","KQ424659",3048,5512,2464
"9741","Ocbimv22029744m.g","KQ420816",107726,109286,1560
"9742","Ocbimv22011291m.g","KQ417776",230823,232366,1543
"9743","Ocbimv22033712m.g","KQ416493",30969,31178,209
"9744","Ocbimv22022331m.g","KQ419199",336148,336459,311
"9745","Ocbimv22003775m.g","KQ417112",161118,179075,17957
"9746","Ocbimv22023541m.g","KQ419429",40631,41110,479
"9747","Ocbimv22005060m.g","KQ425510",22244,31741,9497
"9748","Ocbimv22008585m.g","KQ417510",308429,321635,13206
"9749","Ocbimv22010077m.g","KQ417641",72265,95439,23174
"9750","Ocbimv22028596m.g","KQ416263",494228,509385,15157
"9751","Ocbimv22011556m.g","KQ417802",228180,230427,2247
"9752","Ocbimv22003454m.g","KQ425015",157392,165413,8021
"9753","Ocbimv22017797m.g","KQ418547",494333,494518,185
"9754","Ocbimv22034643m.g","KQ422099",485526,485870,344
"9755","Ocbimv22007691m.g","KQ415846",394314,394625,311
"9756","Ocbimv22039193m.g","KQ416784",613041,614483,1442
"9757","Ocbimv22007817m.g","KQ426461",365555,367074,1519
"9758","Ocbimv22015656m.g","KQ429444",4681,9320,4639
"9759","Ocbimv22038578m.g","KQ423411",138162,138986,824
"9760","Ocbimv22039480m.g","KQ423675",316825,321606,4781
"9761","Ocbimv22017359m.g","KQ418484",160609,168862,8253
"9762","Ocbimv22034669m.g","KQ416546",58630,110360,51730
"9763","Ocbimv22032514m.g","KQ421570",83437,83962,525
"9764","Ocbimv22005766m.g","KQ417277",69886,70185,299
"9765","Ocbimv22014480m.g","KQ428960",65223,67273,2050
"9766","Ocbimv22024645m.g","KQ419605",1083227,1083559,332
"9767","Ocbimv22013061m.g","KQ417977",388804,393389,4585
"9768","Ocbimv22028387m.g","KQ416257",569758,589813,20055
"9769","Ocbimv22025862m.g","KQ419916",152121,185206,33085
"9770","Ocbimv22002259m.g","KQ424589",64284,89750,25466
"9771","Ocbimv22029332m.g","KQ420711",483677,489397,5720
"9772","Ocbimv22016156m.g","KQ429717",204,934,730
"9773","Ocbimv22039841m.g","KQ416831",79654,82185,2531
"9774","Ocbimv22018473m.g","KQ430702",87885,110865,22980
"9775","Ocbimv22012610m.g","KQ417921",181425,199450,18025
"9776","Ocbimv22021865m.g","KQ419113",223843,278580,54737
"9777","Ocbimv22020140m.g","KQ418859",411565,477129,65564
"9778","Ocbimv22031946m.g","KQ421388",73420,87929,14509
"9779","Ocbimv22020432m.g","KQ416027",243999,245335,1336
"9780","Ocbimv22026573m.g","KQ416193",523052,564839,41787
"9781","Ocbimv22035205m.g","KQ422311",430,21232,20802
"9782","Ocbimv22018531m.g","KQ418634",11285,15727,4442
"9783","Ocbimv22012265m.g","KQ417896",119560,120705,1145
"9784","Ocbimv22030230m.g","KQ420925",20172,20772,600
"9785","Ocbimv22014797m.g","KQ429075",89903,90499,596
"9786","Ocbimv22028739m.g","KQ420566",234923,267376,32453
"9787","Ocbimv22024162m.g","KQ419543",188330,284927,96597
"9788","Ocbimv22035878m.g","KQ416608",841099,841335,236
"9789","Ocbimv22003339m.g","KQ424979",25705,29553,3848
"9790","Ocbimv22006304m.g","KQ425868",109576,110604,1028
"9791","Ocbimv22001474m.g","LGKD01502328",20,358,338
"9792","Ocbimv22008109m.g","KQ426567",197832,198594,762
"9793","Ocbimv22021377m.g","KQ432103",33695,55314,21619
"9794","Ocbimv22035966m.g","KQ416612",2009990,2014058,4068
"9795","Ocbimv22023953m.g","KQ419507",15136,16709,1573
"9796","Ocbimv22030747m.g","KQ421083",405003,417831,12828
"9797","Ocbimv22015597m.g","KQ415946",412809,426254,13445
"9798","Ocbimv22018680m.g","KQ415684",1753367,1821624,68257
"9799","Ocbimv22003756m.g","KQ425086",1590,1991,401
"9800","Ocbimv22010081m.g","KQ417641",124864,125656,792
"9801","Ocbimv22022913m.g","KQ419326",235890,236515,625
"9802","Ocbimv22000386m.g","KQ423942",2541,6070,3529
"9803","Ocbimv22001343m.g","KQ416923",4207,4404,197
"9804","Ocbimv22025470m.g","KQ419810",78159,91032,12873
"9805","Ocbimv22014635m.g","KQ418159",1057639,1059546,1907
"9806","Ocbimv22000521m.g","KQ416865",31159,40766,9607
"9807","Ocbimv22033190m.g","KQ421748",72595,72822,227
"9808","Ocbimv22018848m.g","KQ416003",1476611,1476979,368
"9809","Ocbimv22000619m.g","KQ416869",91658,157239,65581
"9810","Ocbimv22008981m.g","KQ417547",30647,31148,501
"9811","Ocbimv22028942m.g","KQ420605",346367,350563,4196
"9812","Ocbimv22032746m.g","KQ421651",121898,132190,10292
"9813","Ocbimv22019215m.g","KQ431053",3524,4386,862
"9814","Ocbimv22008037m.g","KQ417473",33961,36520,2559
"9815","Ocbimv22030405m.g","KQ420971",94866,113438,18572
"9816","Ocbimv22009173m.g","KQ415862",497558,497824,266
"9817","Ocbimv22015955m.g","KQ429628",436,624,188
"9818","Ocbimv22011223m.g","KQ417763",403189,423243,20054
"9819","Ocbimv22037263m.g","KQ422986",186224,319281,133057
"9820","Ocbimv22005195m.g","KQ425540",153260,153490,230
"9821","Ocbimv22011739m.g","KQ427887",20935,22387,1452
"9822","Ocbimv22000687m.g","KQ424055",532945,538406,5461
"9823","Ocbimv22038617m.g","KQ416755",18187,19004,817
"9824","Ocbimv22015925m.g","KQ418303",936327,936830,503
"9825","Ocbimv22003164m.g","KQ417062",58342,59604,1262
"9826","Ocbimv22037112m.g","KQ422923",278955,292547,13592
"9827","Ocbimv22016440m.g","KQ418355",185844,186356,512
"9828","Ocbimv22034352m.g","KQ422018",1904,16218,14314
"9829","Ocbimv22032629m.g","KQ421619",47998,49229,1231
"9830","Ocbimv22038779m.g","KQ416765",928439,930306,1867
"9831","Ocbimv22022847m.g","KQ433054",100879,101333,454
"9832","Ocbimv22026549m.g","KQ416192",113048,131613,18565
"9833","Ocbimv22014253m.g","KQ428821",38092,53683,15591
"9834","Ocbimv22036066m.g","KQ416616",409892,410362,470
"9835","Ocbimv22024766m.g","KQ419625",68163,69181,1018
"9836","Ocbimv22025509m.g","KQ419828",217880,218292,412
"9837","Ocbimv22019028m.g","KQ418711",808883,856122,47239
"9838","Ocbimv22028346m.g","KQ420477",74696,79910,5214
"9839","Ocbimv22022128m.g","KQ419175",418575,419439,864
"9840","Ocbimv22030666m.g","KQ421056",135215,190286,55071
"9841","Ocbimv22033969m.g","KQ416503",174010,174243,233
"9842","Ocbimv22028398m.g","KQ416257",810330,812178,1848
"9843","Ocbimv22027016m.g","KQ420162",782591,783115,524
"9844","Ocbimv22031501m.g","KQ421263",214463,216048,1585
"9845","Ocbimv22015775m.g","KQ418291",64,4546,4482
"9846","Ocbimv22014404m.g","KQ418128",105047,118011,12964
"9847","Ocbimv22032632m.g","KQ421620",512225,512914,689
"9848","Ocbimv22039887m.g","KQ416833",598532,599659,1127
"9849","Ocbimv22022717m.g","KQ419287",57634,58379,745
"9850","Ocbimv22025350m.g","KQ419780",82228,140851,58623
"9851","Ocbimv22012246m.g","KQ417893",634218,706777,72559
"9852","Ocbimv22029114m.g","KQ420656",376960,379664,2704
"9853","Ocbimv22004584m.g","KQ425371",325384,325794,410
"9854","Ocbimv22010986m.g","KQ417731",208437,223981,15544
"9855","Ocbimv22020819m.g","KQ418970",625837,640473,14636
"9856","Ocbimv22011731m.g","KQ427883",7291,8215,924
"9857","Ocbimv22011949m.g","KQ417847",1095502,1098477,2975
"9858","Ocbimv22031168m.g","KQ421187",264558,288619,24061
"9859","Ocbimv22032634m.g","KQ421620",713033,713269,236
"9860","Ocbimv22011723m.g","KQ427877",311,577,266
"9861","Ocbimv22016187m.g","KQ418323",937951,939252,1301
"9862","Ocbimv22029894m.g","KQ420840",380158,382150,1992
"9863","Ocbimv22036620m.g","KQ416651",357870,358403,533
"9864","Ocbimv22018790m.g","KQ430875",72269,72662,393
"9865","Ocbimv22006731m.g","LGKD01549378",17,160,143
"9866","Ocbimv22013610m.g","KQ418039",213042,214287,1245
"9867","Ocbimv22011038m.g","KQ417740",74899,79743,4844
"9868","Ocbimv22011774m.g","KQ415891",399096,399278,182
"9869","Ocbimv22005806m.g","KQ415823",1254814,1255011,197
"9870","Ocbimv22019057m.g","KQ430957",8,316,308
"9871","Ocbimv22016153m.g","KQ418322",1024478,1049348,24870
"9872","Ocbimv22009108m.g","KQ426881",26577,55614,29037
"9873","Ocbimv22007204m.g","KQ426241",343,690,347
"9874","Ocbimv22015031m.g","KQ418194",583666,585483,1817
"9875","Ocbimv22009529m.g","KQ415865",916651,921697,5046
"9876","Ocbimv22000887m.g","KQ424103",159598,246228,86630
"9877","Ocbimv22024318m.g","KQ419566",100243,101153,910
"9878","Ocbimv22025288m.g","KQ419763",15188,62175,46987
"9879","Ocbimv22026984m.g","KQ420157",405953,406138,185
"9880","Ocbimv22023125m.g","LGKD01685714",283,591,308
"9881","Ocbimv22003848m.g","KQ415798",32391,49666,17275
"9882","Ocbimv22039322m.g","KQ416788",118911,123605,4694
"9883","Ocbimv22021348m.g","KQ416042",1270735,1271351,616
"9884","Ocbimv22039623m.g","KQ416810",702491,702790,299
"9885","Ocbimv22009365m.g","KQ417587",183547,184008,461
"9886","Ocbimv22034894m.g","KQ422208",469421,469897,476
"9887","Ocbimv22007355m.g","KQ426312",29768,34307,4539
"9888","Ocbimv22004968m.g","KQ425490",81903,89996,8093
"9889","Ocbimv22002307m.g","KQ424627",196957,197309,352
"9890","Ocbimv22039719m.g","KQ416816",209849,234399,24550
"9891","Ocbimv22035888m.g","KQ422595",185807,186730,923
"9892","Ocbimv22035104m.g","KQ416573",111219,111431,212
"9893","Ocbimv22007478m.g","KQ415843",4453,6046,1593
"9894","Ocbimv22037438m.g","KQ423024",10190,10378,188
"9895","Ocbimv22038761m.g","KQ416765",155218,156697,1479
"9896","Ocbimv22036686m.g","KQ422835",34198,34347,149
"9897","Ocbimv22031637m.g","KQ421305",251811,266204,14393
"9898","Ocbimv22037017m.g","KQ422909",47248,57225,9977
"9899","Ocbimv22012575m.g","KQ417917",1585698,1588118,2420
"9900","Ocbimv22026785m.g","KQ420117",136169,137194,1025
"9901","Ocbimv22020259m.g","KQ431561",2115,4538,2423
"9902","Ocbimv22003032m.g","KQ417055",1319440,1325713,6273
"9903","Ocbimv22017600m.g","KQ415979",120097,120477,380
"9904","Ocbimv22011735m.g","LGKD01589870",93,803,710
"9905","Ocbimv22009277m.g","KQ426944",380116,380616,500
"9906","Ocbimv22007175m.g","KQ426223",23549,31207,7658
"9907","Ocbimv22039769m.g","KQ423744",237236,237574,338
"9908","Ocbimv22023577m.g","LGKD01690168",290,631,341
"9909","Ocbimv22038601m.g","KQ416754",7764,8078,314
"9910","Ocbimv22034414m.g","KQ422034",5462,7768,2306
"9911","Ocbimv22002536m.g","KQ424678",233022,251433,18411
"9912","Ocbimv22016006m.g","KQ418310",2834,5364,2530
"9913","Ocbimv22037521m.g","KQ423057",13949,14515,566
"9914","Ocbimv22022449m.g","KQ419216",471767,473622,1855
"9915","Ocbimv22023328m.g","KQ419394",79981,114394,34413
"9916","Ocbimv22002429m.g","KQ417009",1375340,1381454,6114
"9917","Ocbimv22009771m.g","KQ427115",55492,55653,161
"9918","Ocbimv22000325m.g","KQ423925",2922,3563,641
"9919","Ocbimv22007512m.g","KQ426358",34802,35098,296
"9920","Ocbimv22033877m.g","KQ421896",509000,516910,7910
"9921","Ocbimv22037846m.g","KQ423139",567968,568339,371
"9922","Ocbimv22022223m.g","KQ416062",274856,275149,293
"9923","Ocbimv22022176m.g","KQ419180",545943,546137,194
"9924","Ocbimv22013463m.g","KQ418025",82772,96507,13735
"9925","Ocbimv22009297m.g","KQ417581",56084,63523,7439
"9926","Ocbimv22035962m.g","KQ416612",1822611,1847269,24658
"9927","Ocbimv22000180m.g","KQ423886",94321,94605,284
"9928","Ocbimv22020890m.g","KQ431871",59141,60461,1320
"9929","Ocbimv22026017m.g","KQ419957",227203,228676,1473
"9930","Ocbimv22009126m.g","KQ426892",56289,56660,371
"9931","Ocbimv22025735m.g","KQ419895",125866,126350,484
"9932","Ocbimv22035577m.g","KQ422442",14415,18715,4300
"9933","Ocbimv22001966m.g","KQ424504",95613,95900,287
"9934","Ocbimv22025266m.g","KQ419753",86,328,242
"9935","Ocbimv22013240m.g","KQ418003",163917,284414,120497
"9936","Ocbimv22012133m.g","KQ415902",169788,209599,39811
"9937","Ocbimv22004807m.g","KQ417208",161309,162626,1317
"9938","Ocbimv22024325m.g","LGKD01697898",185,343,158
"9939","Ocbimv22000405m.g","KQ423956",3893,53216,49323
"9940","Ocbimv22023124m.g","KQ419350",988967,996462,7495
"9941","Ocbimv22001399m.g","KQ416931",177241,180818,3577
"9942","Ocbimv22037730m.g","KQ423122",56713,68458,11745
"9943","Ocbimv22027909m.g","KQ420395",64743,65026,283
"9944","Ocbimv22014995m.g","KQ418193",581437,581766,329
"9945","Ocbimv22032617m.g","KQ421607",348331,382188,33857
"9946","Ocbimv22026671m.g","KQ416196",481211,561961,80750
"9947","Ocbimv22035003m.g","KQ422241",524774,524956,182
"9948","Ocbimv22032202m.g","KQ421479",195940,196335,395
"9949","Ocbimv22002486m.g","KQ424671",162432,202795,40363
"9950","Ocbimv22023362m.g","KQ419395",234659,237416,2757
"9951","Ocbimv22006451m.g","KQ425926",19533,20519,986
"9952","Ocbimv22033918m.g","KQ421906",558789,559080,291
"9953","Ocbimv22003449m.g","KQ425015",59450,61310,1860
"9954","Ocbimv22031438m.g","KQ421244",73242,75748,2506
"9955","Ocbimv22012659m.g","KQ428198",3469,3630,161
"9956","Ocbimv22024420m.g","KQ419577",377196,395456,18260
"9957","Ocbimv22013251m.g","KQ428426",58894,68054,9160
"9958","Ocbimv22002345m.g","KQ424639",24599,106528,81929
"9959","Ocbimv22026456m.g","KQ420053",101704,103219,1515
"9960","Ocbimv22039864m.g","KQ423780",943974,1115359,171385
"9961","Ocbimv22024144m.g","KQ419539",163415,213304,49889
"9962","Ocbimv22020902m.g","KQ418974",277161,294860,17699
"9963","Ocbimv22038975m.g","KQ423497",19616,20113,497
"9964","Ocbimv22022925m.g","KQ419326",601784,638435,36651
"9965","Ocbimv22001691m.g","KQ416955",242233,242649,416
"9966","Ocbimv22039462m.g","KQ423672",48123,49370,1247
"9967","Ocbimv22006644m.g","KQ426045",281830,300366,18536
"9968","Ocbimv22008451m.g","KQ415854",152196,157642,5446
"9969","Ocbimv22022782m.g","KQ433008",380671,383887,3216
"9970","Ocbimv22021925m.g","KQ419133",52220,53588,1368
"9971","Ocbimv22038629m.g","KQ423423",82333,113785,31452
"9972","Ocbimv22018895m.g","KQ430924",33228,65195,31967
"9973","Ocbimv22013742m.g","KQ428640",39526,40924,1398
"9974","Ocbimv22009551m.g","KQ415865",1602983,1629763,26780
"9975","Ocbimv22035225m.g","KQ422321",166373,166627,254
"9976","Ocbimv22017571m.g","KQ430359",32829,75880,43051
"9977","Ocbimv22035744m.g","KQ422521",474958,480013,5055
"9978","Ocbimv22008302m.g","KQ417496",246086,246385,299
"9979","Ocbimv22013233m.g","KQ418003",123,24875,24752
"9980","Ocbimv22031247m.g","KQ421206",441001,467359,26358
"9981","Ocbimv22015170m.g","KQ418202",89617,89871,254
"9982","Ocbimv22025623m.g","KQ419861",705639,751398,45759
"9983","Ocbimv22003510m.g","KQ425021",76005,85072,9067
"9984","Ocbimv22033769m.g","KQ421866",205158,207373,2215
"9985","Ocbimv22039947m.g","KQ423808",146058,180650,34592
"9986","Ocbimv22036539m.g","KQ422788",63257,63659,402
"9987","Ocbimv22005341m.g","KQ417245",529080,596435,67355
"9988","Ocbimv22002129m.g","KQ415788",381968,386715,4747
"9989","Ocbimv22006044m.g","KQ417291",256148,260546,4398
"9990","Ocbimv22029655m.g","KQ416315",90761,104682,13921
"9991","Ocbimv22030547m.g","KQ421018",235655,236141,486
"9992","Ocbimv22007522m.g","KQ426360",79910,80185,275
"9993","Ocbimv22002363m.g","KQ424648",9001,9301,300
"9994","Ocbimv22003296m.g","KQ424942",162043,250369,88326
"9995","Ocbimv22037768m.g","KQ423130",241588,251490,9902
"9996","Ocbimv22008895m.g","KQ426795",838,2128,1290
"9997","Ocbimv22036734m.g","KQ416655",385063,387070,2007
"9998","Ocbimv22034076m.g","KQ416508",1093034,1095512,2478
"9999","Ocbimv22009748m.g","KQ427110",1,101198,101197
"10000","Ocbimv22018223m.g","KQ415990",1950090,1971907,21817
"10001","Ocbimv22014460m.g","KQ428942",81996,82265,269
"10002","Ocbimv22033615m.g","LGKD01419028",1,309,308
"10003","Ocbimv22024399m.g","KQ415693",535391,535759,368
"10004","Ocbimv22002577m.g","KQ424701",155874,156053,179
"10005","Ocbimv22005854m.g","KQ417280",228437,230822,2385
"10006","Ocbimv22013604m.g","KQ418039",175359,196604,21245
"10007","Ocbimv22023800m.g","KQ419478",110184,111006,822
"10008","Ocbimv22028977m.g","KQ416278",310918,314503,3585
"10009","Ocbimv22023268m.g","KQ419386",109547,109750,203
"10010","Ocbimv22032435m.g","KQ421540",26747,27775,1028
"10011","Ocbimv22035613m.g","KQ422473",31691,133912,102221
"10012","Ocbimv22011854m.g","KQ427927",5227,41069,35842
"10013","Ocbimv22027841m.g","KQ420375",1402292,1447044,44752
"10014","Ocbimv22028623m.g","KQ420534",7275,65993,58718
"10015","Ocbimv22034062m.g","KQ416508",785845,815829,29984
"10016","Ocbimv22011351m.g","KQ417786",20300,21945,1645
"10017","Ocbimv22024141m.g","KQ419539",32534,57068,24534
"10018","Ocbimv22006827m.g","KQ417358",40404,41795,1391
"10019","Ocbimv22003249m.g","KQ417068",893015,893170,155
"10020","Ocbimv22019568m.g","KQ418784",94717,104817,10100
"10021","Ocbimv22030156m.g","KQ420911",58558,80045,21487
"10022","Ocbimv22010094m.g","KQ417641",433207,434523,1316
"10023","Ocbimv22029283m.g","KQ420696",608305,623037,14732
"10024","Ocbimv22016018m.g","KQ418310",610455,624798,14343
"10025","Ocbimv22009714m.g","KQ427096",145610,163673,18063
"10026","Ocbimv22000892m.g","KQ424104",120427,120711,284
"10027","Ocbimv22023711m.g","KQ419463",7737,9036,1299
"10028","Ocbimv22009623m.g","KQ427054",139262,144293,5031
"10029","Ocbimv22031587m.g","KQ421283",11585,51954,40369
"10030","Ocbimv22006533m.g","KQ425990",50926,90537,39611
"10031","Ocbimv22001496m.g","KQ416938",213850,214492,642
"10032","Ocbimv22036894m.g","KQ422894",39786,45248,5462
"10033","Ocbimv22004011m.g","KQ417132",501229,502283,1054
"10034","Ocbimv22032200m.g","KQ421477",636,933,297
"10035","Ocbimv22009227m.g","KQ426934",19495,32391,12896
"10036","Ocbimv22021993m.g","KQ419142",48277,48672,395
"10037","Ocbimv22039785m.g","KQ416823",34589,35080,491
"10038","Ocbimv22034301m.g","KQ422015",1119941,1179769,59828
"10039","Ocbimv22003149m.g","KQ424898",45289,46722,1433
"10040","Ocbimv22039931m.g","KQ416835",108716,109670,954
"10041","Ocbimv22023778m.g","KQ416096",1279908,1282386,2478
"10042","Ocbimv22002740m.g","KQ424770",100630,129807,29177
"10043","Ocbimv22001967m.g","LGKD01507835",197,856,659
"10044","Ocbimv22023673m.g","KQ419458",137229,137678,449
"10045","Ocbimv22014828m.g","KQ429096",521186,521893,707
"10046","Ocbimv22006726m.g","KQ426080",1,6968,6967
"10047","Ocbimv22002506m.g","KQ417011",204833,212313,7480
"10048","Ocbimv22009331m.g","KQ426953",105698,131835,26137
"10049","Ocbimv22017465m.g","KQ418498",641934,642218,284
"10050","Ocbimv22014439m.g","KQ428926",20825,21511,686
"10051","Ocbimv22007123m.g","KQ417381",63262,67000,3738
"10052","Ocbimv22002649m.g","KQ417023",1507353,1518192,10839
"10053","Ocbimv22039633m.g","KQ416810",1058675,1059100,425
"10054","Ocbimv22000472m.g","KQ423976",158997,166307,7310
"10055","Ocbimv22029775m.g","KQ420820",953017,977740,24723
"10056","Ocbimv22018288m.g","KQ430628",38764,40470,1706
"10057","Ocbimv22001563m.g","KQ415665",7109,30575,23466
"10058","Ocbimv22029454m.g","KQ420753",958,31740,30782
"10059","Ocbimv22025802m.g","KQ419906",279881,280177,296
"10060","Ocbimv22005356m.g","KQ425594",9126,16475,7349
"10061","Ocbimv22017311m.g","KQ415681",1439930,1440313,383
"10062","Ocbimv22029961m.g","KQ420859",537051,553192,16141
"10063","Ocbimv22021516m.g","KQ419064",68541,69101,560
"10064","Ocbimv22014422m.g","KQ418132",24,8302,8278
"10065","Ocbimv22005055m.g","KQ425509",14104,27740,13636
"10066","Ocbimv22037774m.g","KQ423131",116407,122424,6017
"10067","Ocbimv22005947m.g","KQ417285",117942,138853,20911
"10068","Ocbimv22035145m.g","KQ422290",189080,192078,2998
"10069","Ocbimv22010141m.g","KQ427275",452433,452585,152
"10070","Ocbimv22033478m.g","KQ416483",8419,15647,7228
"10071","Ocbimv22009044m.g","KQ415859",634909,636419,1510
"10072","Ocbimv22007419m.g","KQ426334",103776,104537,761
"10073","Ocbimv22018982m.g","KQ418706",39172,100488,61316
"10074","Ocbimv22006158m.g","KQ417300",1056876,1135416,78540
"10075","Ocbimv22001904m.g","KQ424463",231501,277350,45849
"10076","Ocbimv22031700m.g","KQ421318",101092,102810,1718
"10077","Ocbimv22013692m.g","KQ428612",93603,97708,4105
"10078","Ocbimv22025067m.g","KQ419691",155307,156910,1603
"10079","Ocbimv22004925m.g","KQ425470",202838,228936,26098
"10080","Ocbimv22022543m.g","KQ419244",44377,44975,598
"10081","Ocbimv22016441m.g","KQ418355",192838,194171,1333
"10082","Ocbimv22028924m.g","KQ416274",2061167,2062786,1619
"10083","Ocbimv22014741m.g","KQ429057",219194,219895,701
"10084","Ocbimv22007267m.g","KQ417395",433233,546620,113387
"10085","Ocbimv22020322m.g","KQ418892",278180,278563,383
"10086","Ocbimv22039574m.g","KQ423703",354681,374287,19606
"10087","Ocbimv22035852m.g","KQ416605",141662,143819,2157
"10088","Ocbimv22033684m.g","KQ416490",1022128,1022559,431
"10089","Ocbimv22025826m.g","KQ419909",355575,359036,3461
"10090","Ocbimv22005623m.g","KQ425681",224094,224412,318
"10091","Ocbimv22011877m.g","KQ417844",868006,868260,254
"10092","Ocbimv22027387m.g","KQ420268",629271,629762,491
"10093","Ocbimv22010863m.g","KQ427549",238725,239009,284
"10094","Ocbimv22029037m.g","KQ420631",9838,10696,858
"10095","Ocbimv22002880m.g","KQ424814",14067,16849,2782
"10096","Ocbimv22022724m.g","KQ416074",63856,68640,4784
"10097","Ocbimv22036049m.g","KQ422639",1575,2243,668
"10098","Ocbimv22037338m.g","KQ423006",6271,103777,97506
"10099","Ocbimv22010885m.g","KQ417722",367652,390284,22632
"10100","Ocbimv22004052m.g","KQ425190",150055,151101,1046
"10101","Ocbimv22021499m.g","KQ432186",418,1562,1144
"10102","Ocbimv22026768m.g","KQ420112",149200,172172,22972
"10103","Ocbimv22010022m.g","KQ427207",98719,99099,380
"10104","Ocbimv22029557m.g","KQ420776",492557,492742,185
"10105","Ocbimv22004106m.g","KQ417137",25477,25671,194
"10106","Ocbimv22039027m.g","KQ423515",93903,128802,34899
"10107","Ocbimv22024733m.g","KQ416128",802605,802848,243
"10108","Ocbimv22005488m.g","KQ425619",136169,137738,1569
"10109","Ocbimv22010451m.g","KQ427393",53483,57719,4236
"10110","Ocbimv22004418m.g","KQ415804",325024,331425,6401
"10111","Ocbimv22001884m.g","KQ424459",806233,806442,209
"10112","Ocbimv22036650m.g","KQ422819",141295,141844,549
"10113","Ocbimv22028826m.g","KQ420590",28114,28463,349
"10114","Ocbimv22028994m.g","KQ416279",43088,46572,3484
"10115","Ocbimv22021331m.g","KQ419031",454270,456153,1883
"10116","Ocbimv22034663m.g","KQ422105",85361,85666,305
"10117","Ocbimv22031864m.g","KQ421363",3983,34227,30244
"10118","Ocbimv22005117m.g","KQ415813",547792,548838,1046
"10119","Ocbimv22030268m.g","KQ416339",318614,318763,149
"10120","Ocbimv22003050m.g","KQ424867",30934,36791,5857
"10121","Ocbimv22013096m.g","KQ417981",572543,628593,56050
"10122","Ocbimv22032714m.g","KQ421639",246204,246716,512
"10123","Ocbimv22017831m.g","LGKD01639333",502,801,299
"10124","Ocbimv22027589m.g","KQ420312",18691,28345,9654
"10125","Ocbimv22031767m.g","KQ416405",769121,769435,314
"10126","Ocbimv22023710m.g","LGKD01691973",276,653,377
"10127","Ocbimv22002110m.g","KQ424545",214444,219055,4611
"10128","Ocbimv22003241m.g","KQ417067",131775,132281,506
"10129","Ocbimv22006324m.g","KQ425876",155162,156067,905
"10130","Ocbimv22035898m.g","KQ422595",268287,327282,58995
"10131","Ocbimv22039958m.g","KQ423809",51716,52515,799
"10132","Ocbimv22009873m.g","KQ417621",172349,183315,10966
"10133","Ocbimv22016721m.g","KQ429980",2791,16086,13295
"10134","Ocbimv22025031m.g","KQ416136",422308,459274,36966
"10135","Ocbimv22026690m.g","KQ416197",43698,44011,313
"10136","Ocbimv22035646m.g","KQ422489",220743,221694,951
"10137","Ocbimv22005322m.g","KQ417240",450335,455064,4729
"10138","Ocbimv22012492m.g","KQ417917",158616,164865,6249
"10139","Ocbimv22018930m.g","KQ418698",111982,113712,1730
"10140","Ocbimv22032473m.g","KQ421549",567216,614782,47566
"10141","Ocbimv22000025m.g","KQ423826",67022,69012,1990
"10142","Ocbimv22030995m.g","KQ421142",9479,77807,68328
"10143","Ocbimv22006109m.g","KQ417297",258616,268076,9460
"10144","Ocbimv22030173m.g","KQ420915",794740,795279,539
"10145","Ocbimv22011178m.g","KQ427660",41546,47708,6162
"10146","Ocbimv22037982m.g","KQ416717",165955,166875,920
"10147","Ocbimv22016473m.g","KQ415966",208168,208506,338
"10148","Ocbimv22008152m.g","KQ417481",782964,783344,380
"10149","Ocbimv22005096m.g","KQ417228",5959,6222,263
"10150","Ocbimv22014347m.g","KQ418120",492368,511965,19597
"10151","Ocbimv22012220m.g","KQ415905",698479,702509,4030
"10152","Ocbimv22021218m.g","KQ419013",278727,278894,167
"10153","Ocbimv22021515m.g","KQ419064",33207,33539,332
"10154","Ocbimv22027595m.g","KQ420313",237689,256991,19302
"10155","Ocbimv22004036m.g","KQ425190",57721,68298,10577
"10156","Ocbimv22032763m.g","KQ421655",361927,365552,3625
"10157","Ocbimv22020595m.g","KQ418930",316245,374878,58633
"10158","Ocbimv22014658m.g","KQ418165",229519,230010,491
"10159","Ocbimv22009894m.g","KQ417621",669419,683290,13871
"10160","Ocbimv22027720m.g","KQ420347",245708,260112,14404
"10161","Ocbimv22038472m.g","KQ423358",56266,58568,2302
"10162","Ocbimv22011686m.g","KQ417819",77220,78011,791
"10163","Ocbimv22010618m.g","KQ415669",825128,825780,652
"10164","Ocbimv22026954m.g","KQ420148",671753,680104,8351
"10165","Ocbimv22002233m.g","KQ416997",18100,18952,852
"10166","Ocbimv22020714m.g","KQ416032",522604,606154,83550
"10167","Ocbimv22033049m.g","KQ421721",477156,537223,60067
"10168","Ocbimv22004884m.g","KQ417211",507262,507468,206
"10169","Ocbimv22033428m.g","KQ421810",14140,50642,36502
"10170","Ocbimv22012748m.g","KQ417935",63648,66563,2915
"10171","Ocbimv22031889m.g","KQ421372",377846,378350,504
"10172","Ocbimv22011803m.g","KQ415893",141763,142119,356
"10173","Ocbimv22027196m.g","KQ420216",1066,39832,38766
"10174","Ocbimv22008505m.g","KQ417506",492994,496659,3665
"10175","Ocbimv22004045m.g","KQ425190",103259,114276,11017
"10176","Ocbimv22034081m.g","KQ421960",162765,163007,242
"10177","Ocbimv22020446m.g","KQ431695",15654,20794,5140
"10178","Ocbimv22028157m.g","KQ420439",216703,233622,16919
"10179","Ocbimv22022740m.g","KQ416074",601138,616128,14990
"10180","Ocbimv22008692m.g","KQ426737",14154,20207,6053
"10181","Ocbimv22039667m.g","KQ423725",16124,27073,10949
"10182","Ocbimv22032776m.g","KQ421656",291230,378372,87142
"10183","Ocbimv22037752m.g","KQ416709",8482,16723,8241
"10184","Ocbimv22016860m.g","KQ418413",219680,221203,1523
"10185","Ocbimv22027020m.g","KQ420163",127382,140630,13248
"10186","Ocbimv22015434m.g","KQ418245",38602,39018,416
"10187","Ocbimv22039588m.g","KQ423712",339173,339848,675
"10188","Ocbimv22034592m.g","KQ422081",167417,168767,1350
"10189","Ocbimv22011345m.g","KQ427732",61,927,866
"10190","Ocbimv22014693m.g","KQ418168",506586,542284,35698
"10191","Ocbimv22017885m.g","KQ430504",11550,31932,20382
"10192","Ocbimv22037454m.g","KQ423031",193367,200273,6906
"10193","Ocbimv22001341m.g","LGKD01501483",5,178,173
"10194","Ocbimv22001878m.g","KQ424459",82686,178977,96291
"10195","Ocbimv22032323m.g","KQ421523",325300,410222,84922
"10196","Ocbimv22017694m.g","KQ430417",231015,232174,1159
"10197","Ocbimv22013912m.g","KQ418071",208683,208910,227
"10198","Ocbimv22016627m.g","KQ415967",316820,317053,233
"10199","Ocbimv22024809m.g","KQ419631",470378,491174,20796
"10200","Ocbimv22007087m.g","KQ417377",624452,624748,296
"10201","Ocbimv22022069m.g","KQ432553",6693,7904,1211
"10202","Ocbimv22020669m.g","KQ418949",19892,29209,9317
"10203","Ocbimv22024641m.g","KQ419605",440106,441051,945
"10204","Ocbimv22030929m.g","KQ421121",73757,74224,467
"10205","Ocbimv22009414m.g","KQ417591",986138,986398,260
"10206","Ocbimv22038196m.g","KQ416731",63919,66598,2679
"10207","Ocbimv22024719m.g","KQ419621",749748,751460,1712
"10208","Ocbimv22000941m.g","KQ424129",16023,17244,1221
"10209","Ocbimv22006883m.g","KQ417359",39907,50791,10884
"10210","Ocbimv22017305m.g","KQ415681",575521,575808,287
"10211","Ocbimv22016308m.g","KQ418338",230014,233500,3486
"10212","Ocbimv22016949m.g","KQ430102",269275,283449,14174
"10213","Ocbimv22039363m.g","KQ423631",242038,252267,10229
"10214","Ocbimv22003447m.g","KQ425015",39697,46218,6521
"10215","Ocbimv22039878m.g","KQ416832",327318,327572,254
"10216","Ocbimv22017171m.g","KQ418459",338970,408901,69931
"10217","Ocbimv22039183m.g","KQ416784",427291,432360,5069
"10218","Ocbimv22006919m.g","KQ426143",44501,45895,1394
"10219","Ocbimv22013731m.g","KQ418054",480716,481152,436
"10220","Ocbimv22006041m.g","KQ417291",9442,22284,12842
"10221","Ocbimv22032102m.g","KQ421447",25899,79816,53917
"10222","Ocbimv22038020m.g","KQ416719",778430,779194,764
"10223","Ocbimv22018540m.g","KQ415995",152341,157627,5286
"10224","Ocbimv22009947m.g","KQ427173",4790,66528,61738
"10225","Ocbimv22016818m.g","KQ418408",29304,75321,46017
"10226","Ocbimv22010045m.g","KQ417634",428177,428720,543
"10227","Ocbimv22021290m.g","KQ419026",18935,43078,24143
"10228","Ocbimv22005955m.g","KQ417285",225408,274048,48640
"10229","Ocbimv22009493m.g","KQ415865",414492,415073,581
"10230","Ocbimv22015359m.g","KQ429292",43841,43996,155
"10231","Ocbimv22024391m.g","KQ415693",341177,354523,13346
"10232","Ocbimv22018570m.g","KQ430766",7007,24659,17652
"10233","Ocbimv22010611m.g","KQ415669",537464,539049,1585
"10234","Ocbimv22009096m.g","KQ417561",127633,127902,269
"10235","Ocbimv22029197m.g","KQ420675",126838,127147,309
"10236","Ocbimv22007832m.g","KQ426466",182653,190724,8071
"10237","Ocbimv22000637m.g","KQ424026",37121,37504,383
"10238","Ocbimv22008571m.g","KQ417510",148624,148782,158
"10239","Ocbimv22021082m.g","KQ419000",8734,16615,7881
"10240","Ocbimv22035517m.g","KQ422416",294920,297851,2931
"10241","Ocbimv22025782m.g","KQ419904",3161,10920,7759
"10242","Ocbimv22016377m.g","KQ415962",1301035,1301428,393
"10243","Ocbimv22028704m.g","KQ420562",11975,40707,28732
"10244","Ocbimv22015488m.g","KQ429393",1,1744,1743
"10245","Ocbimv22012861m.g","KQ417945",877915,921752,43837
"10246","Ocbimv22008188m.g","KQ417482",221089,226897,5808
"10247","Ocbimv22037431m.g","KQ416694",2982631,3033374,50743
"10248","Ocbimv22010173m.g","KQ427300",33335,55374,22039
"10249","Ocbimv22006554m.g","KQ426014",44279,53636,9357
"10250","Ocbimv22012947m.g","KQ417960",49116,50784,1668
"10251","Ocbimv22036558m.g","KQ422792",310616,311596,980
"10252","Ocbimv22008836m.g","KQ417537",83648,101776,18128
"10253","Ocbimv22025699m.g","KQ419887",139838,142056,2218
"10254","Ocbimv22036532m.g","KQ422786",4811,24949,20138
"10255","Ocbimv22000563m.g","KQ416867",6716,67979,61263
"10256","Ocbimv22002568m.g","KQ424695",5621,15181,9560
"10257","Ocbimv22032331m.g","KQ421523",525169,525689,520
"10258","Ocbimv22003604m.g","KQ425041",318461,318851,390
"10259","Ocbimv22023228m.g","KQ419376",677090,678738,1648
"10260","Ocbimv22026173m.g","KQ420009",250967,301998,51031
"10261","Ocbimv22035439m.g","KQ415750",86651,88078,1427
"10262","Ocbimv22035444m.g","KQ422384",62218,62421,203
"10263","Ocbimv22019938m.g","KQ418838",56212,78051,21839
"10264","Ocbimv22006779m.g","KQ426101",239920,271104,31184
"10265","Ocbimv22029389m.g","KQ416303",546471,546731,260
"10266","Ocbimv22037709m.g","KQ423105",3213,14063,10850
"10267","Ocbimv22006657m.g","KQ426060",3278,11413,8135
"10268","Ocbimv22001027m.g","KQ424157",408021,412247,4226
"10269","Ocbimv22030684m.g","KQ421065",38093,48191,10098
"10270","Ocbimv22004675m.g","KQ417196",48742,49633,891
"10271","Ocbimv22007796m.g","KQ426457",1986,3429,1443
"10272","Ocbimv22008603m.g","KQ417510",648495,669402,20907
"10273","Ocbimv22028627m.g","KQ416265",38357,39347,990
"10274","Ocbimv22039496m.g","KQ416800",16338,48409,32071
"10275","Ocbimv22016950m.g","KQ415972",47036,48246,1210
"10276","Ocbimv22005000m.g","KQ415811",271455,280643,9188
"10277","Ocbimv22026307m.g","KQ420023",486344,509796,23452
"10278","Ocbimv22034521m.g","KQ422068",83891,87157,3266
"10279","Ocbimv22016181m.g","KQ418323",576266,576802,536
"10280","Ocbimv22005116m.g","KQ415813",525133,525381,248
"10281","Ocbimv22016177m.g","KQ418323",55450,55866,416
"10282","Ocbimv22008637m.g","KQ417515",82559,82918,359
"10283","Ocbimv22033779m.g","KQ421871",192920,210326,17406
"10284","Ocbimv22024478m.g","KQ416124",248701,249252,551
"10285","Ocbimv22023731m.g","KQ433600",27374,32639,5265
"10286","Ocbimv22023554m.g","KQ419432",67470,79102,11632
"10287","Ocbimv22012681m.g","KQ417925",31144,59447,28303
"10288","Ocbimv22015301m.g","KQ418217",24243,29864,5621
"10289","Ocbimv22022456m.g","KQ419220",76822,77013,191
"10290","Ocbimv22024602m.g","KQ419601",1233899,1245226,11327
"10291","Ocbimv22037398m.g","KQ416694",1450007,1450228,221
"10292","Ocbimv22015606m.g","KQ418268",4662,6296,1634
"10293","Ocbimv22027526m.g","KQ420299",115633,118866,3233
"10294","Ocbimv22017670m.g","KQ418525",324887,325120,233
"10295","Ocbimv22026376m.g","KQ416188",303499,303978,479
"10296","Ocbimv22015958m.g","KQ429629",38596,48071,9475
"10297","Ocbimv22011111m.g","KQ427640",4017,6471,2454
"10298","Ocbimv22015203m.g","LGKD01615562",435,680,245
"10299","Ocbimv22013991m.g","KQ428718",61605,64069,2464
"10300","Ocbimv22019544m.g","KQ418783",424754,435722,10968
"10301","Ocbimv22004426m.g","KQ415804",454621,486453,31832
"10302","Ocbimv22009814m.g","KQ417620",80138,83449,3311
"10303","Ocbimv22012542m.g","KQ417917",868452,883769,15317
"10304","Ocbimv22026142m.g","KQ420001",54450,55319,869
"10305","Ocbimv22030642m.g","KQ421040",125015,125511,496
"10306","Ocbimv22025387m.g","KQ419787",20028,28480,8452
"10307","Ocbimv22038009m.g","KQ416719",368799,432433,63634
"10308","Ocbimv22020996m.g","KQ431922",8669,10563,1894
"10309","Ocbimv22037549m.g","KQ423059",80662,92903,12241
"10310","Ocbimv22038372m.g","KQ423298",216560,218587,2027
"10311","Ocbimv22006973m.g","KQ417369",82031,82753,722
"10312","Ocbimv22009244m.g","KQ417578",239304,254488,15184
"10313","Ocbimv22000639m.g","KQ424026",212962,214163,1201
"10314","Ocbimv22031529m.g","KQ421265",380848,381421,573
"10315","Ocbimv22003743m.g","KQ417105",88224,88502,278
"10316","Ocbimv22022209m.g","KQ416062",22927,23307,380
"10317","Ocbimv22014402m.g","KQ428905",148104,148970,866
"10318","Ocbimv22001008m.g","KQ424147",274083,274436,353
"10319","Ocbimv22021078m.g","KQ418998",1357445,1358351,906
"10320","Ocbimv22037577m.g","KQ423072",111705,112052,347
"10321","Ocbimv22010301m.g","KQ417666",449664,450383,719
"10322","Ocbimv22027670m.g","KQ416230",164114,164608,494
"10323","Ocbimv22039796m.g","KQ423753",25691,26158,467
"10324","Ocbimv22030522m.g","KQ421009",1818269,1818643,374
"10325","Ocbimv22004889m.g","KQ425464",17301,45115,27814
"10326","Ocbimv22024417m.g","KQ419577",348912,366146,17234
"10327","Ocbimv22030743m.g","LGKD01384392",1,1991,1990
"10328","Ocbimv22001681m.g","KQ416953",559642,574299,14657
"10329","Ocbimv22029364m.g","KQ416300",23742,24155,413
"10330","Ocbimv22019948m.g","KQ418838",599272,607764,8492
"10331","Ocbimv22016596m.g","KQ418369",47788,47985,197
"10332","Ocbimv22031477m.g","KQ416399",401235,402582,1347
"10333","Ocbimv22034884m.g","KQ422206",257039,257770,731
"10334","Ocbimv22018092m.g","KQ418571",431921,500644,68723
"10335","Ocbimv22021570m.g","KQ419079",21303,22542,1239
"10336","Ocbimv22026540m.g","KQ420065",456026,456271,245
"10337","Ocbimv22031670m.g","KQ421308",87950,106271,18321
"10338","Ocbimv22021379m.g","KQ432103",77699,77995,296
"10339","Ocbimv22031278m.g","KQ421217",26165,77090,50925
"10340","Ocbimv22012036m.g","KQ417857",18458,26050,7592
"10341","Ocbimv22017608m.g","KQ430378",59677,60688,1011
"10342","Ocbimv22003630m.g","KQ425054",19,2987,2968
"10343","Ocbimv22022363m.g","KQ419207",93464,93766,302
"10344","Ocbimv22010243m.g","KQ417660",445432,464464,19032
"10345","Ocbimv22025705m.g","KQ419887",629705,657931,28226
"10346","Ocbimv22032631m.g","KQ421620",318522,318776,254
"10347","Ocbimv22010135m.g","KQ427275",5330,5692,362
"10348","Ocbimv22018734m.g","KQ415998",361715,362776,1061
"10349","Ocbimv22019736m.g","KQ431287",3,607,604
"10350","Ocbimv22022996m.g","KQ419337",37462,45362,7900
"10351","Ocbimv22038043m.g","KQ416721",30350,38008,7658
"10352","Ocbimv22037046m.g","KQ422909",1076983,1077971,988
"10353","Ocbimv22007753m.g","KQ415847",738615,744616,6001
"10354","Ocbimv22022679m.g","KQ419281",55719,57698,1979
"10355","Ocbimv22009949m.g","KQ427173",116442,117332,890
"10356","Ocbimv22035903m.g","KQ422595",452507,454802,2295
"10357","Ocbimv22039444m.g","KQ416799",1693447,1694748,1301
"10358","Ocbimv22004942m.g","KQ417215",410527,410718,191
"10359","Ocbimv22022458m.g","KQ419220",440676,441053,377
"10360","Ocbimv22021175m.g","KQ415686",531022,697853,166831
"10361","Ocbimv22026747m.g","KQ420105",164906,166324,1418
"10362","Ocbimv22005336m.g","KQ417245",147288,148239,951
"10363","Ocbimv22001915m.g","KQ424474",20167,49773,29606
"10364","Ocbimv22025327m.g","KQ419774",213109,217072,3963
"10365","Ocbimv22038531m.g","KQ416750",50135,50596,461
"10366","Ocbimv22016624m.g","KQ415967",178044,178310,266
"10367","Ocbimv22006948m.g","KQ417365",63026,78743,15717
"10368","Ocbimv22020060m.g","KQ418847",234456,287441,52985
"10369","Ocbimv22005684m.g","KQ425709",2830,6301,3471
"10370","Ocbimv22008435m.g","KQ417501",255801,261392,5591
"10371","Ocbimv22016506m.g","KQ429904",52785,65758,12973
"10372","Ocbimv22006327m.g","KQ425877",102329,124731,22402
"10373","Ocbimv22037712m.g","KQ423108",78818,79063,245
"10374","Ocbimv22036638m.g","KQ422815",126576,126776,200
"10375","Ocbimv22005853m.g","KQ417280",217813,225994,8181
"10376","Ocbimv22037572m.g","KQ416702",148592,148999,407
"10377","Ocbimv22029801m.g","KQ420827",4391,4853,462
"10378","Ocbimv22020720m.g","KQ418956",123213,163519,40306
"10379","Ocbimv22003463m.g","KQ425015",370836,376454,5618
"10380","Ocbimv22020945m.g","KQ418982",239177,239921,744
"10381","Ocbimv22013634m.g","KQ418040",363043,363261,218
"10382","Ocbimv22001373m.g","KQ424293",1884,5895,4011
"10383","Ocbimv22002535m.g","KQ424678",172961,230687,57726
"10384","Ocbimv22013248m.g","KQ418004",311691,326403,14712
"10385","Ocbimv22014782m.g","KQ418176",1472981,1473638,657
"10386","Ocbimv22006660m.g","KQ417341",201193,208696,7503
"10387","Ocbimv22023597m.g","KQ419439",409607,409816,209
"10388","Ocbimv22029154m.g","KQ420670",12576,86410,73834
"10389","Ocbimv22034746m.g","KQ422141",71747,81689,9942
"10390","Ocbimv22001836m.g","KQ424442",52535,72527,19992
"10391","Ocbimv22033955m.g","KQ416501",81496,81918,422
"10392","Ocbimv22016913m.g","KQ418422",823301,824485,1184
"10393","Ocbimv22018889m.g","KQ418694",139840,174045,34205
"10394","Ocbimv22023143m.g","LGKD01685892",116,376,260
"10395","Ocbimv22003674m.g","KQ417100",543236,543388,152
"10396","Ocbimv22023314m.g","KQ416087",1761032,1802950,41918
"10397","Ocbimv22037333m.g","KQ423002",55291,56883,1592
"10398","Ocbimv22001521m.g","KQ424343",20077,20925,848
"10399","Ocbimv22001561m.g","KQ424358",5943,6348,405
"10400","Ocbimv22027736m.g","KQ420350",294562,326172,31610
"10401","Ocbimv22038314m.g","KQ423276",80914,105274,24360
"10402","Ocbimv22022243m.g","KQ432655",13640,15415,1775
"10403","Ocbimv22035641m.g","KQ422484",81495,81917,422
"10404","Ocbimv22017593m.g","KQ430374",39946,40185,239
"10405","Ocbimv22003475m.g","KQ425015",677640,678125,485
"10406","Ocbimv22022085m.g","KQ416059",50111,50290,179
"10407","Ocbimv22036128m.g","KQ422647",205566,208748,3182
"10408","Ocbimv22002416m.g","KQ417009",719786,719944,158
"10409","Ocbimv22010107m.g","KQ427263",1268,41411,40143
"10410","Ocbimv22022052m.g","KQ419154",476865,477023,158
"10411","Ocbimv22000809m.g","KQ416885",718000,718800,800
"10412","Ocbimv22022577m.g","LGKD01680338",116,373,257
"10413","Ocbimv22030816m.g","KQ421092",265978,269054,3076
"10414","Ocbimv22006628m.g","KQ426038",2705,3298,593
"10415","Ocbimv22010192m.g","KQ417654",217070,299680,82610
"10416","Ocbimv22031531m.g","KQ421265",477134,477901,767
"10417","Ocbimv22014217m.g","KQ418101",261199,275315,14116
"10418","Ocbimv22028580m.g","KQ420525",231518,248959,17441
"10419","Ocbimv22013523m.g","KQ428545",47419,48554,1135
"10420","Ocbimv22035696m.g","KQ422516",843450,911410,67960
"10421","Ocbimv22024778m.g","KQ419629",342515,342670,155
"10422","Ocbimv22038745m.g","KQ416765",16869,17632,763
"10423","Ocbimv22000859m.g","KQ424096",46246,51187,4941
"10424","Ocbimv22020959m.g","KQ418983",2083,2571,488
"10425","Ocbimv22016606m.g","KQ418370",86802,138374,51572
"10426","Ocbimv22019308m.g","KQ418747",388536,391883,3347
"10427","Ocbimv22005343m.g","KQ425586",1,857,856
"10428","Ocbimv22003690m.g","KQ425066",246889,248759,1870
"10429","Ocbimv22024393m.g","KQ415693",390005,390784,779
"10430","Ocbimv22028995m.g","KQ416279",73898,74065,167
"10431","Ocbimv22019765m.g","KQ418811",1117333,1118668,1335
"10432","Ocbimv22038316m.g","KQ423277",49745,70667,20922
"10433","Ocbimv22032214m.g","KQ416425",894197,894433,236
"10434","Ocbimv22033954m.g","KQ416501",77157,79991,2834
"10435","Ocbimv22007147m.g","KQ426214",116550,116738,188
"10436","Ocbimv22014233m.g","KQ428808",3111,3455,344
"10437","Ocbimv22033518m.g","KQ421823",373151,373417,266
"10438","Ocbimv22007535m.g","KQ426370",3644,4424,780
"10439","Ocbimv22023379m.g","KQ419395",333311,337744,4433
"10440","Ocbimv22024612m.g","KQ416126",104506,104949,443
"10441","Ocbimv22025397m.g","KQ419788",229567,231168,1601
"10442","Ocbimv22027985m.g","KQ420415",142151,158228,16077
"10443","Ocbimv22039001m.g","KQ423506",136535,143371,6836
"10444","Ocbimv22039150m.g","LGKD01479075",62,376,314
"10445","Ocbimv22031847m.g","KQ421357",24713,49265,24552
"10446","Ocbimv22019396m.g","KQ416010",337594,349691,12097
"10447","Ocbimv22029053m.g","LGKD01363153",119,277,158
"10448","Ocbimv22006606m.g","KQ426027",176853,204565,27712
"10449","Ocbimv22011489m.g","KQ417795",420075,474617,54542
"10450","Ocbimv22035514m.g","KQ422416",141649,189877,48228
"10451","Ocbimv22004514m.g","LGKD01530797",193,384,191
"10452","Ocbimv22015081m.g","KQ418194",1533970,1540230,6260
"10453","Ocbimv22033364m.g","KQ421799",16573,20287,3714
"10454","Ocbimv22019063m.g","KQ418714",229102,229731,629
"10455","Ocbimv22018376m.g","KQ418610",247260,259051,11791
"10456","Ocbimv22007129m.g","KQ417381",92624,94958,2334
"10457","Ocbimv22037839m.g","KQ423139",422936,436968,14032
"10458","Ocbimv22003348m.g","KQ424990",45820,51504,5684
"10459","Ocbimv22032277m.g","KQ421510",39221,39931,710
"10460","Ocbimv22032585m.g","KQ421602",148695,149163,468
"10461","Ocbimv22023281m.g","KQ419392",583,2165,1582
"10462","Ocbimv22027697m.g","KQ420346",24914,48282,23368
"10463","Ocbimv22029754m.g","LGKD01372203",50,298,248
"10464","Ocbimv22037626m.g","KQ415761",530547,531125,578
"10465","Ocbimv22026827m.g","KQ420125",47815,48036,221
"10466","Ocbimv22031415m.g","KQ416398",2196,51991,49795
"10467","Ocbimv22022167m.g","KQ419180",403133,429222,26089
"10468","Ocbimv22000737m.g","KQ416877",1162178,1177055,14877
"10469","Ocbimv22022439m.g","KQ419216",166821,168349,1528
"10470","Ocbimv22005391m.g","KQ417249",1324911,1445251,120340
"10471","Ocbimv22038205m.g","KQ416731",547684,550637,2953
"10472","Ocbimv22023882m.g","KQ419491",151558,164821,13263
"10473","Ocbimv22001724m.g","KQ416957",27810,28829,1019
"10474","Ocbimv22027126m.g","KQ420194",370887,372068,1181
"10475","Ocbimv22030593m.g","KQ421034",278226,278570,344
"10476","Ocbimv22001201m.g","KQ424228",9462,43163,33701
"10477","Ocbimv22027454m.g","KQ420287",469960,477816,7856
"10478","Ocbimv22033218m.g","KQ421758",137898,138765,867
"10479","Ocbimv22039096m.g","KQ416779",94591,95604,1013
"10480","Ocbimv22033115m.g","KQ421731",86236,89569,3333
"10481","Ocbimv22029669m.g","KQ420799",228166,229204,1038
"10482","Ocbimv22027906m.g","KQ416240",35180,38538,3358
"10483","Ocbimv22039681m.g","KQ416813",1546136,1546636,500
"10484","Ocbimv22016849m.g","KQ418413",52512,85796,33284
"10485","Ocbimv22032443m.g","KQ416431",59768,84234,24466
"10486","Ocbimv22013760m.g","KQ418059",32169,35218,3049
"10487","Ocbimv22038765m.g","KQ416765",298267,321354,23087
"10488","Ocbimv22030829m.g","KQ421100",67799,73831,6032
"10489","Ocbimv22022328m.g","KQ419199",93759,164882,71123
"10490","Ocbimv22028993m.g","KQ416279",38268,65235,26967
"10491","Ocbimv22033299m.g","KQ415661",70521,77035,6514
"10492","Ocbimv22027117m.g","KQ420188",103423,113238,9815
"10493","Ocbimv22034962m.g","KQ422230",47712,51365,3653
"10494","Ocbimv22008915m.g","KQ426806",27241,28005,764
"10495","Ocbimv22017176m.g","LGKD01633434",1,703,702
"10496","Ocbimv22034391m.g","KQ422028",57916,67043,9127
"10497","Ocbimv22011793m.g","KQ427906",61074,61571,497
"10498","Ocbimv22036938m.g","KQ416666",973818,1023225,49407
"10499","Ocbimv22023112m.g","KQ419350",537375,571114,33739
"10500","Ocbimv22000258m.g","KQ423908",90677,90907,230
"10501","Ocbimv22005342m.g","KQ417245",588774,596435,7661
"10502","Ocbimv22038379m.g","KQ416738",283181,283486,305
"10503","Ocbimv22000410m.g","KQ423958",94154,94405,251
"10504","Ocbimv22019863m.g","KQ418823",44048,49041,4993
"10505","Ocbimv22006039m.g","KQ425794",45411,73825,28414
"10506","Ocbimv22023903m.g","KQ419497",98792,99796,1004
"10507","Ocbimv22001582m.g","KQ424363",356339,357714,1375
"10508","Ocbimv22016137m.g","KQ418322",99522,117182,17660
"10509","Ocbimv22011192m.g","KQ415884",239753,240034,281
"10510","Ocbimv22015185m.g","KQ418204",16735,19023,2288
"10511","Ocbimv22028000m.g","KQ420415",575988,581954,5966
"10512","Ocbimv22034581m.g","KQ422077",469472,469914,442
"10513","Ocbimv22012231m.g","KQ417892",51853,92864,41011
"10514","Ocbimv22032461m.g","KQ421549",164496,178797,14301
"10515","Ocbimv22009127m.g","KQ426892",69210,70514,1304
"10516","Ocbimv22026067m.g","KQ419981",59684,60367,683
"10517","Ocbimv22023630m.g","KQ419448",37236,43385,6149
"10518","Ocbimv22038628m.g","KQ423423",61482,69738,8256
"10519","Ocbimv22006690m.g","KQ426075",206071,212730,6659
"10520","Ocbimv22024255m.g","KQ419553",13254,27090,13836
"10521","Ocbimv22007670m.g","KQ426420",10642,13173,2531
"10522","Ocbimv22033420m.g","KQ421809",7543,8526,983
"10523","Ocbimv22006058m.g","KQ417293",196247,227495,31248
"10524","Ocbimv22026958m.g","KQ420152",1349,1870,521
"10525","Ocbimv22028440m.g","KQ420488",120807,158814,38007
"10526","Ocbimv22030288m.g","KQ420939",323892,344831,20939
"10527","Ocbimv22021606m.g","KQ432245",106383,107162,779
"10528","Ocbimv22027403m.g","KQ416223",384876,394453,9577
"10529","Ocbimv22005101m.g","KQ417229",790,7286,6496
"10530","Ocbimv22029704m.g","KQ416318",31338,31711,373
"10531","Ocbimv22037990m.g","KQ423190",9745,10005,260
"10532","Ocbimv22036709m.g","KQ416654",322791,322940,149
"10533","Ocbimv22016292m.g","KQ429791",45676,48456,2780
"10534","Ocbimv22022748m.g","KQ416074",840295,878589,38294
"10535","Ocbimv22018651m.g","KQ418649",687483,705247,17764
"10536","Ocbimv22009354m.g","KQ417585",1109322,1109678,356
"10537","Ocbimv22014397m.g","KQ415929",106627,148444,41817
"10538","Ocbimv22020249m.g","KQ418877",288128,289373,1245
"10539","Ocbimv22037557m.g","KQ416701",53570,78981,25411
"10540","Ocbimv22029569m.g","KQ420776",1004695,1049456,44761
"10541","Ocbimv22038606m.g","KQ416754",168429,193334,24905
"10542","Ocbimv22010145m.g","KQ417648",468672,474115,5443
"10543","Ocbimv22001202m.g","KQ424229",20231,26945,6714
"10544","Ocbimv22038026m.g","KQ416719",980296,1051878,71582
"10545","Ocbimv22014099m.g","KQ428760",18611,40391,21780
"10546","Ocbimv22003659m.g","KQ425062",556946,557116,170
"10547","Ocbimv22022476m.g","KQ432769",4504,25222,20718
"10548","Ocbimv22007782m.g","KQ426456",217400,217873,473
"10549","Ocbimv22024772m.g","KQ419627",6619,64757,58138
"10550","Ocbimv22031927m.g","KQ416413",1246666,1248579,1913
"10551","Ocbimv22005524m.g","KQ417260",47622,47963,341
"10552","Ocbimv22020499m.g","KQ418919",668863,671099,2236
"10553","Ocbimv22022076m.g","KQ419158",176813,177061,248
"10554","Ocbimv22029241m.g","KQ420690",324947,349271,24324
"10555","Ocbimv22004096m.g","KQ425201",23925,31036,7111
"10556","Ocbimv22021337m.g","KQ419033",73807,88469,14662
"10557","Ocbimv22013142m.g","KQ417987",75883,85636,9753
"10558","Ocbimv22033673m.g","KQ421858",291381,294565,3184
"10559","Ocbimv22002236m.g","KQ416997",90676,90945,269
"10560","Ocbimv22002388m.g","KQ424655",5861,6376,515
"10561","Ocbimv22003218m.g","KQ417064",92426,138292,45866
"10562","Ocbimv22016345m.g","KQ415679",889,7285,6396
"10563","Ocbimv22005616m.g","KQ425681",74426,81083,6657
"10564","Ocbimv22024904m.g","KQ416131",498931,501824,2893
"10565","Ocbimv22023479m.g","KQ433417",320662,333583,12921
"10566","Ocbimv22011265m.g","KQ417771",1073345,1085903,12558
"10567","Ocbimv22005964m.g","KQ425764",6721,76398,69677
"10568","Ocbimv22030004m.g","KQ416329",173993,174193,200
"10569","Ocbimv22037220m.g","KQ422970",100977,101639,662
"10570","Ocbimv22001007m.g","KQ424147",184590,184748,158
"10571","Ocbimv22027691m.g","KQ420343",2805,44783,41978
"10572","Ocbimv22018934m.g","KQ418698",167608,168728,1120
"10573","Ocbimv22019026m.g","KQ418711",762251,762592,341
"10574","Ocbimv22003448m.g","KQ425015",54433,56882,2449
"10575","Ocbimv22038607m.g","KQ416754",256740,288889,32149
"10576","Ocbimv22032329m.g","KQ421523",499296,515445,16149
"10577","Ocbimv22024219m.g","KQ419550",189476,206644,17168
"10578","Ocbimv22006450m.g","KQ425923",12131,44096,31965
"10579","Ocbimv22004438m.g","KQ425306",86358,86855,497
"10580","Ocbimv22035496m.g","KQ422411",100936,106795,5859
"10581","Ocbimv22013462m.g","KQ418025",64823,81199,16376
"10582","Ocbimv22022654m.g","KQ419277",200872,222606,21734
"10583","Ocbimv22030350m.g","KQ416345",868,17068,16200
"10584","Ocbimv22037371m.g","KQ416694",27785,31757,3972
"10585","Ocbimv22013034m.g","KQ428349",219310,219657,347
"10586","Ocbimv22004827m.g","KQ417209",86322,100710,14388
"10587","Ocbimv22000399m.g","KQ423954",112302,112505,203
"10588","Ocbimv22002177m.g","KQ424568",23828,40237,16409
"10589","Ocbimv22027877m.g","KQ420386",149657,150160,503
"10590","Ocbimv22000557m.g","KQ423995",388245,405429,17184
"10591","Ocbimv22001850m.g","KQ424450",121331,123127,1796
"10592","Ocbimv22019095m.g","KQ430963",230286,233543,3257
"10593","Ocbimv22011999m.g","KQ417851",935257,965173,29916
"10594","Ocbimv22028740m.g","KQ420569",5959,47771,41812
"10595","Ocbimv22036756m.g","KQ416656",1424,3911,2487
"10596","Ocbimv22034395m.g","KQ422028",165095,179504,14409
"10597","Ocbimv22036730m.g","KQ416655",189212,254396,65184
"10598","Ocbimv22014151m.g","KQ418095",49717,63291,13574
"10599","Ocbimv22015092m.g","KQ418194",2329288,2329602,314
"10600","Ocbimv22020548m.g","KQ418923",1483,4005,2522
"10601","Ocbimv22019686m.g","KQ431257",28336,30961,2625
"10602","Ocbimv22030309m.g","KQ420942",337782,338027,245
"10603","Ocbimv22005161m.g","KQ425534",10795,12861,2066
"10604","Ocbimv22026505m.g","KQ420059",826921,827478,557
"10605","Ocbimv22032208m.g","KQ416425",84910,95365,10455
"10606","Ocbimv22034713m.g","KQ422121",125832,127901,2069
"10607","Ocbimv22025123m.g","KQ416138",248687,248911,224
"10608","Ocbimv22026560m.g","KQ416193",72056,99061,27005
"10609","Ocbimv22019352m.g","KQ418754",58896,60816,1920
"10610","Ocbimv22024376m.g","KQ433960",1844,49071,47227
"10611","Ocbimv22038722m.g","KQ423455",2774,41212,38438
"10612","Ocbimv22006528m.g","KQ417333",461381,461818,437
"10613","Ocbimv22025746m.g","KQ415694",961827,962045,218
"10614","Ocbimv22024025m.g","KQ419523",11335,14828,3493
"10615","Ocbimv22036605m.g","KQ422804",149582,218839,69257
"10616","Ocbimv22035889m.g","KQ422595",190029,196480,6451
"10617","Ocbimv22029797m.g","KQ420825",430370,430650,280
"10618","Ocbimv22013387m.g","KQ418018",872301,885662,13361
"10619","Ocbimv22037350m.g","KQ423011",19,1714,1695
"10620","Ocbimv22009307m.g","KQ417581",269037,378920,109883
"10621","Ocbimv22033245m.g","KQ421758",919858,925122,5264
"10622","Ocbimv22014000m.g","KQ418075",605671,609951,4280
"10623","Ocbimv22015556m.g","KQ429416",245473,279750,34277
"10624","Ocbimv22021535m.g","KQ419071",192390,196850,4460
"10625","Ocbimv22003824m.g","KQ415667",158483,158911,428
"10626","Ocbimv22021489m.g","KQ419057",116525,139252,22727
"10627","Ocbimv22036800m.g","KQ416657",571646,592161,20515
"10628","Ocbimv22004398m.g","KQ417158",188206,318996,130790
"10629","Ocbimv22020274m.g","KQ416024",58302,59765,1463
"10630","Ocbimv22005791m.g","KQ415823",677589,681948,4359
"10631","Ocbimv22008970m.g","KQ417544",345556,380239,34683
"10632","Ocbimv22017118m.g","KQ418451",219821,290606,70785
"10633","Ocbimv22013955m.g","KQ418073",163200,171357,8157
"10634","Ocbimv22020015m.g","KQ431401",406,24282,23876
"10635","Ocbimv22020614m.g","KQ418940",281,703,422
"10636","Ocbimv22020970m.g","KQ418985",251705,269931,18226
"10637","Ocbimv22003491m.g","KQ425015",1284052,1284489,437
"10638","Ocbimv22035704m.g","KQ416599",78872,79838,966
"10639","Ocbimv22030506m.g","KQ421009",264368,264941,573
"10640","Ocbimv22018192m.g","KQ415990",367099,403221,36122
"10641","Ocbimv22007190m.g","KQ426234",6502,15418,8916
"10642","Ocbimv22002836m.g","KQ417040",259142,264957,5815
"10643","Ocbimv22004692m.g","KQ417198",238140,239594,1454
"10644","Ocbimv22025941m.g","KQ419930",976061,1028325,52264
"10645","Ocbimv22039833m.g","KQ423774",94322,94591,269
"10646","Ocbimv22035452m.g","KQ422386",12931,13651,720
"10647","Ocbimv22039660m.g","KQ423720",7541,9075,1534
"10648","Ocbimv22013767m.g","KQ418059",382121,392446,10325
"10649","Ocbimv22016216m.g","KQ418328",297001,380308,83307
"10650","Ocbimv22007881m.g","KQ417458",35225,45814,10589
"10651","Ocbimv22008005m.g","KQ415849",195238,197019,1781
"10652","Ocbimv22023035m.g","KQ433192",13528,77255,63727
"10653","Ocbimv22029830m.g","KQ420828",1051288,1051635,347
"10654","Ocbimv22029212m.g","KQ416291",1131261,1132224,963
"10655","Ocbimv22002867m.g","KQ424811",275694,280966,5272
"10656","Ocbimv22030399m.g","KQ420971",22553,74033,51480
"10657","Ocbimv22033479m.g","KQ416483",19284,32524,13240
"10658","Ocbimv22030697m.g","LGKD01383837",6,143,137
"10659","Ocbimv22022599m.g","LGKD01680691",32,154,122
"10660","Ocbimv22034734m.g","KQ422138",242995,330124,87129
"10661","Ocbimv22021957m.g","KQ419138",460351,461306,955
"10662","Ocbimv22037528m.g","KQ423058",44314,70735,26421
"10663","Ocbimv22034146m.g","KQ421987",82004,89307,7303
"10664","Ocbimv22018306m.g","KQ418599",233344,290146,56802
"10665","Ocbimv22007643m.g","KQ417439",60835,71812,10977
"10666","Ocbimv22023951m.g","KQ419506",103572,103799,227
"10667","Ocbimv22023308m.g","KQ416087",913223,913378,155
"10668","Ocbimv22000512m.g","KQ415777",600910,639034,38124
"10669","Ocbimv22013060m.g","KQ417977",341716,376192,34476
"10670","Ocbimv22002256m.g","KQ424585",148454,149975,1521
"10671","Ocbimv22005795m.g","KQ415823",904354,908219,3865
"10672","Ocbimv22006224m.g","KQ425846",103025,105674,2649
"10673","Ocbimv22008466m.g","KQ415854",478211,479683,1472
"10674","Ocbimv22002068m.g","KQ424530",903031,916180,13149
"10675","Ocbimv22005842m.g","KQ417280",150173,166773,16600
"10676","Ocbimv22034905m.g","KQ422211",125033,125610,577
"10677","Ocbimv22007771m.g","KQ426456",45982,47564,1582
"10678","Ocbimv22009200m.g","KQ417573",395945,397220,1275
"10679","Ocbimv22011733m.g","KQ427883",23795,24485,690
"10680","Ocbimv22009855m.g","KQ417620",1249141,1262027,12886
"10681","Ocbimv22005291m.g","KQ425571",123045,124439,1394
"10682","Ocbimv22033058m.g","KQ421721",640356,649728,9372
"10683","Ocbimv22001895m.g","KQ415786",426926,428326,1400
"10684","Ocbimv22028870m.g","KQ420595",497622,498722,1100
"10685","Ocbimv22015622m.g","KQ418269",328242,365958,37716
"10686","Ocbimv22007932m.g","KQ426495",187378,188019,641
"10687","Ocbimv22022059m.g","KQ419155",52241,52519,278
"10688","Ocbimv22009931m.g","KQ417623",356867,357214,347
"10689","Ocbimv22023709m.g","KQ419461",124448,125727,1279
"10690","Ocbimv22038910m.g","KQ416771",1374432,1374677,245
"10691","Ocbimv22031238m.g","KQ421206",903,60346,59443
"10692","Ocbimv22036388m.g","KQ422739",30888,56506,25618
"10693","Ocbimv22005826m.g","KQ417280",85745,89271,3526
"10694","Ocbimv22019204m.g","KQ418734",34988,37905,2917
"10695","Ocbimv22025546m.g","KQ416158",8930,18200,9270
"10696","Ocbimv22018898m.g","KQ430924",70332,70785,453
"10697","Ocbimv22034609m.g","KQ416539",205666,209043,3377
"10698","Ocbimv22039309m.g","KQ416788",16004,17380,1376
"10699","Ocbimv22025203m.g","KQ419727",691804,693611,1807
"10700","Ocbimv22006994m.g","KQ417370",87604,92228,4624
"10701","Ocbimv22004180m.g","KQ425220",295626,301170,5544
"10702","Ocbimv22035926m.g","KQ416610",26106,26612,506
"10703","Ocbimv22038627m.g","KQ423423",37886,59528,21642
"10704","Ocbimv22016965m.g","KQ418430",378716,381323,2607
"10705","Ocbimv22036288m.g","KQ422697",276902,277106,204
"10706","Ocbimv22036771m.g","KQ422853",35565,69410,33845
"10707","Ocbimv22012341m.g","KQ415907",971042,972269,1227
"10708","Ocbimv22033146m.g","KQ421737",23063,101030,77967
"10709","Ocbimv22006989m.g","KQ417370",62044,65435,3391
"10710","Ocbimv22028018m.g","KQ420421",17782,28822,11040
"10711","Ocbimv22026050m.g","KQ419973",717272,734041,16769
"10712","Ocbimv22037830m.g","KQ423139",277254,279613,2359
"10713","Ocbimv22024402m.g","KQ415693",629619,629867,248
"10714","Ocbimv22003700m.g","KQ417101",186813,198174,11361
"10715","Ocbimv22015618m.g","KQ418269",169846,195284,25438
"10716","Ocbimv22032192m.g","KQ421476",155297,205284,49987
"10717","Ocbimv22039323m.g","KQ416788",127454,134270,6816
"10718","Ocbimv22035657m.g","KQ422493",331762,343365,11603
"10719","Ocbimv22033887m.g","KQ421897",159383,159553,170
"10720","Ocbimv22009043m.g","KQ415859",631547,633096,1549
"10721","Ocbimv22034740m.g","KQ422141",3924,5165,1241
"10722","Ocbimv22010576m.g","LGKD01580632",44,250,206
"10723","Ocbimv22007437m.g","KQ417414",17876,18025,149
"10724","Ocbimv22007550m.g","KQ426371",363364,363522,158
"10725","Ocbimv22022220m.g","KQ416062",141831,148769,6938
"10726","Ocbimv22019345m.g","KQ418753",27857,28639,782
"10727","Ocbimv22029085m.g","KQ420642",286461,286673,212
"10728","Ocbimv22014116m.g","KQ418091",22581,22826,245
"10729","Ocbimv22018435m.g","KQ415992",201591,218386,16795
"10730","Ocbimv22012593m.g","KQ428184",1106,1477,371
"10731","Ocbimv22036307m.g","KQ416632",7621,41394,33773
"10732","Ocbimv22001446m.g","KQ416933",475251,567865,92614
"10733","Ocbimv22035045m.g","KQ415746",149017,150177,1160
"10734","Ocbimv22009157m.g","KQ426902",215579,216073,494
"10735","Ocbimv22039595m.g","KQ416807",63985,64146,161
"10736","Ocbimv22007646m.g","KQ417439",152366,154366,2000
"10737","Ocbimv22007587m.g","KQ426385",217509,217712,203
"10738","Ocbimv22032781m.g","KQ421658",125324,136031,10707
"10739","Ocbimv22017605m.g","KQ415979",240550,240723,173
"10740","Ocbimv22039372m.g","KQ423634",95836,110227,14391
"10741","Ocbimv22031320m.g","KQ421217",1270833,1271168,335
"10742","Ocbimv22026721m.g","KQ420102",95300,95741,441
"10743","Ocbimv22025865m.g","KQ419916",212850,217239,4389
"10744","Ocbimv22006219m.g","KQ425846",33969,34475,506
"10745","Ocbimv22021043m.g","KQ418997",109586,109906,320
"10746","Ocbimv22003973m.g","KQ425162",40652,47216,6564
"10747","Ocbimv22015731m.g","KQ429528",5612,8279,2667
"10748","Ocbimv22015956m.g","KQ429629",4579,8349,3770
"10749","Ocbimv22022107m.g","KQ432583",39,699,660
"10750","Ocbimv22024088m.g","KQ419533",407051,425776,18725
"10751","Ocbimv22035195m.g","KQ422300",99789,132815,33026
"10752","Ocbimv22009467m.g","KQ417596",128618,129109,491
"10753","Ocbimv22015717m.g","LGKD01621209",173,349,176
"10754","Ocbimv22032674m.g","KQ416444",93623,100004,6381
"10755","Ocbimv22004316m.g","KQ417147",1590790,1594732,3942
"10756","Ocbimv22000092m.g","KQ416839",172110,178156,6046
"10757","Ocbimv22027059m.g","KQ420170",140722,141372,650
"10758","Ocbimv22010215m.g","KQ427311",110718,122339,11621
"10759","Ocbimv22036131m.g","KQ422651",9096,9320,224
"10760","Ocbimv22038528m.g","KQ423384",387988,424401,36413
"10761","Ocbimv22003662m.g","KQ417100",13509,71087,57578
"10762","Ocbimv22029630m.g","KQ420787",943846,948107,4261
"10763","Ocbimv22000404m.g","KQ423954",356635,356958,323
"10764","Ocbimv22027432m.g","KQ420273",155873,165009,9136
"10765","Ocbimv22015080m.g","KQ418194",1526471,1530298,3827
"10766","Ocbimv22034960m.g","KQ422228",34012,54975,20963
"10767","Ocbimv22036631m.g","KQ416651",1567017,1568587,1570
"10768","Ocbimv22002103m.g","KQ416986",162342,164737,2395
"10769","Ocbimv22030810m.g","KQ421092",155882,157218,1336
"10770","Ocbimv22021926m.g","KQ419133",118705,145252,26547
"10771","Ocbimv22021164m.g","KQ415686",128755,142531,13776
"10772","Ocbimv22032688m.g","KQ416444",312496,375145,62649
"10773","Ocbimv22032300m.g","KQ421519",39714,72894,33180
"10774","Ocbimv22005532m.g","KQ425649",4600,42898,38298
"10775","Ocbimv22001349m.g","KQ416924",629277,642109,12832
"10776","Ocbimv22038493m.g","KQ423374",36990,39016,2026
"10777","Ocbimv22023701m.g","KQ416093",293165,293560,395
"10778","Ocbimv22032156m.g","LGKD01400552",141,362,221
"10779","Ocbimv22023494m.g","KQ419417",113617,125908,12291
"10780","Ocbimv22011150m.g","KQ427654",145046,155005,9959
"10781","Ocbimv22006476m.g","KQ417326",960540,960929,389
"10782","Ocbimv22023015m.g","KQ419338",378834,417714,38880
"10783","Ocbimv22016120m.g","KQ418320",486065,561239,75174
"10784","Ocbimv22013658m.g","LGKD01602973",13,1887,1874
"10785","Ocbimv22037094m.g","KQ422920",286068,310851,24783
"10786","Ocbimv22010462m.g","KQ417680",31829,33450,1621
"10787","Ocbimv22018057m.g","KQ430541",106957,136622,29665
"10788","Ocbimv22008395m.g","KQ426629",124718,127031,2313
"10789","Ocbimv22016660m.g","LGKD01629164",1,264,263
"10790","Ocbimv22027442m.g","KQ420279",79719,107216,27497
"10791","Ocbimv22008181m.g","KQ417481",2065837,2072072,6235
"10792","Ocbimv22012110m.g","KQ417874",363243,365062,1819
"10793","Ocbimv22028692m.g","KQ420556",101594,101992,398
"10794","Ocbimv22000416m.g","KQ423958",312057,320794,8737
"10795","Ocbimv22035099m.g","KQ416572",39902,40189,287
"10796","Ocbimv22038435m.g","KQ423338",182753,229359,46606
"10797","Ocbimv22010442m.g","KQ427389",75925,76930,1005
"10798","Ocbimv22016953m.g","KQ418429",20991,22924,1933
"10799","Ocbimv22034156m.g","KQ421989",11991,31411,19420
"10800","Ocbimv22020167m.g","KQ418865",24654,70382,45728
"10801","Ocbimv22019434m.g","KQ418767",5702,36441,30739
"10802","Ocbimv22015475m.g","KQ418259",5141,104714,99573
"10803","Ocbimv22002124m.g","KQ415788",202438,203310,872
"10804","Ocbimv22009746m.g","KQ417610",286532,343770,57238
"10805","Ocbimv22008407m.g","KQ426632",257193,259975,2782
"10806","Ocbimv22029009m.g","KQ416279",658605,679237,20632
"10807","Ocbimv22026745m.g","KQ416198",474764,480292,5528
"10808","Ocbimv22030938m.g","KQ421122",124566,168931,44365
"10809","Ocbimv22009004m.g","KQ417549",363767,364504,737
"10810","Ocbimv22020661m.g","KQ418947",143829,144472,643
"10811","Ocbimv22000243m.g","KQ423905",53173,70035,16862
"10812","Ocbimv22028120m.g","KQ420434",508136,508414,278
"10813","Ocbimv22030410m.g","KQ420971",148102,148544,442
"10814","Ocbimv22006980m.g","KQ417370",2615,7690,5075
"10815","Ocbimv22033099m.g","KQ421727",68811,90359,21548
"10816","Ocbimv22035186m.g","KQ422300",22242,28917,6675
"10817","Ocbimv22009387m.g","KQ426987",34108,42927,8819
"10818","Ocbimv22027632m.g","KQ415703",86793,114810,28017
"10819","Ocbimv22020994m.g","KQ418990",154059,155117,1058
"10820","Ocbimv22022133m.g","KQ419175",478535,513160,34625
"10821","Ocbimv22015155m.g","KQ418200",588688,622451,33763
"10822","Ocbimv22004184m.g","KQ425220",328994,335227,6233
"10823","Ocbimv22023126m.g","KQ419352",118712,119062,350
"10824","Ocbimv22012893m.g","KQ417949",70675,71511,836
"10825","Ocbimv22021795m.g","KQ419103",364560,400173,35613
"10826","Ocbimv22010884m.g","KQ417722",337725,338021,296
"10827","Ocbimv22006869m.g","KQ426126",482803,483072,269
"10828","Ocbimv22017839m.g","KQ418552",7105,37479,30374
"10829","Ocbimv22030848m.g","KQ421114",35485,36548,1063
"10830","Ocbimv22002663m.g","KQ424723",32231,37472,5241
"10831","Ocbimv22029233m.g","LGKD01365934",2,456,454
"10832","Ocbimv22018688m.g","KQ418653",139761,140883,1122
"10833","Ocbimv22022273m.g","KQ419192",306816,309581,2765
"10834","Ocbimv22037570m.g","KQ416702",107997,112940,4943
"10835","Ocbimv22031751m.g","KQ421338",114443,126096,11653
"10836","Ocbimv22012514m.g","KQ417917",398398,405365,6967
"10837","Ocbimv22006442m.g","KQ417320",30557,63528,32971
"10838","Ocbimv22026591m.g","KQ416194",144577,152427,7850
"10839","Ocbimv22038563m.g","KQ423403",197791,197982,191
"10840","Ocbimv22039143m.g","KQ416781",149348,149512,164
"10841","Ocbimv22035437m.g","KQ415750",42121,42720,599
"10842","Ocbimv22027741m.g","KQ416232",233717,233914,197
"10843","Ocbimv22036700m.g","KQ422841",25216,25688,472
"10844","Ocbimv22000885m.g","KQ424103",90093,91588,1495
"10845","Ocbimv22039906m.g","KQ416834",344866,346171,1305
"10846","Ocbimv22038690m.g","KQ423444",219735,219893,158
"10847","Ocbimv22002149m.g","KQ424561",23459,25088,1629
"10848","Ocbimv22034494m.g","KQ422062",196841,198050,1209
"10849","Ocbimv22021259m.g","KQ432063",68381,82596,14215
"10850","Ocbimv22031380m.g","KQ416393",681392,682112,720
"10851","Ocbimv22010471m.g","KQ417681",121464,121865,401
"10852","Ocbimv22031754m.g","KQ421338",168248,171031,2783
"10853","Ocbimv22026396m.g","KQ420036",68125,109702,41577
"10854","Ocbimv22031658m.g","KQ421305",621934,629053,7119
"10855","Ocbimv22012771m.g","KQ417939",70515,230810,160295
"10856","Ocbimv22000592m.g","KQ424015",195486,197089,1603
"10857","Ocbimv22000987m.g","KQ416902",27443,40971,13528
"10858","Ocbimv22019838m.g","KQ418821",528496,530916,2420
"10859","Ocbimv22007213m.g","KQ426252",3747,19568,15821
"10860","Ocbimv22025354m.g","KQ419780",210555,210824,269
"10861","Ocbimv22007093m.g","KQ417377",922157,924955,2798
"10862","Ocbimv22026960m.g","KQ420154",153003,164492,11489
"10863","Ocbimv22000868m.g","KQ424096",494207,545189,50982
"10864","Ocbimv22023099m.g","KQ419349",4672,5626,954
"10865","Ocbimv22000581m.g","KQ424005",73745,90533,16788
"10866","Ocbimv22017216m.g","KQ418468",302470,302736,266
"10867","Ocbimv22030872m.g","KQ416373",948134,1002323,54189
"10868","Ocbimv22037237m.g","KQ422973",25608,26835,1227
"10869","Ocbimv22027894m.g","KQ420392",243316,243561,245
"10870","Ocbimv22026370m.g","KQ416188",122303,123478,1175
"10871","Ocbimv22031613m.g","KQ421296",220989,222177,1188
"10872","Ocbimv22002075m.g","KQ416985",1139,39488,38349
"10873","Ocbimv22006976m.g","KQ426171",35364,35561,197
"10874","Ocbimv22030519m.g","KQ421009",1447495,1447704,209
"10875","Ocbimv22000833m.g","KQ415780",164506,164818,312
"10876","Ocbimv22027056m.g","KQ420170",68289,72325,4036
"10877","Ocbimv22032477m.g","KQ421550",113331,131232,17901
"10878","Ocbimv22037348m.g","KQ423009",402485,404426,1941
"10879","Ocbimv22000731m.g","KQ416877",715099,715796,697
"10880","Ocbimv22029712m.g","KQ420813",383470,385432,1962
"10881","Ocbimv22027198m.g","KQ420217",126960,128809,1849
"10882","Ocbimv22034032m.g","KQ416508",132656,239662,107006
"10883","Ocbimv22008572m.g","KQ417510",194605,214348,19743
"10884","Ocbimv22039721m.g","KQ416816",290125,291022,897
"10885","Ocbimv22006249m.g","KQ417305",448097,456948,8851
"10886","Ocbimv22000277m.g","KQ423910",507960,528986,21026
"10887","Ocbimv22029057m.g","KQ420639",269335,270319,984
"10888","Ocbimv22013364m.g","KQ428462",237600,239578,1978
"10889","Ocbimv22035710m.g","KQ416599",217478,239505,22027
"10890","Ocbimv22031618m.g","KQ415725",9847,215539,205692
"10891","Ocbimv22010050m.g","KQ417635",15533,17855,2322
"10892","Ocbimv22017650m.g","KQ418523",361864,367735,5871
"10893","Ocbimv22001906m.g","KQ424468",25067,25489,422
"10894","Ocbimv22033443m.g","KQ421816",297282,327495,30213
"10895","Ocbimv22001228m.g","KQ416917",349729,379889,30160
"10896","Ocbimv22026448m.g","KQ420052",179353,189776,10423
"10897","Ocbimv22039627m.g","KQ416810",930775,931461,686
"10898","Ocbimv22038673m.g","KQ416759",12871,13083,212
"10899","Ocbimv22002396m.g","KQ424656",72039,78914,6875
"10900","Ocbimv22039548m.g","KQ416802",240772,261845,21073
"10901","Ocbimv22001959m.g","KQ424497",31731,41152,9421
"10902","Ocbimv22038892m.g","KQ416771",359521,362982,3461
"10903","Ocbimv22022288m.g","KQ419192",717469,734941,17472
"10904","Ocbimv22012975m.g","KQ417965",31459,44806,13347
"10905","Ocbimv22007181m.g","KQ426224",279333,283483,4150
"10906","Ocbimv22022615m.g","KQ419273",787,1074,287
"10907","Ocbimv22000548m.g","KQ423995",190680,191262,582
"10908","Ocbimv22011277m.g","KQ417772",203728,204142,414
"10909","Ocbimv22005543m.g","KQ425649",241571,241867,296
"10910","Ocbimv22007966m.g","KQ417466",164401,164721,320
"10911","Ocbimv22035682m.g","KQ422516",386235,417767,31532
"10912","Ocbimv22011623m.g","KQ427818",46505,47183,678
"10913","Ocbimv22028438m.g","KQ420488",110833,112674,1841
"10914","Ocbimv22008267m.g","KQ417492",521247,522146,899
"10915","Ocbimv22021658m.g","KQ416049",154454,154831,377
"10916","Ocbimv22033041m.g","KQ416466",515807,516206,399
"10917","Ocbimv22007789m.g","KQ426456",327033,415652,88619
"10918","Ocbimv22021061m.g","KQ431974",109561,122725,13164
"10919","Ocbimv22005514m.g","KQ417259",18209,40888,22679
"10920","Ocbimv22000156m.g","KQ423874",16011,17007,996
"10921","Ocbimv22027162m.g","KQ416211",81954,86210,4256
"10922","Ocbimv22024404m.g","KQ419577",4834,25360,20526
"10923","Ocbimv22006169m.g","KQ417300",2389936,2392254,2318
"10924","Ocbimv22036247m.g","KQ416627",282670,303948,21278
"10925","Ocbimv22037268m.g","KQ422987",12112,12745,633
"10926","Ocbimv22017604m.g","KQ415979",216976,226032,9056
"10927","Ocbimv22027069m.g","KQ420174",156885,157214,329
"10928","Ocbimv22027565m.g","KQ420308",2968,8030,5062
"10929","Ocbimv22036536m.g","KQ422787",55304,55492,188
"10930","Ocbimv22011593m.g","KQ417807",176022,182808,6786
"10931","Ocbimv22018867m.g","KQ418693",397874,409590,11716
"10932","Ocbimv22017878m.g","KQ418552",745486,765102,19616
"10933","Ocbimv22002450m.g","KQ424659",173829,184117,10288
"10934","Ocbimv22000851m.g","KQ424093",692408,726537,34129
"10935","Ocbimv22026058m.g","KQ415697",1624817,1625233,416
"10936","Ocbimv22024933m.g","KQ419659",146019,161366,15347
"10937","Ocbimv22035690m.g","KQ422516",520445,569900,49455
"10938","Ocbimv22034757m.g","KQ422146",114632,119926,5294
"10939","Ocbimv22036740m.g","KQ422849",21580,24040,2460
"10940","Ocbimv22024665m.g","KQ419607",731866,764958,33092
"10941","Ocbimv22028985m.g","KQ420621",172266,172588,322
"10942","Ocbimv22038331m.g","KQ423285",41166,41744,578
"10943","Ocbimv22023258m.g","KQ419380",904803,905150,347
"10944","Ocbimv22022685m.g","KQ419281",511443,523488,12045
"10945","Ocbimv22007470m.g","KQ426356",14035,15331,1296
"10946","Ocbimv22029912m.g","KQ420843",3766,15415,11649
"10947","Ocbimv22022486m.g","KQ416070",37696,94240,56544
"10948","Ocbimv22005864m.g","KQ417280",309178,313219,4041
"10949","Ocbimv22007209m.g","KQ417393",2515,25937,23422
"10950","Ocbimv22003657m.g","KQ425062",403961,431180,27219
"10951","Ocbimv22014367m.g","KQ428883",245607,246724,1117
"10952","Ocbimv22017860m.g","KQ418552",314306,361760,47454
"10953","Ocbimv22000012m.g","KQ423819",363156,374302,11146
"10954","Ocbimv22016382m.g","KQ415962",1654010,1654312,302
"10955","Ocbimv22003501m.g","KQ417089",793490,794043,553
"10956","Ocbimv22018820m.g","LGKD01646372",200,1075,875
"10957","Ocbimv22021776m.g","KQ419098",977713,1024189,46476
"10958","Ocbimv22000585m.g","KQ424014",3010,3258,248
"10959","Ocbimv22005553m.g","KQ425652",7334,19078,11744
"10960","Ocbimv22029741m.g","KQ420815",54,15745,15691
"10961","Ocbimv22036055m.g","KQ416615",120933,122219,1286
"10962","Ocbimv22025190m.g","KQ419727",32651,46155,13504
"10963","Ocbimv22017392m.g","KQ418489",33810,101091,67281
"10964","Ocbimv22020802m.g","KQ418969",30545,37224,6679
"10965","Ocbimv22009643m.g","KQ427059",392499,421339,28840
"10966","Ocbimv22007633m.g","KQ415845",200546,220498,19952
"10967","Ocbimv22012585m.g","KQ417917",1775456,1778345,2889
"10968","Ocbimv22024220m.g","KQ419550",221657,221978,321
"10969","Ocbimv22039598m.g","KQ416807",160191,160712,521
"10970","Ocbimv22033079m.g","KQ421724",306147,309059,2912
"10971","Ocbimv22020239m.g","KQ431554",17091,21470,4379
"10972","Ocbimv22016182m.g","KQ418323",609516,609887,371
"10973","Ocbimv22001217m.g","KQ424229",327040,327600,560
"10974","Ocbimv22003080m.g","KQ424877",268934,282748,13814
"10975","Ocbimv22030013m.g","KQ416330",128606,130084,1478
"10976","Ocbimv22028974m.g","KQ416278",251357,296342,44985
"10977","Ocbimv22009101m.g","KQ417562",132997,133380,383
"10978","Ocbimv22032990m.g","KQ421710",73971,78740,4769
"10979","Ocbimv22009486m.g","KQ415865",93680,94583,903
"10980","Ocbimv22037168m.g","KQ422947",1996,49130,47134
"10981","Ocbimv22029176m.g","KQ420672",494730,502402,7672
"10982","Ocbimv22028297m.g","KQ420463",232903,236851,3948
"10983","Ocbimv22032004m.g","KQ421409",938822,939085,263
"10984","Ocbimv22028466m.g","KQ420496",146388,150454,4066
"10985","Ocbimv22001435m.g","KQ416933",153811,161109,7298
"10986","Ocbimv22011370m.g","KQ417791",196769,197540,771
"10987","Ocbimv22010441m.g","KQ427386",174835,175627,792
"10988","Ocbimv22003072m.g","KQ424877",150144,151260,1116
"10989","Ocbimv22019984m.g","KQ418840",1119248,1120931,1683
"10990","Ocbimv22038671m.g","KQ423435",185533,185742,209
"10991","Ocbimv22022420m.g","KQ419216",17731,24051,6320
"10992","Ocbimv22031211m.g","KQ421200",251457,252214,757
"10993","Ocbimv22038693m.g","KQ423444",269424,270831,1407
"10994","Ocbimv22008317m.g","KQ426613",415988,416179,191
"10995","Ocbimv22015371m.g","KQ418232",552372,552770,398
"10996","Ocbimv22001791m.g","KQ424420",182050,182532,482
"10997","Ocbimv22013193m.g","KQ428421",9027,65329,56302
"10998","Ocbimv22016240m.g","KQ429763",241040,248973,7933
"10999","Ocbimv22010403m.g","KQ417676",371703,375835,4132
"11000","Ocbimv22004703m.g","KQ417198",407077,413977,6900
"11001","Ocbimv22024718m.g","KQ419621",632513,748994,116481
"11002","Ocbimv22002156m.g","KQ416990",291046,373368,82322
"11003","Ocbimv22012240m.g","KQ417892",560039,565194,5155
"11004","Ocbimv22024667m.g","KQ419607",775579,782381,6802
"11005","Ocbimv22036805m.g","KQ416657",1051297,1095846,44549
"11006","Ocbimv22006743m.g","KQ417345",547359,570233,22874
"11007","Ocbimv22038065m.g","KQ423210",131339,131674,335
"11008","Ocbimv22009404m.g","KQ417591",377187,391676,14489
"11009","Ocbimv22035569m.g","KQ422438",180672,207665,26993
"11010","Ocbimv22035599m.g","KQ422458",49911,65224,15313
"11011","Ocbimv22026314m.g","KQ420025",46832,47074,242
"11012","Ocbimv22009641m.g","KQ427059",301537,353887,52350
"11013","Ocbimv22003541m.g","KQ417090",1627069,1633865,6796
"11014","Ocbimv22036716m.g","KQ416654",440591,446682,6091
"11015","Ocbimv22031862m.g","KQ416411",97437,99897,2460
"11016","Ocbimv22023979m.g","KQ419513",185039,185720,681
"11017","Ocbimv22004033m.g","KQ425190",47425,47991,566
"11018","Ocbimv22038700m.g","KQ416761",11781,88650,76869
"11019","Ocbimv22036516m.g","KQ422783",88612,92934,4322
"11020","Ocbimv22037118m.g","KQ416673",257571,257852,281
"11021","Ocbimv22031173m.g","KQ421192",175925,188780,12855
"11022","Ocbimv22020125m.g","KQ418857",30252,30615,363
"11023","Ocbimv22037637m.g","KQ423084",178937,180875,1938
"11024","Ocbimv22000178m.g","KQ423884",49487,93688,44201
"11025","Ocbimv22030920m.g","KQ421117",1856620,1872208,15588
"11026","Ocbimv22031041m.g","KQ421146",17223,17918,695
"11027","Ocbimv22020943m.g","KQ418982",211617,242742,31125
"11028","Ocbimv22030117m.g","KQ416332",9904,10452,548
"11029","Ocbimv22019276m.g","KQ418740",224059,283453,59394
"11030","Ocbimv22026002m.g","KQ419952",180929,273942,93013
"11031","Ocbimv22011140m.g","KQ427654",14186,27914,13728
"11032","Ocbimv22030537m.g","KQ421018",16811,26238,9427
"11033","Ocbimv22005959m.g","KQ417285",778795,779075,280
"11034","Ocbimv22036004m.g","KQ422631",19164,26634,7470
"11035","Ocbimv22024463m.g","KQ433994",37488,47524,10036
"11036","Ocbimv22036484m.g","KQ422772",81668,82111,443
"11037","Ocbimv22001235m.g","KQ424231",496884,524971,28087
"11038","Ocbimv22011144m.g","KQ427654",40246,55387,15141
"11039","Ocbimv22033592m.g","KQ421843",12485,36704,24219
"11040","Ocbimv22035637m.g","KQ422481",243848,244477,629
"11041","Ocbimv22024100m.g","KQ419533",774110,779302,5192
"11042","Ocbimv22024860m.g","KQ419643",92983,93339,356
"11043","Ocbimv22039331m.g","KQ416788",328204,334475,6271
"11044","Ocbimv22008425m.g","KQ417501",170027,185298,15271
"11045","Ocbimv22022981m.g","KQ419333",186557,249513,62956
"11046","Ocbimv22037699m.g","KQ423101",154952,155974,1022
"11047","Ocbimv22027013m.g","KQ420162",709035,755339,46304
"11048","Ocbimv22010819m.g","KQ427527",95142,96678,1536
"11049","Ocbimv22001182m.g","KQ424217",134913,166240,31327
"11050","Ocbimv22036368m.g","KQ422726",97075,167526,70451
"11051","Ocbimv22019525m.g","KQ416015",213630,213962,332
"11052","Ocbimv22035963m.g","KQ416612",1851693,1866696,15003
"11053","Ocbimv22012152m.g","KQ417877",1020354,1030115,9761
"11054","Ocbimv22033135m.g","KQ421733",20965,22462,1497
"11055","Ocbimv22014477m.g","KQ428960",36129,36473,344
"11056","Ocbimv22011218m.g","KQ417763",253016,256716,3700
"11057","Ocbimv22003511m.g","KQ425021",92037,92417,380
"11058","Ocbimv22007863m.g","KQ417455",385719,394275,8556
"11059","Ocbimv22022866m.g","KQ419315",30770,34616,3846
"11060","Ocbimv22011423m.g","KQ415885",1460965,1495472,34507
"11061","Ocbimv22020554m.g","KQ431718",2546,9253,6707
"11062","Ocbimv22030947m.g","KQ421127",184062,184728,666
"11063","Ocbimv22014902m.g","KQ418187",239850,248339,8489
"11064","Ocbimv22001894m.g","KQ415786",183738,183998,260
"11065","Ocbimv22000725m.g","KQ416877",634551,722940,88389
"11066","Ocbimv22003429m.g","KQ417087",855752,884348,28596
"11067","Ocbimv22005540m.g","KQ425649",148244,169597,21353
"11068","Ocbimv22008104m.g","KQ426567",158830,178049,19219
"11069","Ocbimv22008230m.g","KQ426596",98107,98355,248
"11070","Ocbimv22033531m.g","KQ421824",664204,666286,2082
"11071","Ocbimv22025374m.g","KQ416152",510374,515489,5115
"11072","Ocbimv22019775m.g","KQ418812",201011,201897,886
"11073","Ocbimv22005517m.g","KQ417259",83340,95074,11734
"11074","Ocbimv22022005m.g","KQ419146",82085,82582,497
"11075","Ocbimv22030782m.g","KQ421086",200494,237610,37116
"11076","Ocbimv22013310m.g","KQ418009",667121,668170,1049
"11077","Ocbimv22021326m.g","KQ419030",49422,53192,3770
"11078","Ocbimv22030708m.g","KQ421078",3570,3884,314
"11079","Ocbimv22007514m.g","KQ426358",39103,39282,179
"11080","Ocbimv22002682m.g","KQ424738",47258,91870,44612
"11081","Ocbimv22016236m.g","KQ429763",71932,109373,37441
"11082","Ocbimv22017002m.g","KQ418431",1014588,1032904,18316
"11083","Ocbimv22004861m.g","LGKD01533405",90,371,281
"11084","Ocbimv22020231m.g","KQ431549",8954,9583,629
"11085","Ocbimv22026817m.g","KQ420120",101416,101574,158
"11086","Ocbimv22001957m.g","KQ416977",48682,52294,3612
"11087","Ocbimv22026251m.g","KQ416187",264140,264565,425
"11088","Ocbimv22008322m.g","KQ417497",318595,319518,923
"11089","Ocbimv22033507m.g","KQ421821",530140,550072,19932
"11090","Ocbimv22016056m.g","KQ415951",116849,117194,345
"11091","Ocbimv22020693m.g","KQ418954",442500,443858,1358
"11092","Ocbimv22011602m.g","KQ417809",32921,44603,11682
"11093","Ocbimv22000474m.g","KQ423977",21617,70277,48660
"11094","Ocbimv22025615m.g","KQ419861",407628,411505,3877
"11095","Ocbimv22026399m.g","KQ420038",26253,26880,627
"11096","Ocbimv22009734m.g","KQ417608",498698,499258,560
"11097","Ocbimv22031674m.g","KQ421308",216633,243031,26398
"11098","Ocbimv22022258m.g","KQ419190",444189,444419,230
"11099","Ocbimv22014078m.g","KQ415924",2814,10301,7487
"11100","Ocbimv22024532m.g","KQ419593",18707,22035,3328
"11101","Ocbimv22022568m.g","KQ419260",719935,720129,194
"11102","Ocbimv22029940m.g","KQ416325",84272,85599,1327
"11103","Ocbimv22011807m.g","KQ415893",206681,257997,51316
"11104","Ocbimv22033973m.g","KQ421934",5229,8800,3571
"11105","Ocbimv22016278m.g","LGKD01626256",704,937,233
"11106","Ocbimv22009699m.g","LGKD01572881",75,254,179
"11107","Ocbimv22035348m.g","KQ422362",304592,305539,947
"11108","Ocbimv22024110m.g","KQ419534",276364,276828,464
"11109","Ocbimv22038812m.g","KQ423471",39812,42885,3073
"11110","Ocbimv22009689m.g","KQ417604",1324,121374,120050
"11111","Ocbimv22025661m.g","KQ419878",107732,190146,82414
"11112","Ocbimv22013852m.g","KQ415921",208535,226582,18047
"11113","Ocbimv22018329m.g","KQ418607",4041,26667,22626
"11114","Ocbimv22022919m.g","KQ419326",338518,340156,1638
"11115","Ocbimv22007693m.g","KQ415846",1010246,1011544,1298
"11116","Ocbimv22023098m.g","KQ419348",118140,121933,3793
"11117","Ocbimv22003489m.g","KQ425015",1092037,1094083,2046
"11118","Ocbimv22019217m.g","KQ431058",17749,18544,795
"11119","Ocbimv22006614m.g","KQ417337",1889,5342,3453
"11120","Ocbimv22000907m.g","KQ424107",20149,20811,662
"11121","Ocbimv22006102m.g","KQ425821",10621,11800,1179
"11122","Ocbimv22034697m.g","KQ416547",105438,109341,3903
"11123","Ocbimv22014192m.g","KQ418099",36930,40114,3184
"11124","Ocbimv22008994m.g","KQ426830",500,14713,14213
"11125","Ocbimv22008217m.g","KQ417487",835286,845774,10488
"11126","Ocbimv22036109m.g","KQ416617",665185,665403,218
"11127","Ocbimv22037427m.g","KQ416694",2795799,2801670,5871
"11128","Ocbimv22024601m.g","KQ419601",1213126,1230004,16878
"11129","Ocbimv22025455m.g","KQ419807",127042,200430,73388
"11130","Ocbimv22029220m.g","KQ420685",26842,28488,1646
"11131","Ocbimv22012054m.g","KQ427994",873,5333,4460
"11132","Ocbimv22028527m.g","KQ420517",297485,297805,320
"11133","Ocbimv22022422m.g","KQ419216",41621,42242,621
"11134","Ocbimv22034971m.g","KQ422233",119096,119374,278
"11135","Ocbimv22013435m.g","KQ418024",838,1962,1124
"11136","Ocbimv22006683m.g","KQ417343",161075,186189,25114
"11137","Ocbimv22002289m.g","KQ417001",353136,353558,422
"11138","Ocbimv22033869m.g","KQ421896",356297,362285,5988
"11139","Ocbimv22025755m.g","KQ416166",282887,283357,470
"11140","Ocbimv22000261m.g","KQ423909",1861,50713,48852
"11141","Ocbimv22007459m.g","KQ426347",226816,229121,2305
"11142","Ocbimv22007608m.g","KQ417438",3800,11853,8053
"11143","Ocbimv22036556m.g","KQ422791",221976,222314,338
"11144","Ocbimv22005793m.g","KQ415823",782638,818441,35803
"11145","Ocbimv22018974m.g","KQ430934",119448,144369,24921
"11146","Ocbimv22012800m.g","KQ417942",345433,345657,224
"11147","Ocbimv22026303m.g","KQ420023",447408,447890,482
"11148","Ocbimv22021842m.g","KQ415687",1113281,1114579,1298
"11149","Ocbimv22011352m.g","KQ417788",221710,223118,1408
"11150","Ocbimv22014882m.g","KQ415936",307492,339680,32188
"11151","Ocbimv22012367m.g","KQ428131",30138,34016,3878
"11152","Ocbimv22031030m.g","KQ421144",315743,366267,50524
"11153","Ocbimv22011847m.g","KQ427920",177987,178193,206
"11154","Ocbimv22037527m.g","KQ423058",41073,44182,3109
"11155","Ocbimv22021931m.g","KQ419133",410696,416232,5536
"11156","Ocbimv22032609m.g","KQ421606",167686,168177,491
"11157","Ocbimv22032345m.g","KQ421523",1279485,1287859,8374
"11158","Ocbimv22024762m.g","KQ419623",164272,172295,8023
"11159","Ocbimv22039424m.g","KQ423654",414394,414807,413
"11160","Ocbimv22014669m.g","KQ418166",252398,309415,57017
"11161","Ocbimv22017672m.g","KQ418526",10141,10711,570
"11162","Ocbimv22024150m.g","KQ419541",558,2284,1726
"11163","Ocbimv22024380m.g","KQ433973",16971,21658,4687
"11164","Ocbimv22036905m.g","KQ422894",239593,243085,3492
"11165","Ocbimv22025926m.g","KQ419928",52974,54540,1566
"11166","Ocbimv22020571m.g","KQ418926",150565,151554,989
"11167","Ocbimv22021018m.g","KQ418994",1496,20687,19191
"11168","Ocbimv22000894m.g","KQ424106",47450,48618,1168
"11169","Ocbimv22027249m.g","KQ420228",260271,261446,1175
"11170","Ocbimv22035364m.g","KQ416583",93445,93834,389
"11171","Ocbimv22031907m.g","KQ421376",406412,450160,43748
"11172","Ocbimv22034986m.g","KQ422234",28147,33351,5204
"11173","Ocbimv22033961m.g","KQ421920",248289,248576,287
"11174","Ocbimv22033715m.g","KQ416493",313642,313926,284
"11175","Ocbimv22017060m.g","KQ430145",54091,54751,660
"11176","Ocbimv22038130m.g","KQ423217",332628,340010,7382
"11177","Ocbimv22002168m.g","KQ416992",20217,130714,110497
"11178","Ocbimv22039720m.g","KQ416816",263716,276071,12355
"11179","Ocbimv22026520m.g","KQ420063",235630,235824,194
"11180","Ocbimv22014234m.g","KQ428809",37662,38045,383
"11181","Ocbimv22037066m.g","KQ422913",138029,138361,332
"11182","Ocbimv22037252m.g","KQ422978",6834,47593,40759
"11183","Ocbimv22015896m.g","KQ429620",116406,140675,24269
"11184","Ocbimv22017614m.g","KQ430378",165655,166235,580
"11185","Ocbimv22017402m.g","LGKD01635411",6,431,425
"11186","Ocbimv22019854m.g","KQ418822",26288,26644,356
"11187","Ocbimv22019194m.g","KQ418732",84988,85594,606
"11188","Ocbimv22037515m.g","KQ423056",251722,252369,647
"11189","Ocbimv22038458m.g","KQ416743",38879,39352,473
"11190","Ocbimv22033490m.g","KQ421821",299083,304208,5125
"11191","Ocbimv22031071m.g","KQ416384",24848,25009,161
"11192","Ocbimv22005384m.g","KQ417249",524930,537533,12603
"11193","Ocbimv22024639m.g","KQ419605",427000,427992,992
"11194","Ocbimv22032006m.g","KQ421409",965583,966421,838
"11195","Ocbimv22009368m.g","KQ426974",7259,28516,21257
"11196","Ocbimv22003111m.g","KQ417059",29298,30326,1028
"11197","Ocbimv22025544m.g","KQ419836",98543,98752,209
"11198","Ocbimv22023697m.g","KQ416093",35146,36289,1143
"11199","Ocbimv22002041m.g","KQ424528",197,7114,6917
"11200","Ocbimv22002480m.g","KQ417010",680019,680540,521
"11201","Ocbimv22024455m.g","KQ416123",124004,124790,786
"11202","Ocbimv22024302m.g","KQ419564",54412,67830,13418
"11203","Ocbimv22028910m.g","KQ416274",1456142,1536148,80006
"11204","Ocbimv22014149m.g","KQ428776",4078,7484,3406
"11205","Ocbimv22023417m.g","LGKD01688250",183,413,230
"11206","Ocbimv22009113m.g","KQ417563",205430,206023,593
"11207","Ocbimv22011794m.g","KQ427906",62003,63593,1590
"11208","Ocbimv22012696m.g","KQ417928",31543,31797,254
"11209","Ocbimv22032690m.g","KQ416444",658920,660882,1962
"11210","Ocbimv22016634m.g","LGKD01628858",40,228,188
"11211","Ocbimv22012126m.g","KQ415902",80561,93498,12937
"11212","Ocbimv22018314m.g","LGKD01642279",560,3802,3242
"11213","Ocbimv22039954m.g","KQ423809",30802,32903,2101
"11214","Ocbimv22019079m.g","KQ418715",124405,124771,366
"11215","Ocbimv22018300m.g","KQ418598",414015,414283,268
"11216","Ocbimv22022774m.g","LGKD01682387",1,453,452
"11217","Ocbimv22026990m.g","KQ420159",187594,189413,1819
"11218","Ocbimv22003753m.g","KQ417105",1002955,1003557,602
"11219","Ocbimv22018687m.g","KQ418653",52259,52679,420
"11220","Ocbimv22021285m.g","KQ419024",26967,27506,539
"11221","Ocbimv22008723m.g","KQ417527",169398,169568,170
"11222","Ocbimv22035466m.g","KQ422391",267185,268934,1749
"11223","Ocbimv22020913m.g","KQ418974",1085693,1086037,344
"11224","Ocbimv22035950m.g","KQ416612",1464116,1464325,209
"11225","Ocbimv22009058m.g","KQ417556",218539,245908,27369
"11226","Ocbimv22021559m.g","KQ419078",63738,64113,375
"11227","Ocbimv22031519m.g","KQ421264",55961,56152,191
"11228","Ocbimv22034348m.g","KQ422016",306426,306751,325
"11229","Ocbimv22001500m.g","KQ424337",8238,14942,6704
"11230","Ocbimv22025745m.g","KQ415694",789644,789990,346
"11231","Ocbimv22026140m.g","KQ420000",19168,20676,1508
"11232","Ocbimv22018373m.g","KQ418610",234900,235319,419
"11233","Ocbimv22009171m.g","KQ415862",157059,157492,433
"11234","Ocbimv22012843m.g","KQ417945",508283,521482,13199
"11235","Ocbimv22008977m.g","KQ417544",990622,991014,392
"11236","Ocbimv22025664m.g","KQ419878",244829,267826,22997
"11237","Ocbimv22019084m.g","KQ418715",838518,838703,185
"11238","Ocbimv22030496m.g","KQ416353",82713,125439,42726
"11239","Ocbimv22005042m.g","KQ415812",234356,234745,389
"11240","Ocbimv22015560m.g","KQ418266",25374,26420,1046
"11241","Ocbimv22003239m.g","KQ424913",170531,172271,1740
"11242","Ocbimv22001077m.g","KQ424173",25471,25671,200
"11243","Ocbimv22001256m.g","KQ424243",175504,190535,15031
"11244","Ocbimv22016175m.g","KQ429730",79333,158396,79063
"11245","Ocbimv22000733m.g","KQ416877",1078912,1079684,772
"11246","Ocbimv22021296m.g","KQ419026",177819,178202,383
"11247","Ocbimv22009187m.g","KQ426913",7566,8639,1073
"11248","Ocbimv22012791m.g","KQ428240",120273,120854,581
"11249","Ocbimv22036338m.g","KQ422714",111490,145838,34348
"11250","Ocbimv22011812m.g","KQ415893",475178,475727,549
"11251","Ocbimv22028336m.g","KQ420475",654579,676390,21811
"11252","Ocbimv22026192m.g","KQ420016",434,3308,2874
"11253","Ocbimv22038567m.g","KQ423405",29415,45658,16243
"11254","Ocbimv22002121m.g","KQ415788",31965,32293,328
"11255","Ocbimv22009358m.g","LGKD01176351",1889,5000,3111
"11256","Ocbimv22026978m.g","KQ420157",110802,127110,16308
"11257","Ocbimv22038553m.g","KQ423398",191754,192110,356
"11258","Ocbimv22025910m.g","KQ419924",67581,67889,308
"11259","Ocbimv22038463m.g","KQ416744",50344,51753,1409
"11260","Ocbimv22013675m.g","KQ428592",6341,19003,12662
"11261","Ocbimv22022985m.g","LGKD01684923",6,179,173
"11262","Ocbimv22017263m.g","KQ430232",75317,88697,13380
"11263","Ocbimv22028941m.g","KQ420605",258258,258419,161
"11264","Ocbimv22022136m.g","KQ419175",524172,524381,209
"11265","Ocbimv22015932m.g","KQ418303",1095659,1104451,8792
"11266","Ocbimv22002471m.g","KQ424665",94997,99162,4165
"11267","Ocbimv22031719m.g","KQ421325",187064,209826,22762
"11268","Ocbimv22024388m.g","KQ415693",289838,325876,36038
"11269","Ocbimv22023200m.g","KQ419368",801594,890401,88807
"11270","Ocbimv22032860m.g","KQ416453",244233,251735,7502
"11271","Ocbimv22003704m.g","KQ417101",276369,277854,1485
"11272","Ocbimv22034350m.g","KQ422016",510848,511210,362
"11273","Ocbimv22011095m.g","KQ417747",364940,392028,27088
"11274","Ocbimv22003919m.g","KQ417124",72538,74208,1670
"11275","Ocbimv22036156m.g","KQ422659",283992,284472,480
"11276","Ocbimv22002215m.g","KQ424575",51922,52153,231
"11277","Ocbimv22020950m.g","KQ418982",437008,472254,35246
"11278","Ocbimv22025363m.g","KQ419781",204137,275295,71158
"11279","Ocbimv22025021m.g","KQ416136",225229,228117,2888
"11280","Ocbimv22015253m.g","KQ418215",334667,334876,209
"11281","Ocbimv22037030m.g","KQ422909",376253,381695,5442
"11282","Ocbimv22018142m.g","KQ415987",397358,403259,5901
"11283","Ocbimv22033645m.g","KQ421856",6436,7293,857
"11284","Ocbimv22032319m.g","KQ421523",242953,246251,3298
"11285","Ocbimv22010241m.g","LGKD01182379",101,343,242
"11286","Ocbimv22020382m.g","LGKD01659646",8,380,372
"11287","Ocbimv22017122m.g","KQ418453",285,750,465
"11288","Ocbimv22018719m.g","KQ418660",61078,61401,323
"11289","Ocbimv22025146m.g","KQ419709",7551,8685,1134
"11290","Ocbimv22026001m.g","KQ419952",39096,39745,649
"11291","Ocbimv22013049m.g","KQ417977",86780,89491,2711
"11292","Ocbimv22034868m.g","KQ416560",118300,118806,506
"11293","Ocbimv22028961m.g","KQ420616",162925,163176,251
"11294","Ocbimv22022676m.g","KQ419280",340485,387102,46617
"11295","Ocbimv22003232m.g","KQ424913",44723,44926,203
"11296","Ocbimv22004006m.g","KQ417132",75135,80499,5364
"11297","Ocbimv22003385m.g","KQ425000",50413,82287,31874
"11298","Ocbimv22005124m.g","KQ415813",696816,718696,21880
"11299","Ocbimv22003169m.g","KQ417062",76797,87414,10617
"11300","Ocbimv22029040m.g","KQ420631",76819,81617,4798
"11301","Ocbimv22006253m.g","KQ417305",484461,494931,10470
"11302","Ocbimv22026349m.g","KQ420032",10160,48019,37859
"11303","Ocbimv22032680m.g","KQ416444",178168,185627,7459
"11304","Ocbimv22028637m.g","KQ415707",109170,109334,164
"11305","Ocbimv22037354m.g","KQ423013",18149,22800,4651
"11306","Ocbimv22010140m.g","KQ427275",450764,451318,554
"11307","Ocbimv22029506m.g","KQ416311",104788,105264,476
"11308","Ocbimv22001284m.g","KQ416918",4229,31994,27765
"11309","Ocbimv22038978m.g","KQ423497",32016,33887,1871
"11310","Ocbimv22020960m.g","KQ418983",3372,4433,1061
"11311","Ocbimv22024911m.g","KQ416131",875840,877264,1424
"11312","Ocbimv22021727m.g","KQ419092",1624,2292,668
"11313","Ocbimv22029473m.g","KQ416308",559759,559988,229
"11314","Ocbimv22027476m.g","KQ416225",114959,122729,7770
"11315","Ocbimv22032987m.g","LGKD01081230",1,438,437
"11316","Ocbimv22037074m.g","KQ422919",144869,145027,158
"11317","Ocbimv22035561m.g","KQ422438",29065,29547,482
"11318","Ocbimv22021221m.g","KQ419015",69753,70208,455
"11319","Ocbimv22027776m.g","KQ420366",63672,64980,1308
"11320","Ocbimv22026468m.g","KQ420053",928858,929697,839
"11321","Ocbimv22004728m.g","KQ425430",19685,45638,25953
"11322","Ocbimv22026097m.g","KQ419989",264340,283723,19383
"11323","Ocbimv22026057m.g","KQ415697",1565089,1565331,242
"11324","Ocbimv22007908m.g","KQ417459",236729,260986,24257
"11325","Ocbimv22029434m.g","KQ416306",891034,891195,161
"11326","Ocbimv22017001m.g","KQ418431",994048,1013927,19879
"11327","Ocbimv22015370m.g","KQ418232",446474,446644,170
"11328","Ocbimv22029916m.g","KQ420844",77196,79077,1881
"11329","Ocbimv22018073m.g","KQ430556",454,9113,8659
"11330","Ocbimv22025634m.g","KQ419866",20890,70239,49349
"11331","Ocbimv22034650m.g","KQ416544",45802,54918,9116
"11332","Ocbimv22026859m.g","LGKD01336516",124,603,479
"11333","Ocbimv22018838m.g","KQ416003",126411,126680,269
"11334","Ocbimv22009306m.g","KQ417581",259176,259586,410
"11335","Ocbimv22035984m.g","KQ422621",251150,251341,191
"11336","Ocbimv22024240m.g","KQ433876",76781,76995,214
"11337","Ocbimv22003176m.g","KQ424901",1473,6114,4641
"11338","Ocbimv22024485m.g","KQ416124",587956,588201,245
"11339","Ocbimv22033069m.g","KQ421721",884346,907180,22834
"11340","Ocbimv22026475m.g","KQ420055",141387,198631,57244
"11341","Ocbimv22012803m.g","KQ417942",413784,414275,491
"11342","Ocbimv22035374m.g","KQ416583",280143,294303,14160
"11343","Ocbimv22010438m.g","KQ427386",53308,54104,796
"11344","Ocbimv22014047m.g","KQ428735",107600,111583,3983
"11345","Ocbimv22019784m.g","KQ431304",79864,87817,7953
"11346","Ocbimv22000348m.g","KQ423930",50636,51460,824
"11347","Ocbimv22001267m.g","KQ424245",10130,17198,7068
"11348","Ocbimv22014833m.g","LGKD01613258",4,273,269
"11349","Ocbimv22003900m.g","KQ417120",326,1155,829
"11350","Ocbimv22023736m.g","LGKD01692301",179,639,460
"11351","Ocbimv22035297m.g","KQ422351",135203,158583,23380
"11352","Ocbimv22002852m.g","KQ424804",15231,15681,450
"11353","Ocbimv22003040m.g","KQ417055",1721672,1733199,11527
"11354","Ocbimv22017592m.g","KQ430374",14068,17530,3462
"11355","Ocbimv22007414m.g","KQ426334",44346,45524,1178
"11356","Ocbimv22025024m.g","KQ416136",275318,284220,8902
"11357","Ocbimv22032340m.g","KQ421523",1002024,1017668,15644
"11358","Ocbimv22029969m.g","KQ420864",618,9539,8921
"11359","Ocbimv22031998m.g","KQ421409",641423,679186,37763
"11360","Ocbimv22007524m.g","KQ426360",278665,279625,960
"11361","Ocbimv22006689m.g","KQ426075",178396,178775,379
"11362","Ocbimv22011640m.g","KQ427828",42843,44293,1450
"11363","Ocbimv22037984m.g","KQ416717",233741,234196,455
"11364","Ocbimv22008238m.g","KQ426602",4397,8476,4079
"11365","Ocbimv22009829m.g","KQ417620",429120,447122,18002
"11366","Ocbimv22008550m.g","KQ426686",36754,91153,54399
"11367","Ocbimv22032815m.g","KQ416452",194932,195228,296
"11368","Ocbimv22025881m.g","KQ416175",371028,372324,1296
"11369","Ocbimv22011610m.g","KQ427798",684,2597,1913
"11370","Ocbimv22016102m.g","KQ429708",217428,218248,820
"11371","Ocbimv22020041m.g","KQ431411",117,1115,998
"11372","Ocbimv22015644m.g","KQ418271",304248,304415,167
"11373","Ocbimv22003165m.g","KQ417062",62210,63372,1162
"11374","Ocbimv22018796m.g","LGKD01646283",8,286,278
"11375","Ocbimv22017383m.g","KQ430272",293772,294219,447
"11376","Ocbimv22004468m.g","KQ417165",157119,157391,272
"11377","Ocbimv22014898m.g","KQ418187",50845,51413,568
"11378","Ocbimv22026936m.g","KQ416206",10037,28150,18113
"11379","Ocbimv22007292m.g","KQ417400",21896,25207,3311
"11380","Ocbimv22029365m.g","KQ416300",31822,40672,8850
"11381","Ocbimv22009568m.g","KQ427028",360523,362872,2349
"11382","Ocbimv22029938m.g","KQ416325",79932,80436,504
"11383","Ocbimv22016478m.g","KQ415966",538678,539205,527
"11384","Ocbimv22000931m.g","KQ424119",18438,19751,1313
"11385","Ocbimv22020295m.g","KQ418886",142927,143349,422
"11386","Ocbimv22033081m.g","KQ421724",400249,400443,194
"11387","Ocbimv22002494m.g","KQ424671",395254,395528,274
"11388","Ocbimv22008358m.g","KQ417498",236193,246769,10576
"11389","Ocbimv22032939m.g","KQ421687",17729,81703,63974
"11390","Ocbimv22032350m.g","KQ421523",1350677,1350999,322
"11391","Ocbimv22030170m.g","KQ420915",680914,681462,548
"11392","Ocbimv22012885m.g","KQ428271",1057,3516,2459
"11393","Ocbimv22035259m.g","KQ415748",460153,461269,1116
"11394","Ocbimv22006596m.g","KQ426027",64794,74427,9633
"11395","Ocbimv22012200m.g","KQ417887",484553,492744,8191
"11396","Ocbimv22005880m.g","KQ417280",413542,417055,3513
"11397","Ocbimv22031509m.g","KQ421263",338000,348314,10314
"11398","Ocbimv22021241m.g","KQ419018",547456,548106,650
"11399","Ocbimv22033353m.g","KQ416476",70222,70467,245
"11400","Ocbimv22017585m.g","KQ418510",10420,10653,233
"11401","Ocbimv22022240m.g","KQ432650",13092,13316,224
"11402","Ocbimv22014160m.g","KQ418096",147257,147670,413
"11403","Ocbimv22010663m.g","KQ427464",554912,555139,227
"11404","Ocbimv22010155m.g","KQ427290",30492,31517,1025
"11405","Ocbimv22007021m.g","KQ417370",523821,532776,8955
"11406","Ocbimv22036672m.g","KQ422826",13188,13343,155
"11407","Ocbimv22027516m.g","KQ420295",67069,68053,984
"11408","Ocbimv22009253m.g","KQ417578",624252,625139,887
"11409","Ocbimv22035372m.g","KQ416583",224377,225739,1362
"11410","Ocbimv22017906m.g","KQ418559",356,6047,5691
"11411","Ocbimv22025045m.g","KQ416136",762843,778346,15503
"11412","Ocbimv22007835m.g","KQ426466",227676,234445,6769
"11413","Ocbimv22033767m.g","KQ421866",112502,162443,49941
"11414","Ocbimv22022817m.g","KQ433029",105749,105934,185
"11415","Ocbimv22001207m.g","KQ424229",122193,122411,218
"11416","Ocbimv22034944m.g","KQ415743",143496,143792,296
"11417","Ocbimv22007902m.g","KQ417459",116838,117083,245
"11418","Ocbimv22027142m.g","KQ416210",145076,145453,377
"11419","Ocbimv22002736m.g","KQ417030",1293481,1294227,746
"11420","Ocbimv22016320m.g","KQ418338",393177,398394,5217
"11421","Ocbimv22011169m.g","KQ417756",87482,90836,3354
"11422","Ocbimv22021086m.g","KQ419000",148375,154761,6386
"11423","Ocbimv22006646m.g","KQ426051",2799,13378,10579
"11424","Ocbimv22014570m.g","KQ428991",20876,22264,1388
"11425","Ocbimv22009183m.g","KQ426911",215473,220433,4960
"11426","Ocbimv22026271m.g","KQ420022",513909,514633,724
"11427","Ocbimv22037914m.g","KQ423164",339955,360489,20534
"11428","Ocbimv22039757m.g","KQ423738",82407,91579,9172
"11429","Ocbimv22020176m.g","KQ418868",4203,4740,537
"11430","Ocbimv22020186m.g","KQ418871",3690,3905,215
"11431","Ocbimv22020607m.g","KQ418936",612410,612601,191
"11432","Ocbimv22037517m.g","KQ423056",321286,321612,326
"11433","Ocbimv22018803m.g","KQ416002",124091,139928,15837
"11434","Ocbimv22035449m.g","KQ422385",407753,437653,29900
"11435","Ocbimv22017838m.g","KQ418552",1,4298,4297
"11436","Ocbimv22014616m.g","KQ415934",96537,122573,26036
"11437","Ocbimv22013983m.g","KQ428717",89142,153259,64117
"11438","Ocbimv22028201m.g","KQ420444",140358,149953,9595
"11439","Ocbimv22001113m.g","LGKD01498590",199,492,293
"11440","Ocbimv22010340m.g","KQ415875",49615,50507,892
"11441","Ocbimv22025773m.g","KQ416166",1199310,1199534,224
"11442","Ocbimv22013807m.g","KQ418061",515033,541365,26332
"11443","Ocbimv22024414m.g","KQ419577",315283,318946,3663
"11444","Ocbimv22038467m.g","KQ423354",174361,174765,404
"11445","Ocbimv22038677m.g","KQ416760",226240,227619,1379
"11446","Ocbimv22031441m.g","KQ421244",99822,100789,967
"11447","Ocbimv22038878m.g","KQ423484",184236,203125,18889
"11448","Ocbimv22009565m.g","KQ427028",147432,147635,203
"11449","Ocbimv22026594m.g","KQ416194",288019,381470,93451
"11450","Ocbimv22013172m.g","KQ417996",351952,356994,5042
"11451","Ocbimv22002386m.g","KQ417007",245859,359923,114064
"11452","Ocbimv22028903m.g","KQ416274",1111291,1113712,2421
"11453","Ocbimv22008143m.g","KQ417481",428158,440681,12523
"11454","Ocbimv22013597m.g","KQ418038",713395,720599,7204
"11455","Ocbimv22028872m.g","KQ420595",609197,629885,20688
"11456","Ocbimv22025241m.g","KQ419743",303714,354794,51080
"11457","Ocbimv22024278m.g","KQ419562",235767,237239,1472
"11458","Ocbimv22010151m.g","KQ427279",24797,26632,1835
"11459","Ocbimv22002126m.g","KQ415788",350776,354582,3806
"11460","Ocbimv22000924m.g","KQ416895",61854,62126,272
"11461","Ocbimv22008595m.g","KQ417510",479447,487609,8162
"11462","Ocbimv22007424m.g","KQ426340",559,20892,20333
"11463","Ocbimv22035264m.g","KQ422348",30122,32885,2763
"11464","Ocbimv22034440m.g","KQ422036",1384280,1385707,1427
"11465","Ocbimv22020321m.g","KQ418892",215001,215171,170
"11466","Ocbimv22001635m.g","KQ416950",858198,858461,263
"11467","Ocbimv22013274m.g","KQ418005",56004,56637,633
"11468","Ocbimv22037075m.g","KQ422919",303336,303620,284
"11469","Ocbimv22021878m.g","KQ432376",317,604,287
"11470","Ocbimv22021454m.g","KQ419052",74542,74778,236
"11471","Ocbimv22011962m.g","KQ417847",1396437,1427466,31029
"11472","Ocbimv22028026m.g","KQ416244",16387,17723,1336
"11473","Ocbimv22011471m.g","KQ417793",210330,211876,1546
"11474","Ocbimv22028716m.g","KQ416268",423100,526436,103336
"11475","Ocbimv22024195m.g","KQ419547",34103,34408,305
"11476","Ocbimv22035850m.g","KQ416605",36692,58456,21764
"11477","Ocbimv22009100m.g","KQ417561",157084,157518,434
"11478","Ocbimv22036096m.g","KQ416616",2460709,2466536,5827
"11479","Ocbimv22013748m.g","KQ428648",55209,55517,308
"11480","Ocbimv22004903m.g","KQ417213",345633,356774,11141
"11481","Ocbimv22018998m.g","KQ418710",25295,25755,460
"11482","Ocbimv22007655m.g","KQ426410",24550,39986,15436
"11483","Ocbimv22008396m.g","KQ426629",128210,129008,798
"11484","Ocbimv22035076m.g","KQ416570",188818,189048,230
"11485","Ocbimv22003174m.g","KQ417062",147361,168647,21286
"11486","Ocbimv22005355m.g","LGKD01537134",113,280,167
"11487","Ocbimv22006821m.g","KQ417358",2815,5206,2391
"11488","Ocbimv22019943m.g","KQ418838",252753,252998,245
"11489","Ocbimv22026974m.g","KQ416207",282841,287170,4329
"11490","Ocbimv22000275m.g","KQ423910",397517,398418,901
"11491","Ocbimv22019563m.g","KQ418783",906756,907112,356
"11492","Ocbimv22003078m.g","KQ424877",260935,265206,4271
"11493","Ocbimv22008020m.g","KQ417470",634447,636261,1814
"11494","Ocbimv22002364m.g","KQ424650",66150,98113,31963
"11495","Ocbimv22000962m.g","KQ416899",228268,228495,227
"11496","Ocbimv22007410m.g","KQ417412",199782,208932,9150
"11497","Ocbimv22032754m.g","KQ421655",56975,57440,465
"11498","Ocbimv22032232m.g","KQ421487",128820,207458,78638
"11499","Ocbimv22034959m.g","KQ422228",23603,23966,363
"11500","Ocbimv22024866m.g","KQ419643",399617,401374,1757
"11501","Ocbimv22036399m.g","KQ422748",13203,14830,1627
"11502","Ocbimv22002091m.g","KQ424538",199179,200742,1563
"11503","Ocbimv22015019m.g","KQ418194",321979,322329,350
"11504","Ocbimv22013161m.g","KQ428407",39886,42802,2916
"11505","Ocbimv22036849m.g","KQ422876",208046,222618,14572
"11506","Ocbimv22029453m.g","KQ420752",171799,172357,558
"11507","Ocbimv22026976m.g","KQ420157",8907,9473,566
"11508","Ocbimv22018089m.g","KQ418571",330047,330623,576
"11509","Ocbimv22000293m.g","KQ415775",32371,34888,2517
"11510","Ocbimv22017903m.g","KQ430515",7093,163023,155930
"11511","Ocbimv22017199m.g","LGKD01633857",2,244,242
"11512","Ocbimv22005196m.g","KQ425544",2042,2260,218
"11513","Ocbimv22013809m.g","KQ428677",23390,24077,687
"11514","Ocbimv22019373m.g","KQ418757",104490,116555,12065
"11515","Ocbimv22031922m.g","KQ416413",410137,410289,152
"11516","Ocbimv22039249m.g","KQ423592",51629,51859,230
"11517","Ocbimv22006951m.g","KQ426164",80556,81941,1385
"11518","Ocbimv22032257m.g","KQ421505",480564,486750,6186
"11519","Ocbimv22035612m.g","KQ422472",5018,6322,1304
"11520","Ocbimv22027539m.g","KQ420299",1321753,1373417,51664
"11521","Ocbimv22020930m.g","KQ431886",4738,5763,1025
"11522","Ocbimv22010738m.g","LGKD01581925",5018,5592,574
"11523","Ocbimv22016585m.g","KQ418368",420118,420559,441
"11524","Ocbimv22038839m.g","KQ416768",310459,337943,27484
"11525","Ocbimv22002873m.g","KQ424812",485048,518043,32995
"11526","Ocbimv22002885m.g","KQ424814",235054,235662,608
"11527","Ocbimv22006862m.g","KQ417358",793138,793966,828
"11528","Ocbimv22004566m.g","KQ425361",392359,398367,6008
"11529","Ocbimv22003940m.g","KQ425153",5753,6934,1181
"11530","Ocbimv22027128m.g","KQ420195",28354,28548,194
"11531","Ocbimv22037391m.g","KQ416694",1092176,1092805,629
"11532","Ocbimv22006494m.g","LGKD01546157",11,740,729
"11533","Ocbimv22001232m.g","KQ416917",1104276,1104464,188
"11534","Ocbimv22027626m.g","KQ420319",107184,107486,302
"11535","Ocbimv22011557m.g","KQ417802",357849,401277,43428
"11536","Ocbimv22012151m.g","KQ417877",992915,1012852,19937
"11537","Ocbimv22028477m.g","KQ420501",12607,17108,4501
"11538","Ocbimv22032493m.g","KQ421560",267734,268590,856
"11539","Ocbimv22024615m.g","KQ416126",535266,599808,64542
"11540","Ocbimv22023264m.g","KQ433306",89,1359,1270
"11541","Ocbimv22015055m.g","KQ418194",737826,741527,3701
"11542","Ocbimv22034671m.g","KQ416546",174959,237065,62106
"11543","Ocbimv22036507m.g","KQ422783",138,6664,6526
"11544","Ocbimv22028383m.g","KQ416257",466907,545808,78901
"11545","Ocbimv22024861m.g","KQ419643",164154,166118,1964
"11546","Ocbimv22025229m.g","KQ419741",236454,237557,1103
"11547","Ocbimv22003263m.g","KQ424932",7404,8600,1196
"11548","Ocbimv22027634m.g","KQ415703",144152,161427,17275
"11549","Ocbimv22022955m.g","KQ433165",36304,36606,302
"11550","Ocbimv22007454m.g","KQ426347",15825,16328,503
"11551","Ocbimv22005603m.g","KQ425671",23249,23833,584
"11552","Ocbimv22003024m.g","KQ417055",780657,849578,68921
"11553","Ocbimv22036229m.g","KQ416626",471946,481344,9398
"11554","Ocbimv22016396m.g","KQ429832",1531,1710,179
"11555","Ocbimv22028840m.g","KQ420592",136144,137347,1203
"11556","Ocbimv22038932m.g","KQ423490",264105,264925,820
"11557","Ocbimv22011308m.g","KQ417780",60398,72192,11794
"11558","Ocbimv22036061m.g","KQ416616",220847,221583,736
"11559","Ocbimv22031052m.g","KQ421149",16618,17223,605
"11560","Ocbimv22031450m.g","KQ421252",6213,7801,1588
"11561","Ocbimv22017572m.g","KQ430359",70837,71007,170
"11562","Ocbimv22008430m.g","KQ417501",200009,220419,20410
"11563","Ocbimv22026943m.g","KQ420146",300612,302092,1480
"11564","Ocbimv22010887m.g","KQ417722",397027,397224,197
"11565","Ocbimv22025794m.g","KQ416167",580958,581224,266
"11566","Ocbimv22036186m.g","KQ422667",219849,287278,67429
"11567","Ocbimv22000164m.g","KQ416846",308269,309045,776
"11568","Ocbimv22037065m.g","KQ422913",133581,134622,1041
"11569","Ocbimv22030670m.g","KQ416362",4497,10497,6000
"11570","Ocbimv22017034m.g","KQ418441",350680,351525,845
"11571","Ocbimv22021258m.g","KQ432063",3820,15423,11603
"11572","Ocbimv22019683m.g","KQ431257",3908,5956,2048
"11573","Ocbimv22024182m.g","KQ419545",51404,56205,4801
"11574","Ocbimv22031653m.g","KQ421305",560094,580274,20180
"11575","Ocbimv22003127m.g","KQ424891",50122,50391,269
"11576","Ocbimv22017491m.g","KQ418502",6243,6971,728
"11577","Ocbimv22019721m.g","KQ431275",1844,2098,254
"11578","Ocbimv22015226m.g","KQ429223",97,606,509
"11579","Ocbimv22016215m.g","KQ418328",255044,264375,9331
"11580","Ocbimv22001756m.g","KQ424404",1356,1607,251
"11581","Ocbimv22036063m.g","KQ416616",303025,303348,323
"11582","Ocbimv22012643m.g","KQ428192",131721,169905,38184
"11583","Ocbimv22039791m.g","KQ416823",224254,224863,609
"11584","Ocbimv22033618m.g","KQ416488",772855,773028,173
"11585","Ocbimv22006522m.g","KQ425980",87864,88733,869
"11586","Ocbimv22033860m.g","KQ421896",254115,263752,9637
"11587","Ocbimv22031495m.g","KQ421261",424526,425779,1253
"11588","Ocbimv22030973m.g","KQ416379",724072,725159,1087
"11589","Ocbimv22005273m.g","KQ417238",773,82450,81677
"11590","Ocbimv22028348m.g","KQ420477",136426,143055,6629
"11591","Ocbimv22033350m.g","KQ421792",93038,93220,182
"11592","Ocbimv22030532m.g","KQ421014",108600,137510,28910
"11593","Ocbimv22021762m.g","LGKD01670759",9,993,984
"11594","Ocbimv22005901m.g","KQ417284",12,185,173
"11595","Ocbimv22023484m.g","KQ419416",95569,96633,1064
"11596","Ocbimv22035951m.g","KQ416612",1467213,1468996,1783
"11597","Ocbimv22004077m.g","KQ417133",614396,615258,862
"11598","Ocbimv22005119m.g","KQ415813",570859,587486,16627
"11599","Ocbimv22027970m.g","KQ420410",93314,93580,266
"11600","Ocbimv22018249m.g","KQ418587",60301,97060,36759
"11601","Ocbimv22020309m.g","KQ418887",74481,74687,206
"11602","Ocbimv22002835m.g","KQ417040",250857,256115,5258
"11603","Ocbimv22010934m.g","KQ417725",368314,402513,34199
"11604","Ocbimv22025338m.g","KQ416149",68880,69929,1049
"11605","Ocbimv22020622m.g","KQ431780",9284,87884,78600
"11606","Ocbimv22029196m.g","KQ420675",94616,138315,43699
"11607","Ocbimv22038631m.g","KQ423424",147573,147878,305
"11608","Ocbimv22039291m.g","KQ423605",196527,283394,86867
"11609","Ocbimv22027278m.g","KQ420241",106664,108566,1902
"11610","Ocbimv22033330m.g","KQ421780",160360,176403,16043
"11611","Ocbimv22005921m.g","KQ417284",396612,397142,530
"11612","Ocbimv22009675m.g","KQ417601",269655,270088,433
"11613","Ocbimv22036649m.g","KQ422819",137341,139976,2635
"11614","Ocbimv22034586m.g","KQ416537",755083,756380,1297
"11615","Ocbimv22035763m.g","KQ422530",225379,232868,7489
"11616","Ocbimv22039057m.g","KQ423531",195181,196234,1053
"11617","Ocbimv22001017m.g","KQ424157",166636,226755,60119
"11618","Ocbimv22020067m.g","KQ418849",105993,122456,16463
"11619","Ocbimv22024189m.g","KQ433854",1673,2050,377
"11620","Ocbimv22024784m.g","KQ419631",64902,65118,216
"11621","Ocbimv22029388m.g","KQ416303",456030,456691,661
"11622","Ocbimv22039731m.g","KQ423737",40487,43016,2529
"11623","Ocbimv22017335m.g","KQ418483",177614,216976,39362
"11624","Ocbimv22014714m.g","KQ418169",190275,201472,11197
"11625","Ocbimv22036791m.g","KQ416657",445929,457921,11992
"11626","Ocbimv22007392m.g","KQ426321",84919,85265,346
"11627","Ocbimv22012295m.g","KQ417901",141230,141766,536
"11628","Ocbimv22021075m.g","KQ418998",752072,752536,464
"11629","Ocbimv22017427m.g","KQ418495",323488,360931,37443
"11630","Ocbimv22021284m.g","KQ419023",141909,143019,1110
"11631","Ocbimv22024883m.g","KQ419646",51540,51819,279
"11632","Ocbimv22021654m.g","KQ416049",60910,83706,22796
"11633","Ocbimv22027465m.g","KQ416225",61639,65548,3909
"11634","Ocbimv22039530m.g","KQ423695",3872,19601,15729
"11635","Ocbimv22018385m.g","KQ418612",310318,331447,21129
"11636","Ocbimv22036201m.g","KQ422675",555,3349,2794
"11637","Ocbimv22009607m.g","KQ427052",62413,116362,53949
"11638","Ocbimv22031414m.g","KQ421233",251703,284981,33278
"11639","Ocbimv22028855m.g","KQ420593",302504,302728,224
"11640","Ocbimv22038613m.g","KQ423415",61227,61532,305
"11641","Ocbimv22022227m.g","KQ419186",216670,266732,50062
"11642","Ocbimv22033602m.g","KQ416487",411230,442432,31202
"11643","Ocbimv22020908m.g","KQ418974",406925,440286,33361
"11644","Ocbimv22021844m.g","KQ415687",1137012,1141728,4716
"11645","Ocbimv22026781m.g","KQ420117",3482,71529,68047
"11646","Ocbimv22010684m.g","KQ417701",438619,439062,443
"11647","Ocbimv22025500m.g","KQ419823",2974,86497,83523
"11648","Ocbimv22026213m.g","KQ420017",351878,373245,21367
"11649","Ocbimv22037044m.g","KQ422909",873579,873803,224
"11650","Ocbimv22037794m.g","KQ423136",14,9673,9659
"11651","Ocbimv22023653m.g","KQ419455",3822,16121,12299
"11652","Ocbimv22031245m.g","KQ421206",300937,403764,102827
"11653","Ocbimv22030868m.g","KQ416373",858502,909527,51025
"11654","Ocbimv22026235m.g","KQ420017",1050527,1050967,440
"11655","Ocbimv22032765m.g","KQ421655",587428,592944,5516
"11656","Ocbimv22028519m.g","KQ420517",14437,94223,79786
"11657","Ocbimv22034384m.g","KQ422024",85914,96401,10487
"11658","Ocbimv22018523m.g","KQ418633",205061,227619,22558
"11659","Ocbimv22013241m.g","KQ418003",329129,365771,36642
"11660","Ocbimv22006941m.g","KQ426160",52526,53095,569
"11661","Ocbimv22024425m.g","KQ419577",459291,487123,27832
"11662","Ocbimv22005018m.g","KQ417224",184860,193552,8692
"11663","Ocbimv22026878m.g","KQ420132",962738,1032939,70201
"11664","Ocbimv22008712m.g","KQ426740",453089,453636,547
"11665","Ocbimv22038431m.g","KQ423338",136290,163100,26810
"11666","Ocbimv22011477m.g","KQ417794",69847,71591,1744
"11667","Ocbimv22001669m.g","KQ424380",1570,10650,9080
"11668","Ocbimv22015939m.g","KQ418303",1383230,1386169,2939
"11669","Ocbimv22022285m.g","KQ419192",651690,652091,401
"11670","Ocbimv22005246m.g","KQ417234",518532,519698,1166
"11671","Ocbimv22022613m.g","KQ419272",116738,119290,2552
"11672","Ocbimv22004971m.g","KQ425490",195771,202124,6353
"11673","Ocbimv22029165m.g","KQ420672",250042,306276,56234
"11674","Ocbimv22016558m.g","KQ418367",462334,521576,59242
"11675","Ocbimv22009899m.g","KQ417622",49815,49991,176
"11676","Ocbimv22004727m.g","KQ425428",4214,4747,533
"11677","Ocbimv22004246m.g","KQ417143",526540,530767,4227
"11678","Ocbimv22032684m.g","KQ416444",201035,206189,5154
"11679","Ocbimv22036978m.g","KQ422897",142335,146770,4435
"11680","Ocbimv22033459m.g","KQ421819",33688,35382,1694
"11681","Ocbimv22039053m.g","KQ416778",2089,3166,1077
"11682","Ocbimv22011601m.g","KQ417809",9391,9922,531
"11683","Ocbimv22039343m.g","KQ423624",750,112733,111983
"11684","Ocbimv22039577m.g","KQ423704",162222,162740,518
"11685","Ocbimv22034119m.g","KQ421982",22677,25231,2554
"11686","Ocbimv22004714m.g","KQ417199",140562,142424,1862
"11687","Ocbimv22023546m.g","KQ416091",211673,212335,662
"11688","Ocbimv22027091m.g","KQ420180",52619,52879,260
"11689","Ocbimv22000324m.g","KQ423923",68743,71731,2988
"11690","Ocbimv22025231m.g","KQ419742",117494,117808,314
"11691","Ocbimv22016870m.g","KQ418415",14728,15171,443
"11692","Ocbimv22023689m.g","KQ433567",2954,5501,2547
"11693","Ocbimv22000567m.g","KQ423998",179465,197184,17719
"11694","Ocbimv22032275m.g","LGKD01078590",2,244,242
"11695","Ocbimv22028257m.g","KQ415659",540486,541807,1321
"11696","Ocbimv22015877m.g","KQ429602",233016,233264,248
"11697","Ocbimv22003356m.g","KQ424993",301130,334786,33656
"11698","Ocbimv22006026m.g","KQ425781",41570,42560,990
"11699","Ocbimv22008625m.g","KQ426706",171193,172763,1570
"11700","Ocbimv22032151m.g","KQ421460",242712,243335,623
"11701","Ocbimv22032225m.g","KQ421487",45288,58495,13207
"11702","Ocbimv22003641m.g","KQ417098",27651,28924,1273
"11703","Ocbimv22024136m.g","KQ419538",489965,492080,2115
"11704","Ocbimv22005012m.g","KQ417224",32153,36944,4791
"11705","Ocbimv22026249m.g","KQ416187",174349,176486,2137
"11706","Ocbimv22035081m.g","KQ422274",13137,35328,22191
"11707","Ocbimv22027547m.g","KQ420299",1853321,1856418,3097
"11708","Ocbimv22018320m.g","KQ430647",1923,12910,10987
"11709","Ocbimv22023939m.g","KQ416106",140121,145697,5576
"11710","Ocbimv22027684m.g","LGKD01348864",59,247,188
"11711","Ocbimv22022523m.g","KQ419241",94392,95150,758
"11712","Ocbimv22022470m.g","KQ416069",186591,187023,432
"11713","Ocbimv22031692m.g","KQ421308",792007,915490,123483
"11714","Ocbimv22030508m.g","KQ421009",381862,382239,377
"11715","Ocbimv22032485m.g","KQ416432",960030,979022,18992
"11716","Ocbimv22029436m.g","KQ416306",1213396,1213623,227
"11717","Ocbimv22001421m.g","KQ424303",11276,62189,50913
"11718","Ocbimv22034423m.g","KQ416530",415399,415569,170
"11719","Ocbimv22030763m.g","KQ421085",42746,48635,5889
"11720","Ocbimv22037907m.g","KQ416715",130522,130875,353
"11721","Ocbimv22011503m.g","KQ417796",435993,453424,17431
"11722","Ocbimv22036595m.g","KQ422794",511027,512408,1381
"11723","Ocbimv22038396m.g","KQ423316",131,34778,34647
"11724","Ocbimv22010200m.g","KQ417655",311553,311723,170
"11725","Ocbimv22000714m.g","KQ416877",483052,488313,5261
"11726","Ocbimv22022518m.g","KQ419239",541117,642958,101841
"11727","Ocbimv22008613m.g","KQ417510",847641,847869,228
"11728","Ocbimv22030650m.g","KQ421049",372,54960,54588
"11729","Ocbimv22031676m.g","KQ421308",260465,273665,13200
"11730","Ocbimv22037538m.g","KQ423058",459363,459766,403
"11731","Ocbimv22023102m.g","KQ419349",100245,101838,1593
"11732","Ocbimv22030269m.g","LGKD01377370",700,1146,446
"11733","Ocbimv22004013m.g","KQ425188",62098,62316,218
"11734","Ocbimv22026155m.g","KQ420006",150363,150746,383
"11735","Ocbimv22002096m.g","KQ424539",19729,20061,332
"11736","Ocbimv22039217m.g","KQ423583",2147,3306,1159
"11737","Ocbimv22038985m.g","KQ423499",119775,121064,1289
"11738","Ocbimv22006568m.g","KQ417336",936643,937121,478
"11739","Ocbimv22009996m.g","KQ427202",125546,136182,10636
"11740","Ocbimv22015311m.g","KQ418217",135132,136508,1376
"11741","Ocbimv22028304m.g","KQ420464",521093,535051,13958
"11742","Ocbimv22039650m.g","KQ416811",196629,197793,1164
"11743","Ocbimv22001319m.g","KQ424265",174566,175518,952
"11744","Ocbimv22036735m.g","KQ416655",405019,417733,12714
"11745","Ocbimv22026836m.g","KQ420126",422341,432238,9897
"11746","Ocbimv22039973m.g","KQ415773",248901,316296,67395
"11747","Ocbimv22018525m.g","KQ418633",237808,274871,37063
"11748","Ocbimv22015742m.g","KQ429535",12496,18975,6479
"11749","Ocbimv22025943m.g","KQ419930",1286367,1287319,952
"11750","Ocbimv22036585m.g","KQ422794",216514,217460,946
"11751","Ocbimv22019732m.g","KQ418807",42773,45123,2350
"11752","Ocbimv22032755m.g","KQ421655",57849,58957,1108
"11753","Ocbimv22028399m.g","KQ416257",818851,877640,58789
"11754","Ocbimv22032599m.g","KQ416441",400880,402493,1613
"11755","Ocbimv22014784m.g","KQ429069",4327,56439,52112
"11756","Ocbimv22036618m.g","KQ416650",30451,31313,862
"11757","Ocbimv22004919m.g","KQ417213",853944,869372,15428
"11758","Ocbimv22021969m.g","KQ432475",1280,3047,1767
"11759","Ocbimv22001459m.g","KQ416933",790968,792849,1881
"11760","Ocbimv22003697m.g","KQ417101",87440,88597,1157
"11761","Ocbimv22003720m.g","KQ425075",56344,57422,1078
"11762","Ocbimv22028351m.g","KQ420477",189485,199124,9639
"11763","Ocbimv22023855m.g","KQ416102",153955,155499,1544
"11764","Ocbimv22004491m.g","KQ417173",215750,217617,1867
"11765","Ocbimv22013343m.g","KQ418015",207025,207701,676
"11766","Ocbimv22005564m.g","KQ425654",154489,154952,463
"11767","Ocbimv22018726m.g","KQ430830",3389,3841,452
"11768","Ocbimv22036591m.g","KQ422794",338179,353632,15453
"11769","Ocbimv22024743m.g","KQ419623",25803,29590,3787
"11770","Ocbimv22008411m.g","KQ426634",136271,137962,1691
"11771","Ocbimv22012747m.g","KQ417935",56167,58130,1963
"11772","Ocbimv22034484m.g","KQ422055",198162,204244,6082
"11773","Ocbimv22039687m.g","KQ423726",1,491,490
"11774","Ocbimv22035078m.g","KQ422268",109099,109845,746
"11775","Ocbimv22011884m.g","KQ417845",72968,73420,452
"11776","Ocbimv22028248m.g","KQ415659",121663,122707,1044
"11777","Ocbimv22016392m.g","KQ429831",54885,91780,36895
"11778","Ocbimv22013922m.g","KQ428714",13019,13490,471
"11779","Ocbimv22020865m.g","KQ418971",156938,185191,28253
"11780","Ocbimv22038966m.g","KQ423494",269785,320553,50768
"11781","Ocbimv22016368m.g","KQ415962",772576,773860,1284
"11782","Ocbimv22035344m.g","KQ422362",271198,271707,509
"11783","Ocbimv22036968m.g","KQ416666",2311975,2331089,19114
"11784","Ocbimv22007456m.g","KQ426347",168424,169264,840
"11785","Ocbimv22019200m.g","KQ418733",43705,52365,8660
"11786","Ocbimv22003703m.g","KQ417101",262406,291945,29539
"11787","Ocbimv22029636m.g","KQ420791",2324,2806,482
"11788","Ocbimv22018430m.g","KQ415992",41568,51833,10265
"11789","Ocbimv22007630m.g","KQ415845",72733,155508,82775
"11790","Ocbimv22035160m.g","KQ422291",29324,30084,760
"11791","Ocbimv22020596m.g","KQ431746",23994,47888,23894
"11792","Ocbimv22035731m.g","KQ422521",326580,327521,941
"11793","Ocbimv22037358m.g","KQ423013",41458,48249,6791
"11794","Ocbimv22027192m.g","KQ420215",61030,78061,17031
"11795","Ocbimv22015127m.g","KQ418196",368469,370683,2214
"11796","Ocbimv22027858m.g","KQ416234",37395,37685,290
"11797","Ocbimv22031253m.g","KQ421206",574916,600455,25539
"11798","Ocbimv22017288m.g","KQ418476",350709,353838,3129
"11799","Ocbimv22034334m.g","KQ422016",207122,209026,1904
"11800","Ocbimv22001932m.g","KQ416974",477092,477274,182
"11801","Ocbimv22000131m.g","KQ416841",1467611,1467829,218
"11802","Ocbimv22022369m.g","KQ432701",20509,23720,3211
"11803","Ocbimv22021088m.g","KQ431981",7440,7658,218
"11804","Ocbimv22009120m.g","KQ426892",25445,26792,1347
"11805","Ocbimv22001857m.g","KQ416971",299671,314778,15107
"11806","Ocbimv22030124m.g","KQ420902",59181,60770,1589
"11807","Ocbimv22018304m.g","KQ418599",161539,166175,4636
"11808","Ocbimv22038650m.g","KQ423430",950807,950968,161
"11809","Ocbimv22038224m.g","KQ416731",675090,683371,8281
"11810","Ocbimv22027210m.g","KQ420220",62106,68990,6884
"11811","Ocbimv22024310m.g","KQ419564",189787,189951,164
"11812","Ocbimv22025145m.g","KQ419708",42667,42939,272
"11813","Ocbimv22039688m.g","KQ423730",71148,72760,1612
"11814","Ocbimv22021896m.g","KQ432404",25118,25360,242
"11815","Ocbimv22018491m.g","KQ418627",127395,127616,221
"11816","Ocbimv22015393m.g","KQ429320",17435,28969,11534
"11817","Ocbimv22010634m.g","KQ415879",155247,155429,182
"11818","Ocbimv22013710m.g","KQ418051",120634,196475,75841
"11819","Ocbimv22007945m.g","KQ426499",177885,237255,59370
"11820","Ocbimv22010912m.g","KQ417724",512271,545561,33290
"11821","Ocbimv22017386m.g","KQ430272",311021,311294,273
"11822","Ocbimv22034922m.g","KQ415742",509570,510418,848
"11823","Ocbimv22006754m.g","KQ417347",371452,371610,158
"11824","Ocbimv22002620m.g","KQ417023",720809,732661,11852
"11825","Ocbimv22035825m.g","KQ416602",206786,206962,176
"11826","Ocbimv22037760m.g","KQ416710",772025,772420,395
"11827","Ocbimv22009148m.g","KQ415861",351572,359714,8142
"11828","Ocbimv22003684m.g","KQ425066",51713,53211,1498
"11829","Ocbimv22009092m.g","KQ426874",34002,34622,620
"11830","Ocbimv22013178m.g","LGKD01599959",366,743,377
"11831","Ocbimv22001992m.g","KQ416979",977618,977797,179
"11832","Ocbimv22002904m.g","KQ424815",261718,262020,302
"11833","Ocbimv22002052m.g","KQ424530",205881,213379,7498
"11834","Ocbimv22027294m.g","KQ416218",193393,193657,264
"11835","Ocbimv22036579m.g","KQ422794",171134,190418,19284
"11836","Ocbimv22029338m.g","KQ420711",763668,765637,1969
"11837","Ocbimv22037448m.g","LGKD01460658",14,733,719
"11838","Ocbimv22000333m.g","KQ423927",6,5448,5442
"11839","Ocbimv22007150m.g","KQ426215",28514,30046,1532
"11840","Ocbimv22025835m.g","KQ416171",162450,190383,27933
"11841","Ocbimv22026268m.g","KQ420022",497450,505712,8262
"11842","Ocbimv22009465m.g","KQ417596",16773,24494,7721
"11843","Ocbimv22024761m.g","KQ419623",146887,152682,5795
"11844","Ocbimv22029504m.g","KQ416311",75918,79434,3516
"11845","Ocbimv22023421m.g","LGKD01688416",58,342,284
"11846","Ocbimv22007281m.g","KQ417398",18478,39467,20989
"11847","Ocbimv22028295m.g","KQ420462",190222,194508,4286
"11848","Ocbimv22038937m.g","KQ416772",640175,641387,1212
"11849","Ocbimv22025888m.g","KQ416175",528928,541560,12632
"11850","Ocbimv22003497m.g","KQ417089",158297,159672,1375
"11851","Ocbimv22031740m.g","KQ421336",371743,372174,431
"11852","Ocbimv22017598m.g","KQ415979",94086,94645,559
"11853","Ocbimv22021017m.g","KQ431950",17256,26787,9531
"11854","Ocbimv22009906m.g","KQ417622",762719,765899,3180
"11855","Ocbimv22009849m.g","KQ417620",802968,821416,18448
"11856","Ocbimv22023166m.g","KQ419366",122175,167974,45799
"11857","Ocbimv22026731m.g","KQ416198",183021,226894,43873
"11858","Ocbimv22036488m.g","KQ422777",11333,12405,1072
"11859","Ocbimv22032708m.g","KQ421638",438097,438267,170
"11860","Ocbimv22001977m.g","KQ415787",232272,232487,215
"11861","Ocbimv22006178m.g","KQ417300",2915381,2917384,2003
"11862","Ocbimv22024936m.g","KQ419660",64600,102003,37403
"11863","Ocbimv22015703m.g","LGKD01620841",234,2201,1967
"11864","Ocbimv22033653m.g","KQ421858",133479,143400,9921
"11865","Ocbimv22025274m.g","KQ416146",237659,238006,347
"11866","Ocbimv22013408m.g","KQ428501",30534,32646,2112
"11867","Ocbimv22022916m.g","KQ419326",285860,287856,1996
"11868","Ocbimv22020624m.g","KQ418943",2205,98128,95923
"11869","Ocbimv22021952m.g","KQ432454",5076,6854,1778
"11870","Ocbimv22033551m.g","KQ421829",54915,55112,197
"11871","Ocbimv22016389m.g","KQ415962",1822574,1851504,28930
"11872","Ocbimv22013273m.g","KQ418005",17511,32784,15273
"11873","Ocbimv22026726m.g","KQ416198",28428,28822,394
"11874","Ocbimv22012087m.g","KQ417871",3033,4632,1599
"11875","Ocbimv22026028m.g","KQ419958",129503,136543,7040
"11876","Ocbimv22014514m.g","KQ415932",634999,653343,18344
"11877","Ocbimv22006412m.g","KQ425905",77294,80117,2823
"11878","Ocbimv22021234m.g","KQ419018",32378,35489,3111
"11879","Ocbimv22021310m.g","KQ419027",123598,125026,1428
"11880","Ocbimv22021919m.g","KQ419131",24697,33967,9270
"11881","Ocbimv22021070m.g","KQ418998",21531,28437,6906
"11882","Ocbimv22030752m.g","KQ421083",512122,519041,6919
"11883","Ocbimv22035486m.g","KQ422401",242545,256630,14085
"11884","Ocbimv22037575m.g","KQ416702",1045414,1045797,383
"11885","Ocbimv22035451m.g","KQ422386",6351,6548,197
"11886","Ocbimv22025947m.g","KQ419931",244921,251474,6553
"11887","Ocbimv22006291m.g","KQ425860",85501,85797,296
"11888","Ocbimv22029299m.g","KQ420701",5709,6632,923
"11889","Ocbimv22011133m.g","KQ427653",47660,55917,8257
"11890","Ocbimv22000087m.g","KQ416839",82018,85415,3397
"11891","Ocbimv22004210m.g","KQ425225",1407,1673,266
"11892","Ocbimv22026603m.g","KQ420078",295224,310614,15390
"11893","Ocbimv22019711m.g","KQ418804",691756,691953,197
"11894","Ocbimv22022784m.g","KQ419298",6403,42285,35882
"11895","Ocbimv22034173m.g","KQ416518",375565,376709,1144
"11896","Ocbimv22000688m.g","KQ424055",606638,659933,53295
"11897","Ocbimv22027870m.g","KQ416236",112837,113097,260
"11898","Ocbimv22037340m.g","KQ423006",114425,114622,197
"11899","Ocbimv22015297m.g","KQ429255",250790,251062,272
"11900","Ocbimv22012142m.g","KQ417877",73761,113154,39393
"11901","Ocbimv22007300m.g","KQ426287",25004,25702,698
"11902","Ocbimv22000167m.g","KQ416846",350504,350722,218
"11903","Ocbimv22014794m.g","LGKD01612679",4,408,404
"11904","Ocbimv22015076m.g","KQ418194",1333453,1359754,26301
"11905","Ocbimv22033385m.g","KQ416479",534213,548349,14136
"11906","Ocbimv22029041m.g","KQ420632",13514,14317,803
"11907","Ocbimv22004160m.g","KQ425220",109666,121680,12014
"11908","Ocbimv22027993m.g","KQ420415",384919,386231,1312
"11909","Ocbimv22031810m.g","KQ415726",154664,189897,35233
"11910","Ocbimv22036310m.g","KQ422711",25427,25768,341
"11911","Ocbimv22014847m.g","KQ415935",192509,198673,6164
"11912","Ocbimv22008509m.g","KQ417506",735614,748003,12389
"11913","Ocbimv22027761m.g","KQ420358",311028,337534,26506
"11914","Ocbimv22000839m.g","KQ424091",54916,60815,5899
"11915","Ocbimv22012285m.g","KQ428101",130626,139441,8815
"11916","Ocbimv22016289m.g","KQ429791",28721,33832,5111
"11917","Ocbimv22012917m.g","KQ417953",298077,298504,427
"11918","Ocbimv22009503m.g","KQ415865",490361,530429,40068
"11919","Ocbimv22006105m.g","KQ425821",62947,63588,641
"11920","Ocbimv22023598m.g","KQ416092",64544,72958,8414
"11921","Ocbimv22001003m.g","KQ424146",266755,267066,311
"11922","Ocbimv22020023m.g","KQ418843",76165,83453,7288
"11923","Ocbimv22032195m.g","KQ421476",235470,280161,44691
"11924","Ocbimv22032327m.g","KQ421523",480280,488031,7751
"11925","Ocbimv22000102m.g","KQ423860",100814,113893,13079
"11926","Ocbimv22022448m.g","KQ419216",442814,461310,18496
"11927","Ocbimv22020410m.g","KQ418908",494793,520875,26082
"11928","Ocbimv22039392m.g","KQ423638",245800,279292,33492
"11929","Ocbimv22000837m.g","KQ424091",44,334,290
"11930","Ocbimv22038014m.g","KQ416719",439361,468408,29047
"11931","Ocbimv22004420m.g","KQ415804",341473,349034,7561
"11932","Ocbimv22027513m.g","KQ420294",731181,731888,707
"11933","Ocbimv22014594m.g","KQ418155",34640,35173,533
"11934","Ocbimv22018247m.g","KQ418587",29424,55781,26357
"11935","Ocbimv22011181m.g","KQ417759",20989,28183,7194
"11936","Ocbimv22024570m.g","KQ434061",30825,48618,17793
"11937","Ocbimv22039502m.g","KQ423680",111881,112051,170
"11938","Ocbimv22036746m.g","KQ422849",104148,108693,4545
"11939","Ocbimv22039002m.g","KQ423506",156854,194250,37396
"11940","Ocbimv22016611m.g","KQ418370",185186,204960,19774
"11941","Ocbimv22015707m.g","KQ429491",1,478,477
"11942","Ocbimv22024254m.g","KQ416118",180698,181000,302
"11943","Ocbimv22031672m.g","KQ421308",168230,183008,14778
"11944","Ocbimv22005685m.g","KQ425710",26379,26588,209
"11945","Ocbimv22036111m.g","KQ422643",75950,76305,355
"11946","Ocbimv22014482m.g","KQ418140",65224,65466,242
"11947","Ocbimv22003118m.g","KQ417059",251971,273974,22003
"11948","Ocbimv22029647m.g","KQ416314",104852,106325,1473
"11949","Ocbimv22038732m.g","KQ416764",113138,117446,4308
"11950","Ocbimv22036797m.g","KQ416657",532509,538070,5561
"11951","Ocbimv22033277m.g","KQ421759",540635,540790,155
"11952","Ocbimv22017304m.g","KQ415681",525388,525759,371
"11953","Ocbimv22035933m.g","LGKD01446731",41,343,302
"11954","Ocbimv22034724m.g","KQ416548",424761,425174,413
"11955","Ocbimv22000977m.g","KQ424142",43662,44255,593
"11956","Ocbimv22029289m.g","KQ420698",26866,27192,326
"11957","Ocbimv22030363m.g","KQ420963",61881,64294,2413
"11958","Ocbimv22030236m.g","KQ420927",65505,68258,2753
"11959","Ocbimv22027084m.g","KQ420176",43369,44370,1001
"11960","Ocbimv22031270m.g","KQ421212",221006,242957,21951
"11961","Ocbimv22034781m.g","KQ422172",2244,2531,287
"11962","Ocbimv22011579m.g","KQ417806",380876,392905,12029
"11963","Ocbimv22012773m.g","KQ417939",124697,131339,6642
"11964","Ocbimv22028971m.g","KQ416278",194418,220634,26216
"11965","Ocbimv22035555m.g","KQ422436",72918,82689,9771
"11966","Ocbimv22027129m.g","KQ420195",28489,29062,573
"11967","Ocbimv22011681m.g","KQ417817",32065,33893,1828
"11968","Ocbimv22000116m.g","KQ416840",591184,591861,677
"11969","Ocbimv22025362m.g","KQ419781",202143,204089,1946
"11970","Ocbimv22017527m.g","KQ418504",325936,352019,26083
"11971","Ocbimv22033030m.g","KQ421720",290795,291700,905
"11972","Ocbimv22015320m.g","KQ418220",44966,48940,3974
"11973","Ocbimv22011926m.g","KQ427949",445307,445921,614
"11974","Ocbimv22036120m.g","KQ422647",57454,74667,17213
"11975","Ocbimv22017277m.g","KQ418475",207052,270222,63170
"11976","Ocbimv22030386m.g","KQ420970",178781,181872,3091
"11977","Ocbimv22007598m.g","LGKD01164803",8,350,342
"11978","Ocbimv22002589m.g","KQ424709",140623,141871,1248
"11979","Ocbimv22017028m.g","KQ418438",274073,274312,239
"11980","Ocbimv22028261m.g","KQ415659",1091436,1091747,311
"11981","Ocbimv22004071m.g","KQ425193",81383,81805,422
"11982","Ocbimv22030359m.g","KQ420963",14715,20180,5465
"11983","Ocbimv22035741m.g","KQ422521",416634,416996,362
"11984","Ocbimv22000706m.g","KQ416877",307953,308283,330
"11985","Ocbimv22031099m.g","KQ421163",1099632,1100457,825
"11986","Ocbimv22020869m.g","KQ418971",340023,348487,8464
"11987","Ocbimv22036044m.g","KQ422636",112235,112616,381
"11988","Ocbimv22006507m.g","KQ425966",39390,40288,898
"11989","Ocbimv22018375m.g","KQ418610",241964,244000,2036
"11990","Ocbimv22027391m.g","KQ416223",122806,123997,1191
"11991","Ocbimv22012001m.g","KQ417853",53792,54133,341
"11992","Ocbimv22021099m.g","KQ419003",431934,432122,188
"11993","Ocbimv22005957m.g","KQ417285",292196,293327,1131
"11994","Ocbimv22035774m.g","KQ416600",276475,390573,114098
"11995","Ocbimv22034207m.g","KQ416523",456348,463658,7310
"11996","Ocbimv22037403m.g","KQ416694",1771752,1773538,1786
"11997","Ocbimv22027416m.g","KQ420270",82020,122719,40699
"11998","Ocbimv22019803m.g","KQ418816",251510,251689,179
"11999","Ocbimv22010209m.g","LGKD01577757",149,614,465
"12000","Ocbimv22034589m.g","KQ422081",36007,63180,27173
"12001","Ocbimv22012461m.g","KQ428165",147894,158490,10596
"12002","Ocbimv22029978m.g","KQ420866",13896,84302,70406
"12003","Ocbimv22002697m.g","KQ424748",12370,14278,1908
"12004","Ocbimv22029180m.g","KQ420672",571413,614970,43557
"12005","Ocbimv22011528m.g","KQ427770",8144,8907,763
"12006","Ocbimv22030219m.g","KQ420924",368518,369505,987
"12007","Ocbimv22032466m.g","KQ421549",219646,220851,1205
"12008","Ocbimv22000644m.g","KQ416872",7136,9321,2185
"12009","Ocbimv22020933m.g","KQ431889",159127,217658,58531
"12010","Ocbimv22020383m.g","KQ418902",2259,11333,9074
"12011","Ocbimv22033340m.g","KQ421785",192815,193791,976
"12012","Ocbimv22032406m.g","KQ421532",192767,193480,713
"12013","Ocbimv22025027m.g","KQ416136",394433,394640,207
"12014","Ocbimv22014966m.g","KQ418188",347542,349901,2359
"12015","Ocbimv22022904m.g","KQ433131",33338,41990,8652
"12016","Ocbimv22010587m.g","KQ427440",116837,117070,233
"12017","Ocbimv22033929m.g","KQ416499",114953,132268,17315
"12018","Ocbimv22020337m.g","KQ418897",56142,56570,428
"12019","Ocbimv22035770m.g","KQ416600",145397,180710,35313
"12020","Ocbimv22037711m.g","KQ423107",59699,59848,149
"12021","Ocbimv22017220m.g","KQ418469",40614,53787,13173
"12022","Ocbimv22037370m.g","KQ423022",26304,28389,2085
"12023","Ocbimv22037006m.g","KQ422903",502836,526527,23691
"12024","Ocbimv22014852m.g","KQ418181",8735,10180,1445
"12025","Ocbimv22019903m.g","KQ418833",384067,419017,34950
"12026","Ocbimv22039541m.g","KQ423702",22797,23877,1080
"12027","Ocbimv22004846m.g","KQ425445",13549,23118,9569
"12028","Ocbimv22007996m.g","KQ426525",60848,106636,45788
"12029","Ocbimv22028334m.g","KQ420475",617542,654348,36806
"12030","Ocbimv22007763m.g","KQ415847",965163,974569,9406
"12031","Ocbimv22004436m.g","KQ425305",1533,1862,329
"12032","Ocbimv22009010m.g","KQ426840",21677,22821,1144
"12033","Ocbimv22009673m.g","KQ427065",8571,11245,2674
"12034","Ocbimv22014941m.g","KQ429139",398269,405101,6832
"12035","Ocbimv22019489m.g","KQ418774",4891,9301,4410
"12036","Ocbimv22026413m.g","KQ420047",119717,205631,85914
"12037","Ocbimv22036112m.g","KQ422643",173055,173339,284
"12038","Ocbimv22031905m.g","KQ421376",167469,167801,332
"12039","Ocbimv22023843m.g","KQ416101",16558,16797,239
"12040","Ocbimv22015986m.g","KQ429639",2788,3221,433
"12041","Ocbimv22006090m.g","KQ417294",497436,497723,287
"12042","Ocbimv22021975m.g","KQ419141",12888,13313,425
"12043","Ocbimv22009732m.g","KQ417608",233271,233615,344
"12044","Ocbimv22015505m.g","KQ418263",979685,979870,185
"12045","Ocbimv22015803m.g","KQ418294",30944,31279,335
"12046","Ocbimv22017541m.g","KQ430345",113065,122219,9154
"12047","Ocbimv22021526m.g","LGKD01669148",3,290,287
"12048","Ocbimv22012660m.g","KQ428198",8227,10457,2230
"12049","Ocbimv22029729m.g","KQ420813",852684,853097,413
"12050","Ocbimv22004446m.g","KQ417160",140380,140739,359
"12051","Ocbimv22016854m.g","KQ418413",98888,121822,22934
"12052","Ocbimv22000210m.g","KQ423900",39181,43192,4011
"12053","Ocbimv22016898m.g","KQ418420",387485,387871,386
"12054","Ocbimv22006371m.g","KQ425894",203516,204412,896
"12055","Ocbimv22020909m.g","KQ418974",636022,638773,2751
"12056","Ocbimv22035605m.g","KQ422461",1558,1734,176
"12057","Ocbimv22016531m.g","KQ418364",697691,735350,37659
"12058","Ocbimv22015517m.g","KQ415945",791956,796812,4856
"12059","Ocbimv22006666m.g","KQ417342",223817,228510,4693
"12060","Ocbimv22009281m.g","KQ426944",820917,841088,20171
"12061","Ocbimv22032089m.g","KQ421440",1805,17568,15763
"12062","Ocbimv22008922m.g","KQ426806",134964,146268,11304
"12063","Ocbimv22012626m.g","KQ417921",1226753,1267171,40418
"12064","Ocbimv22006503m.g","LGKD01546421",19,693,674
"12065","Ocbimv22013768m.g","KQ418059",509755,558690,48935
"12066","Ocbimv22038376m.g","KQ416738",175209,175789,580
"12067","Ocbimv22033024m.g","KQ416465",5580,18052,12472
"12068","Ocbimv22036972m.g","KQ416666",2441184,2447320,6136
"12069","Ocbimv22038257m.g","KQ423250",723019,723168,149
"12070","Ocbimv22000919m.g","KQ424114",88778,101525,12747
"12071","Ocbimv22038148m.g","KQ423220",968,2596,1628
"12072","Ocbimv22023553m.g","KQ419432",56724,58424,1700
"12073","Ocbimv22038166m.g","KQ423221",396526,403055,6529
"12074","Ocbimv22015471m.g","LGKD01619027",52,504,452
"12075","Ocbimv22015579m.g","KQ418267",752664,812781,60117
"12076","Ocbimv22013847m.g","KQ418068",53780,54094,314
"12077","Ocbimv22001361m.g","KQ416925",24610,32799,8189
"12078","Ocbimv22039379m.g","KQ423634",374461,393170,18709
"12079","Ocbimv22034587m.g","KQ416537",1089659,1089904,245
"12080","Ocbimv22015834m.g","KQ418295",271231,273213,1982
"12081","Ocbimv22013370m.g","KQ428463",30978,31232,254
"12082","Ocbimv22009927m.g","KQ417623",189477,189698,221
"12083","Ocbimv22020590m.g","KQ416030",44826,114669,69843
"12084","Ocbimv22016906m.g","LGKD01631598",1,329,328
"12085","Ocbimv22012400m.g","KQ417910",662709,662927,218
"12086","Ocbimv22001482m.g","KQ424317",33375,33638,263
"12087","Ocbimv22022862m.g","KQ416078",121,312,191
"12088","Ocbimv22009964m.g","KQ427186",116475,121628,5153
"12089","Ocbimv22024708m.g","KQ419620",5412,6897,1485
"12090","Ocbimv22033304m.g","KQ421769",86125,145307,59182
"12091","Ocbimv22039178m.g","KQ423573",17,879,862
"12092","Ocbimv22026343m.g","KQ420031",75056,116057,41001
"12093","Ocbimv22032804m.g","KQ421658",722180,724141,1961
"12094","Ocbimv22039166m.g","KQ423556",75192,108924,33732
"12095","Ocbimv22036422m.g","KQ422757",1523,2304,781
"12096","Ocbimv22014462m.g","KQ428942",153083,212909,59826
"12097","Ocbimv22037146m.g","KQ422940",28524,44734,16210
"12098","Ocbimv22022820m.g","KQ433031",82461,83543,1082
"12099","Ocbimv22012734m.g","KQ417931",1508194,1542903,34709
"12100","Ocbimv22017360m.g","LGKD01634957",163,531,368
"12101","Ocbimv22016257m.g","KQ418333",198594,198838,244
"12102","Ocbimv22036164m.g","KQ422662",43417,46670,3253
"12103","Ocbimv22007979m.g","KQ426514",206720,216669,9949
"12104","Ocbimv22015842m.g","KQ418295",324529,328161,3632
"12105","Ocbimv22006720m.g","KQ415834",146239,170377,24138
"12106","Ocbimv22009509m.g","KQ415865",645413,645733,320
"12107","Ocbimv22008623m.g","KQ417510",976194,1045922,69728
"12108","Ocbimv22002516m.g","KQ417012",223772,264470,40698
"12109","Ocbimv22000754m.g","KQ416878",477773,478429,656
"12110","Ocbimv22014457m.g","LGKD01609718",64,171,107
"12111","Ocbimv22038584m.g","KQ423412",71535,72740,1205
"12112","Ocbimv22031174m.g","KQ421192",191637,194484,2847
"12113","Ocbimv22035430m.g","KQ422381",344921,347598,2677
"12114","Ocbimv22024476m.g","KQ416124",63227,85220,21993
"12115","Ocbimv22029911m.g","KQ420843",813,2933,2120
"12116","Ocbimv22018201m.g","KQ415990",1344184,1366887,22703
"12117","Ocbimv22023845m.g","KQ433670",5425,9157,3732
"12118","Ocbimv22003487m.g","KQ425015",969758,987949,18191
"12119","Ocbimv22023890m.g","KQ419491",508712,515499,6787
"12120","Ocbimv22010577m.g","KQ427436",13143,13490,347
"12121","Ocbimv22029076m.g","KQ420642",155564,156117,553
"12122","Ocbimv22014743m.g","KQ418175",76250,130346,54096
"12123","Ocbimv22011070m.g","KQ427619",25058,26802,1744
"12124","Ocbimv22039387m.g","KQ423638",147103,152567,5464
"12125","Ocbimv22008729m.g","KQ417528",118736,135750,17014
"12126","Ocbimv22002434m.g","KQ417009",1972518,1972727,209
"12127","Ocbimv22035042m.g","KQ415746",31833,39123,7290
"12128","Ocbimv22009695m.g","KQ417604",623150,623701,551
"12129","Ocbimv22012470m.g","KQ417913",2528,16454,13926
"12130","Ocbimv22026842m.g","KQ420126",584547,584720,173
"12131","Ocbimv22021998m.g","KQ432500",1716,2981,1265
"12132","Ocbimv22012740m.g","KQ417934",446444,447576,1132
"12133","Ocbimv22005171m.g","KQ425538",7328,7794,466
"12134","Ocbimv22012797m.g","KQ415910",146751,146927,176
"12135","Ocbimv22034425m.g","KQ416531",97298,134546,37248
"12136","Ocbimv22020839m.g","KQ418970",2287474,2289299,1825
"12137","Ocbimv22010524m.g","KQ417687",506926,507099,173
"12138","Ocbimv22030323m.g","KQ420950",84382,84714,332
"12139","Ocbimv22030892m.g","KQ421117",415887,416120,233
"12140","Ocbimv22016493m.g","KQ429898",29077,88612,59535
"12141","Ocbimv22012554m.g","KQ417917",1090673,1105336,14663
"12142","Ocbimv22020409m.g","KQ418908",460871,479284,18413
"12143","Ocbimv22033188m.g","KQ421742",195679,196155,476
"12144","Ocbimv22003887m.g","KQ415799",130224,131358,1134
"12145","Ocbimv22030884m.g","KQ421116",265453,280699,15246
"12146","Ocbimv22028337m.g","KQ420477",210,6276,6066
"12147","Ocbimv22025595m.g","KQ419857",437603,437902,299
"12148","Ocbimv22033679m.g","KQ421858",327738,333054,5316
"12149","Ocbimv22024249m.g","LGKD01697111",1,315,314
"12150","Ocbimv22029759m.g","KQ420820",73916,74189,273
"12151","Ocbimv22017200m.g","LGKD01633926",75,377,302
"12152","Ocbimv22003878m.g","KQ417118",571646,572109,463
"12153","Ocbimv22010297m.g","KQ417666",164421,164660,239
"12154","Ocbimv22032637m.g","KQ416443",87415,89724,2309
"12155","Ocbimv22033298m.g","KQ415661",63167,77035,13868
"12156","Ocbimv22007720m.g","KQ417446",217666,246746,29080
"12157","Ocbimv22018437m.g","KQ415992",232752,259295,26543
"12158","Ocbimv22017509m.g","KQ430326",71900,78594,6694
"12159","Ocbimv22004432m.g","KQ425304",42830,44449,1619
"12160","Ocbimv22034304m.g","KQ422015",1208694,1249527,40833
"12161","Ocbimv22010287m.g","KQ417665",332260,332484,224
"12162","Ocbimv22024586m.g","KQ419601",752204,797935,45731
"12163","Ocbimv22017143m.g","KQ418454",51193,76074,24881
"12164","Ocbimv22011035m.g","KQ427610",1414,2155,741
"12165","Ocbimv22027131m.g","KQ420195",83337,83579,242
"12166","Ocbimv22029813m.g","KQ420828",710791,710994,203
"12167","Ocbimv22029715m.g","KQ420813",482487,488161,5674
"12168","Ocbimv22013873m.g","KQ418069",115470,135661,20191
"12169","Ocbimv22008913m.g","KQ426801",28131,29801,1670
"12170","Ocbimv22016874m.g","KQ430064",117137,165457,48320
"12171","Ocbimv22029405m.g","KQ420742",4698,31564,26866
"12172","Ocbimv22012267m.g","KQ417896",297726,298013,287
"12173","Ocbimv22014507m.g","KQ418146",17311,130493,113182
"12174","Ocbimv22026963m.g","KQ420154",165924,168991,3067
"12175","Ocbimv22015401m.g","KQ418240",4774,12928,8154
"12176","Ocbimv22033281m.g","KQ421759",923591,923899,308
"12177","Ocbimv22002563m.g","KQ415793",1531171,1631833,100662
"12178","Ocbimv22023318m.g","KQ416087",2001955,2015238,13283
"12179","Ocbimv22024135m.g","KQ419538",407613,408116,503
"12180","Ocbimv22019397m.g","KQ416010",369592,394129,24537
"12181","Ocbimv22013995m.g","KQ428719",33467,43244,9777
"12182","Ocbimv22027253m.g","KQ420233",8695,8946,251
"12183","Ocbimv22025743m.g","KQ415694",250536,282350,31814
"12184","Ocbimv22020719m.g","KQ418956",76758,84620,7862
"12185","Ocbimv22014239m.g","KQ418105",304859,305784,925
"12186","Ocbimv22020014m.g","LGKD01655666",52,321,269
"12187","Ocbimv22014185m.g","KQ418098",436519,466836,30317
"12188","Ocbimv22006237m.g","KQ417305",81463,82103,640
"12189","Ocbimv22024807m.g","KQ419631",264189,428892,164703
"12190","Ocbimv22034620m.g","LGKD01429331",47,409,362
"12191","Ocbimv22008845m.g","KQ426789",38257,41074,2817
"12192","Ocbimv22007568m.g","KQ417430",190474,192445,1971
"12193","Ocbimv22003780m.g","KQ417112",251821,300071,48250
"12194","Ocbimv22039362m.g","KQ423631",208575,234742,26167
"12195","Ocbimv22009883m.g","KQ417621",361839,380349,18510
"12196","Ocbimv22033044m.g","KQ421721",230910,231395,485
"12197","Ocbimv22026705m.g","KQ420096",111513,151496,39983
"12198","Ocbimv22023784m.g","KQ416096",1419778,1423522,3744
"12199","Ocbimv22013450m.g","KQ428518",40550,53039,12489
"12200","Ocbimv22028665m.g","KQ420546",230331,230639,308
"12201","Ocbimv22030997m.g","KQ421143",15001,19853,4852
"12202","Ocbimv22031134m.g","KQ421173",71811,97744,25933
"12203","Ocbimv22006697m.g","KQ426075",347643,347842,199
"12204","Ocbimv22015616m.g","KQ418269",81509,82562,1053
"12205","Ocbimv22000436m.g","KQ423963",169368,169745,377
"12206","Ocbimv22021040m.g","KQ418995",53070,55421,2351
"12207","Ocbimv22019383m.g","KQ431108",33771,34091,320
"12208","Ocbimv22007581m.g","KQ417432",88288,89743,1455
"12209","Ocbimv22038785m.g","KQ423464",171328,172679,1351
"12210","Ocbimv22001809m.g","KQ424426",82095,82514,419
"12211","Ocbimv22025954m.g","KQ419933",274632,276154,1522
"12212","Ocbimv22023997m.g","KQ419515",524084,525241,1157
"12213","Ocbimv22034278m.g","KQ422015",749111,749824,713
"12214","Ocbimv22031685m.g","KQ421308",597438,598221,783
"12215","Ocbimv22002137m.g","KQ415788",742989,743297,308
"12216","Ocbimv22029990m.g","KQ420876",26131,26988,857
"12217","Ocbimv22028273m.g","KQ415659",1970634,2030873,60239
"12218","Ocbimv22011193m.g","KQ415884",464698,467023,2325
"12219","Ocbimv22032172m.g","KQ421465",79582,79746,164
"12220","Ocbimv22038660m.g","KQ423432",123568,130795,7227
"12221","Ocbimv22024555m.g","KQ419593",138961,140364,1403
"12222","Ocbimv22015504m.g","KQ418263",979607,982296,2689
"12223","Ocbimv22026571m.g","KQ416193",499393,521378,21985
"12224","Ocbimv22021588m.g","KQ432245",12873,13118,245
"12225","Ocbimv22004689m.g","KQ417198",216672,217403,731
"12226","Ocbimv22008885m.g","KQ426791",698626,699576,950
"12227","Ocbimv22011013m.g","KQ427587",203752,205881,2129
"12228","Ocbimv22027815m.g","KQ420375",270761,272577,1816
"12229","Ocbimv22020380m.g","KQ418901",1376,2077,701
"12230","Ocbimv22032940m.g","KQ421688",23162,41336,18174
"12231","Ocbimv22038708m.g","KQ416761",369618,372320,2702
"12232","Ocbimv22033107m.g","KQ416467",6203,11545,5342
"12233","Ocbimv22038572m.g","KQ423406",5,8734,8729
"12234","Ocbimv22001272m.g","KQ424245",71944,72471,527
"12235","Ocbimv22025142m.g","KQ419707",9361,92901,83540
"12236","Ocbimv22025389m.g","KQ419788",8759,40758,31999
"12237","Ocbimv22030524m.g","KQ421009",1967295,1968361,1066
"12238","Ocbimv22000318m.g","KQ415776",590844,591766,922
"12239","Ocbimv22026530m.g","KQ420065",123780,129230,5450
"12240","Ocbimv22000394m.g","KQ416856",66236,66736,500
"12241","Ocbimv22012139m.g","KQ415902",514159,533172,19013
"12242","Ocbimv22000589m.g","KQ424015",125882,129040,3158
"12243","Ocbimv22029664m.g","KQ420799",56,28553,28497
"12244","Ocbimv22014316m.g","KQ428863",60028,61323,1295
"12245","Ocbimv22028258m.g","KQ415659",543441,579635,36194
"12246","Ocbimv22037725m.g","KQ423122",26412,28580,2168
"12247","Ocbimv22029908m.g","KQ416322",53969,54399,430
"12248","Ocbimv22023213m.g","KQ419372",318017,318271,254
"12249","Ocbimv22016208m.g","KQ429753",39183,67199,28016
"12250","Ocbimv22020673m.g","KQ418949",232640,280511,47871
"12251","Ocbimv22031123m.g","KQ421171",64460,64666,206
"12252","Ocbimv22021643m.g","KQ419081",57843,57998,155
"12253","Ocbimv22015651m.g","KQ429442",53500,56900,3400
"12254","Ocbimv22008035m.g","KQ417472",139354,156952,17598
"12255","Ocbimv22019664m.g","KQ416016",97213,129094,31881
"12256","Ocbimv22022736m.g","KQ416074",485558,576218,90660
"12257","Ocbimv22009178m.g","KQ426911",39827,64791,24964
"12258","Ocbimv22011717m.g","KQ417824",960225,996227,36002
"12259","Ocbimv22010875m.g","KQ417721",1229450,1229731,281
"12260","Ocbimv22001218m.g","KQ424229",330984,339749,8765
"12261","Ocbimv22030283m.g","KQ420938",20802,21176,374
"12262","Ocbimv22035560m.g","KQ422437",7874,8605,731
"12263","Ocbimv22006645m.g","KQ426049",7566,7811,245
"12264","Ocbimv22005777m.g","KQ415823",60720,61323,603
"12265","Ocbimv22039616m.g","KQ416810",112376,122351,9975
"12266","Ocbimv22014937m.g","KQ429139",246804,247909,1105
"12267","Ocbimv22018861m.g","KQ418693",256629,260066,3437
"12268","Ocbimv22030361m.g","KQ420963",45806,51309,5503
"12269","Ocbimv22039037m.g","KQ415769",170810,190532,19722
"12270","Ocbimv22020643m.g","KQ418945",825315,832410,7095
"12271","Ocbimv22000571m.g","KQ423998",219205,223683,4478
"12272","Ocbimv22032146m.g","KQ421460",212625,213035,410
"12273","Ocbimv22027449m.g","KQ420280",445831,446016,185
"12274","Ocbimv22003099m.g","KQ415796",303984,305392,1408
"12275","Ocbimv22021128m.g","KQ416039",1939005,1939166,161
"12276","Ocbimv22020192m.g","KQ418873",168847,176641,7794
"12277","Ocbimv22010595m.g","KQ417695",115056,115811,755
"12278","Ocbimv22038558m.g","KQ416751",209439,224083,14644
"12279","Ocbimv22025063m.g","KQ419690",90875,91399,524
"12280","Ocbimv22018806m.g","KQ416002",186725,218041,31316
"12281","Ocbimv22015753m.g","KQ418289",229523,236872,7349
"12282","Ocbimv22007449m.g","KQ415842",412126,412359,233
"12283","Ocbimv22032744m.g","KQ421650",137694,140371,2677
"12284","Ocbimv22003357m.g","KQ424993",334948,338598,3650
"12285","Ocbimv22028196m.g","KQ420442",96474,98180,1706
"12286","Ocbimv22028545m.g","KQ416260",517679,519080,1401
"12287","Ocbimv22009755m.g","KQ427111",10327,38901,28574
"12288","Ocbimv22002560m.g","KQ415793",1279658,1309078,29420
"12289","Ocbimv22021227m.g","KQ419016",8717,9235,518
"12290","Ocbimv22025200m.g","KQ419727",522453,586934,64481
"12291","Ocbimv22012949m.g","KQ417960",273372,275385,2013
"12292","Ocbimv22014835m.g","KQ429098",27388,27573,185
"12293","Ocbimv22010699m.g","KQ417704",1190,1545,355
"12294","Ocbimv22007178m.g","KQ426223",110855,117839,6984
"12295","Ocbimv22035849m.g","KQ416605",25673,26317,644
"12296","Ocbimv22012311m.g","KQ415907",142383,166610,24227
"12297","Ocbimv22006053m.g","KQ417293",91055,102360,11305
"12298","Ocbimv22020294m.g","KQ431584",178782,179382,600
"12299","Ocbimv22008134m.g","KQ417481",206569,208693,2124
"12300","Ocbimv22035947m.g","KQ416612",1312393,1316341,3948
"12301","Ocbimv22008043m.g","KQ417476",2657,3629,972
"12302","Ocbimv22029279m.g","KQ420696",397048,397854,806
"12303","Ocbimv22017363m.g","KQ418485",71315,71617,302
"12304","Ocbimv22016882m.g","KQ418417",45398,74759,29361
"12305","Ocbimv22010469m.g","KQ417681",51381,66733,15352
"12306","Ocbimv22039641m.g","KQ416810",1315641,1316405,764
"12307","Ocbimv22003610m.g","KQ425044",48747,104623,55876
"12308","Ocbimv22032161m.g","KQ421464",58523,179825,121302
"12309","Ocbimv22033943m.g","KQ421910",2115,13681,11566
"12310","Ocbimv22022633m.g","KQ432932",372498,373874,1376
"12311","Ocbimv22017192m.g","KQ430193",27627,39977,12350
"12312","Ocbimv22010830m.g","KQ417717",7705,8386,681
"12313","Ocbimv22038547m.g","KQ423395",91903,116697,24794
"12314","Ocbimv22000769m.g","KQ416879",294931,320587,25656
"12315","Ocbimv22000352m.g","KQ423935",47246,48504,1258
"12316","Ocbimv22031192m.g","KQ416390",623096,623504,408
"12317","Ocbimv22015087m.g","KQ418194",1937345,1937809,464
"12318","Ocbimv22007058m.g","KQ417372",150370,162702,12332
"12319","Ocbimv22023342m.g","KQ419395",105903,106448,545
"12320","Ocbimv22000538m.g","KQ423989",205852,206504,652
"12321","Ocbimv22025555m.g","KQ419838",123505,124185,680
"12322","Ocbimv22037176m.g","KQ422960",3055,24071,21016
"12323","Ocbimv22010385m.g","KQ415876",1045776,1046539,763
"12324","Ocbimv22028379m.g","KQ416257",199830,202191,2361
"12325","Ocbimv22032624m.g","KQ421611",54105,54362,257
"12326","Ocbimv22008990m.g","KQ426829",190078,200619,10541
"12327","Ocbimv22024448m.g","KQ419581",9208,44899,35691
"12328","Ocbimv22019743m.g","KQ431293",20562,28508,7946
"12329","Ocbimv22038890m.g","KQ416771",295683,348664,52981
"12330","Ocbimv22029502m.g","KQ416311",50211,55154,4943
"12331","Ocbimv22023971m.g","KQ419512",105866,140668,34802
"12332","Ocbimv22009204m.g","KQ417574",36251,36697,446
"12333","Ocbimv22002893m.g","KQ424814",520522,524782,4260
"12334","Ocbimv22006517m.g","KQ425980",3811,4836,1025
"12335","Ocbimv22028329m.g","KQ420475",366726,371650,4924
"12336","Ocbimv22021173m.g","KQ415686",526221,527888,1667
"12337","Ocbimv22014312m.g","KQ428859",110507,119104,8597
"12338","Ocbimv22034506m.g","KQ422063",20511,41005,20494
"12339","Ocbimv22019187m.g","KQ431041",16404,18013,1609
"12340","Ocbimv22010766m.g","KQ427511",19223,23601,4378
"12341","Ocbimv22007486m.g","KQ415843",127933,128154,221
"12342","Ocbimv22027672m.g","KQ416230",385135,385809,674
"12343","Ocbimv22033760m.g","KQ421866",42120,45688,3568
"12344","Ocbimv22002147m.g","KQ424561",5256,14068,8812
"12345","Ocbimv22017253m.g","KQ430221",8169,10397,2228
"12346","Ocbimv22001575m.g","KQ416945",114021,130302,16281
"12347","Ocbimv22019940m.g","KQ418838",101121,101765,644
"12348","Ocbimv22037155m.g","KQ416677",792239,792409,170
"12349","Ocbimv22029468m.g","KQ416308",379897,462492,82595
"12350","Ocbimv22000453m.g","KQ423968",193113,199376,6263
"12351","Ocbimv22021601m.g","KQ432245",79040,82065,3025
"12352","Ocbimv22032772m.g","KQ421656",159162,159395,233
"12353","Ocbimv22016831m.g","KQ430050",329306,350313,21007
"12354","Ocbimv22007740m.g","KQ426448",2,592,590
"12355","Ocbimv22022970m.g","KQ416079",352366,364606,12240
"12356","Ocbimv22022706m.g","KQ432975",22533,22864,331
"12357","Ocbimv22009061m.g","KQ417556",303326,304075,749
"12358","Ocbimv22023331m.g","LGKD01687898",107,289,182
"12359","Ocbimv22037045m.g","KQ422909",1026020,1067772,41752
"12360","Ocbimv22014593m.g","LGKD01611045",2,1409,1407
"12361","Ocbimv22024324m.g","KQ419568",118886,119838,952
"12362","Ocbimv22012955m.g","KQ428311",3952,4152,200
"12363","Ocbimv22031903m.g","KQ421376",47889,54155,6266
"12364","Ocbimv22016446m.g","KQ415965",332348,333652,1304
"12365","Ocbimv22018406m.g","KQ430684",696973,697611,638
"12366","Ocbimv22039625m.g","KQ416810",917328,920020,2692
"12367","Ocbimv22038172m.g","KQ423223",309473,311354,1881
"12368","Ocbimv22030631m.g","KQ416360",10893,32865,21972
"12369","Ocbimv22015884m.g","KQ415948",10400,11989,1589
"12370","Ocbimv22039136m.g","KQ423548",46280,63179,16899
"12371","Ocbimv22007874m.g","KQ426471",40494,42151,1657
"12372","Ocbimv22036693m.g","KQ422839",181634,186444,4810
"12373","Ocbimv22015865m.g","KQ418297",429944,445097,15153
"12374","Ocbimv22001938m.g","KQ416974",1086670,1118773,32103
"12375","Ocbimv22020156m.g","KQ418863",347255,347485,230
"12376","Ocbimv22013621m.g","KQ418039",662028,663285,1257
"12377","Ocbimv22007432m.g","KQ417413",8587,29096,20509
"12378","Ocbimv22037574m.g","KQ416702",221364,231382,10018
"12379","Ocbimv22038805m.g","KQ423466",25547,29298,3751
"12380","Ocbimv22028016m.g","KQ420420",10095,17968,7873
"12381","Ocbimv22022364m.g","KQ432698",1974,80733,78759
"12382","Ocbimv22034632m.g","KQ422095",6747,9327,2580
"12383","Ocbimv22010268m.g","KQ427339",124736,146497,21761
"12384","Ocbimv22026638m.g","KQ420085",7457,40001,32544
"12385","Ocbimv22010971m.g","KQ417729",722821,727437,4616
"12386","Ocbimv22009769m.g","KQ417611",656799,690656,33857
"12387","Ocbimv22029505m.g","KQ416311",101972,102289,317
"12388","Ocbimv22004040m.g","KQ425190",80308,82224,1916
"12389","Ocbimv22020948m.g","KQ418982",341685,341948,263
"12390","Ocbimv22018544m.g","KQ415995",221916,226818,4902
"12391","Ocbimv22015502m.g","KQ418263",808491,809600,1109
"12392","Ocbimv22013895m.g","KQ428707",123351,132009,8658
"12393","Ocbimv22034152m.g","KQ421988",76524,78335,1811
"12394","Ocbimv22028413m.g","KQ420483",94706,95492,786
"12395","Ocbimv22038954m.g","KQ423493",919680,922156,2476
"12396","Ocbimv22035202m.g","KQ422304",13821,14330,509
"12397","Ocbimv22015014m.g","KQ418194",279493,289862,10369
"12398","Ocbimv22020179m.g","KQ431512",71017,71892,875
"12399","Ocbimv22023820m.g","KQ419484",35303,46543,11240
"12400","Ocbimv22031386m.g","KQ421226",88746,125998,37252
"12401","Ocbimv22004027m.g","KQ425190",13090,13824,734
"12402","Ocbimv22023209m.g","LGKD01686425",5,1634,1629
"12403","Ocbimv22009961m.g","KQ417627",61297,64832,3535
"12404","Ocbimv22010764m.g","KQ427506",37661,74410,36749
"12405","Ocbimv22015544m.g","KQ429413",4055,6107,2052
"12406","Ocbimv22014736m.g","KQ429053",47673,48549,876
"12407","Ocbimv22033817m.g","KQ421880",215211,216293,1082
"12408","Ocbimv22012663m.g","KQ417924",154310,154651,341
"12409","Ocbimv22027030m.g","KQ420166",405462,405782,320
"12410","Ocbimv22013686m.g","KQ428610",6753,7390,637
"12411","Ocbimv22033729m.g","KQ416495",208802,214846,6044
"12412","Ocbimv22019872m.g","KQ431346",27439,64096,36657
"12413","Ocbimv22022781m.g","KQ433008",353866,371123,17257
"12414","Ocbimv22017664m.g","KQ418525",230592,259716,29124
"12415","Ocbimv22036281m.g","KQ416628",1170763,1172644,1881
"12416","Ocbimv22028738m.g","KQ420566",92278,92529,251
"12417","Ocbimv22001158m.g","KQ416913",145733,151105,5372
"12418","Ocbimv22013900m.g","KQ428707",147451,147737,286
"12419","Ocbimv22007615m.g","KQ417438",165652,166533,881
"12420","Ocbimv22013449m.g","KQ428518",17745,44165,26420
"12421","Ocbimv22014747m.g","KQ418175",342068,374443,32375
"12422","Ocbimv22017312m.g","KQ415681",1638834,1639118,284
"12423","Ocbimv22034167m.g","KQ416518",109137,109361,224
"12424","Ocbimv22025849m.g","KQ419912",97530,106411,8881
"12425","Ocbimv22037318m.g","KQ423000",13079,13273,194
"12426","Ocbimv22009469m.g","KQ417596",246145,246489,344
"12427","Ocbimv22034105m.g","KQ421976",46442,76961,30519
"12428","Ocbimv22009318m.g","KQ415863",67096,75400,8304
"12429","Ocbimv22022789m.g","KQ433011",3056,4414,1358
"12430","Ocbimv22001749m.g","KQ416960",277132,277443,311
"12431","Ocbimv22008799m.g","KQ426774",142671,142826,155
"12432","Ocbimv22001268m.g","KQ424245",18404,30902,12498
"12433","Ocbimv22016755m.g","KQ418393",16127,41429,25302
"12434","Ocbimv22020339m.g","KQ431627",56,411,355
"12435","Ocbimv22025723m.g","KQ419887",1265303,1289244,23941
"12436","Ocbimv22004521m.g","KQ415805",90342,90569,227
"12437","Ocbimv22015144m.g","KQ418200",317301,319339,2038
"12438","Ocbimv22035549m.g","KQ415751",130822,132558,1736
"12439","Ocbimv22008988m.g","KQ426829",5749,6315,566
"12440","Ocbimv22002272m.g","KQ424608",47123,61636,14513
"12441","Ocbimv22015608m.g","KQ418268",38701,39002,301
"12442","Ocbimv22019955m.g","KQ418839",27018,66452,39434
"12443","Ocbimv22005317m.g","KQ417240",114331,114540,209
"12444","Ocbimv22016399m.g","LGKD01627025",39,452,413
"12445","Ocbimv22004634m.g","KQ417189",39512,40009,497
"12446","Ocbimv22003609m.g","KQ425044",47224,47498,274
"12447","Ocbimv22018236m.g","KQ415990",2282523,2282851,328
"12448","Ocbimv22004488m.g","KQ417173",48595,49255,660
"12449","Ocbimv22018764m.g","KQ418671",14726,32795,18069
"12450","Ocbimv22037024m.g","KQ422909",201300,201596,296
"12451","Ocbimv22001487m.g","KQ424321",29406,34071,4665
"12452","Ocbimv22039583m.g","KQ423712",142188,142973,785
"12453","Ocbimv22016603m.g","KQ418370",23288,30560,7272
"12454","Ocbimv22013906m.g","KQ418071",2026,53566,51540
"12455","Ocbimv22024405m.g","KQ419577",14742,24206,9464
"12456","Ocbimv22037467m.g","KQ415759",196491,226078,29587
"12457","Ocbimv22032739m.g","KQ421649",144453,145128,675
"12458","Ocbimv22039428m.g","KQ423655",289091,351907,62816
"12459","Ocbimv22028219m.g","KQ420446",189045,236557,47512
"12460","Ocbimv22013019m.g","KQ417974",99847,100032,185
"12461","Ocbimv22007757m.g","KQ415847",820645,838894,18249
"12462","Ocbimv22014730m.g","KQ418172",2108,4290,2182
"12463","Ocbimv22031510m.g","KQ421263",560782,561968,1186
"12464","Ocbimv22004402m.g","KQ415804",91427,113356,21929
"12465","Ocbimv22005121m.g","KQ415813",599509,618620,19111
"12466","Ocbimv22010743m.g","KQ427491",14744,17715,2971
"12467","Ocbimv22003290m.g","KQ417076",271610,271876,266
"12468","Ocbimv22000207m.g","KQ423900",59,1991,1932
"12469","Ocbimv22032500m.g","KQ421564",121634,148176,26542
"12470","Ocbimv22018467m.g","KQ415993",356064,356297,233
"12471","Ocbimv22035573m.g","KQ422438",341595,342086,491
"12472","Ocbimv22003420m.g","KQ425007",12702,14347,1645
"12473","Ocbimv22023377m.g","KQ419395",306973,308220,1247
"12474","Ocbimv22020570m.g","KQ418926",145589,147096,1507
"12475","Ocbimv22012173m.g","KQ417880",681345,681572,227
"12476","Ocbimv22026686m.g","KQ416196",1236639,1237289,650
"12477","Ocbimv22033778m.g","KQ421871",172111,174770,2659
"12478","Ocbimv22022969m.g","KQ416079",343718,352198,8480
"12479","Ocbimv22002996m.g","KQ424859",233673,237656,3983
"12480","Ocbimv22017197m.g","KQ430200",29931,30233,302
"12481","Ocbimv22025257m.g","KQ419750",26525,46620,20095
"12482","Ocbimv22006578m.g","KQ426026",106897,117867,10970
"12483","Ocbimv22011180m.g","KQ417757",167527,167793,266
"12484","Ocbimv22008003m.g","KQ415849",42428,65745,23317
"12485","Ocbimv22028429m.g","KQ415705",694162,694509,347
"12486","Ocbimv22023721m.g","KQ416094",825694,858347,32653
"12487","Ocbimv22003803m.g","KQ425115",148796,173588,24792
"12488","Ocbimv22016547m.g","KQ418367",264389,278660,14271
"12489","Ocbimv22022764m.g","KQ432990",185255,199898,14643
"12490","Ocbimv22028959m.g","KQ420616",96455,96652,197
"12491","Ocbimv22039575m.g","KQ423703",525355,534097,8742
"12492","Ocbimv22000308m.g","KQ415776",28347,29942,1595
"12493","Ocbimv22019219m.g","KQ418736",9853,10125,272
"12494","Ocbimv22011927m.g","KQ427949",536756,616734,79978
"12495","Ocbimv22029402m.g","KQ420741",1509610,1509960,350
"12496","Ocbimv22028014m.g","KQ420420",110,385,275
"12497","Ocbimv22013213m.g","KQ418002",279293,286430,7137
"12498","Ocbimv22036481m.g","KQ422772",15160,17245,2085
"12499","Ocbimv22038101m.g","KQ423214",153329,205240,51911
"12500","Ocbimv22002793m.g","KQ417037",102009,139129,37120
"12501","Ocbimv22002125m.g","KQ415788",307450,343763,36313
"12502","Ocbimv22031091m.g","KQ421158",313539,314899,1360
"12503","Ocbimv22028795m.g","KQ416272",385711,461142,75431
"12504","Ocbimv22015994m.g","KQ418308",78,3467,3389
"12505","Ocbimv22027281m.g","KQ420241",137229,139142,1913
"12506","Ocbimv22002433m.g","KQ417009",1720068,1727236,7168
"12507","Ocbimv22036892m.g","KQ422892",40891,42773,1882
"12508","Ocbimv22009902m.g","KQ417622",539575,540483,908
"12509","Ocbimv22030010m.g","KQ416330",55711,71209,15498
"12510","Ocbimv22008651m.g","KQ417518",407755,407964,209
"12511","Ocbimv22028776m.g","KQ420579",796494,830215,33721
"12512","Ocbimv22011252m.g","KQ417771",170481,193319,22838
"12513","Ocbimv22018256m.g","KQ418587",667808,700198,32390
"12514","Ocbimv22025247m.g","KQ419745",7973,8344,371
"12515","Ocbimv22014854m.g","KQ418181",19748,23316,3568
"12516","Ocbimv22033265m.g","KQ421758",1783250,1789878,6628
"12517","Ocbimv22015114m.g","KQ429161",4189,6235,2046
"12518","Ocbimv22024824m.g","KQ419635",4714,4920,206
"12519","Ocbimv22037405m.g","KQ416694",2012595,2044660,32065
"12520","Ocbimv22012090m.g","LGKD01592898",115,423,308
"12521","Ocbimv22037592m.g","KQ423077",355762,369038,13276
"12522","Ocbimv22035862m.g","KQ422586",36287,36505,218
"12523","Ocbimv22011627m.g","KQ427821",11252,54358,43106
"12524","Ocbimv22013874m.g","KQ418069",141986,156795,14809
"12525","Ocbimv22006631m.g","KQ426041",22976,23290,314
"12526","Ocbimv22008072m.g","KQ426557",159693,173178,13485
"12527","Ocbimv22018196m.g","KQ415990",793176,793956,780
"12528","Ocbimv22037633m.g","KQ415761",1161507,1161710,203
"12529","Ocbimv22019253m.g","KQ431068",241931,242287,356
"12530","Ocbimv22010109m.g","KQ427263",60071,60837,766
"12531","Ocbimv22017036m.g","KQ418442",147747,148307,560
"12532","Ocbimv22038306m.g","KQ423275",6281,11787,5506
"12533","Ocbimv22018204m.g","KQ415990",1391745,1402194,10449
"12534","Ocbimv22038538m.g","KQ423394",147103,147291,188
"12535","Ocbimv22006388m.g","LGKD01545096",63,707,644
"12536","Ocbimv22037257m.g","LGKD01458516",9,1679,1670
"12537","Ocbimv22022145m.g","KQ419176",11635,47984,36349
"12538","Ocbimv22002931m.g","KQ417050",274898,275233,335
"12539","Ocbimv22033344m.g","KQ416475",124879,125354,475
"12540","Ocbimv22027085m.g","KQ420176",45688,47800,2112
"12541","Ocbimv22036285m.g","KQ422694",142632,142895,263
"12542","Ocbimv22001171m.g","KQ424212",33,43779,43746
"12543","Ocbimv22003325m.g","KQ417080",190445,198168,7723
"12544","Ocbimv22003941m.g","KQ425153",10103,10435,332
"12545","Ocbimv22000575m.g","KQ423998",246071,250997,4926
"12546","Ocbimv22038262m.g","LGKD01468593",1,735,734
"12547","Ocbimv22037249m.g","KQ422977",123,341,218
"12548","Ocbimv22022415m.g","KQ419216",12,1159,1147
"12549","Ocbimv22031120m.g","KQ421170",559691,560723,1032
"12550","Ocbimv22017820m.g","KQ418549",982624,983495,871
"12551","Ocbimv22007473m.g","KQ426357",6,5423,5417
"12552","Ocbimv22014780m.g","KQ418176",1368004,1369314,1310
"12553","Ocbimv22024326m.g","KQ433942",11586,14408,2822
"12554","Ocbimv22032789m.g","KQ421658",538008,542235,4227
"12555","Ocbimv22002234m.g","KQ416997",44978,47785,2807
"12556","Ocbimv22023720m.g","KQ416094",804219,804503,284
"12557","Ocbimv22028449m.g","KQ420490",87654,87848,194
"12558","Ocbimv22006492m.g","KQ425946",11560,17197,5637
"12559","Ocbimv22021246m.g","KQ419018",711321,711677,356
"12560","Ocbimv22037809m.g","KQ423139",54304,56072,1768
"12561","Ocbimv22034034m.g","KQ416508",280867,281169,302
"12562","Ocbimv22003766m.g","KQ417110",71121,100299,29178
"12563","Ocbimv22012057m.g","KQ417858",112394,146768,34374
"12564","Ocbimv22034006m.g","KQ421945",21026,27708,6682
"12565","Ocbimv22010851m.g","KQ417719",395003,402686,7683
"12566","Ocbimv22032777m.g","KQ421656",554255,554676,421
"12567","Ocbimv22026383m.g","KQ420035",10188,10523,335
"12568","Ocbimv22001946m.g","KQ424486",392078,392335,257
"12569","Ocbimv22035571m.g","KQ422438",254209,278804,24595
"12570","Ocbimv22028313m.g","KQ420471",106226,108178,1952
"12571","Ocbimv22015307m.g","KQ418217",109651,114058,4407
"12572","Ocbimv22013566m.g","KQ418038",124537,125521,984
"12573","Ocbimv22033085m.g","KQ421724",662833,663150,317
"12574","Ocbimv22007896m.g","KQ426484",224852,261082,36230
"12575","Ocbimv22025103m.g","KQ419694",9392,11662,2270
"12576","Ocbimv22019661m.g","KQ416016",31552,31707,155
"12577","Ocbimv22036501m.g","KQ422779",9275,12364,3089
"12578","Ocbimv22032226m.g","KQ421487",58569,60825,2256
"12579","Ocbimv22016917m.g","KQ430081",15985,19269,3284
"12580","Ocbimv22036032m.g","KQ416614",426809,427072,263
"12581","Ocbimv22034288m.g","KQ422015",868063,897802,29739
"12582","Ocbimv22016331m.g","KQ429810",72497,72814,317
"12583","Ocbimv22012653m.g","KQ417923",445838,475353,29515
"12584","Ocbimv22029406m.g","KQ420742",50163,87135,36972
"12585","Ocbimv22012349m.g","KQ428125",6867,10954,4087
"12586","Ocbimv22029100m.g","KQ420649",5487,76989,71502
"12587","Ocbimv22002825m.g","KQ417040",78071,79265,1194
"12588","Ocbimv22028263m.g","KQ415659",1708049,1709143,1094
"12589","Ocbimv22018817m.g","KQ418683",281769,282131,362
"12590","Ocbimv22034243m.g","KQ422015",27696,55414,27718
"12591","Ocbimv22027088m.g","KQ420177",80381,82821,2440
"12592","Ocbimv22029059m.g","KQ420639",292170,294168,1998
"12593","Ocbimv22030890m.g","KQ421117",167469,187810,20341
"12594","Ocbimv22027452m.g","KQ420287",442339,454397,12058
"12595","Ocbimv22005105m.g","KQ415813",120954,127065,6111
"12596","Ocbimv22017851m.g","KQ418552",211396,220074,8678
"12597","Ocbimv22007205m.g","KQ426242",68456,74438,5982
"12598","Ocbimv22002082m.g","KQ424537",77545,96582,19037
"12599","Ocbimv22002454m.g","KQ424659",185726,231869,46143
"12600","Ocbimv22012693m.g","KQ417927",33557,38742,5185
"12601","Ocbimv22003008m.g","KQ417054",104105,181243,77138
"12602","Ocbimv22032215m.g","KQ421482",97464,124060,26596
"12603","Ocbimv22010922m.g","KQ417725",158961,159326,365
"12604","Ocbimv22007756m.g","KQ415847",806633,815401,8768
"12605","Ocbimv22030529m.g","KQ421014",76252,88472,12220
"12606","Ocbimv22015151m.g","KQ418200",502951,504468,1517
"12607","Ocbimv22033886m.g","KQ421897",157512,158715,1203
"12608","Ocbimv22026804m.g","LGKD01335466",242,1665,1423
"12609","Ocbimv22029614m.g","KQ420783",17509,46072,28563
"12610","Ocbimv22003051m.g","KQ424867",43295,93812,50517
"12611","Ocbimv22016802m.g","KQ418402",26720,78989,52269
"12612","Ocbimv22009662m.g","KQ427059",739161,741451,2290
"12613","Ocbimv22028469m.g","KQ420498",27979,28545,566
"12614","Ocbimv22005852m.g","KQ417280",213111,215810,2699
"12615","Ocbimv22034296m.g","KQ422015",1045348,1083673,38325
"12616","Ocbimv22017441m.g","KQ418496",329569,334837,5268
"12617","Ocbimv22015029m.g","KQ418194",448342,448884,542
"12618","Ocbimv22020752m.g","KQ431827",37358,38320,962
"12619","Ocbimv22014659m.g","KQ429033",32055,32359,304
"12620","Ocbimv22029792m.g","KQ420822",319007,319579,572
"12621","Ocbimv22026429m.g","KQ420048",30486,31340,854
"12622","Ocbimv22027254m.g","KQ420233",10107,12359,2252
"12623","Ocbimv22007008m.g","KQ417370",318971,322862,3891
"12624","Ocbimv22017469m.g","KQ430304",6431,7626,1195
"12625","Ocbimv22012619m.g","KQ417921",811613,812739,1126
"12626","Ocbimv22037226m.g","KQ416684",449872,484092,34220
"12627","Ocbimv22017153m.g","KQ430174",31801,32434,633
"12628","Ocbimv22012762m.g","KQ417936",224200,226886,2686
"12629","Ocbimv22018557m.g","KQ430750",362,1187,825
"12630","Ocbimv22007561m.g","KQ417427",54210,87934,33724
"12631","Ocbimv22031435m.g","KQ421242",3258,4043,785
"12632","Ocbimv22014208m.g","KQ418101",27844,56434,28590
"12633","Ocbimv22001786m.g","KQ424419",202,35785,35583
"12634","Ocbimv22039968m.g","KQ416836",256916,257371,455
"12635","Ocbimv22007370m.g","KQ426313",291971,292275,304
"12636","Ocbimv22032600m.g","KQ416441",423455,423688,233
"12637","Ocbimv22017324m.g","KQ418483",39753,40340,587
"12638","Ocbimv22037410m.g","KQ416694",2481284,2481457,173
"12639","Ocbimv22031655m.g","KQ421305",579095,603312,24217
"12640","Ocbimv22013209m.g","KQ418002",238908,239386,478
"12641","Ocbimv22004146m.g","KQ417141",196293,196845,552
"12642","Ocbimv22033740m.g","KQ421864",62013,62397,384
"12643","Ocbimv22034106m.g","KQ421978",18106,18330,224
"12644","Ocbimv22028401m.g","KQ416257",884399,884614,215
"12645","Ocbimv22005277m.g","KQ417238",99471,99866,395
"12646","Ocbimv22019739m.g","KQ418810",136756,137904,1148
"12647","Ocbimv22006062m.g","KQ417293",261661,262005,344
"12648","Ocbimv22009400m.g","KQ417591",91889,92796,907
"12649","Ocbimv22022546m.g","LGKD01679475",789,2208,1419
"12650","Ocbimv22007898m.g","KQ426486",40115,40312,197
"12651","Ocbimv22035368m.g","KQ416583",171599,201790,30191
"12652","Ocbimv22032668m.g","KQ421629",44298,46202,1904
"12653","Ocbimv22028664m.g","KQ420546",172268,172658,390
"12654","Ocbimv22010981m.g","KQ417731",34321,35901,1580
"12655","Ocbimv22010564m.g","KQ417691",386198,411799,25601
"12656","Ocbimv22033220m.g","KQ421758",159457,171754,12297
"12657","Ocbimv22012662m.g","KQ417924",25391,25582,191
"12658","Ocbimv22012071m.g","KQ428000",56530,82552,26022
"12659","Ocbimv22016244m.g","KQ418331",66902,67306,404
"12660","Ocbimv22004193m.g","KQ425220",521435,577293,55858
"12661","Ocbimv22039377m.g","KQ423634",284118,287159,3041
"12662","Ocbimv22015858m.g","KQ418297",337304,346444,9140
"12663","Ocbimv22009910m.g","KQ417622",953024,953416,392
"12664","Ocbimv22033425m.g","KQ421809",178585,200239,21654
"12665","Ocbimv22016604m.g","KQ418370",53577,57667,4090
"12666","Ocbimv22015454m.g","KQ429355",7551,7772,221
"12667","Ocbimv22013205m.g","KQ418002",74051,74414,363
"12668","Ocbimv22019715m.g","KQ418804",706312,706716,404
"12669","Ocbimv22034679m.g","KQ416547",27902,32417,4515
"12670","Ocbimv22038373m.g","KQ416738",17895,18068,173
"12671","Ocbimv22030558m.g","KQ421022",141408,164172,22764
"12672","Ocbimv22039013m.g","KQ416777",376460,376975,515
"12673","Ocbimv22028690m.g","KQ420555",340119,340274,155
"12674","Ocbimv22033538m.g","KQ421825",96822,111051,14229
"12675","Ocbimv22025173m.g","KQ416141",725915,830787,104872
"12676","Ocbimv22011551m.g","KQ417802",45565,45852,287
"12677","Ocbimv22032723m.g","KQ421646",13892,45392,31500
"12678","Ocbimv22007182m.g","KQ426224",355663,401705,46042
"12679","Ocbimv22029480m.g","KQ416308",713832,714850,1018
"12680","Ocbimv22034443m.g","KQ416532",126950,127177,227
"12681","Ocbimv22000534m.g","KQ423989",104135,104341,206
"12682","Ocbimv22021930m.g","KQ419133",337862,376681,38819
"12683","Ocbimv22004335m.g","KQ417149",518539,536849,18310
"12684","Ocbimv22023299m.g","KQ416087",405682,407170,1488
"12685","Ocbimv22030358m.g","KQ420963",2146,2789,643
"12686","Ocbimv22015165m.g","KQ418202",14177,18005,3828
"12687","Ocbimv22038777m.g","KQ416765",878837,879241,404
"12688","Ocbimv22020349m.g","KQ418899",136409,138262,1853
"12689","Ocbimv22031521m.g","KQ421265",126767,157802,31035
"12690","Ocbimv22032891m.g","KQ421676",246469,247566,1097
"12691","Ocbimv22023670m.g","KQ433566",50050,52652,2602
"12692","Ocbimv22029774m.g","KQ420820",892531,892864,333
"12693","Ocbimv22039018m.g","KQ423509",81034,90052,9018
"12694","Ocbimv22034730m.g","KQ422135",35749,36295,546
"12695","Ocbimv22007573m.g","KQ417430",995342,1014158,18816
"12696","Ocbimv22026385m.g","KQ420035",83729,112517,28788
"12697","Ocbimv22003462m.g","KQ425015",339043,370779,31736
"12698","Ocbimv22004034m.g","KQ425190",48709,48903,194
"12699","Ocbimv22036799m.g","KQ416657",555176,562674,7498
"12700","Ocbimv22014129m.g","KQ418093",324697,324900,203
"12701","Ocbimv22004301m.g","KQ417147",105207,109600,4393
"12702","Ocbimv22032330m.g","KQ421523",524744,579419,54675
"12703","Ocbimv22003862m.g","KQ417118",129674,131190,1516
"12704","Ocbimv22028786m.g","KQ420583",214917,215616,699
"12705","Ocbimv22009837m.g","KQ417620",645191,646377,1186
"12706","Ocbimv22016829m.g","KQ430050",251920,262609,10689
"12707","Ocbimv22009770m.g","KQ427114",68604,70744,2140
"12708","Ocbimv22008985m.g","KQ426828",60975,61472,497
"12709","Ocbimv22016113m.g","KQ418320",90033,176839,86806
"12710","Ocbimv22003631m.g","KQ417097",5490,11798,6308
"12711","Ocbimv22037862m.g","KQ423141",81850,86491,4641
"12712","Ocbimv22039622m.g","KQ416810",588791,589003,212
"12713","Ocbimv22033968m.g","KQ416503",105726,105890,164
"12714","Ocbimv22025939m.g","KQ419930",693093,694902,1809
"12715","Ocbimv22005833m.g","KQ417280",111033,111269,236
"12716","Ocbimv22015816m.g","KQ418295",135143,140478,5335
"12717","Ocbimv22016302m.g","KQ415960",10504,36015,25511
"12718","Ocbimv22006092m.g","KQ417294",584001,585545,1544
"12719","Ocbimv22021145m.g","KQ419009",310660,319117,8457
"12720","Ocbimv22007596m.g","KQ426396",50222,89356,39134
"12721","Ocbimv22033174m.g","KQ416469",244427,245215,788
"12722","Ocbimv22016492m.g","KQ429898",19417,26318,6901
"12723","Ocbimv22033287m.g","KQ421765",162363,166573,4210
"12724","Ocbimv22025280m.g","KQ419758",134196,157918,23722
"12725","Ocbimv22005020m.g","KQ417224",199928,200754,826
"12726","Ocbimv22027881m.g","KQ420387",174995,175285,290
"12727","Ocbimv22003870m.g","KQ417118",313639,332250,18611
"12728","Ocbimv22018847m.g","KQ416003",1476393,1476608,215
"12729","Ocbimv22027410m.g","KQ420269",57774,58166,392
"12730","Ocbimv22024247m.g","KQ419552",168863,170169,1306
"12731","Ocbimv22014662m.g","KQ418166",1783,2448,665
"12732","Ocbimv22033208m.g","KQ421754",20098,21108,1010
"12733","Ocbimv22010679m.g","KQ417701",392605,425782,33177
"12734","Ocbimv22028397m.g","KQ416257",785631,816723,31092
"12735","Ocbimv22039668m.g","KQ423725",25026,47524,22498
"12736","Ocbimv22033945m.g","KQ421912",86598,103642,17044
"12737","Ocbimv22025683m.g","KQ419886",260893,318651,57758
"12738","Ocbimv22024632m.g","KQ419605",324100,337178,13078
"12739","Ocbimv22019542m.g","KQ418783",253239,253538,299
"12740","Ocbimv22005954m.g","KQ417285",181106,196133,15027
"12741","Ocbimv22022921m.g","KQ419326",454907,507835,52928
"12742","Ocbimv22007252m.g","KQ426262",57903,125519,67616
"12743","Ocbimv22032945m.g","KQ421688",195103,206497,11394
"12744","Ocbimv22037177m.g","KQ422960",157364,157579,215
"12745","Ocbimv22018307m.g","KQ418599",304298,318594,14296
"12746","Ocbimv22023842m.g","KQ419485",546576,601348,54772
"12747","Ocbimv22018401m.g","KQ430684",238875,243954,5079
"12748","Ocbimv22017718m.g","KQ430433",54820,55062,242
"12749","Ocbimv22032036m.g","KQ421411",498587,498799,212
"12750","Ocbimv22039559m.g","KQ416802",520613,545332,24719
"12751","Ocbimv22005574m.g","KQ425655",154564,218724,64160
"12752","Ocbimv22007532m.g","KQ426366",15021,15939,918
"12753","Ocbimv22034949m.g","KQ422223",430060,433699,3639
"12754","Ocbimv22012828m.g","KQ428255",73114,97423,24309
"12755","Ocbimv22039652m.g","KQ416811",214001,249946,35945
"12756","Ocbimv22016068m.g","KQ418316",89078,98480,9402
"12757","Ocbimv22030423m.g","KQ420978",149365,156220,6855
"12758","Ocbimv22023703m.g","KQ416093",298800,299255,455
"12759","Ocbimv22025289m.g","KQ419763",29344,32700,3356
"12760","Ocbimv22026908m.g","KQ420140",111259,132541,21282
"12761","Ocbimv22037697m.g","KQ423101",103535,108920,5385
"12762","Ocbimv22035385m.g","KQ422366",71806,72809,1003
"12763","Ocbimv22031214m.g","KQ421200",298477,325576,27099
"12764","Ocbimv22017780m.g","KQ430471",32049,55238,23189
"12765","Ocbimv22036552m.g","KQ422791",35673,35912,239
"12766","Ocbimv22037713m.g","KQ423110",35538,37404,1866
"12767","Ocbimv22017071m.g","KQ418448",64276,64647,371
"12768","Ocbimv22008883m.g","KQ426791",666640,689279,22639
"12769","Ocbimv22001562m.g","KQ424358",8250,21117,12867
"12770","Ocbimv22016713m.g","KQ418388",27917,39575,11658
"12771","Ocbimv22024832m.g","KQ419638",48807,48983,176
"12772","Ocbimv22032081m.g","KQ421430",45831,142587,96756
"12773","Ocbimv22031860m.g","KQ421362",44094,44264,170
"12774","Ocbimv22023233m.g","KQ419378",76161,77332,1171
"12775","Ocbimv22002084m.g","KQ424537",124398,125885,1487
"12776","Ocbimv22004958m.g","LGKD01534218",95,388,293
"12777","Ocbimv22038626m.g","KQ423423",1528,17562,16034
"12778","Ocbimv22032672m.g","KQ416444",34255,35147,892
"12779","Ocbimv22029378m.g","KQ420735",8317,8544,227
"12780","Ocbimv22023316m.g","KQ416087",1840143,1854874,14731
"12781","Ocbimv22029811m.g","KQ420828",432713,432916,203
"12782","Ocbimv22008445m.g","KQ415854",43850,62391,18541
"12783","Ocbimv22022727m.g","KQ416074",331051,331722,671
"12784","Ocbimv22029975m.g","KQ415714",173892,174056,164
"12785","Ocbimv22014230m.g","KQ428805",19449,79797,60348
"12786","Ocbimv22028107m.g","KQ416249",495631,496155,524
"12787","Ocbimv22015629m.g","KQ418269",803139,803892,753
"12788","Ocbimv22031849m.g","KQ421357",61535,72331,10796
"12789","Ocbimv22007784m.g","KQ426456",242210,252607,10397
"12790","Ocbimv22008916m.g","KQ426806",28126,70813,42687
"12791","Ocbimv22001600m.g","KQ424367",195120,195631,511
"12792","Ocbimv22012954m.g","KQ417960",770907,771140,233
"12793","Ocbimv22025467m.g","KQ419810",9500,11149,1649
"12794","Ocbimv22024459m.g","KQ419582",58023,63411,5388
"12795","Ocbimv22033087m.g","KQ421725",51,6248,6197
"12796","Ocbimv22038506m.g","KQ423383",9869,11064,1195
"12797","Ocbimv22034684m.g","KQ416547",56911,61982,5071
"12798","Ocbimv22023728m.g","KQ433599",3394,11853,8459
"12799","Ocbimv22001751m.g","LGKD01504771",2,997,995
"12800","Ocbimv22016789m.g","KQ430029",93576,95820,2244
"12801","Ocbimv22024306m.g","KQ419564",170754,178553,7799
"12802","Ocbimv22026092m.g","KQ419989",167995,168630,635
"12803","Ocbimv22035004m.g","LGKD01435517",80,280,200
"12804","Ocbimv22004022m.g","KQ425190",13,3053,3040
"12805","Ocbimv22030568m.g","LGKD01381841",1252,1407,155
"12806","Ocbimv22026805m.g","KQ416203",232879,233034,155
"12807","Ocbimv22021176m.g","KQ415686",540817,541795,978
"12808","Ocbimv22004471m.g","LGKD01530502",572,739,167
"12809","Ocbimv22010211m.g","KQ417656",274670,278875,4205
"12810","Ocbimv22023426m.g","KQ433390",12826,14304,1478
"12811","Ocbimv22002698m.g","KQ417027",17007,40785,23778
"12812","Ocbimv22012056m.g","KQ417858",58118,92609,34491
"12813","Ocbimv22011665m.g","KQ415889",66541,66862,321
"12814","Ocbimv22011478m.g","KQ417795",28028,29076,1048
"12815","Ocbimv22028101m.g","KQ416249",146915,147076,161
"12816","Ocbimv22029686m.g","KQ420801",94857,135819,40962
"12817","Ocbimv22026925m.g","KQ416205",508246,511830,3584
"12818","Ocbimv22014403m.g","KQ418128",87668,93563,5895
"12819","Ocbimv22011693m.g","KQ427858",113892,114314,422
"12820","Ocbimv22013153m.g","KQ417989",728618,729618,1000
"12821","Ocbimv22028235m.g","KQ420455",2359,2568,209
"12822","Ocbimv22017881m.g","KQ418552",804241,804607,366
"12823","Ocbimv22030862m.g","KQ416373",823440,823699,259
"12824","Ocbimv22039197m.g","KQ423574",64557,74096,9539
"12825","Ocbimv22003799m.g","KQ425109",45128,45573,445
"12826","Ocbimv22011796m.g","KQ427906",72785,73868,1083
"12827","Ocbimv22039618m.g","KQ416810",305719,307585,1866
"12828","Ocbimv22016763m.g","KQ418393",456435,457067,632
"12829","Ocbimv22000109m.g","KQ423864",189314,189837,523
"12830","Ocbimv22007884m.g","KQ417458",164863,168536,3673
"12831","Ocbimv22018050m.g","KQ430541",12,17344,17332
"12832","Ocbimv22036540m.g","KQ422788",65162,109166,44004
"12833","Ocbimv22027018m.g","KQ420162",806862,815608,8746
"12834","Ocbimv22012590m.g","KQ417917",1892029,1894048,2019
"12835","Ocbimv22015563m.g","KQ429424",44831,47371,2540
"12836","Ocbimv22020556m.g","KQ431722",44528,46784,2256
"12837","Ocbimv22002367m.g","KQ424650",135684,137635,1951
"12838","Ocbimv22022514m.g","KQ419238",67869,68537,668
"12839","Ocbimv22035289m.g","KQ422349",215276,217535,2259
"12840","Ocbimv22038440m.g","KQ423338",265130,265351,221
"12841","Ocbimv22032966m.g","KQ421702",188574,188903,329
"12842","Ocbimv22033749m.g","KQ421864",190562,198034,7472
"12843","Ocbimv22020341m.g","KQ431630",75345,76114,769
"12844","Ocbimv22033626m.g","KQ421852",33671,34356,685
"12845","Ocbimv22021901m.g","KQ432411",2891,4820,1929
"12846","Ocbimv22011527m.g","KQ427770",1031,37407,36376
"12847","Ocbimv22000812m.g","KQ416886",78781,97313,18532
"12848","Ocbimv22037148m.g","KQ416677",313296,313736,440
"12849","Ocbimv22012028m.g","KQ427974",4124,10062,5938
"12850","Ocbimv22021739m.g","KQ419093",155287,155529,242
"12851","Ocbimv22012325m.g","KQ415907",412896,413123,227
"12852","Ocbimv22033734m.g","KQ416495",550599,551033,434
"12853","Ocbimv22036648m.g","KQ422819",100211,128362,28151
"12854","Ocbimv22004231m.g","KQ417143",70923,71184,261
"12855","Ocbimv22027392m.g","KQ416223",137792,258491,120699
"12856","Ocbimv22028820m.g","KQ420587",75267,75827,560
"12857","Ocbimv22024205m.g","KQ419550",5812,30323,24511
"12858","Ocbimv22015110m.g","KQ418195",43196,43447,251
"12859","Ocbimv22001734m.g","KQ424397",88546,116699,28153
"12860","Ocbimv22006369m.g","KQ425894",142362,166133,23771
"12861","Ocbimv22026457m.g","KQ420053",290774,290938,164
"12862","Ocbimv22006791m.g","KQ426107",146847,159816,12969
"12863","Ocbimv22007929m.g","KQ417462",52115,53435,1320
"12864","Ocbimv22016097m.g","KQ429708",134132,135548,1416
"12865","Ocbimv22002869m.g","KQ424812",69270,76916,7646
"12866","Ocbimv22002009m.g","KQ424513",54771,84581,29810
"12867","Ocbimv22009226m.g","KQ426934",10879,16822,5943
"12868","Ocbimv22033061m.g","KQ421721",696546,697494,948
"12869","Ocbimv22027834m.g","KQ420375",1327359,1360618,33259
"12870","Ocbimv22039500m.g","KQ423679",213,542,329
"12871","Ocbimv22012801m.g","KQ417942",382499,384222,1723
"12872","Ocbimv22013586m.g","KQ418038",496051,548680,52629
"12873","Ocbimv22008474m.g","KQ415854",687820,700890,13070
"12874","Ocbimv22002662m.g","KQ417024",11,4547,4536
"12875","Ocbimv22039473m.g","KQ423675",151337,194269,42932
"12876","Ocbimv22014343m.g","KQ418120",266537,281457,14920
"12877","Ocbimv22015878m.g","KQ429602",233574,236303,2729
"12878","Ocbimv22027488m.g","KQ420289",73171,73840,669
"12879","Ocbimv22033469m.g","KQ421820",100695,104499,3804
"12880","Ocbimv22032247m.g","LGKD01078583",1437,10673,9236
"12881","Ocbimv22004314m.g","KQ417147",1524587,1528610,4023
"12882","Ocbimv22037594m.g","KQ423077",413685,438427,24742
"12883","Ocbimv22016523m.g","KQ418364",331093,350397,19304
"12884","Ocbimv22003364m.g","KQ417085",247287,247713,426
"12885","Ocbimv22032484m.g","KQ416432",873575,882617,9042
"12886","Ocbimv22021883m.g","LGKD01671926",1,273,272
"12887","Ocbimv22013218m.g","KQ418002",338588,343053,4465
"12888","Ocbimv22030326m.g","KQ420950",296543,296704,161
"12889","Ocbimv22012881m.g","KQ428261",135073,260518,125445
"12890","Ocbimv22029177m.g","KQ420672",557340,557507,167
"12891","Ocbimv22031686m.g","KQ421308",635444,636397,953
"12892","Ocbimv22008708m.g","KQ426740",402791,411228,8437
"12893","Ocbimv22015509m.g","KQ415945",107406,107882,476
"12894","Ocbimv22017209m.g","KQ430209",166902,169845,2943
"12895","Ocbimv22035834m.g","KQ422573",50514,51187,673
"12896","Ocbimv22025117m.g","KQ419695",186244,191648,5404
"12897","Ocbimv22022720m.g","KQ419287",73404,74497,1093
"12898","Ocbimv22035919m.g","KQ416609",38143,38358,215
"12899","Ocbimv22030552m.g","KQ421020",11956,13713,1757
"12900","Ocbimv22006693m.g","KQ426075",316442,334401,17959
"12901","Ocbimv22027671m.g","KQ416230",293167,293352,185
"12902","Ocbimv22035572m.g","KQ422438",278272,278664,392
"12903","Ocbimv22037027m.g","KQ422909",333344,335157,1813
"12904","Ocbimv22013221m.g","KQ418002",383774,401650,17876
"12905","Ocbimv22010070m.g","LGKD01576488",21,408,387
"12906","Ocbimv22020551m.g","KQ418923",44214,44787,573
"12907","Ocbimv22003431m.g","KQ417087",912278,914020,1742
"12908","Ocbimv22003121m.g","KQ424889",132240,132518,278
"12909","Ocbimv22020296m.g","KQ418886",172194,172391,197
"12910","Ocbimv22020270m.g","KQ418881",943909,944346,437
"12911","Ocbimv22031396m.g","KQ416395",173353,187938,14585
"12912","Ocbimv22025695m.g","KQ419887",57981,69483,11502
"12913","Ocbimv22014325m.g","KQ428867",13855,22292,8437
"12914","Ocbimv22017668m.g","KQ418525",289644,290069,425
"12915","Ocbimv22006482m.g","KQ415831",368604,369425,821
"12916","Ocbimv22016799m.g","KQ418401",179768,179929,161
"12917","Ocbimv22013342m.g","KQ418015",139129,139386,257
"12918","Ocbimv22019315m.g","KQ418749",144117,147611,3494
"12919","Ocbimv22038781m.g","KQ423461",86116,86316,200
"12920","Ocbimv22030913m.g","KQ421117",1768713,1769112,399
"12921","Ocbimv22022417m.g","KQ419216",6172,6537,365
"12922","Ocbimv22039467m.g","KQ423675",50988,51528,540
"12923","Ocbimv22014037m.g","KQ418081",21846,22418,572
"12924","Ocbimv22029391m.g","KQ416303",697516,697716,200
"12925","Ocbimv22010229m.g","KQ417658",515381,516244,863
"12926","Ocbimv22014027m.g","KQ418079",433262,448927,15665
"12927","Ocbimv22034459m.g","KQ422048",52215,52484,269
"12928","Ocbimv22018737m.g","LGKD01645607",259,420,161
"12929","Ocbimv22003414m.g","KQ417086",752408,767120,14712
"12930","Ocbimv22003172m.g","KQ417062",131782,134112,2330
"12931","Ocbimv22024188m.g","KQ433854",244,1598,1354
"12932","Ocbimv22029634m.g","KQ420791",475,1775,1300
"12933","Ocbimv22027279m.g","KQ420241",109758,110940,1182
"12934","Ocbimv22004484m.g","KQ425336",20538,21806,1268
"12935","Ocbimv22025564m.g","KQ419844",20162,28558,8396
"12936","Ocbimv22030115m.g","KQ420897",772,35889,35117
"12937","Ocbimv22013584m.g","KQ418038",444726,463687,18961
"12938","Ocbimv22035292m.g","KQ422349",232388,237747,5359
"12939","Ocbimv22025640m.g","KQ419868",304588,305007,419
"12940","Ocbimv22012576m.g","KQ417917",1612593,1628189,15596
"12941","Ocbimv22031176m.g","KQ421193",3842,5426,1584
"12942","Ocbimv22020169m.g","LGKD01657326",398,763,365
"12943","Ocbimv22023850m.g","KQ433676",28046,37465,9419
"12944","Ocbimv22020330m.g","KQ418895",146595,147539,944
"12945","Ocbimv22008033m.g","KQ417472",117176,118122,946
"12946","Ocbimv22035293m.g","KQ422349",235144,240623,5479
"12947","Ocbimv22016330m.g","KQ429810",50077,50361,284
"12948","Ocbimv22029876m.g","KQ420828",2064901,2065534,633
"12949","Ocbimv22007580m.g","KQ417432",34915,84826,49911
"12950","Ocbimv22002631m.g","KQ417023",898807,905829,7022
"12951","Ocbimv22006634m.g","KQ426043",116788,117367,579
"12952","Ocbimv22003484m.g","KQ425015",840127,847724,7597
"12953","Ocbimv22023398m.g","KQ419401",163484,185314,21830
"12954","Ocbimv22026851m.g","KQ420130",717603,750132,32529
"12955","Ocbimv22008116m.g","KQ415851",26396,26647,251
"12956","Ocbimv22014924m.g","KQ418187",654588,671424,16836
"12957","Ocbimv22001900m.g","KQ424463",149154,161847,12693
"12958","Ocbimv22028731m.g","KQ416270",1806040,1894752,88712
"12959","Ocbimv22013909m.g","KQ418071",164777,165148,371
"12960","Ocbimv22008788m.g","KQ426774",84660,87807,3147
"12961","Ocbimv22019692m.g","KQ418800",38419,48121,9702
"12962","Ocbimv22036115m.g","KQ416618",14268,20106,5838
"12963","Ocbimv22023949m.g","KQ419506",35356,35556,200
"12964","Ocbimv22010294m.g","KQ417665",1483377,1493396,10019
"12965","Ocbimv22028767m.g","KQ420579",471062,487002,15940
"12966","Ocbimv22006988m.g","KQ417370",54116,58843,4727
"12967","Ocbimv22034116m.g","KQ416513",604779,604949,170
"12968","Ocbimv22011517m.g","KQ417796",770333,780961,10628
"12969","Ocbimv22016651m.g","KQ418375",146448,218375,71927
"12970","Ocbimv22000735m.g","KQ416877",1129048,1155442,26394
"12971","Ocbimv22029530m.g","KQ420774",299132,302491,3359
"12972","Ocbimv22000099m.g","LGKD01488833",8,306,298
"12973","Ocbimv22030813m.g","KQ421092",208766,213789,5023
"12974","Ocbimv22006546m.g","KQ426003",22184,25876,3692
"12975","Ocbimv22001114m.g","KQ424184",19087,20416,1329
"12976","Ocbimv22039734m.g","KQ423737",66502,99197,32695
"12977","Ocbimv22006448m.g","KQ417320",187994,188521,527
"12978","Ocbimv22003370m.g","KQ424997",30676,32013,1337
"12979","Ocbimv22022911m.g","KQ419324",381881,399061,17180
"12980","Ocbimv22030628m.g","KQ421036",17823,49436,31613
"12981","Ocbimv22022155m.g","KQ419176",942198,943415,1217
"12982","Ocbimv22014799m.g","KQ429084",6975,55482,48507
"12983","Ocbimv22005892m.g","KQ425751",8957,24437,15480
"12984","Ocbimv22007617m.g","KQ417438",185936,262208,76272
"12985","Ocbimv22037603m.g","KQ423077",677109,689184,12075
"12986","Ocbimv22011101m.g","KQ417748",28978,35079,6101
"12987","Ocbimv22035485m.g","KQ422401",239722,240200,478
"12988","Ocbimv22023122m.g","KQ419350",981989,984750,2761
"12989","Ocbimv22004042m.g","KQ425190",87883,96199,8316
"12990","Ocbimv22007025m.g","KQ417370",557759,563149,5390
"12991","Ocbimv22009615m.g","KQ427054",25353,70261,44908
"12992","Ocbimv22033621m.g","KQ421850",139657,140362,705
"12993","Ocbimv22034648m.g","KQ422103",569860,570702,842
"12994","Ocbimv22036646m.g","KQ422818",121144,124537,3393
"12995","Ocbimv22032471m.g","KQ421549",393584,445259,51675
"12996","Ocbimv22013613m.g","KQ418039",477035,477566,531
"12997","Ocbimv22013071m.g","KQ417978",529,31465,30936
"12998","Ocbimv22016027m.g","KQ429665",556,7005,6449
"12999","Ocbimv22002094m.g","KQ424538",343854,367817,23963
"13000","Ocbimv22011481m.g","KQ417795",150667,150879,212
"13001","Ocbimv22008732m.g","KQ417528",243193,249146,5953
"13002","Ocbimv22024983m.g","KQ419670",486972,491289,4317
"13003","Ocbimv22011208m.g","KQ417763",21947,23554,1607
"13004","Ocbimv22022626m.g","KQ432932",133162,156828,23666
"13005","Ocbimv22030299m.g","KQ420942",87946,104608,16662
"13006","Ocbimv22027494m.g","KQ416226",42078,43383,1305
"13007","Ocbimv22012822m.g","KQ428249",149,634,485
"13008","Ocbimv22033746m.g","KQ421864",138785,143546,4761
"13009","Ocbimv22038740m.g","KQ416764",313500,333255,19755
"13010","Ocbimv22001739m.g","KQ416959",21812,46667,24855
"13011","Ocbimv22028972m.g","KQ416278",235543,248486,12943
"13012","Ocbimv22006083m.g","KQ417294",133400,149489,16089
"13013","Ocbimv22036234m.g","KQ416626",994048,994485,437
"13014","Ocbimv22035660m.g","KQ422493",402398,409765,7367
"13015","Ocbimv22012260m.g","KQ417896",21369,22484,1115
"13016","Ocbimv22009640m.g","KQ427059",267340,269227,1887
"13017","Ocbimv22015822m.g","KQ418295",156854,159580,2726
"13018","Ocbimv22000877m.g","KQ424097",262,9846,9584
"13019","Ocbimv22010005m.g","KQ427204",38751,39297,546
"13020","Ocbimv22011155m.g","KQ417754",10839,12170,1331
"13021","Ocbimv22012962m.g","KQ417963",5632,6187,555
"13022","Ocbimv22022355m.g","KQ419204",109795,110163,368
"13023","Ocbimv22037569m.g","KQ416702",1821,2042,221
"13024","Ocbimv22025741m.g","KQ415694",162917,230246,67329
"13025","Ocbimv22012388m.g","KQ417910",10654,35107,24453
"13026","Ocbimv22009886m.g","KQ417621",523548,524740,1192
"13027","Ocbimv22012182m.g","KQ417884",11601,11864,263
"13028","Ocbimv22034915m.g","KQ415742",289889,290218,329
"13029","Ocbimv22010655m.g","KQ427464",168561,170223,1662
"13030","Ocbimv22025753m.g","KQ419903",211504,217712,6208
"13031","Ocbimv22021473m.g","KQ416046",2313256,2313694,438
"13032","Ocbimv22034644m.g","KQ422099",496099,496643,544
"13033","Ocbimv22034701m.g","KQ416547",142883,143733,850
"13034","Ocbimv22029068m.g","KQ420640",116438,117141,703
"13035","Ocbimv22029123m.g","KQ420660",86704,95991,9287
"13036","Ocbimv22026212m.g","KQ420017",342755,346961,4206
"13037","Ocbimv22015559m.g","KQ429416",311771,344520,32749
"13038","Ocbimv22023006m.g","KQ419338",51797,52087,290
"13039","Ocbimv22004877m.g","KQ417211",440142,440352,210
"13040","Ocbimv22001578m.g","KQ424363",104673,104990,317
"13041","Ocbimv22030184m.g","KQ420917",89905,163563,73658
"13042","Ocbimv22038353m.g","KQ416737",1502037,1510143,8106
"13043","Ocbimv22037832m.g","KQ423139",308933,312418,3485
"13044","Ocbimv22011576m.g","KQ417806",299612,367097,67485
"13045","Ocbimv22012005m.g","KQ415896",61018,61200,182
"13046","Ocbimv22009457m.g","LGKD01570826",238,496,258
"13047","Ocbimv22002550m.g","KQ424684",115153,122129,6976
"13048","Ocbimv22027556m.g","KQ420302",124619,124861,242
"13049","Ocbimv22022834m.g","KQ433045",4868,5373,505
"13050","Ocbimv22025666m.g","KQ419882",128991,129212,221
"13051","Ocbimv22023388m.g","LGKD01687938",172,513,341
"13052","Ocbimv22011263m.g","KQ417771",1001812,1002387,575
"13053","Ocbimv22021050m.g","LGKD01664962",407,918,511
"13054","Ocbimv22017832m.g","KQ430490",5763,6979,1216
"13055","Ocbimv22016653m.g","KQ418375",505728,506081,353
"13056","Ocbimv22006389m.g","KQ417318",97750,97905,155
"13057","Ocbimv22004973m.g","KQ425492",61825,80711,18886
"13058","Ocbimv22033622m.g","KQ421851",19107,46272,27165
"13059","Ocbimv22010850m.g","KQ417719",389736,392975,3239
"13060","Ocbimv22028755m.g","KQ420579",246007,291283,45276
"13061","Ocbimv22009854m.g","KQ417620",1225945,1229129,3184
"13062","Ocbimv22020298m.g","KQ418886",282760,283071,311
"13063","Ocbimv22038969m.g","KQ423495",493,26446,25953
"13064","Ocbimv22006848m.g","KQ417358",305678,319120,13442
"13065","Ocbimv22000647m.g","KQ416872",529760,530329,569
"13066","Ocbimv22030911m.g","KQ421117",1671122,1763422,92300
"13067","Ocbimv22029033m.g","KQ420630",136576,143585,7009
"13068","Ocbimv22004427m.g","KQ415804",503581,504943,1362
"13069","Ocbimv22021005m.g","KQ431922",136084,137702,1618
"13070","Ocbimv22001066m.g","KQ424172",77996,108123,30127
"13071","Ocbimv22039921m.g","KQ423797",48091,69671,21580
"13072","Ocbimv22007877m.g","KQ426474",37403,57989,20586
"13073","Ocbimv22014810m.g","KQ429096",173300,182132,8832
"13074","Ocbimv22001649m.g","KQ416951",3694,5946,2252
"13075","Ocbimv22007442m.g","KQ417416",51205,54989,3784
"13076","Ocbimv22036753m.g","KQ422849",184700,186311,1611
"13077","Ocbimv22017179m.g","LGKD01633531",448,1902,1454
"13078","Ocbimv22022715m.g","KQ419285",5348,5581,233
"13079","Ocbimv22033997m.g","KQ416505",266136,268675,2539
"13080","Ocbimv22027413m.g","KQ420269",323544,367848,44304
"13081","Ocbimv22017175m.g","KQ418459",490907,503960,13053
"13082","Ocbimv22003171m.g","KQ417062",117656,128958,11302
"13083","Ocbimv22006478m.g","KQ417326",1336799,1338674,1875
"13084","Ocbimv22005397m.g","KQ417249",1625048,1634691,9643
"13085","Ocbimv22010286m.g","KQ417665",151951,275295,123344
"13086","Ocbimv22030695m.g","KQ421067",358330,358497,167
"13087","Ocbimv22015569m.g","KQ418267",576302,585130,8828
"13088","Ocbimv22004257m.g","KQ425245",89573,92225,2652
"13089","Ocbimv22037540m.g","KQ423058",597608,646845,49237
"13090","Ocbimv22012105m.g","KQ417874",147906,148579,673
"13091","Ocbimv22034833m.g","KQ422189",107016,131394,24378
"13092","Ocbimv22003054m.g","KQ424867",114475,115419,944
"13093","Ocbimv22025956m.g","KQ416177",133095,133346,251
"13094","Ocbimv22018336m.g","KQ430665",103288,104004,716
"13095","Ocbimv22001021m.g","KQ424157",281467,288435,6968
"13096","Ocbimv22006453m.g","KQ417321",29933,30142,209
"13097","Ocbimv22028365m.g","KQ420477",443169,447704,4535
"13098","Ocbimv22006551m.g","KQ426010",20541,20957,416
"13099","Ocbimv22036670m.g","KQ422824",87629,91643,4014
"13100","Ocbimv22018798m.g","KQ418682",272018,272942,924
"13101","Ocbimv22018883m.g","KQ430914",156222,256905,100683
"13102","Ocbimv22020102m.g","KQ418855",86086,96779,10693
"13103","Ocbimv22033086m.g","KQ421724",726740,735855,9115
"13104","Ocbimv22030166m.g","KQ420915",204448,204771,323
"13105","Ocbimv22002922m.g","KQ424838",64101,67277,3176
"13106","Ocbimv22021202m.g","KQ432038",131168,131697,529
"13107","Ocbimv22032959m.g","KQ421695",25977,127819,101842
"13108","Ocbimv22021212m.g","KQ432038",341922,347022,5100
"13109","Ocbimv22033854m.g","KQ421896",117840,128160,10320
"13110","Ocbimv22022581m.g","KQ416072",39364,44490,5126
"13111","Ocbimv22038482m.g","KQ423361",15326,15556,230
"13112","Ocbimv22027462m.g","KQ416225",39256,40359,1103
"13113","Ocbimv22026236m.g","KQ420017",1051518,1051949,431
"13114","Ocbimv22026531m.g","KQ420065",129402,146533,17131
"13115","Ocbimv22027035m.g","KQ420166",680838,717253,36415
"13116","Ocbimv22034470m.g","KQ416534",436490,436744,254
"13117","Ocbimv22022707m.g","KQ432975",43300,68420,25120
"13118","Ocbimv22018426m.g","KQ418618",11369,22574,11205
"13119","Ocbimv22017208m.g","KQ430209",126795,161750,34955
"13120","Ocbimv22011641m.g","KQ427828",49609,57661,8052
"13121","Ocbimv22010366m.g","KQ427371",72679,73023,344
"13122","Ocbimv22038161m.g","KQ423221",209672,209971,299
"13123","Ocbimv22006699m.g","KQ426075",367347,368622,1275
"13124","Ocbimv22019006m.g","KQ418710",968273,968719,446
"13125","Ocbimv22020563m.g","KQ418926",118887,119609,722
"13126","Ocbimv22020743m.g","KQ418958",159848,160054,206
"13127","Ocbimv22005303m.g","KQ417239",134169,189422,55253
"13128","Ocbimv22011940m.g","KQ417847",815822,816040,218
"13129","Ocbimv22028945m.g","KQ420605",503754,507605,3851
"13130","Ocbimv22024813m.g","KQ419631",639670,640008,338
"13131","Ocbimv22035915m.g","KQ422600",49273,50553,1280
"13132","Ocbimv22037856m.g","KQ423139",760857,761027,170
"13133","Ocbimv22032382m.g","KQ416430",293500,294743,1243
"13134","Ocbimv22021939m.g","KQ419136",2824,41644,38820
"13135","Ocbimv22006403m.g","KQ417318",509270,524547,15277
"13136","Ocbimv22030321m.g","KQ420950",44689,45048,359
"13137","Ocbimv22026397m.g","KQ420036",144681,149268,4587
"13138","Ocbimv22014948m.g","KQ429139",471915,472394,479
"13139","Ocbimv22016981m.g","KQ418431",534207,546989,12782
"13140","Ocbimv22003912m.g","KQ417122",78205,78636,431
"13141","Ocbimv22004152m.g","KQ425219",82230,83210,980
"13142","Ocbimv22003333m.g","LGKD01520863",61,336,275
"13143","Ocbimv22034397m.g","KQ422028",214507,215414,907
"13144","Ocbimv22004725m.g","KQ425427",262202,263371,1169
"13145","Ocbimv22010728m.g","KQ417706",173768,176879,3111
"13146","Ocbimv22037114m.g","KQ416673",42071,44063,1992
"13147","Ocbimv22028991m.g","KQ416279",5413,24499,19086
"13148","Ocbimv22039696m.g","KQ423732",20449,120759,100310
"13149","Ocbimv22033958m.g","KQ421920",91394,99899,8505
"13150","Ocbimv22036823m.g","KQ422863",11108,29300,18192
"13151","Ocbimv22019326m.g","KQ431096",9654,10379,725
"13152","Ocbimv22018087m.g","KQ418571",324451,325596,1145
"13153","Ocbimv22022454m.g","LGKD01678149",244,528,284
"13154","Ocbimv22009622m.g","KQ427054",121219,124603,3384
"13155","Ocbimv22017480m.g","KQ430313",126361,134724,8363
"13156","Ocbimv22022382m.g","KQ419212",397065,397646,581
"13157","Ocbimv22038238m.g","KQ423244",161297,179638,18341
"13158","Ocbimv22028479m.g","KQ420501",73402,73908,506
"13159","Ocbimv22010633m.g","KQ415879",154623,155033,410
"13160","Ocbimv22011591m.g","KQ417807",155688,160109,4421
"13161","Ocbimv22001790m.g","KQ424420",180740,194594,13854
"13162","Ocbimv22006435m.g","KQ417319",19505,19855,350
"13163","Ocbimv22029313m.g","KQ420707",135022,135180,158
"13164","Ocbimv22025817m.g","KQ419909",93554,103947,10393
"13165","Ocbimv22028825m.g","KQ420589",49988,50155,167
"13166","Ocbimv22028321m.g","KQ420475",144664,144930,266
"13167","Ocbimv22000951m.g","KQ415782",6049,118991,112942
"13168","Ocbimv22022524m.g","KQ419241",100406,100738,332
"13169","Ocbimv22005883m.g","KQ415824",138549,139379,830
"13170","Ocbimv22029337m.g","KQ420711",740680,832455,91775
"13171","Ocbimv22014414m.g","KQ418131",5923,12185,6262
"13172","Ocbimv22001176m.g","KQ424213",80653,80964,311
"13173","Ocbimv22000181m.g","KQ423886",105225,105374,149
"13174","Ocbimv22033755m.g","KQ421864",243533,243834,301
"13175","Ocbimv22035749m.g","KQ422521",614070,617146,3076
"13176","Ocbimv22024123m.g","KQ419535",902958,913446,10488
"13177","Ocbimv22014614m.g","KQ415934",66483,67283,800
"13178","Ocbimv22003954m.g","KQ425160",86239,126938,40699
"13179","Ocbimv22008108m.g","KQ426567",191116,207290,16174
"13180","Ocbimv22030332m.g","KQ420950",590150,590320,170
"13181","Ocbimv22016740m.g","LGKD01629971",212,595,383
"13182","Ocbimv22007255m.g","KQ426270",1983,20756,18773
"13183","Ocbimv22023315m.g","KQ416087",1806463,1806648,185
"13184","Ocbimv22033727m.g","KQ416495",158245,158854,609
"13185","Ocbimv22036742m.g","KQ422849",30845,31165,320
"13186","Ocbimv22001787m.g","KQ424419",35818,36444,626
"13187","Ocbimv22019815m.g","KQ431332",14434,31514,17080
"13188","Ocbimv22025780m.g","KQ415695",37510,37948,438
"13189","Ocbimv22015786m.g","KQ418293",81845,82355,510
"13190","Ocbimv22027204m.g","KQ420217",480696,484054,3358
"13191","Ocbimv22008239m.g","KQ426602",15367,17666,2299
"13192","Ocbimv22016110m.g","KQ429708",348921,349115,194
"13193","Ocbimv22007981m.g","KQ426515",9602,10900,1298
"13194","Ocbimv22003877m.g","KQ417118",553785,553980,195
"13195","Ocbimv22009083m.g","KQ426865",99220,100030,810
"13196","Ocbimv22009588m.g","KQ427031",7271,7942,671
"13197","Ocbimv22010345m.g","KQ427361",28620,29892,1272
"13198","Ocbimv22007699m.g","KQ415846",2062165,2062419,254
"13199","Ocbimv22004904m.g","KQ417213",450019,493241,43222
"13200","Ocbimv22026459m.g","KQ420053",318845,319893,1048
"13201","Ocbimv22038802m.g","KQ423465",232622,241891,9269
"13202","Ocbimv22027336m.g","KQ420261",482479,482649,170
"13203","Ocbimv22013516m.g","KQ418031",1116638,1118542,1904
"13204","Ocbimv22007983m.g","KQ426517",43049,89949,46900
"13205","Ocbimv22033867m.g","KQ421896",331208,342368,11160
"13206","Ocbimv22020498m.g","KQ418919",650506,650697,191
"13207","Ocbimv22027675m.g","KQ416230",996611,997433,822
"13208","Ocbimv22002448m.g","KQ424659",134216,156372,22156
"13209","Ocbimv22012615m.g","KQ417921",353651,353944,293
"13210","Ocbimv22010386m.g","KQ415876",1085849,1092071,6222
"13211","Ocbimv22013719m.g","KQ428621",96558,128820,32262
"13212","Ocbimv22038688m.g","KQ423444",51446,51652,206
"13213","Ocbimv22031790m.g","KQ421347",1972,2124,152
"13214","Ocbimv22016962m.g","KQ418430",239401,247429,8028
"13215","Ocbimv22023434m.g","KQ419409",436534,549398,112864
"13216","Ocbimv22006878m.g","KQ426130",226221,280541,54320
"13217","Ocbimv22000459m.g","KQ416860",43260,45350,2090
"13218","Ocbimv22017599m.g","KQ415979",100421,112295,11874
"13219","Ocbimv22000888m.g","KQ424103",242835,243165,330
"13220","Ocbimv22024296m.g","KQ419563",14131,77790,63659
"13221","Ocbimv22018372m.g","KQ418610",215020,239588,24568
"13222","Ocbimv22007963m.g","KQ417464",25352,25905,553
"13223","Ocbimv22030424m.g","KQ420978",181610,183619,2009
"13224","Ocbimv22029679m.g","KQ420800",3508,4740,1232
"13225","Ocbimv22037597m.g","KQ423077",520273,533042,12769
"13226","Ocbimv22025403m.g","KQ419790",39046,97450,58404
"13227","Ocbimv22019449m.g","KQ431136",28122,30954,2832
"13228","Ocbimv22024102m.g","KQ419533",1285831,1286094,263
"13229","Ocbimv22007922m.g","KQ417459",627143,640524,13381
"13230","Ocbimv22032026m.g","KQ421411",229629,241650,12021
"13231","Ocbimv22022754m.g","KQ432985",67908,80069,12161
"13232","Ocbimv22003280m.g","KQ417075",172436,172786,350
"13233","Ocbimv22011458m.g","KQ427753",86751,86942,191
"13234","Ocbimv22012298m.g","KQ428115",88438,103801,15363
"13235","Ocbimv22014200m.g","KQ428798",860,1030,170
"13236","Ocbimv22002472m.g","KQ424666",24728,38574,13846
"13237","Ocbimv22000732m.g","KQ416877",1052742,1073143,20401
"13238","Ocbimv22009593m.g","KQ417598",222939,223577,638
"13239","Ocbimv22024433m.g","KQ419577",581990,582469,479
"13240","Ocbimv22010620m.g","KQ415669",1099978,1101231,1253
"13241","Ocbimv22003043m.g","KQ417055",1758866,1768422,9556
"13242","Ocbimv22012810m.g","KQ417942",489432,536189,46757
"13243","Ocbimv22018993m.g","KQ418708",579650,582118,2468
"13244","Ocbimv22001161m.g","KQ416913",163560,171450,7890
"13245","Ocbimv22026339m.g","KQ420029",270547,273804,3257
"13246","Ocbimv22020276m.g","KQ416024",90950,94844,3894
"13247","Ocbimv22021091m.g","KQ431983",28027,28443,416
"13248","Ocbimv22012556m.g","KQ417917",1163773,1199845,36072
"13249","Ocbimv22012765m.g","KQ417938",290707,290919,212
"13250","Ocbimv22002907m.g","KQ424815",394590,394751,161
"13251","Ocbimv22036607m.g","KQ422804",223782,279665,55883
"13252","Ocbimv22033993m.g","KQ416504",28372,56694,28322
"13253","Ocbimv22007156m.g","KQ415838",77837,78040,203
"13254","Ocbimv22004943m.g","KQ417216",4431,7347,2916
"13255","Ocbimv22037007m.g","KQ422903",526556,531595,5039
"13256","Ocbimv22015125m.g","KQ418196",271231,287057,15826
"13257","Ocbimv22015797m.g","KQ429581",24157,33697,9540
"13258","Ocbimv22029611m.g","KQ420782",48616,127905,79289
"13259","Ocbimv22031760m.g","KQ421338",788448,802404,13956
"13260","Ocbimv22033271m.g","KQ421758",1827423,1843825,16402
"13261","Ocbimv22011571m.g","KQ427785",134570,135184,614
"13262","Ocbimv22005082m.g","KQ425517",27554,37236,9682
"13263","Ocbimv22004213m.g","KQ425227",187001,188290,1289
"13264","Ocbimv22003992m.g","KQ425171",31355,44819,13464
"13265","Ocbimv22006093m.g","KQ417294",635807,664512,28705
"13266","Ocbimv22009708m.g","KQ427096",13632,28035,14403
"13267","Ocbimv22025530m.g","KQ419831",339250,370697,31447
"13268","Ocbimv22021166m.g","KQ415686",244956,245556,600
"13269","Ocbimv22015455m.g","KQ429355",52810,63558,10748
"13270","Ocbimv22037407m.g","KQ416694",2108556,2108720,164
"13271","Ocbimv22034476m.g","KQ422053",34466,35281,815
"13272","Ocbimv22022475m.g","KQ419225",41070,43998,2928
"13273","Ocbimv22008647m.g","KQ417518",14969,15208,239
"13274","Ocbimv22013603m.g","KQ418039",132305,153549,21244
"13275","Ocbimv22027656m.g","KQ420331",10574,10933,359
"13276","Ocbimv22004441m.g","KQ425306",123209,129193,5984
"13277","Ocbimv22039581m.g","KQ423712",122409,122872,463
"13278","Ocbimv22037125m.g","KQ422927",30950,61641,30691
"13279","Ocbimv22025485m.g","KQ419818",166214,263981,97767
"13280","Ocbimv22015908m.g","KQ418303",115019,122019,7000
"13281","Ocbimv22013456m.g","KQ428518",153054,191415,38361
"13282","Ocbimv22039385m.g","KQ423638",92459,93337,878
"13283","Ocbimv22001564m.g","KQ415665",10838,11273,435
"13284","Ocbimv22004532m.g","KQ415805",1602203,1602746,543
"13285","Ocbimv22032495m.g","KQ421563",98456,99051,595
"13286","Ocbimv22007985m.g","KQ426517",113493,113651,158
"13287","Ocbimv22011617m.g","KQ417811",6269,17011,10742
"13288","Ocbimv22037345m.g","KQ423009",90326,90658,332
"13289","Ocbimv22001282m.g","KQ424251",4617,22959,18342
"13290","Ocbimv22029213m.g","KQ416291",1458723,1460979,2256
"13291","Ocbimv22012916m.g","KQ417953",234684,289199,54515
"13292","Ocbimv22000478m.g","KQ423980",47185,49691,2506
"13293","Ocbimv22021415m.g","KQ419042",133639,193383,59744
"13294","Ocbimv22001840m.g","KQ416969",619157,619339,182
"13295","Ocbimv22003627m.g","KQ425047",4624,4932,308
"13296","Ocbimv22001068m.g","KQ424172",92875,97399,4524
"13297","Ocbimv22034132m.g","KQ421984",160398,173586,13188
"13298","Ocbimv22000922m.g","LGKD01496172",801,1097,296
"13299","Ocbimv22037758m.g","KQ416710",163590,164754,1164
"13300","Ocbimv22037238m.g","KQ422973",27206,28318,1112
"13301","Ocbimv22037737m.g","KQ416708",204595,204986,391
"13302","Ocbimv22023966m.g","KQ433731",2352,23322,20970
"13303","Ocbimv22022318m.g","KQ432680",119471,154377,34906
"13304","Ocbimv22002290m.g","KQ417001",412898,416090,3192
"13305","Ocbimv22020667m.g","KQ431801",10533,34202,23669
"13306","Ocbimv22026352m.g","KQ420032",178942,179163,221
"13307","Ocbimv22007659m.g","KQ426411",12872,15109,2237
"13308","Ocbimv22020845m.g","KQ418970",2329406,2333185,3779
"13309","Ocbimv22003800m.g","KQ425111",7315,7638,323
"13310","Ocbimv22035347m.g","KQ422362",281651,299295,17644
"13311","Ocbimv22023230m.g","KQ419378",15271,15937,666
"13312","Ocbimv22000244m.g","KQ423905",71950,122610,50660
"13313","Ocbimv22037116m.g","KQ416673",72465,72770,305
"13314","Ocbimv22011998m.g","KQ417851",881845,894015,12170
"13315","Ocbimv22026903m.g","KQ420138",1132368,1132687,319
"13316","Ocbimv22015134m.g","KQ418196",684208,684777,569
"13317","Ocbimv22011823m.g","KQ415893",717493,789082,71589
"13318","Ocbimv22022095m.g","KQ419162",42334,42540,206
"13319","Ocbimv22036994m.g","KQ422903",24458,57371,32913
"13320","Ocbimv22038897m.g","KQ416771",660491,662202,1711
"13321","Ocbimv22035342m.g","KQ422362",173805,199298,25493
"13322","Ocbimv22019190m.g","KQ431043",163,531,368
"13323","Ocbimv22024573m.g","KQ419600",78930,79817,887
"13324","Ocbimv22001800m.g","KQ424423",2642,46038,43396
"13325","Ocbimv22008221m.g","KQ417488",1900,6565,4665
"13326","Ocbimv22009395m.g","KQ426989",392,10664,10272
"13327","Ocbimv22025012m.g","KQ419688",74232,75053,821
"13328","Ocbimv22026441m.g","KQ420052",82004,82171,167
"13329","Ocbimv22019362m.g","KQ416009",99096,99323,227
"13330","Ocbimv22023207m.g","KQ419369",104465,105188,723
"13331","Ocbimv22005298m.g","KQ425571",270223,303743,33520
"13332","Ocbimv22038395m.g","KQ423313",51027,54025,2998
"13333","Ocbimv22003345m.g","KQ424989",1442,27885,26443
"13334","Ocbimv22037539m.g","KQ423058",513598,514128,530
"13335","Ocbimv22012129m.g","KQ415902",142705,142983,278
"13336","Ocbimv22021300m.g","KQ419026",400690,400914,224
"13337","Ocbimv22023222m.g","KQ419376",538902,539150,248
"13338","Ocbimv22026532m.g","KQ420065",146101,148405,2304
"13339","Ocbimv22029973m.g","KQ420865",252357,252716,359
"13340","Ocbimv22025286m.g","KQ419759",1351102,1355448,4346
"13341","Ocbimv22030177m.g","KQ416337",14546,15560,1014
"13342","Ocbimv22030249m.g","KQ420928",51489,55841,4352
"13343","Ocbimv22012390m.g","KQ417910",38800,59320,20520
"13344","Ocbimv22030464m.g","KQ420992",119908,150154,30246
"13345","Ocbimv22014754m.g","KQ418175",533604,535727,2123
"13346","Ocbimv22024930m.g","KQ419659",98,1033,935
"13347","Ocbimv22031977m.g","KQ416415",90963,96474,5511
"13348","Ocbimv22017830m.g","KQ430486",116599,119113,2514
"13349","Ocbimv22004435m.g","KQ425305",981,2283,1302
"13350","Ocbimv22027106m.g","KQ420184",17588,70450,52862
"13351","Ocbimv22001717m.g","KQ424391",140818,141036,218
"13352","Ocbimv22018082m.g","KQ418571",278032,278508,476
"13353","Ocbimv22012767m.g","KQ417938",786337,786722,385
"13354","Ocbimv22027273m.g","KQ420241",11049,22469,11420
"13355","Ocbimv22017825m.g","KQ430486",7825,26500,18675
"13356","Ocbimv22032071m.g","KQ421422",19755,24430,4675
"13357","Ocbimv22031974m.g","KQ416415",35152,43506,8354
"13358","Ocbimv22033672m.g","KQ421858",284929,287199,2270
"13359","Ocbimv22007091m.g","KQ417377",852364,867069,14705
"13360","Ocbimv22002327m.g","KQ424629",135307,189988,54681
"13361","Ocbimv22017643m.g","KQ418522",122268,152307,30039
"13362","Ocbimv22002095m.g","KQ424538",415945,416166,221
"13363","Ocbimv22006557m.g","KQ417336",4530,17727,13197
"13364","Ocbimv22031321m.g","KQ421218",24809,25306,497
"13365","Ocbimv22002008m.g","KQ424513",21204,54593,33389
"13366","Ocbimv22033506m.g","KQ421821",502475,524816,22341
"13367","Ocbimv22001698m.g","KQ424387",125720,126052,332
"13368","Ocbimv22032982m.g","KQ416463",4709,58565,53856
"13369","Ocbimv22017953m.g","KQ418560",371425,620224,248799
"13370","Ocbimv22009634m.g","KQ427059",90324,114013,23689
"13371","Ocbimv22037342m.g","KQ423006",126139,126507,368
"13372","Ocbimv22010030m.g","KQ415869",515357,515581,224
"13373","Ocbimv22030413m.g","KQ416347",29998,30359,361
"13374","Ocbimv22017284m.g","KQ418476",36138,38048,1910
"13375","Ocbimv22029606m.g","KQ420780",104908,106473,1565
"13376","Ocbimv22006781m.g","KQ426104",6952,27058,20106
"13377","Ocbimv22023067m.g","KQ433194",86271,86790,519
"13378","Ocbimv22020022m.g","KQ418843",55571,75990,20419
"13379","Ocbimv22025513m.g","KQ419829",58598,64284,5686
"13380","Ocbimv22028271m.g","KQ415659",1929416,1929928,512
"13381","Ocbimv22014396m.g","KQ415929",77892,93674,15782
"13382","Ocbimv22002966m.g","KQ417051",1851942,1866244,14302
"13383","Ocbimv22037510m.g","KQ416699",50762,50983,221
"13384","Ocbimv22026927m.g","KQ416205",586080,593701,7621
"13385","Ocbimv22016540m.g","LGKD01628399",22,252,230
"13386","Ocbimv22023656m.g","KQ419456",9935,59354,49419
"13387","Ocbimv22016757m.g","KQ418393",75528,118392,42864
"13388","Ocbimv22028067m.g","KQ420424",216220,302236,86016
"13389","Ocbimv22031002m.g","KQ421143",203986,250791,46805
"13390","Ocbimv22021942m.g","KQ419136",384250,438954,54704
"13391","Ocbimv22007277m.g","KQ417397",113160,158149,44989
"13392","Ocbimv22038792m.g","KQ415767",96119,97876,1757
"13393","Ocbimv22034904m.g","KQ422211",118792,124956,6164
"13394","Ocbimv22001342m.g","KQ416922",2,653,651
"13395","Ocbimv22025791m.g","KQ416167",18072,19786,1714
"13396","Ocbimv22034994m.g","KQ416567",47103,63422,16319
"13397","Ocbimv22019236m.g","KQ418737",79589,87874,8285
"13398","Ocbimv22000717m.g","KQ416877",514706,521324,6618
"13399","Ocbimv22008167m.g","KQ417481",1538067,1570599,32532
"13400","Ocbimv22005516m.g","KQ417259",58263,59655,1392
"13401","Ocbimv22007104m.g","KQ426196",49579,79341,29762
"13402","Ocbimv22004267m.g","KQ415802",143102,144028,926
"13403","Ocbimv22007466m.g","KQ426354",62621,68254,5633
"13404","Ocbimv22017801m.g","KQ418548",172722,173207,485
"13405","Ocbimv22030792m.g","KQ416370",92079,93271,1192
"13406","Ocbimv22002781m.g","KQ424779",527338,527517,179
"13407","Ocbimv22018521m.g","KQ418633",125165,125515,350
"13408","Ocbimv22021646m.g","KQ432262",2,751,749
"13409","Ocbimv22012222m.g","KQ415905",707979,727338,19359
"13410","Ocbimv22016294m.g","KQ429791",52789,57386,4597
"13411","Ocbimv22006968m.g","KQ417368",297575,297787,212
"13412","Ocbimv22035338m.g","KQ416581",491705,492352,647
"13413","Ocbimv22029002m.g","KQ416279",377110,391576,14466
"13414","Ocbimv22017464m.g","KQ418498",577573,633844,56271
"13415","Ocbimv22011543m.g","KQ427775",183971,192400,8429
"13416","Ocbimv22034436m.g","KQ422036",958798,961395,2597
"13417","Ocbimv22034524m.g","KQ422068",92200,101016,8816
"13418","Ocbimv22024767m.g","KQ419625",79352,86312,6960
"13419","Ocbimv22019847m.g","KQ418821",668585,698486,29901
"13420","Ocbimv22006659m.g","KQ417341",19464,47728,28264
"13421","Ocbimv22002100m.g","KQ416986",102399,102557,158
"13422","Ocbimv22036420m.g","KQ416641",515853,516047,194
"13423","Ocbimv22022143m.g","KQ419175",681781,689890,8109
"13424","Ocbimv22009510m.g","KQ415865",662695,679388,16693
"13425","Ocbimv22011633m.g","KQ427825",15197,34012,18815
"13426","Ocbimv22013315m.g","KQ418010",27826,28149,323
"13427","Ocbimv22037416m.g","KQ416694",2691737,2693129,1392
"13428","Ocbimv22001905m.g","KQ424463",310896,311138,242
"13429","Ocbimv22020128m.g","KQ418859",69857,86960,17103
"13430","Ocbimv22039529m.g","KQ423692",187339,188139,800
"13431","Ocbimv22036933m.g","KQ416666",787793,794105,6312
"13432","Ocbimv22033846m.g","KQ421894",151385,151999,614
"13433","Ocbimv22009629m.g","KQ427059",25990,34915,8925
"13434","Ocbimv22024846m.g","KQ419640",103082,105381,2299
"13435","Ocbimv22015734m.g","KQ429530",105407,126657,21250
"13436","Ocbimv22032845m.g","KQ421665",169410,169607,197
"13437","Ocbimv22029495m.g","KQ420764",7515,9946,2431
"13438","Ocbimv22035252m.g","KQ422342",43533,49323,5790
"13439","Ocbimv22037095m.g","KQ422920",311646,319545,7899
"13440","Ocbimv22034852m.g","KQ422195",37834,38256,422
"13441","Ocbimv22025967m.g","KQ419937",85556,86995,1439
"13442","Ocbimv22013386m.g","KQ418018",850790,877244,26454
"13443","Ocbimv22027485m.g","KQ416225",499751,506758,7007
"13444","Ocbimv22032602m.g","KQ416441",475584,476386,802
"13445","Ocbimv22032389m.g","KQ421529",44796,45623,827
"13446","Ocbimv22031738m.g","KQ421336",41077,41451,374
"13447","Ocbimv22026214m.g","KQ420017",429144,471525,42381
"13448","Ocbimv22010128m.g","KQ427268",25273,62280,37007
"13449","Ocbimv22024004m.g","KQ419520",65436,90208,24772
"13450","Ocbimv22037529m.g","KQ423058",60030,62030,2000
"13451","Ocbimv22007284m.g","KQ417398",362883,364347,1464
"13452","Ocbimv22029710m.g","KQ420813",231814,232610,796
"13453","Ocbimv22004492m.g","KQ417173",222735,223118,383
"13454","Ocbimv22016648m.g","KQ429944",1415,17876,16461
"13455","Ocbimv22033906m.g","KQ421906",222143,236190,14047
"13456","Ocbimv22033416m.g","KQ421808",320533,320958,425
"13457","Ocbimv22019348m.g","KQ418754",20092,32373,12281
"13458","Ocbimv22009458m.g","KQ427011",9333,15995,6662
"13459","Ocbimv22019538m.g","KQ418783",106026,141695,35669
"13460","Ocbimv22015612m.g","KQ418269",17309,23711,6402
"13461","Ocbimv22034316m.g","KQ422015",1460718,1493618,32900
"13462","Ocbimv22005423m.g","KQ425601",295016,298832,3816
"13463","Ocbimv22009527m.g","KQ415865",903623,910552,6929
"13464","Ocbimv22007334m.g","KQ426298",1,4373,4372
"13465","Ocbimv22035226m.g","KQ415747",106560,106868,308
"13466","Ocbimv22034939m.g","KQ416562",694926,695860,934
"13467","Ocbimv22008404m.g","KQ426631",19552,27530,7978
"13468","Ocbimv22000048m.g","KQ423834",136529,161849,25320
"13469","Ocbimv22033462m.g","KQ421819",82932,109133,26201
"13470","Ocbimv22037666m.g","KQ416705",2161676,2161939,263
"13471","Ocbimv22003996m.g","KQ417129",533335,533532,197
"13472","Ocbimv22005510m.g","KQ425636",190433,192108,1675
"13473","Ocbimv22016980m.g","KQ418431",519422,523289,3867
"13474","Ocbimv22021293m.g","KQ419026",119818,130790,10972
"13475","Ocbimv22000617m.g","KQ416869",46139,46839,700
"13476","Ocbimv22014269m.g","KQ418111",30793,45283,14490
"13477","Ocbimv22001837m.g","KQ424442",60164,60433,269
"13478","Ocbimv22009999m.g","KQ427202",161596,172448,10852
"13479","Ocbimv22006620m.g","KQ417337",147088,158148,11060
"13480","Ocbimv22010015m.g","KQ427206",15878,16081,203
"13481","Ocbimv22023602m.g","KQ416092",193042,195068,2026
"13482","Ocbimv22003185m.g","KQ417063",231006,233250,2244
"13483","Ocbimv22022463m.g","KQ419223",266291,308453,42162
"13484","Ocbimv22026345m.g","KQ420031",116109,132689,16580
"13485","Ocbimv22039663m.g","KQ423723",101318,102351,1033
"13486","Ocbimv22025687m.g","KQ419886",559185,560120,935
"13487","Ocbimv22014394m.g","KQ415929",48337,49713,1376
"13488","Ocbimv22028546m.g","KQ416260",519360,520186,826
"13489","Ocbimv22008980m.g","KQ426825",22143,22600,457
"13490","Ocbimv22037683m.g","KQ423101",41,379,338
"13491","Ocbimv22026131m.g","KQ419991",245136,254685,9549
"13492","Ocbimv22002899m.g","KQ424814",574176,593496,19320
"13493","Ocbimv22035222m.g","KQ416578",482380,483584,1204
"13494","Ocbimv22004429m.g","KQ425304",35267,35802,535
"13495","Ocbimv22008282m.g","KQ426608",152,1512,1360
"13496","Ocbimv22010347m.g","KQ427361",57652,73430,15778
"13497","Ocbimv22004969m.g","KQ425490",115611,131984,16373
"13498","Ocbimv22001868m.g","KQ424455",6793,22425,15632
"13499","Ocbimv22023688m.g","KQ433567",2066,2725,659
"13500","Ocbimv22004391m.g","KQ425290",22533,23217,684
"13501","Ocbimv22008214m.g","KQ417487",647846,649544,1698
"13502","Ocbimv22036056m.g","KQ416615",122177,166595,44418
"13503","Ocbimv22029042m.g","KQ420632",360684,364297,3613
"13504","Ocbimv22021294m.g","KQ419026",162408,163373,965
"13505","Ocbimv22015943m.g","KQ418303",1475366,1476255,889
"13506","Ocbimv22026178m.g","KQ420011",85359,86892,1533
"13507","Ocbimv22019375m.g","KQ418758",87489,125857,38368
"13508","Ocbimv22034287m.g","KQ422015",857819,865597,7778
"13509","Ocbimv22030427m.g","KQ420978",213982,242921,28939
"13510","Ocbimv22029884m.g","KQ420830",47285,68293,21008
"13511","Ocbimv22036042m.g","KQ422636",6375,90605,84230
"13512","Ocbimv22021597m.g","KQ432245",57557,58367,810
"13513","Ocbimv22010985m.g","KQ417731",199854,205058,5204
"13514","Ocbimv22024024m.g","KQ419523",26,2216,2190
"13515","Ocbimv22010674m.g","KQ417701",298042,309306,11264
"13516","Ocbimv22039329m.g","KQ416788",277387,291333,13946
"13517","Ocbimv22017485m.g","KQ430314",99455,100369,914
"13518","Ocbimv22031662m.g","KQ421307",189615,191921,2306
"13519","Ocbimv22012416m.g","KQ417911",118001,121390,3389
"13520","Ocbimv22020065m.g","KQ418849",89911,90333,422
"13521","Ocbimv22011054m.g","KQ427612",1154,34493,33339
"13522","Ocbimv22038287m.g","KQ423260",319339,323586,4247
"13523","Ocbimv22023881m.g","KQ419491",135263,143558,8295
"13524","Ocbimv22006017m.g","KQ425779",413654,414471,817
"13525","Ocbimv22026741m.g","KQ416198",380657,405541,24884
"13526","Ocbimv22012987m.g","KQ417968",1089,2641,1552
"13527","Ocbimv22016388m.g","KQ415962",1806923,1807892,969
"13528","Ocbimv22026121m.g","KQ419991",8798,35146,26348
"13529","Ocbimv22022719m.g","KQ419287",64410,68954,4544
"13530","Ocbimv22000136m.g","KQ416841",2671817,2674089,2272
"13531","Ocbimv22001321m.g","KQ424265",185736,192733,6997
"13532","Ocbimv22034856m.g","KQ416560",17615,31059,13444
"13533","Ocbimv22031731m.g","KQ421332",77550,78888,1338
"13534","Ocbimv22031326m.g","KQ421218",234465,287081,52616
"13535","Ocbimv22009064m.g","KQ417557",49114,94053,44939
"13536","Ocbimv22027620m.g","KQ420314",69217,77050,7833
"13537","Ocbimv22039834m.g","KQ423774",160734,161518,784
"13538","Ocbimv22035833m.g","KQ422573",43417,44028,611
"13539","Ocbimv22037039m.g","KQ422909",584388,607189,22801
"13540","Ocbimv22035111m.g","KQ422282",42810,43028,218
"13541","Ocbimv22013137m.g","KQ417985",694684,695100,416
"13542","Ocbimv22036793m.g","KQ416657",460758,484210,23452
"13543","Ocbimv22009293m.g","KQ417580",11354,13174,1820
"13544","Ocbimv22005154m.g","KQ425531",613695,626946,13251
"13545","Ocbimv22008727m.g","KQ417528",18167,27263,9096
"13546","Ocbimv22011316m.g","KQ417780",340753,346437,5684
"13547","Ocbimv22015228m.g","KQ429226",46,930,884
"13548","Ocbimv22020362m.g","KQ418900",366009,376686,10677
"13549","Ocbimv22029290m.g","KQ420698",33377,34912,1535
"13550","Ocbimv22002240m.g","KQ416999",223770,224950,1180
"13551","Ocbimv22026997m.g","KQ420160",91452,132197,40745
"13552","Ocbimv22000462m.g","KQ416860",156718,157140,422
"13553","Ocbimv22024276m.g","KQ419562",232346,232612,266
"13554","Ocbimv22007053m.g","KQ417371",580153,580395,242
"13555","Ocbimv22028416m.g","KQ420483",163871,165840,1969
"13556","Ocbimv22000189m.g","KQ423889",106640,107540,900
"13557","Ocbimv22013786m.g","KQ428664",86324,116456,30132
"13558","Ocbimv22013650m.g","KQ418042",511625,525301,13676
"13559","Ocbimv22031010m.g","KQ416382",271352,271528,176
"13560","Ocbimv22007136m.g","KQ417381",190937,191476,539
"13561","Ocbimv22008176m.g","KQ417481",1878041,1880720,2679
"13562","Ocbimv22029589m.g","KQ420779",308957,321435,12478
"13563","Ocbimv22011690m.g","KQ427853",5319,5567,248
"13564","Ocbimv22000515m.g","KQ423986",36158,38553,2395
"13565","Ocbimv22023814m.g","KQ419480",120294,138490,18196
"13566","Ocbimv22024200m.g","KQ433870",10144,51251,41107
"13567","Ocbimv22018699m.g","KQ430806",53537,54121,584
"13568","Ocbimv22006681m.g","KQ417343",104887,117915,13028
"13569","Ocbimv22002063m.g","KQ424530",725635,734296,8661
"13570","Ocbimv22032308m.g","KQ421521",547160,548208,1048
"13571","Ocbimv22013013m.g","KQ417972",263797,352074,88277
"13572","Ocbimv22006814m.g","KQ417353",355077,356708,1631
"13573","Ocbimv22029205m.g","KQ420677",59604,77252,17648
"13574","Ocbimv22035515m.g","KQ422416",230554,232036,1482
"13575","Ocbimv22032153m.g","KQ421461",2988,15501,12513
"13576","Ocbimv22002953m.g","KQ424852",132856,135182,2326
"13577","Ocbimv22010619m.g","KQ415669",929498,929830,332
"13578","Ocbimv22009869m.g","KQ417620",1963677,1964486,809
"13579","Ocbimv22025584m.g","KQ419852",1832,2020,188
"13580","Ocbimv22038907m.g","KQ416771",1294684,1313270,18586
"13581","Ocbimv22019716m.g","KQ418804",718043,721546,3503
"13582","Ocbimv22010698m.g","KQ427468",24462,25297,835
"13583","Ocbimv22031592m.g","LGKD01393689",1765,2717,952
"13584","Ocbimv22002122m.g","KQ415788",146180,146769,589
"13585","Ocbimv22034673m.g","KQ416547",1,422,421
"13586","Ocbimv22018191m.g","KQ415990",287553,367166,79613
"13587","Ocbimv22011997m.g","KQ417851",880750,881148,398
"13588","Ocbimv22021452m.g","KQ419052",10223,11578,1355
"13589","Ocbimv22012392m.g","KQ417910",68981,69828,847
"13590","Ocbimv22004953m.g","KQ417216",180621,203269,22648
"13591","Ocbimv22002165m.g","KQ424565",30402,30729,327
"13592","Ocbimv22025582m.g","KQ419850",655389,655748,359
"13593","Ocbimv22005796m.g","KQ415823",908776,909385,609
"13594","Ocbimv22037346m.g","KQ423009",188259,189042,783
"13595","Ocbimv22002253m.g","KQ424585",112232,114295,2063
"13596","Ocbimv22034887m.g","KQ422208",303581,306273,2692
"13597","Ocbimv22003986m.g","KQ425165",268295,268597,302
"13598","Ocbimv22026777m.g","KQ420113",97714,113765,16051
"13599","Ocbimv22027072m.g","KQ420175",107029,113554,6525
"13600","Ocbimv22013588m.g","KQ418038",547064,547554,490
"13601","Ocbimv22030818m.g","KQ416371",32847,34867,2020
"13602","Ocbimv22021380m.g","KQ419039",5958,15524,9566
"13603","Ocbimv22036640m.g","KQ422816",76277,79714,3437
"13604","Ocbimv22014441m.g","KQ428930",1048,7876,6828
"13605","Ocbimv22031268m.g","KQ421210",44341,50247,5906
"13606","Ocbimv22017744m.g","KQ418537",157601,157963,362
"13607","Ocbimv22035592m.g","KQ422451",85478,85723,245
"13608","Ocbimv22033284m.g","KQ421761",7330,72486,65156
"13609","Ocbimv22013753m.g","KQ418059",3996,6620,2624
"13610","Ocbimv22003831m.g","KQ425128",196167,213098,16931
"13611","Ocbimv22020347m.g","KQ418899",75275,79575,4300
"13612","Ocbimv22008344m.g","KQ417497",1819186,1851775,32589
"13613","Ocbimv22024984m.g","KQ419670",526487,531731,5244
"13614","Ocbimv22015750m.g","KQ418289",95962,96623,661
"13615","Ocbimv22000330m.g","KQ423926",45959,46525,566
"13616","Ocbimv22020064m.g","KQ418849",45372,57923,12551
"13617","Ocbimv22000934m.g","KQ416896",366516,367495,979
"13618","Ocbimv22018322m.g","KQ418602",1574,10607,9033
"13619","Ocbimv22002170m.g","KQ416992",158491,158718,227
"13620","Ocbimv22031276m.g","LGKD01390611",2799,3479,680
"13621","Ocbimv22039646m.g","KQ423718",84563,86218,1655
"13622","Ocbimv22023863m.g","KQ416102",566628,574606,7978
"13623","Ocbimv22002745m.g","KQ417032",60488,60836,348
"13624","Ocbimv22024049m.g","KQ433770",903,4679,3776
"13625","Ocbimv22017234m.g","KQ418469",560282,566198,5916
"13626","Ocbimv22025382m.g","KQ419786",520278,540568,20290
"13627","Ocbimv22003723m.g","KQ425076",90007,90669,662
"13628","Ocbimv22011770m.g","KQ415891",305990,324466,18476
"13629","Ocbimv22031832m.g","KQ421356",268177,403000,134823
"13630","Ocbimv22022763m.g","KQ432990",156913,177212,20299
"13631","Ocbimv22031377m.g","KQ416393",529819,530703,884
"13632","Ocbimv22006933m.g","KQ426157",128373,164357,35984
"13633","Ocbimv22025336m.g","KQ419775",267517,308992,41475
"13634","Ocbimv22032718m.g","KQ421646",1,525,524
"13635","Ocbimv22029055m.g","KQ420639",65492,94872,29380
"13636","Ocbimv22032009m.g","KQ421409",974656,1014384,39728
"13637","Ocbimv22016319m.g","KQ418338",387264,390778,3514
"13638","Ocbimv22036592m.g","KQ422794",365902,366609,707
"13639","Ocbimv22000187m.g","KQ423889",80625,107719,27094
"13640","Ocbimv22030159m.g","KQ420912",313891,314908,1017
"13641","Ocbimv22024175m.g","KQ419544",45232,45381,149
"13642","Ocbimv22003402m.g","KQ417086",288922,315476,26554
"13643","Ocbimv22005466m.g","KQ425611",316269,317039,770
"13644","Ocbimv22017476m.g","KQ430313",31081,49502,18421
"13645","Ocbimv22007174m.g","KQ426223",4534,4948,414
"13646","Ocbimv22007390m.g","KQ426316",1,5832,5831
"13647","Ocbimv22007132m.g","KQ417381",130346,172910,42564
"13648","Ocbimv22033758m.g","KQ421866",28568,30159,1591
"13649","Ocbimv22020755m.g","LGKD01663192",76,519,443
"13650","Ocbimv22004141m.g","KQ417140",45641,50698,5057
"13651","Ocbimv22033320m.g","KQ421772",262732,264209,1477
"13652","Ocbimv22034410m.g","KQ422033",1503,5238,3735
"13653","Ocbimv22017577m.g","KQ418508",14480,15268,788
"13654","Ocbimv22033561m.g","KQ421832",51785,55329,3544
"13655","Ocbimv22020317m.g","KQ418891",16440,108905,92465
"13656","Ocbimv22001926m.g","KQ416974",169195,169506,311
"13657","Ocbimv22025197m.g","KQ419727",494391,495187,796
"13658","Ocbimv22031425m.g","KQ421241",378394,378597,203
"13659","Ocbimv22023991m.g","KQ419514",760290,761267,977
"13660","Ocbimv22001498m.g","KQ416938",275605,281131,5526
"13661","Ocbimv22011969m.g","KQ415895",412862,472456,59594
"13662","Ocbimv22033202m.g","KQ421750",31434,35732,4298
"13663","Ocbimv22031075m.g","KQ421153",1827,40663,38836
"13664","Ocbimv22016494m.g","KQ429898",90105,90347,242
"13665","Ocbimv22013271m.g","LGKD01600274",3669,5314,1645
"13666","Ocbimv22018094m.g","KQ418571",544169,564596,20427
"13667","Ocbimv22006653m.g","KQ426056",584,38460,37876
"13668","Ocbimv22021250m.g","KQ419020",88243,88988,745
"13669","Ocbimv22031421m.g","KQ421237",120015,120233,218
"13670","Ocbimv22021013m.g","KQ431943",2891,23151,20260
"13671","Ocbimv22019306m.g","KQ418747",127397,130420,3023
"13672","Ocbimv22020931m.g","KQ431889",14184,15446,1262
"13673","Ocbimv22013263m.g","KQ428426",258982,263077,4095
"13674","Ocbimv22031808m.g","KQ415726",138649,139587,938
"13675","Ocbimv22012982m.g","KQ415913",23764,24534,770
"13676","Ocbimv22021094m.g","KQ419002",5663,6712,1049
"13677","Ocbimv22014068m.g","KQ418085",178914,219877,40963
"13678","Ocbimv22001172m.g","KQ424212",87142,93168,6026
"13679","Ocbimv22035166m.g","KQ415662",95509,95700,191
"13680","Ocbimv22037874m.g","KQ423141",139777,150704,10927
"13681","Ocbimv22035221m.g","KQ416578",33688,34137,449
"13682","Ocbimv22004287m.g","KQ417146",7080,22471,15391
"13683","Ocbimv22028848m.g","KQ420593",122288,124446,2158
"13684","Ocbimv22035856m.g","KQ422578",79187,79540,353
"13685","Ocbimv22007100m.g","KQ426195",36396,51005,14609
"13686","Ocbimv22017861m.g","KQ418552",372069,393893,21824
"13687","Ocbimv22004693m.g","KQ417198",244044,252465,8421
"13688","Ocbimv22034356m.g","KQ422018",48814,101929,53115
"13689","Ocbimv22001586m.g","KQ416946",93262,136978,43716
"13690","Ocbimv22033579m.g","KQ421837",34688,59192,24504
"13691","Ocbimv22025183m.g","KQ419721",878169,888124,9955
"13692","Ocbimv22011004m.g","KQ427587",82058,141554,59496
"13693","Ocbimv22028517m.g","KQ420516",869427,869579,152
"13694","Ocbimv22026704m.g","KQ420096",84088,86927,2839
"13695","Ocbimv22011850m.g","KQ417842",78325,78708,383
"13696","Ocbimv22008776m.g","KQ426774",3431,11155,7724
"13697","Ocbimv22001612m.g","KQ416949",220392,225189,4797
"13698","Ocbimv22014626m.g","KQ418159",32755,33238,483
"13699","Ocbimv22036543m.g","KQ422788",494075,494548,473
"13700","Ocbimv22016051m.g","KQ415951",57148,73178,16030
"13701","Ocbimv22039631m.g","KQ416810",1039188,1041550,2362
"13702","Ocbimv22005345m.g","KQ425586",33313,34172,859
"13703","Ocbimv22020396m.g","KQ418904",631676,633618,1942
"13704","Ocbimv22015413m.g","KQ429326",75855,78542,2687
"13705","Ocbimv22015907m.g","KQ418303",109466,110207,741
"13706","Ocbimv22017150m.g","LGKD01633276",746,958,212
"13707","Ocbimv22005507m.g","KQ425635",288702,293262,4560
"13708","Ocbimv22014320m.g","KQ428863",114130,137335,23205
"13709","Ocbimv22038474m.g","KQ423359",18,2820,2802
"13710","Ocbimv22003430m.g","KQ417087",910058,915565,5507
"13711","Ocbimv22023367m.g","KQ419395",267662,272154,4492
"13712","Ocbimv22028094m.g","KQ420429",12778,13017,239
"13713","Ocbimv22003917m.g","KQ417124",63043,67136,4093
"13714","Ocbimv22027851m.g","KQ420377",118981,130376,11395
"13715","Ocbimv22012738m.g","KQ417934",111429,111909,480
"13716","Ocbimv22012563m.g","KQ417917",1294529,1294723,194
"13717","Ocbimv22022682m.g","KQ419281",274961,377470,102509
"13718","Ocbimv22031812m.g","KQ415726",241437,263725,22288
"13719","Ocbimv22031965m.g","KQ421389",1109520,1110364,844
"13720","Ocbimv22004322m.g","KQ425263",143964,144789,825
"13721","Ocbimv22006530m.g","KQ425988",853,18408,17555
"13722","Ocbimv22034616m.g","KQ416540",287707,287943,236
"13723","Ocbimv22025133m.g","KQ419701",136488,232220,95732
"13724","Ocbimv22002965m.g","KQ417051",1829256,1829411,155
"13725","Ocbimv22024901m.g","KQ416131",376645,445065,68420
"13726","Ocbimv22008758m.g","KQ426760",198764,206171,7407
"13727","Ocbimv22023858m.g","KQ416102",179668,223629,43961
"13728","Ocbimv22010162m.g","KQ427290",200151,230350,30199
"13729","Ocbimv22033370m.g","KQ421801",36386,36547,161
"13730","Ocbimv22003238m.g","KQ424913",167699,168602,903
"13731","Ocbimv22021214m.g","KQ419013",134894,182809,47915
"13732","Ocbimv22038938m.g","KQ416772",650107,652230,2123
"13733","Ocbimv22021687m.g","KQ416051",734984,889443,154459
"13734","Ocbimv22018258m.g","KQ418587",782706,794520,11814
"13735","Ocbimv22003584m.g","KQ425034",158718,158924,206
"13736","Ocbimv22035240m.g","KQ422338",298279,306395,8116
"13737","Ocbimv22019749m.g","KQ431294",162017,238358,76341
"13738","Ocbimv22036199m.g","KQ416625",535218,537264,2046
"13739","Ocbimv22015476m.g","KQ418259",5143,104714,99571
"13740","Ocbimv22022767m.g","KQ419290",53049,72413,19364
"13741","Ocbimv22022455m.g","LGKD01287910",138,287,149
"13742","Ocbimv22026200m.g","KQ420016",245624,261944,16320
"13743","Ocbimv22020398m.g","LGKD01659865",3,697,694
"13744","Ocbimv22018260m.g","KQ418587",897979,909649,11670
"13745","Ocbimv22032496m.g","KQ421563",100847,135713,34866
"13746","Ocbimv22016792m.g","KQ430030",51264,51542,278
"13747","Ocbimv22006133m.g","KQ417300",516843,518671,1828
"13748","Ocbimv22002558m.g","KQ415793",585608,585784,176
"13749","Ocbimv22009129m.g","KQ426892",80803,85010,4207
"13750","Ocbimv22027865m.g","KQ416235",126995,128437,1442
"13751","Ocbimv22007007m.g","KQ417370",274848,279378,4530
"13752","Ocbimv22033606m.g","KQ421846",112943,113230,287
"13753","Ocbimv22011105m.g","KQ417748",501456,501976,520
"13754","Ocbimv22005876m.g","KQ417280",381136,384192,3056
"13755","Ocbimv22025574m.g","KQ419849",47737,107861,60124
"13756","Ocbimv22015498m.g","KQ418263",655876,657417,1541
"13757","Ocbimv22000029m.g","KQ423828",89329,90661,1332
"13758","Ocbimv22033429m.g","KQ421810",102411,112867,10456
"13759","Ocbimv22004545m.g","KQ417180",97339,97755,416
"13760","Ocbimv22007839m.g","KQ417455",22726,28802,6076
"13761","Ocbimv22026692m.g","KQ416197",65898,66092,194
"13762","Ocbimv22034685m.g","KQ416547",61557,66542,4985
"13763","Ocbimv22016020m.g","KQ418311",35541,35846,305
"13764","Ocbimv22026306m.g","KQ420023",466272,485012,18740
"13765","Ocbimv22033452m.g","KQ421816",642285,651511,9226
"13766","Ocbimv22032420m.g","KQ421533",423833,447396,23563
"13767","Ocbimv22037884m.g","KQ423143",10679,38329,27650
"13768","Ocbimv22027559m.g","KQ420304",9510,9865,355
"13769","Ocbimv22036426m.g","KQ422761",101090,121318,20228
"13770","Ocbimv22006347m.g","KQ425887",42558,42803,245
"13771","Ocbimv22014375m.g","KQ428891",9427,11644,2217
"13772","Ocbimv22031635m.g","KQ421305",214294,216424,2130
"13773","Ocbimv22007063m.g","KQ417374",54332,56064,1732
"13774","Ocbimv22034043m.g","KQ416508",449542,453209,3667
"13775","Ocbimv22036499m.g","KQ422777",258543,273783,15240
"13776","Ocbimv22035150m.g","KQ422290",431046,456181,25135
"13777","Ocbimv22014459m.g","LGKD01220237",254,691,437
"13778","Ocbimv22026432m.g","KQ420048",97195,102048,4853
"13779","Ocbimv22028015m.g","KQ420420",7034,7387,353
"13780","Ocbimv22034299m.g","KQ422015",1089447,1112872,23425
"13781","Ocbimv22034677m.g","KQ416547",19939,23561,3622
"13782","Ocbimv22015408m.g","KQ429324",11841,47840,35999
"13783","Ocbimv22023184m.g","KQ419368",243825,244500,675
"13784","Ocbimv22011284m.g","KQ427700",3721,5983,2262
"13785","Ocbimv22018641m.g","KQ418649",219391,260024,40633
"13786","Ocbimv22038167m.g","KQ416728",6060,9292,3232
"13787","Ocbimv22028176m.g","KQ416252",143465,270920,127455
"13788","Ocbimv22019629m.g","KQ418789",341764,462967,121203
"13789","Ocbimv22025711m.g","KQ419887",971110,986883,15773
"13790","Ocbimv22032470m.g","KQ421549",372393,373499,1106
"13791","Ocbimv22017568m.g","KQ418506",463434,464272,838
"13792","Ocbimv22038908m.g","KQ416771",1336106,1336423,317
"13793","Ocbimv22007415m.g","KQ426334",59645,71286,11641
"13794","Ocbimv22028695m.g","KQ420556",197527,197841,314
"13795","Ocbimv22002622m.g","KQ417023",741357,749355,7998
"13796","Ocbimv22036952m.g","KQ416666",1546887,1554743,7856
"13797","Ocbimv22032361m.g","KQ421523",1645378,1668678,23300
"13798","Ocbimv22016508m.g","KQ429904",75484,82603,7119
"13799","Ocbimv22009872m.g","KQ417621",153621,154265,644
"13800","Ocbimv22019230m.g","KQ418737",26515,35922,9407
"13801","Ocbimv22039434m.g","KQ423664",10799,11551,752
"13802","Ocbimv22028818m.g","KQ420585",5054,5314,260
"13803","Ocbimv22023323m.g","KQ419393",117737,119345,1608
"13804","Ocbimv22021469m.g","KQ416046",1973301,1973777,476
"13805","Ocbimv22034369m.g","KQ422020",409822,426508,16686
"13806","Ocbimv22031576m.g","KQ416401",11006,25110,14104
"13807","Ocbimv22029223m.g","KQ416293",7679,8050,371
"13808","Ocbimv22030328m.g","KQ420950",414167,414400,233
"13809","Ocbimv22025135m.g","KQ419702",23838,67519,43681
"13810","Ocbimv22022235m.g","KQ432638",11174,118358,107184
"13811","Ocbimv22013928m.g","KQ428714",127589,165499,37910
"13812","Ocbimv22034037m.g","KQ416508",306578,343092,36514
"13813","Ocbimv22023080m.g","KQ419345",91413,92888,1475
"13814","Ocbimv22000476m.g","KQ416863",86346,89390,3044
"13815","Ocbimv22033680m.g","KQ421858",334509,336431,1922
"13816","Ocbimv22024341m.g","KQ419574",203489,233573,30084
"13817","Ocbimv22032738m.g","KQ421649",124266,124697,431
"13818","Ocbimv22034214m.g","KQ422009",338948,342603,3655
"13819","Ocbimv22034367m.g","KQ422020",215214,256792,41578
"13820","Ocbimv22038387m.g","KQ423304",97781,105283,7502
"13821","Ocbimv22027272m.g","KQ420240",637412,646610,9198
"13822","Ocbimv22015589m.g","KQ415946",168144,182981,14837
"13823","Ocbimv22025088m.g","KQ416137",446839,449158,2319
"13824","Ocbimv22024997m.g","KQ419674",200308,201036,728
"13825","Ocbimv22006834m.g","KQ417358",254978,255247,269
"13826","Ocbimv22032403m.g","KQ421532",63469,63861,392
"13827","Ocbimv22029703m.g","KQ416318",3255,3486,231
"13828","Ocbimv22015288m.g","KQ429244",114059,161894,47835
"13829","Ocbimv22026013m.g","KQ419957",15089,16815,1726
"13830","Ocbimv22017835m.g","KQ415984",16738,17220,482
"13831","Ocbimv22005395m.g","KQ417249",1334282,1335185,903
"13832","Ocbimv22030833m.g","KQ421107",15024,25989,10965
"13833","Ocbimv22029248m.g","KQ420694",36569,43064,6495
"13834","Ocbimv22025161m.g","KQ419716",13709,17217,3508
"13835","Ocbimv22029662m.g","KQ420798",424911,425189,278
"13836","Ocbimv22016301m.g","KQ418337",1366,1560,194
"13837","Ocbimv22017834m.g","KQ430497",5212,6023,811
"13838","Ocbimv22024724m.g","KQ419621",895432,923583,28151
"13839","Ocbimv22020268m.g","KQ418881",146857,149341,2484
"13840","Ocbimv22018129m.g","KQ430573",21959,22372,413
"13841","Ocbimv22038512m.g","KQ423384",29258,33884,4626
"13842","Ocbimv22007208m.g","KQ426242",126764,163876,37112
"13843","Ocbimv22008132m.g","KQ417481",196507,209235,12728
"13844","Ocbimv22002250m.g","KQ424585",24414,25106,692
"13845","Ocbimv22027054m.g","KQ420169",1556394,1557400,1006
"13846","Ocbimv22002908m.g","KQ424820",21403,23442,2039
"13847","Ocbimv22025004m.g","KQ419682",72300,77706,5406
"13848","Ocbimv22030458m.g","KQ416350",486855,487148,293
"13849","Ocbimv22006640m.g","KQ426045",172980,214945,41965
"13850","Ocbimv22000007m.g","KQ423819",156420,212422,56002
"13851","Ocbimv22038642m.g","KQ423430",375670,377337,1667
"13852","Ocbimv22016013m.g","KQ418310",171160,172497,1337
"13853","Ocbimv22035626m.g","KQ422481",112861,113016,155
"13854","Ocbimv22020246m.g","KQ418877",95747,96217,470
"13855","Ocbimv22036449m.g","KQ422765",421127,463786,42659
"13856","Ocbimv22026119m.g","KQ419991",1834,3584,1750
"13857","Ocbimv22008202m.g","KQ417485",53697,54608,911
"13858","Ocbimv22003925m.g","KQ417125",163507,171837,8330
"13859","Ocbimv22031741m.g","KQ421337",4511,5477,966
"13860","Ocbimv22009008m.g","KQ417549",402741,403481,740
"13861","Ocbimv22027849m.g","KQ420377",89449,105309,15860
"13862","Ocbimv22032606m.g","KQ421605",117087,125866,8779
"13863","Ocbimv22038683m.g","KQ423442",86595,87268,673
"13864","Ocbimv22030975m.g","KQ416379",730472,733480,3008
"13865","Ocbimv22021916m.g","KQ419129",239987,240598,611
"13866","Ocbimv22037991m.g","KQ423190",12739,13439,700
"13867","Ocbimv22034274m.g","KQ422015",515678,520688,5010
"13868","Ocbimv22038249m.g","KQ423250",12563,26746,14183
"13869","Ocbimv22012218m.g","KQ415905",46304,47527,1223
"13870","Ocbimv22006144m.g","KQ417300",772157,772744,587
"13871","Ocbimv22034974m.g","KQ422233",222757,222963,206
"13872","Ocbimv22026074m.g","KQ419989",12672,38486,25814
"13873","Ocbimv22027226m.g","KQ420222",344918,345067,149
"13874","Ocbimv22014152m.g","KQ418095",463838,508646,44808
"13875","Ocbimv22008023m.g","KQ426531",3813,4049,236
"13876","Ocbimv22016378m.g","KQ415962",1347399,1347713,314
"13877","Ocbimv22003550m.g","KQ417090",1725324,1730614,5290
"13878","Ocbimv22012432m.g","KQ417911",474019,475056,1037
"13879","Ocbimv22028768m.g","KQ420579",514663,547306,32643
"13880","Ocbimv22003018m.g","KQ417055",373628,388223,14595
"13881","Ocbimv22027992m.g","KQ420415",383091,383547,456
"13882","Ocbimv22008832m.g","KQ417537",57346,58010,664
"13883","Ocbimv22011872m.g","KQ417844",255533,256433,900
"13884","Ocbimv22014524m.g","KQ415932",1143726,1144172,446
"13885","Ocbimv22001329m.g","KQ424268",9746,11157,1411
"13886","Ocbimv22015846m.g","KQ418295",339002,344612,5610
"13887","Ocbimv22010813m.g","LGKD01582648",3,1471,1468
"13888","Ocbimv22010786m.g","KQ427521",195184,291973,96789
"13889","Ocbimv22004066m.g","KQ425191",204533,207947,3414
"13890","Ocbimv22005421m.g","KQ425600",19321,23213,3892
"13891","Ocbimv22004074m.g","KQ417133",480109,593647,113538
"13892","Ocbimv22023803m.g","KQ419478",490481,491272,791
"13893","Ocbimv22029982m.g","LGKD01375114",225,745,520
"13894","Ocbimv22039813m.g","KQ423766",59770,63781,4011
"13895","Ocbimv22037100m.g","KQ422921",63576,74464,10888
"13896","Ocbimv22030915m.g","KQ421117",1802106,1804150,2044
"13897","Ocbimv22028104m.g","KQ416249",323079,323414,335
"13898","Ocbimv22007368m.g","KQ426313",227323,239199,11876
"13899","Ocbimv22016033m.g","KQ418312",20448,26543,6095
"13900","Ocbimv22026038m.g","KQ419962",264561,286248,21687
"13901","Ocbimv22036787m.g","KQ416657",273886,277987,4101
"13902","Ocbimv22026622m.g","KQ420080",498839,503865,5026
"13903","Ocbimv22000856m.g","KQ424096",1683,2638,955
"13904","Ocbimv22004285m.g","KQ425259",70472,70984,512
"13905","Ocbimv22028928m.g","KQ416274",2090212,2090809,597
"13906","Ocbimv22031009m.g","KQ416382",87430,93129,5699
"13907","Ocbimv22015335m.g","KQ418224",550,30732,30182
"13908","Ocbimv22035069m.g","KQ422264",3823,4688,865
"13909","Ocbimv22035879m.g","KQ422595",52652,60062,7410
"13910","Ocbimv22030210m.g","KQ420924",193277,195348,2071
"13911","Ocbimv22023787m.g","KQ419475",30365,30538,173
"13912","Ocbimv22015533m.g","KQ429401",26769,51705,24936
"13913","Ocbimv22018275m.g","KQ418590",155473,155661,188
"13914","Ocbimv22023216m.g","KQ419376",5201,5737,536
"13915","Ocbimv22023442m.g","KQ419409",709229,731660,22431
"13916","Ocbimv22017352m.g","KQ418483",414808,415699,891
"13917","Ocbimv22010791m.g","KQ427521",402461,418404,15943
"13918","Ocbimv22016431m.g","KQ429862",8228,43225,34997
"13919","Ocbimv22013022m.g","LGKD01598758",50,427,377
"13920","Ocbimv22037885m.g","KQ423143",65695,114626,48931
"13921","Ocbimv22029523m.g","KQ420768",1571,2367,796
"13922","Ocbimv22003650m.g","KQ425062",60744,92398,31654
"13923","Ocbimv22029340m.g","KQ420711",840260,841595,1335
"13924","Ocbimv22031264m.g","KQ421208",324494,356087,31593
"13925","Ocbimv22017613m.g","KQ430378",129348,130748,1400
"13926","Ocbimv22006079m.g","KQ417294",81694,100080,18386
"13927","Ocbimv22004216m.g","KQ425236",17666,17893,227
"13928","Ocbimv22028013m.g","KQ416243",1814979,1815146,167
"13929","Ocbimv22014032m.g","KQ418080",25998,26555,557
"13930","Ocbimv22010075m.g","KQ417641",41622,63004,21382
"13931","Ocbimv22028732m.g","KQ416270",1810739,1814610,3871
"13932","Ocbimv22005420m.g","KQ417250",63821,70743,6922
"13933","Ocbimv22029344m.g","KQ420714",108523,108708,185
"13934","Ocbimv22000559m.g","KQ423995",483753,495346,11593
"13935","Ocbimv22009098m.g","KQ417561",151093,151356,263
"13936","Ocbimv22036546m.g","KQ416644",547406,565246,17840
"13937","Ocbimv22021705m.g","KQ419087",169151,169489,338
"13938","Ocbimv22032437m.g","KQ421540",97332,97745,413
"13939","Ocbimv22020224m.g","KQ431541",89253,99035,9782
"13940","Ocbimv22002525m.g","KQ417012",423670,425291,1621
"13941","Ocbimv22022848m.g","KQ433062",4450,12053,7603
"13942","Ocbimv22023669m.g","KQ433566",24096,50128,26032
"13943","Ocbimv22030445m.g","KQ416350",114375,115780,1405
"13944","Ocbimv22011947m.g","KQ417847",1087470,1088963,1493
"13945","Ocbimv22025737m.g","KQ415694",28223,48149,19926
"13946","Ocbimv22034251m.g","KQ422015",83776,104474,20698
"13947","Ocbimv22036018m.g","KQ422632",528464,532695,4231
"13948","Ocbimv22006872m.g","KQ426128",104233,118360,14127
"13949","Ocbimv22008381m.g","KQ417499",50798,51235,437
"13950","Ocbimv22018347m.g","LGKD01642657",3,272,269
"13951","Ocbimv22000632m.g","KQ416870",362174,394547,32373
"13952","Ocbimv22019779m.g","KQ418812",709337,710231,894
"13953","Ocbimv22001891m.g","KQ415786",12475,12738,263
"13954","Ocbimv22024530m.g","KQ419593",13621,18653,5032
"13955","Ocbimv22018593m.g","KQ418644",544636,544992,356
"13956","Ocbimv22009144m.g","KQ415861",247870,248591,721
"13957","Ocbimv22013681m.g","KQ418045",161155,183173,22018
"13958","Ocbimv22019043m.g","KQ418711",1138368,1140890,2522
"13959","Ocbimv22014005m.g","KQ418075",865381,866475,1094
"13960","Ocbimv22015933m.g","KQ418303",1138032,1247257,109225
"13961","Ocbimv22014997m.g","KQ418193",621545,622144,599
"13962","Ocbimv22039621m.g","KQ416810",475528,476109,581
"13963","Ocbimv22010033m.g","LGKD01575905",693,923,230
"13964","Ocbimv22017355m.g","KQ418483",428459,434615,6156
"13965","Ocbimv22007359m.g","KQ417408",57074,57499,425
"13966","Ocbimv22013184m.g","KQ428420",45371,52535,7164
"13967","Ocbimv22002850m.g","KQ424803",203480,215862,12382
"13968","Ocbimv22005143m.g","KQ417230",34287,49168,14881
"13969","Ocbimv22002280m.g","KQ424615",84872,85939,1067
"13970","Ocbimv22037411m.g","KQ416694",2490483,2490824,341
"13971","Ocbimv22010179m.g","KQ417653",477272,622324,145052
"13972","Ocbimv22007941m.g","KQ426499",93485,124691,31206
"13973","Ocbimv22008038m.g","KQ426540",3558,4882,1324
"13974","Ocbimv22037379m.g","KQ416694",792414,797501,5087
"13975","Ocbimv22006341m.g","KQ425879",268381,269491,1110
"13976","Ocbimv22035227m.g","KQ415747",152562,152825,263
"13977","Ocbimv22036443m.g","KQ422765",215716,216185,469
"13978","Ocbimv22017401m.g","LGKD01635373",3,245,242
"13979","Ocbimv22028693m.g","KQ420556",121463,151608,30145
"13980","Ocbimv22025575m.g","KQ419849",151699,153756,2057
"13981","Ocbimv22006569m.g","KQ417336",967377,967580,203
"13982","Ocbimv22020483m.g","KQ418919",307442,307922,480
"13983","Ocbimv22009822m.g","KQ417620",299113,308771,9658
"13984","Ocbimv22006780m.g","KQ426103",6365,7642,1277
"13985","Ocbimv22035133m.g","KQ422286",109872,110813,941
"13986","Ocbimv22033422m.g","KQ421809",66176,91705,25529
"13987","Ocbimv22032362m.g","KQ421523",1672044,1675295,3251
"13988","Ocbimv22025093m.g","KQ416137",463711,464027,316
"13989","Ocbimv22011233m.g","KQ417764",5292,20177,14885
"13990","Ocbimv22035923m.g","KQ422607",12525,14909,2384
"13991","Ocbimv22036523m.g","KQ422783",129603,134156,4553
"13992","Ocbimv22012383m.g","KQ417908",115586,136626,21040
"13993","Ocbimv22038927m.g","KQ423490",158790,161382,2592
"13994","Ocbimv22034147m.g","KQ421987",97019,97273,254
"13995","Ocbimv22005261m.g","KQ417237",692457,726655,34198
"13996","Ocbimv22000461m.g","KQ416860",47658,97856,50198
"13997","Ocbimv22027095m.g","KQ420181",13191,13619,428
"13998","Ocbimv22025040m.g","KQ416136",610669,614364,3695
"13999","Ocbimv22018733m.g","KQ415998",355965,357569,1604
"14000","Ocbimv22035073m.g","KQ416570",13844,14371,527
"14001","Ocbimv22026159m.g","KQ420006",398857,399849,992
"14002","Ocbimv22032663m.g","KQ421628",277626,285469,7843
"14003","Ocbimv22000676m.g","KQ424055",42047,62208,20161
"14004","Ocbimv22010832m.g","KQ417717",242503,242820,317
"14005","Ocbimv22018489m.g","KQ418626",50094,55524,5430
"14006","Ocbimv22010846m.g","KQ417719",264761,265605,844
"14007","Ocbimv22006773m.g","KQ426101",105073,109845,4772
"14008","Ocbimv22035354m.g","KQ416582",94635,98988,4353
"14009","Ocbimv22006356m.g","KQ417315",274216,302385,28169
"14010","Ocbimv22024974m.g","KQ419670",266055,266252,197
"14011","Ocbimv22017569m.g","KQ418506",485043,489927,4884
"14012","Ocbimv22037283m.g","KQ422989",145326,148727,3401
"14013","Ocbimv22022645m.g","KQ419277",70341,73181,2840
"14014","Ocbimv22001224m.g","KQ424229",508414,522341,13927
"14015","Ocbimv22039892m.g","KQ416834",68170,68612,442
"14016","Ocbimv22038383m.g","KQ416738",947984,949182,1198
"14017","Ocbimv22027346m.g","KQ420261",1283378,1302175,18797
"14018","Ocbimv22004386m.g","KQ425289",204161,293376,89215
"14019","Ocbimv22008523m.g","KQ426656",29,4283,4254
"14020","Ocbimv22017269m.g","KQ430232",167296,167574,278
"14021","Ocbimv22020957m.g","KQ416036",116186,118325,2139
"14022","Ocbimv22004967m.g","KQ425490",28553,80688,52135
"14023","Ocbimv22038341m.g","KQ416737",14535,14690,155
"14024","Ocbimv22028564m.g","KQ420522",234243,235142,899
"14025","Ocbimv22032562m.g","KQ421590",99561,133391,33830
"14026","Ocbimv22013709m.g","KQ428615",3897,7694,3797
"14027","Ocbimv22033260m.g","KQ421758",1546565,1548658,2093
"14028","Ocbimv22024444m.g","KQ416122",77803,78111,308
"14029","Ocbimv22011450m.g","KQ427751",62708,63308,600
"14030","Ocbimv22037076m.g","KQ422919",498137,498976,839
"14031","Ocbimv22020862m.g","KQ418971",85323,127876,42553
"14032","Ocbimv22006853m.g","KQ417358",713200,721443,8243
"14033","Ocbimv22020183m.g","KQ418870",52203,52601,398
"14034","Ocbimv22001425m.g","KQ424303",75310,90435,15125
"14035","Ocbimv22016029m.g","KQ429665",25234,31516,6282
"14036","Ocbimv22025090m.g","KQ416137",455100,457755,2655
"14037","Ocbimv22018170m.g","KQ418582",54006,106239,52233
"14038","Ocbimv22018519m.g","KQ415994",309154,309369,215
"14039","Ocbimv22001645m.g","KQ416950",1979296,1982529,3233
"14040","Ocbimv22029869m.g","KQ420828",1942716,1958539,15823
"14041","Ocbimv22003228m.g","KQ417066",330967,361427,30460
"14042","Ocbimv22006483m.g","KQ415831",433496,475318,41822
"14043","Ocbimv22027764m.g","KQ420358",387178,388368,1190
"14044","Ocbimv22009754m.g","KQ427110",109149,116808,7659
"14045","Ocbimv22006486m.g","KQ425942",9649,10131,482
"14046","Ocbimv22008153m.g","KQ417481",832681,833245,564
"14047","Ocbimv22002742m.g","KQ424771",19009,19638,629
"14048","Ocbimv22029971m.g","KQ420865",174388,174579,191
"14049","Ocbimv22016883m.g","KQ418417",109789,111477,1688
"14050","Ocbimv22016941m.g","KQ430102",1098,34644,33546
"14051","Ocbimv22020586m.g","KQ418926",460525,461118,593
"14052","Ocbimv22001314m.g","KQ416920",371854,373563,1709
"14053","Ocbimv22036262m.g","KQ416628",29192,36598,7406
"14054","Ocbimv22012870m.g","KQ417946",16000,16230,230
"14055","Ocbimv22024475m.g","KQ416124",2006,40837,38831
"14056","Ocbimv22013196m.g","KQ418001",3870,21516,17646
"14057","Ocbimv22019418m.g","KQ418762",24904,31764,6860
"14058","Ocbimv22022730m.g","KQ416074",384836,387774,2938
"14059","Ocbimv22024282m.g","KQ416121",283567,283752,185
"14060","Ocbimv22034405m.g","KQ422029",85838,98763,12925
"14061","Ocbimv22036227m.g","KQ416626",331848,332096,248
"14062","Ocbimv22022215m.g","KQ416062",61500,75056,13556
"14063","Ocbimv22008325m.g","KQ417497",541564,548315,6751
"14064","Ocbimv22006673m.g","KQ415833",380370,406982,26612
"14065","Ocbimv22039883m.g","KQ416833",248246,248524,278
"14066","Ocbimv22023750m.g","KQ419473",538679,540360,1681
"14067","Ocbimv22023451m.g","KQ419414",110730,204802,94072
"14068","Ocbimv22026985m.g","KQ420157",432402,432608,206
"14069","Ocbimv22031182m.g","KQ415722",68847,69209,362
"14070","Ocbimv22025192m.g","KQ419727",239711,240015,304
"14071","Ocbimv22033045m.g","KQ421721",237188,250167,12979
"14072","Ocbimv22021874m.g","KQ419115",70601,70840,239
"14073","Ocbimv22031680m.g","KQ421308",488796,488993,197
"14074","Ocbimv22010915m.g","KQ417725",12807,14224,1417
"14075","Ocbimv22017763m.g","LGKD01244857",81,566,485
"14076","Ocbimv22037724m.g","KQ423122",18969,21148,2179
"14077","Ocbimv22028875m.g","KQ420595",759959,760564,605
"14078","Ocbimv22014761m.g","KQ418175",852560,866286,13726
"14079","Ocbimv22001515m.g","KQ424340",32890,36198,3308
"14080","Ocbimv22022462m.g","KQ419223",259292,260579,1287
"14081","Ocbimv22001194m.g","KQ424222",19329,19529,200
"14082","Ocbimv22033745m.g","KQ421864",130974,138741,7767
"14083","Ocbimv22004546m.g","KQ417180",129093,131609,2516
"14084","Ocbimv22026123m.g","KQ419991",132519,133114,595
"14085","Ocbimv22009884m.g","KQ417621",384364,389947,5583
"14086","Ocbimv22039830m.g","KQ423773",81642,84736,3094
"14087","Ocbimv22036603m.g","KQ422804",107868,134087,26219
"14088","Ocbimv22021022m.g","KQ418994",157185,184988,27803
"14089","Ocbimv22020236m.g","KQ431554",861,4681,3820
"14090","Ocbimv22037680m.g","KQ423100",56101,72650,16549
"14091","Ocbimv22033098m.g","KQ421727",51951,62446,10495
"14092","Ocbimv22012249m.g","KQ417893",1405376,1405894,518
"14093","Ocbimv22000991m.g","KQ416902",92508,124287,31779
"14094","Ocbimv22019080m.g","KQ418715",145664,238259,92595
"14095","Ocbimv22013054m.g","KQ417977",170101,175121,5020
"14096","Ocbimv22038665m.g","KQ423432",247512,248811,1299
"14097","Ocbimv22031804m.g","KQ415726",61046,61282,236
"14098","Ocbimv22028418m.g","KQ420483",180898,199050,18152
"14099","Ocbimv22002794m.g","KQ417037",140204,161235,21031
"14100","Ocbimv22005443m.g","KQ417252",1056189,1058837,2648
"14101","Ocbimv22038390m.g","KQ423305",46644,50479,3835
"14102","Ocbimv22022049m.g","KQ419152",185334,186467,1133
"14103","Ocbimv22024818m.g","KQ419631",649483,667850,18367
"14104","Ocbimv22020827m.g","KQ418970",1346014,1348504,2490
"14105","Ocbimv22016670m.g","LGKD01629212",5,196,191
"14106","Ocbimv22011062m.g","LGKD01584425",266,1112,846
"14107","Ocbimv22028699m.g","KQ420559",33792,37881,4089
"14108","Ocbimv22013758m.g","KQ418059",15198,15467,269
"14109","Ocbimv22038808m.g","KQ423471",5720,7057,1337
"14110","Ocbimv22009082m.g","KQ426865",59684,98702,39018
"14111","Ocbimv22027407m.g","KQ416223",977189,988078,10889
"14112","Ocbimv22002704m.g","KQ417027",356241,356800,559
"14113","Ocbimv22002326m.g","KQ424629",134173,135027,854
"14114","Ocbimv22014746m.g","KQ418175",236757,260179,23422
"14115","Ocbimv22034258m.g","KQ422015",172917,198095,25178
"14116","Ocbimv22011935m.g","KQ427950",44562,59293,14731
"14117","Ocbimv22010059m.g","KQ417639",13851,19401,5550
"14118","Ocbimv22013547m.g","KQ428560",13715,27763,14048
"14119","Ocbimv22032839m.g","KQ421664",1603813,1604754,941
"14120","Ocbimv22004221m.g","KQ425237",19,945,926
"14121","Ocbimv22002276m.g","KQ424612",9385,9936,551
"14122","Ocbimv22036798m.g","KQ416657",542328,544680,2352
"14123","Ocbimv22012964m.g","KQ417963",30751,45348,14597
"14124","Ocbimv22007494m.g","KQ415843",221062,229157,8095
"14125","Ocbimv22011878m.g","KQ417844",887484,887720,236
"14126","Ocbimv22033398m.g","KQ416479",884782,903094,18312
"14127","Ocbimv22036380m.g","KQ422735",108032,109513,1481
"14128","Ocbimv22009451m.g","KQ427001",111047,111265,218
"14129","Ocbimv22020509m.g","LGKD01661035",12,706,694
"14130","Ocbimv22036781m.g","KQ422859",199380,218787,19407
"14131","Ocbimv22016931m.g","KQ430089",102434,102712,278
"14132","Ocbimv22020285m.g","KQ418883",110808,112220,1412
"14133","Ocbimv22003942m.g","KQ425154",69931,70992,1061
"14134","Ocbimv22008892m.g","KQ426792",140944,154523,13579
"14135","Ocbimv22034091m.g","KQ421972",363476,363634,158
"14136","Ocbimv22007570m.g","KQ417430",630245,630679,434
"14137","Ocbimv22037437m.g","KQ423023",93384,111353,17969
"14138","Ocbimv22000961m.g","KQ416898",114388,114579,191
"14139","Ocbimv22021820m.g","KQ415687",72300,72524,224
"14140","Ocbimv22038844m.g","KQ416768",834969,836087,1118
"14141","Ocbimv22024939m.g","KQ419660",223617,297462,73845
"14142","Ocbimv22032554m.g","KQ421583",16505,22028,5523
"14143","Ocbimv22025586m.g","KQ419857",96797,118368,21571
"14144","Ocbimv22012391m.g","KQ417910",60902,63736,2834
"14145","Ocbimv22002962m.g","KQ417051",1321384,1321975,591
"14146","Ocbimv22028884m.g","KQ420601",193593,193856,263
"14147","Ocbimv22025134m.g","KQ419701",242704,243282,578
"14148","Ocbimv22026619m.g","KQ420080",325155,325357,202
"14149","Ocbimv22002661m.g","KQ417023",1756590,1777643,21053
"14150","Ocbimv22028617m.g","KQ416264",721351,733555,12204
"14151","Ocbimv22009667m.g","KQ427059",839357,856543,17186
"14152","Ocbimv22006162m.g","KQ417300",1263407,1264158,751
"14153","Ocbimv22024925m.g","KQ419657",1419748,1425248,5500
"14154","Ocbimv22017833m.g","KQ430493",641,4964,4323
"14155","Ocbimv22035307m.g","KQ422351",393302,395214,1912
"14156","Ocbimv22037178m.g","KQ422960",192886,194249,1363
"14157","Ocbimv22035379m.g","KQ422366",45191,46075,884
"14158","Ocbimv22022473m.g","KQ416069",710994,711358,364
"14159","Ocbimv22011495m.g","KQ417796",171707,172842,1135
"14160","Ocbimv22035513m.g","KQ422416",31474,32780,1306
"14161","Ocbimv22012516m.g","KQ417917",427260,435097,7837
"14162","Ocbimv22002586m.g","KQ424709",1771,146321,144550
"14163","Ocbimv22004994m.g","KQ415811",141331,143787,2456
"14164","Ocbimv22001024m.g","KQ424157",326271,345874,19603
"14165","Ocbimv22011278m.g","KQ417773",35064,48374,13310
"14166","Ocbimv22009166m.g","KQ426910",7797,18672,10875
"14167","Ocbimv22003271m.g","KQ424932",323792,344538,20746
"14168","Ocbimv22000864m.g","KQ424096",131741,132640,899
"14169","Ocbimv22039673m.g","KQ416813",892841,895048,2207
"14170","Ocbimv22021446m.g","KQ419049",313154,336989,23835
"14171","Ocbimv22031340m.g","KQ421219",130032,130381,349
"14172","Ocbimv22013277m.g","KQ428432",42104,106424,64320
"14173","Ocbimv22004320m.g","KQ425262",89322,114056,24734
"14174","Ocbimv22038225m.g","KQ416731",675090,678901,3811
"14175","Ocbimv22029063m.g","KQ420639",716092,716352,260
"14176","Ocbimv22014471m.g","KQ418139",270925,272084,1159
"14177","Ocbimv22000965m.g","KQ424135",3737,62735,58998
"14178","Ocbimv22020847m.g","KQ418970",2338145,2342378,4233
"14179","Ocbimv22010859m.g","KQ427549",12825,59691,46866
"14180","Ocbimv22000268m.g","KQ423910",120553,130665,10112
"14181","Ocbimv22027567m.g","KQ420308",9769,15956,6187
"14182","Ocbimv22020858m.g","KQ418971",18966,22568,3602
"14183","Ocbimv22004959m.g","KQ425483",5913,8605,2692
"14184","Ocbimv22007663m.g","KQ426413",3230,4600,1370
"14185","Ocbimv22003934m.g","KQ425151",62330,64914,2584
"14186","Ocbimv22026172m.g","KQ420009",188308,189500,1192
"14187","Ocbimv22013933m.g","LGKD01605351",480,629,149
"14188","Ocbimv22012195m.g","KQ417887",75760,75933,173
"14189","Ocbimv22034128m.g","KQ421984",107050,127010,19960
"14190","Ocbimv22025108m.g","KQ419694",118325,134293,15968
"14191","Ocbimv22002694m.g","KQ424745",34966,101233,66267
"14192","Ocbimv22023008m.g","KQ419338",139481,163073,23592
"14193","Ocbimv22017459m.g","KQ418498",312877,335077,22200
"14194","Ocbimv22037360m.g","KQ423014",11970,14013,2043
"14195","Ocbimv22020990m.g","KQ418989",151031,151624,593
"14196","Ocbimv22033185m.g","KQ421741",149293,153509,4216
"14197","Ocbimv22003026m.g","KQ417055",914165,915610,1445
"14198","Ocbimv22036590m.g","KQ422794",334809,336758,1949
"14199","Ocbimv22033837m.g","KQ421893",78163,107296,29133
"14200","Ocbimv22031736m.g","KQ421332",815579,817063,1484
"14201","Ocbimv22035618m.g","KQ422475",57116,64912,7796
"14202","Ocbimv22006147m.g","KQ417300",798209,810012,11803
"14203","Ocbimv22018735m.g","KQ418665",2229,2570,341
"14204","Ocbimv22031456m.g","KQ416399",57594,57923,329
"14205","Ocbimv22030613m.g","KQ416359",1067184,1133389,66205
"14206","Ocbimv22037958m.g","KQ423185",278504,279085,581
"14207","Ocbimv22005406m.g","KQ417249",2321772,2332411,10639
"14208","Ocbimv22028217m.g","KQ420446",157232,166685,9453
"14209","Ocbimv22037964m.g","KQ416716",142894,143316,422
"14210","Ocbimv22035361m.g","KQ416583",65963,76509,10546
"14211","Ocbimv22012866m.g","KQ417945",1122791,1123057,266
"14212","Ocbimv22005989m.g","KQ415827",33604,60527,26923
"14213","Ocbimv22008719m.g","KQ415858",1057425,1063979,6554
"14214","Ocbimv22014206m.g","KQ418101",23826,26099,2273
"14215","Ocbimv22012919m.g","KQ417953",428914,463506,34592
"14216","Ocbimv22009152m.g","KQ426900",2783,4242,1459
"14217","Ocbimv22034054m.g","KQ416508",629155,629615,460
"14218","Ocbimv22023432m.g","KQ419409",317711,436214,118503
"14219","Ocbimv22017164m.g","KQ415974",144693,146045,1352
"14220","Ocbimv22015596m.g","KQ415946",271922,340525,68603
"14221","Ocbimv22034828m.g","KQ422187",609204,651855,42651
"14222","Ocbimv22008369m.g","KQ417498",787020,787399,379
"14223","Ocbimv22037376m.g","KQ416694",341306,342094,788
"14224","Ocbimv22024191m.g","KQ433854",2778,3525,747
"14225","Ocbimv22024171m.g","KQ419543",554983,571768,16785
"14226","Ocbimv22027447m.g","KQ420279",202966,297398,94432
"14227","Ocbimv22019755m.g","KQ431294",368749,368964,215
"14228","Ocbimv22009233m.g","KQ426935",112588,113651,1063
"14229","Ocbimv22039793m.g","KQ416824",10000,12414,2414
"14230","Ocbimv22030877m.g","KQ421116",754,10736,9982
"14231","Ocbimv22032129m.g","KQ421454",260678,282190,21512
"14232","Ocbimv22020666m.g","KQ418948",34490,37689,3199
"14233","Ocbimv22030168m.g","KQ420915",428140,430831,2691
"14234","Ocbimv22015433m.g","LGKD01618288",23,277,254
"14235","Ocbimv22034516m.g","KQ422068",19914,25826,5912
"14236","Ocbimv22029292m.g","KQ420698",47760,52636,4876
"14237","Ocbimv22005760m.g","KQ417276",245710,246029,319
"14238","Ocbimv22002632m.g","KQ417023",899529,901390,1861
"14239","Ocbimv22035566m.g","KQ422438",106079,120426,14347
"14240","Ocbimv22022203m.g","KQ419184",281536,281805,269
"14241","Ocbimv22020756m.g","KQ431842",6181,11115,4934
"14242","Ocbimv22015584m.g","KQ415946",11843,65667,53824
"14243","Ocbimv22023203m.g","KQ419368",979240,979753,513
"14244","Ocbimv22030484m.g","KQ420994",26605,61034,34429
"14245","Ocbimv22001581m.g","KQ424363",333716,341410,7694
"14246","Ocbimv22000064m.g","KQ423840",4401,4862,461
"14247","Ocbimv22027269m.g","KQ420240",293411,295228,1817
"14248","Ocbimv22010189m.g","KQ417653",802991,803880,889
"14249","Ocbimv22001732m.g","KQ424397",33206,67290,34084
"14250","Ocbimv22039894m.g","KQ416834",99066,106306,7240
"14251","Ocbimv22036017m.g","KQ422632",521247,528206,6959
"14252","Ocbimv22008148m.g","KQ417481",563539,563751,212
"14253","Ocbimv22016103m.g","KQ429708",232149,232340,191
"14254","Ocbimv22030789m.g","KQ416370",7501,36609,29108
"14255","Ocbimv22001668m.g","KQ416951",687643,699107,11464
"14256","Ocbimv22004876m.g","KQ417211",437058,438982,1924
"14257","Ocbimv22033747m.g","KQ421864",152408,183014,30606
"14258","Ocbimv22011844m.g","LGKD01590585",163,938,775
"14259","Ocbimv22004639m.g","KQ417191",18888,24084,5196
"14260","Ocbimv22007024m.g","KQ417370",554408,555421,1013
"14261","Ocbimv22025869m.g","KQ419917",73245,74233,988
"14262","Ocbimv22025733m.g","KQ419893",18199,18399,200
"14263","Ocbimv22027767m.g","KQ420361",62996,63654,658
"14264","Ocbimv22018298m.g","KQ418598",370665,378321,7656
"14265","Ocbimv22034993m.g","KQ416567",41074,41502,428
"14266","Ocbimv22028681m.g","KQ420554",53788,77079,23291
"14267","Ocbimv22037289m.g","KQ422993",105297,105719,422
"14268","Ocbimv22000440m.g","KQ423963",324146,338552,14406
"14269","Ocbimv22007989m.g","KQ417469",9846,14112,4266
"14270","Ocbimv22017468m.g","KQ430302",50742,59715,8973
"14271","Ocbimv22034157m.g","KQ416515",44371,44658,287
"14272","Ocbimv22015444m.g","KQ418248",47445,58627,11182
"14273","Ocbimv22004466m.g","KQ425323",10646,11101,455
"14274","Ocbimv22026111m.g","KQ419989",559914,565247,5333
"14275","Ocbimv22003369m.g","KQ424997",30238,30499,261
"14276","Ocbimv22012566m.g","KQ417917",1371470,1376884,5414
"14277","Ocbimv22037654m.g","KQ416705",1100733,1127369,26636
"14278","Ocbimv22000269m.g","KQ423910",130722,169587,38865
"14279","Ocbimv22008614m.g","KQ417510",861416,883172,21756
"14280","Ocbimv22011060m.g","KQ417741",1057362,1115950,58588
"14281","Ocbimv22013609m.g","KQ418039",201921,352359,150438
"14282","Ocbimv22001388m.g","KQ416930",240399,240723,324
"14283","Ocbimv22032061m.g","KQ421416",15062,27955,12893
"14284","Ocbimv22038752m.g","KQ416765",87424,88001,577
"14285","Ocbimv22006581m.g","KQ426026",190823,203088,12265
"14286","Ocbimv22028518m.g","KQ420516",871767,872896,1129
"14287","Ocbimv22008458m.g","KQ415854",358921,369448,10527
"14288","Ocbimv22021699m.g","KQ432284",209733,231605,21872
"14289","Ocbimv22015728m.g","LGKD01621398",1,348,347
"14290","Ocbimv22016641m.g","KQ418371",378408,380433,2025
"14291","Ocbimv22004915m.g","KQ417213",737261,739141,1880
"14292","Ocbimv22007243m.g","KQ426259",116125,116372,247
"14293","Ocbimv22004336m.g","KQ417149",540939,555830,14891
"14294","Ocbimv22005404m.g","KQ417249",2274237,2278811,4574
"14295","Ocbimv22003397m.g","KQ417086",64684,78258,13574
"14296","Ocbimv22011052m.g","KQ417740",350383,353219,2836
"14297","Ocbimv22030589m.g","KQ415718",55281,55896,615
"14298","Ocbimv22027521m.g","KQ420297",258200,287026,28826
"14299","Ocbimv22010840m.g","KQ417719",86016,141045,55029
"14300","Ocbimv22033467m.g","KQ421819",341355,353300,11945
"14301","Ocbimv22022426m.g","KQ419216",68116,73980,5864
"14302","Ocbimv22028343m.g","KQ420477",39993,47770,7777
"14303","Ocbimv22027536m.g","KQ420299",1040597,1041313,716
"14304","Ocbimv22020926m.g","KQ418975",11739,12170,431
"14305","Ocbimv22007895m.g","KQ426484",217672,223574,5902
"14306","Ocbimv22008868m.g","KQ426791",384947,388596,3649
"14307","Ocbimv22002834m.g","KQ417040",242056,243133,1077
"14308","Ocbimv22023232m.g","KQ419378",30950,31105,155
"14309","Ocbimv22021490m.g","LGKD01668612",368,2273,1905
"14310","Ocbimv22013302m.g","KQ418009",62502,62681,179
"14311","Ocbimv22026299m.g","KQ420023",374706,383362,8656
"14312","Ocbimv22031542m.g","KQ421273",33248,48214,14966
"14313","Ocbimv22029666m.g","KQ420799",51663,61586,9923
"14314","Ocbimv22031130m.g","KQ415721",112953,142713,29760
"14315","Ocbimv22024207m.g","KQ419550",32964,36012,3048
"14316","Ocbimv22031829m.g","KQ421356",187337,188428,1091
"14317","Ocbimv22026227m.g","KQ420017",617659,633123,15464
"14318","Ocbimv22012605m.g","KQ417921",75535,90131,14596
"14319","Ocbimv22029751m.g","KQ415712",630623,631033,410
"14320","Ocbimv22014627m.g","KQ418159",43685,65251,21566
"14321","Ocbimv22013470m.g","KQ428524",84547,117561,33014
"14322","Ocbimv22023884m.g","KQ419491",166897,171878,4981
"14323","Ocbimv22004338m.g","KQ425265",6815,7204,389
"14324","Ocbimv22022902m.g","KQ433128",399,5792,5393
"14325","Ocbimv22002220m.g","KQ424575",215358,223070,7712
"14326","Ocbimv22006479m.g","KQ425938",456,869,413
"14327","Ocbimv22024897m.g","KQ416131",89541,90310,769
"14328","Ocbimv22002791m.g","KQ417037",65268,90869,25601
"14329","Ocbimv22000117m.g","KQ416841",178285,178620,335
"14330","Ocbimv22036271m.g","KQ416628",625053,625541,488
"14331","Ocbimv22023860m.g","KQ416102",428302,477351,49049
"14332","Ocbimv22032812m.g","KQ416450",297156,298379,1223
"14333","Ocbimv22025682m.g","KQ419886",230705,258933,28228
"14334","Ocbimv22009125m.g","KQ426892",50474,51940,1466
"14335","Ocbimv22039599m.g","KQ416808",37581,75658,38077
"14336","Ocbimv22020257m.g","KQ418878",2084,6218,4134
"14337","Ocbimv22007854m.g","KQ417455",295460,299181,3721
"14338","Ocbimv22019242m.g","KQ418738",164011,164365,354
"14339","Ocbimv22020826m.g","KQ418970",1163071,1242567,79496
"14340","Ocbimv22026807m.g","KQ416203",546122,546280,158
"14341","Ocbimv22014178m.g","KQ418098",61205,90070,28865
"14342","Ocbimv22007734m.g","KQ417447",943219,943512,293
"14343","Ocbimv22022973m.g","KQ433167",3782,4263,481
"14344","Ocbimv22002369m.g","KQ415792",27895,28104,209
"14345","Ocbimv22004630m.g","KQ425396",87883,94295,6412
"14346","Ocbimv22017580m.g","KQ418509",39713,39865,152
"14347","Ocbimv22030228m.g","KQ420925",2799,24059,21260
"14348","Ocbimv22010539m.g","KQ427428",134951,138944,3993
"14349","Ocbimv22027305m.g","KQ416221",30524,30784,260
"14350","Ocbimv22004864m.g","KQ425454",190841,191265,424
"14351","Ocbimv22016250m.g","KQ429777",42638,43060,422
"14352","Ocbimv22016996m.g","KQ418431",939194,963380,24186
"14353","Ocbimv22035917m.g","KQ422602",98947,111325,12378
"14354","Ocbimv22027688m.g","KQ420340",74384,112904,38520
"14355","Ocbimv22024666m.g","KQ419607",768744,775553,6809
"14356","Ocbimv22008847m.g","KQ426789",51197,60430,9233
"14357","Ocbimv22011112m.g","KQ427641",10371,87450,77079
"14358","Ocbimv22027005m.g","KQ420162",175965,239855,63890
"14359","Ocbimv22003987m.g","KQ425169",19,1247,1228
"14360","Ocbimv22010629m.g","KQ415669",2490643,2491308,665
"14361","Ocbimv22024408m.g","KQ419577",31305,38347,7042
"14362","Ocbimv22014914m.g","KQ418187",385888,404324,18436
"14363","Ocbimv22024655m.g","KQ419607",291172,292838,1666
"14364","Ocbimv22022066m.g","KQ419156",184334,184660,326
"14365","Ocbimv22020307m.g","KQ418887",61385,62646,1261
"14366","Ocbimv22013733m.g","KQ428627",9324,36593,27269
"14367","Ocbimv22039933m.g","KQ423798",151610,151819,209
"14368","Ocbimv22000061m.g","KQ423839",217060,217780,720
"14369","Ocbimv22006497m.g","LGKD01546384",52,330,278
"14370","Ocbimv22021951m.g","LGKD01672937",1,177,176
"14371","Ocbimv22033415m.g","KQ421808",125453,125707,254
"14372","Ocbimv22028242m.g","KQ415659",2986,71389,68403
"14373","Ocbimv22015177m.g","KQ429178",16989,18532,1543
"14374","Ocbimv22038579m.g","KQ423411",221838,225140,3302
"14375","Ocbimv22003699m.g","KQ417101",161608,162507,899
"14376","Ocbimv22036223m.g","KQ416626",273808,300879,27071
"14377","Ocbimv22005617m.g","KQ425681",88125,88409,284
"14378","Ocbimv22010818m.g","KQ427527",90488,93149,2661
"14379","Ocbimv22014338m.g","KQ418120",158325,160281,1956
"14380","Ocbimv22032645m.g","KQ421626",6319,23459,17140
"14381","Ocbimv22018398m.g","KQ430684",146195,174959,28764
"14382","Ocbimv22030601m.g","KQ421034",385301,412329,27028
"14383","Ocbimv22011340m.g","KQ417782",93430,97150,3720
"14384","Ocbimv22031921m.g","KQ416413",207875,208174,299
"14385","Ocbimv22011306m.g","LGKD01586472",558,722,164
"14386","Ocbimv22025147m.g","KQ419709",66503,67090,587
"14387","Ocbimv22029805m.g","KQ420828",19011,40764,21753
"14388","Ocbimv22005487m.g","KQ425619",133177,146138,12961
"14389","Ocbimv22002997m.g","KQ424859",261624,342230,80606
"14390","Ocbimv22014869m.g","KQ429122",4,69706,69702
"14391","Ocbimv22036029m.g","KQ416614",62983,74886,11903
"14392","Ocbimv22031988m.g","KQ421396",293778,343283,49505
"14393","Ocbimv22002743m.g","KQ424771",111753,250205,138452
"14394","Ocbimv22001920m.g","KQ424477",14,44940,44926
"14395","Ocbimv22020628m.g","LGKD01662321",6404,14272,7868
"14396","Ocbimv22015437m.g","KQ418245",214615,240429,25814
"14397","Ocbimv22009614m.g","LGKD01177741",220,591,371
"14398","Ocbimv22017393m.g","KQ418489",134453,144731,10278
"14399","Ocbimv22035778m.g","KQ416600",589732,591558,1826
"14400","Ocbimv22009942m.g","KQ417625",143883,151987,8104
"14401","Ocbimv22039708m.g","KQ416815",112813,132948,20135
"14402","Ocbimv22024298m.g","KQ419563",91787,99207,7420
"14403","Ocbimv22018975m.g","KQ430934",146735,187252,40517
"14404","Ocbimv22031851m.g","KQ421357",85996,101191,15195
"14405","Ocbimv22022098m.g","KQ419162",143966,144926,960
"14406","Ocbimv22009222m.g","KQ417575",230314,235839,5525
"14407","Ocbimv22003162m.g","KQ417062",55717,56500,783
"14408","Ocbimv22016376m.g","KQ415962",1183308,1195378,12070
"14409","Ocbimv22008489m.g","KQ417505",44124,158355,114231
"14410","Ocbimv22025689m.g","KQ416164",32274,32735,461
"14411","Ocbimv22016993m.g","KQ418431",899205,908429,9224
"14412","Ocbimv22015020m.g","KQ418194",335657,337523,1866
"14413","Ocbimv22027496m.g","KQ416226",125265,138780,13515
"14414","Ocbimv22031718m.g","KQ421325",183954,184600,646
"14415","Ocbimv22037894m.g","KQ423149",268643,270658,2015
"14416","Ocbimv22017125m.g","KQ418453",24578,44009,19431
"14417","Ocbimv22006669m.g","KQ417342",439455,439682,227
"14418","Ocbimv22013385m.g","KQ418018",826492,853279,26787
"14419","Ocbimv22021269m.g","KQ419022",221587,307212,85625
"14420","Ocbimv22013145m.g","KQ417988",27735,36537,8802
"14421","Ocbimv22035433m.g","KQ422382",437,970,533
"14422","Ocbimv22014665m.g","KQ418166",59704,103113,43409
"14423","Ocbimv22023263m.g","LGKD01687184",7,460,453
"14424","Ocbimv22037555m.g","KQ423061",102575,102844,269
"14425","Ocbimv22035665m.g","KQ422496",90698,91463,765
"14426","Ocbimv22006575m.g","KQ426022",290822,292153,1331
"14427","Ocbimv22014164m.g","KQ418096",428767,429024,257
"14428","Ocbimv22007956m.g","KQ426505",36152,37236,1084
"14429","Ocbimv22032082m.g","KQ421430",85915,86452,537
"14430","Ocbimv22018917m.g","KQ430924",300150,300916,766
"14431","Ocbimv22035431m.g","KQ422381",358121,374355,16234
"14432","Ocbimv22021483m.g","KQ419056",165444,197035,31591
"14433","Ocbimv22000387m.g","KQ423943",5346,6671,1325
"14434","Ocbimv22031538m.g","KQ421270",1830,2021,191
"14435","Ocbimv22038424m.g","KQ423334",172345,180494,8149
"14436","Ocbimv22036354m.g","KQ422718",124464,125366,902
"14437","Ocbimv22004104m.g","KQ425203",1650,2780,1130
"14438","Ocbimv22038437m.g","KQ423338",239354,244125,4771
"14439","Ocbimv22017524m.g","KQ418504",211423,223626,12203
"14440","Ocbimv22006736m.g","KQ417345",231228,232471,1243
"14441","Ocbimv22030019m.g","KQ420885",40967,41743,776
"14442","Ocbimv22036301m.g","KQ416631",197384,232740,35356
"14443","Ocbimv22039826m.g","KQ423772",1895,10259,8364
"14444","Ocbimv22034883m.g","KQ422206",231456,284310,52854
"14445","Ocbimv22023987m.g","KQ419514",27860,31664,3804
"14446","Ocbimv22001577m.g","KQ424363",92899,93201,302
"14447","Ocbimv22009617m.g","KQ427054",88512,96500,7988
"14448","Ocbimv22022183m.g","KQ419180",765726,766747,1021
"14449","Ocbimv22006033m.g","KQ425787",38324,38692,368
"14450","Ocbimv22038044m.g","KQ416721",76418,100268,23850
"14451","Ocbimv22014086m.g","KQ415924",238302,262911,24609
"14452","Ocbimv22007362m.g","KQ417408",144868,145670,802
"14453","Ocbimv22004881m.g","KQ417211",488526,488971,445
"14454","Ocbimv22006292m.g","KQ425860",292668,316385,23717
"14455","Ocbimv22035640m.g","KQ422482",4016,9354,5338
"14456","Ocbimv22028299m.g","KQ420463",791844,793281,1437
"14457","Ocbimv22022371m.g","KQ419208",270650,308376,37726
"14458","Ocbimv22027880m.g","KQ420387",140959,156939,15980
"14459","Ocbimv22014612m.g","KQ429012",695,2164,1469
"14460","Ocbimv22024312m.g","KQ419564",227442,236066,8624
"14461","Ocbimv22039055m.g","KQ423531",73360,84569,11209
"14462","Ocbimv22022658m.g","KQ419278",85448,85757,309
"14463","Ocbimv22023425m.g","KQ419407",132829,133029,200
"14464","Ocbimv22032263m.g","KQ421506",77350,121106,43756
"14465","Ocbimv22005659m.g","KQ417271",293956,317869,23913
"14466","Ocbimv22031764m.g","KQ416405",1324,2466,1142
"14467","Ocbimv22032494m.g","KQ421563",4413,98288,93875
"14468","Ocbimv22038507m.g","KQ423383",12207,16472,4265
"14469","Ocbimv22008955m.g","KQ417543",27591,31678,4087
"14470","Ocbimv22023681m.g","KQ419458",351328,351848,520
"14471","Ocbimv22028206m.g","KQ420444",239509,248015,8506
"14472","Ocbimv22029307m.g","KQ420703",256831,256992,161
"14473","Ocbimv22039370m.g","KQ423634",37086,38344,1258
"14474","Ocbimv22035916m.g","KQ422600",54918,59140,4222
"14475","Ocbimv22027433m.g","KQ420275",349400,350000,600
"14476","Ocbimv22007222m.g","KQ426253",57649,63510,5861
"14477","Ocbimv22039060m.g","KQ423531",261607,264417,2810
"14478","Ocbimv22010012m.g","KQ427205",94315,119702,25387
"14479","Ocbimv22021494m.g","KQ432177",23324,40467,17143
"14480","Ocbimv22027546m.g","KQ420299",1813795,1839429,25634
"14481","Ocbimv22000464m.g","KQ416861",661387,686877,25490
"14482","Ocbimv22011752m.g","LGKD01590020",266,457,191
"14483","Ocbimv22021205m.g","KQ432038",194705,196438,1733
"14484","Ocbimv22016943m.g","KQ430102",74636,74821,185
"14485","Ocbimv22008524m.g","KQ426659",10671,12917,2246
"14486","Ocbimv22000524m.g","KQ416865",122551,123596,1045
"14487","Ocbimv22001277m.g","KQ424250",323012,323185,173
"14488","Ocbimv22020650m.g","KQ418945",896043,906803,10760
"14489","Ocbimv22037582m.g","KQ423077",97445,203385,105940
"14490","Ocbimv22023396m.g","KQ419401",79770,83105,3335
"14491","Ocbimv22003122m.g","KQ424889",217106,239980,22874
"14492","Ocbimv22015238m.g","KQ415940",849009,849362,353
"14493","Ocbimv22031580m.g","KQ416401",119220,137178,17958
"14494","Ocbimv22012150m.g","KQ417877",986160,992904,6744
"14495","Ocbimv22012721m.g","KQ428207",17222,38846,21624
"14496","Ocbimv22021531m.g","KQ419071",110502,122477,11975
"14497","Ocbimv22021850m.g","KQ415687",1400825,1410901,10076
"14498","Ocbimv22035792m.g","KQ422547",7928,8125,197
"14499","Ocbimv22006009m.g","KQ425779",339814,363030,23216
"14500","Ocbimv22002461m.g","KQ424661",19617,23891,4274
"14501","Ocbimv22013446m.g","KQ428508",186140,201851,15711
"14502","Ocbimv22012398m.g","KQ417910",644410,646189,1779
"14503","Ocbimv22024834m.g","KQ419638",144531,155822,11291
"14504","Ocbimv22023518m.g","KQ433432",11831,28139,16308
"14505","Ocbimv22021824m.g","KQ415687",515200,515628,428
"14506","Ocbimv22005705m.g","KQ425722",68494,74372,5878
"14507","Ocbimv22010710m.g","KQ427472",71,955,884
"14508","Ocbimv22003332m.g","KQ417081",233556,238825,5269
"14509","Ocbimv22013946m.g","KQ418073",14608,57707,43099
"14510","Ocbimv22015637m.g","KQ418271",20589,59065,38476
"14511","Ocbimv22012270m.g","KQ417897",633257,641415,8158
"14512","Ocbimv22014063m.g","KQ415672",522890,527924,5034
"14513","Ocbimv22032693m.g","KQ416445",466615,469367,2752
"14514","Ocbimv22020107m.g","KQ418855",195488,196036,548
"14515","Ocbimv22021063m.g","KQ431974",119553,120038,485
"14516","Ocbimv22000980m.g","KQ424142",219489,220049,560
"14517","Ocbimv22034822m.g","KQ422187",292775,294513,1738
"14518","Ocbimv22031861m.g","KQ416411",2708,3064,356
"14519","Ocbimv22023892m.g","KQ419493",110663,111691,1028
"14520","Ocbimv22007830m.g","KQ426466",154892,159037,4145
"14521","Ocbimv22028509m.g","KQ420516",105920,106195,275
"14522","Ocbimv22010446m.g","KQ427392",125540,126133,593
"14523","Ocbimv22003701m.g","KQ417101",217189,246304,29115
"14524","Ocbimv22025273m.g","KQ416146",119405,119914,509
"14525","Ocbimv22026679m.g","KQ416196",847973,851070,3097
"14526","Ocbimv22017478m.g","KQ430313",64021,114619,50598
"14527","Ocbimv22002581m.g","KQ424708",30089,30346,257
"14528","Ocbimv22016904m.g","KQ430077",46406,46714,308
"14529","Ocbimv22013628m.g","KQ418040",49375,58121,8746
"14530","Ocbimv22021192m.g","KQ416040",299672,304927,5255
"14531","Ocbimv22033801m.g","KQ421873",243130,243930,800
"14532","Ocbimv22006084m.g","KQ417294",155747,156085,338
"14533","Ocbimv22008320m.g","KQ417497",65319,198089,132770
"14534","Ocbimv22028579m.g","KQ420525",225749,226087,338
"14535","Ocbimv22025811m.g","KQ419908",63015,63983,968
"14536","Ocbimv22010001m.g","KQ427202",236384,236634,250
"14537","Ocbimv22029706m.g","KQ416318",32665,35885,3220
"14538","Ocbimv22011842m.g","KQ427917",67340,168633,101293
"14539","Ocbimv22035724m.g","KQ422521",248357,258118,9761
"14540","Ocbimv22012508m.g","KQ417917",335536,341208,5672
"14541","Ocbimv22039006m.g","KQ416777",186783,191306,4523
"14542","Ocbimv22001770m.g","KQ416962",93018,100906,7888
"14543","Ocbimv22014786m.g","KQ418177",13710,15135,1425
"14544","Ocbimv22003719m.g","KQ425074",390,872,482
"14545","Ocbimv22033912m.g","KQ421906",425054,426166,1112
"14546","Ocbimv22001544m.g","KQ424353",157276,158954,1678
"14547","Ocbimv22004324m.g","LGKD01529403",680,3848,3168
"14548","Ocbimv22027036m.g","KQ420166",736592,736774,182
"14549","Ocbimv22005499m.g","KQ425631",6646,19326,12680
"14550","Ocbimv22019136m.g","KQ418719",720241,722640,2399
"14551","Ocbimv22031720m.g","KQ421325",214565,215799,1234
"14552","Ocbimv22021862m.g","KQ419113",67228,86998,19770
"14553","Ocbimv22010116m.g","KQ427263",456909,458941,2032
"14554","Ocbimv22039951m.g","KQ423808",224763,251072,26309
"14555","Ocbimv22025227m.g","KQ419741",142446,142974,528
"14556","Ocbimv22031615m.g","KQ421298",41501,42366,865
"14557","Ocbimv22016772m.g","KQ430007",385,1679,1294
"14558","Ocbimv22023167m.g","KQ419366",143422,143682,260
"14559","Ocbimv22031714m.g","KQ421325",107063,119752,12689
"14560","Ocbimv22030625m.g","KQ416359",1298713,1344567,45854
"14561","Ocbimv22009530m.g","KQ415865",931905,980896,48991
"14562","Ocbimv22012300m.g","KQ428115",154806,156463,1657
"14563","Ocbimv22008215m.g","KQ417487",735283,735519,236
"14564","Ocbimv22038996m.g","KQ423506",96975,113127,16152
"14565","Ocbimv22039293m.g","KQ423609",584253,584573,320
"14566","Ocbimv22016347m.g","KQ415679",73061,73318,257
"14567","Ocbimv22006610m.g","KQ426030",64003,65143,1140
"14568","Ocbimv22027373m.g","KQ420267",500544,501095,551
"14569","Ocbimv22015181m.g","KQ418203",30898,31261,363
"14570","Ocbimv22037004m.g","KQ422903",491368,492011,643
"14571","Ocbimv22032638m.g","KQ416443",338839,339084,245
"14572","Ocbimv22039420m.g","KQ423652",122080,122918,838
"14573","Ocbimv22011612m.g","KQ427805",22227,22955,728
"14574","Ocbimv22038982m.g","KQ423499",80777,81151,374
"14575","Ocbimv22023453m.g","KQ419414",339319,339618,299
"14576","Ocbimv22012069m.g","KQ428000",33948,39360,5412
"14577","Ocbimv22017429m.g","KQ418495",416188,429546,13358
"14578","Ocbimv22029372m.g","KQ420733",48616,48888,272
"14579","Ocbimv22022017m.g","KQ432511",52700,57105,4405
"14580","Ocbimv22030677m.g","KQ421059",3758,4078,320
"14581","Ocbimv22037083m.g","KQ422919",949653,952710,3057
"14582","Ocbimv22035318m.g","KQ422351",590860,640554,49694
"14583","Ocbimv22011336m.g","KQ417782",6788,49456,42668
"14584","Ocbimv22038077m.g","KQ423213",13158,16662,3504
"14585","Ocbimv22009671m.g","KQ427064",20,991,971
"14586","Ocbimv22016059m.g","KQ415952",51682,63288,11606
"14587","Ocbimv22038743m.g","KQ416764",361064,366425,5361
"14588","Ocbimv22024633m.g","KQ419605",337237,338260,1023
"14589","Ocbimv22012247m.g","KQ417893",1287546,1287938,392
"14590","Ocbimv22022079m.g","KQ419158",847570,847986,416
"14591","Ocbimv22019932m.g","KQ418836",414526,415341,815
"14592","Ocbimv22036193m.g","KQ416624",144195,144759,564
"14593","Ocbimv22013708m.g","LGKD01603539",3,164,161
"14594","Ocbimv22010924m.g","KQ417725",194727,227205,32478
"14595","Ocbimv22009538m.g","KQ415865",1028077,1038648,10571
"14596","Ocbimv22020342m.g","KQ431630",76940,77207,267
"14597","Ocbimv22007339m.g","KQ426301",27789,42185,14396
"14598","Ocbimv22030999m.g","KQ421143",81227,85638,4411
"14599","Ocbimv22004199m.g","KQ425223",53740,54403,663
"14600","Ocbimv22025597m.g","KQ419858",57274,78812,21538
"14601","Ocbimv22014742m.g","LGKD01612458",61,531,470
"14602","Ocbimv22011680m.g","KQ417816",472591,475924,3333
"14603","Ocbimv22013904m.g","KQ428708",14382,44295,29913
"14604","Ocbimv22018771m.g","KQ418671",62904,68407,5503
"14605","Ocbimv22017649m.g","KQ418523",100736,101275,539
"14606","Ocbimv22008706m.g","KQ426740",353468,361636,8168
"14607","Ocbimv22012910m.g","KQ415670",116205,133567,17362
"14608","Ocbimv22004283m.g","KQ425258",73536,75888,2352
"14609","Ocbimv22014227m.g","KQ428805",3,2000,1997
"14610","Ocbimv22038136m.g","KQ423217",474944,526647,51703
"14611","Ocbimv22003716m.g","KQ425069",122926,164020,41094
"14612","Ocbimv22008034m.g","KQ417472",117445,117600,155
"14613","Ocbimv22006452m.g","KQ425926",60372,60644,272
"14614","Ocbimv22032955m.g","KQ421694",103088,119984,16896
"14615","Ocbimv22011250m.g","KQ417771",72258,77570,5312
"14616","Ocbimv22011788m.g","KQ417832",832301,832690,389
"14617","Ocbimv22003772m.g","KQ417110",152065,198076,46011
"14618","Ocbimv22021649m.g","KQ419084",74749,81988,7239
"14619","Ocbimv22017675m.g","KQ430413",24346,30530,6184
"14620","Ocbimv22007689m.g","KQ415846",227206,227432,226
"14621","Ocbimv22011656m.g","KQ427833",384128,384460,332
"14622","Ocbimv22033052m.g","KQ421721",547306,568570,21264
"14623","Ocbimv22019699m.g","KQ418800",145729,155969,10240
"14624","Ocbimv22025333m.g","KQ419775",225101,235442,10341
"14625","Ocbimv22003608m.g","KQ425044",45633,47024,1391
"14626","Ocbimv22012304m.g","KQ417902",3822,26928,23106
"14627","Ocbimv22023206m.g","KQ419369",91154,99546,8392
"14628","Ocbimv22028062m.g","KQ420424",145705,146364,659
"14629","Ocbimv22019307m.g","KQ418747",146679,216751,70072
"14630","Ocbimv22002988m.g","LGKD01517693",134,304,170
"14631","Ocbimv22016273m.g","KQ429784",206859,208505,1646
"14632","Ocbimv22039016m.g","KQ423508",3883,5275,1392
"14633","Ocbimv22026616m.g","KQ420080",241193,327730,86537
"14634","Ocbimv22026789m.g","KQ420117",419977,420357,380
"14635","Ocbimv22010483m.g","KQ417681",970215,970643,428
"14636","Ocbimv22028430m.g","KQ420486",3986,16659,12673
"14637","Ocbimv22035398m.g","KQ422367",99148,144777,45629
"14638","Ocbimv22000719m.g","KQ416877",524452,540658,16206
"14639","Ocbimv22023574m.g","KQ419433",241498,246041,4543
"14640","Ocbimv22001740m.g","KQ416959",62271,178358,116087
"14641","Ocbimv22012447m.g","KQ417911",1102371,1129160,26789
"14642","Ocbimv22035216m.g","KQ422314",78022,110459,32437
"14643","Ocbimv22010873m.g","KQ417721",1041253,1042534,1281
"14644","Ocbimv22023320m.g","LGKD01687772",32,247,215
"14645","Ocbimv22000452m.g","KQ423968",191860,192080,220
"14646","Ocbimv22034017m.g","KQ421946",343555,344533,978
"14647","Ocbimv22003457m.g","KQ425015",173712,250001,76289
"14648","Ocbimv22002078m.g","KQ424537",54298,63373,9075
"14649","Ocbimv22036654m.g","KQ422819",191994,192230,236
"14650","Ocbimv22017032m.g","KQ418441",246998,350464,103466
"14651","Ocbimv22002621m.g","KQ417023",728540,729805,1265
"14652","Ocbimv22039071m.g","KQ423536",293422,349118,55696
"14653","Ocbimv22018103m.g","KQ430572",171279,198687,27408
"14654","Ocbimv22005576m.g","KQ425655",241576,244136,2560
"14655","Ocbimv22023489m.g","KQ416088",522906,523829,923
"14656","Ocbimv22020126m.g","KQ418857",122842,123360,518
"14657","Ocbimv22017077m.g","KQ430159",68938,69950,1012
"14658","Ocbimv22014147m.g","LGKD01606795",80,988,908
"14659","Ocbimv22018664m.g","KQ418651",357744,358089,345
"14660","Ocbimv22024277m.g","KQ419562",232929,235594,2665
"14661","Ocbimv22030330m.g","KQ420950",528271,528456,185
"14662","Ocbimv22006019m.g","KQ425779",453618,491046,37428
"14663","Ocbimv22010955m.g","KQ417726",517390,517869,479
"14664","Ocbimv22021945m.g","KQ432446",618,1067,449
"14665","Ocbimv22014890m.g","KQ429131",177307,191505,14198
"14666","Ocbimv22014563m.g","KQ418153",340068,340352,284
"14667","Ocbimv22017908m.g","KQ418559",77977,78177,200
"14668","Ocbimv22007220m.g","KQ426253",25662,27587,1925
"14669","Ocbimv22029456m.g","KQ420753",93332,94973,1641
"14670","Ocbimv22027852m.g","KQ420377",131729,133322,1593
"14671","Ocbimv22012224m.g","KQ415905",851606,885652,34046
"14672","Ocbimv22037133m.g","KQ422938",65158,67336,2178
"14673","Ocbimv22001009m.g","KQ424147",312773,313279,506
"14674","Ocbimv22014766m.g","KQ418176",558289,559329,1040
"14675","Ocbimv22034760m.g","KQ422153",14329,28190,13861
"14676","Ocbimv22001673m.g","KQ416953",18,1146,1128
"14677","Ocbimv22003097m.g","KQ415796",167711,168262,551
"14678","Ocbimv22026073m.g","KQ419983",425625,427806,2181
"14679","Ocbimv22022868m.g","KQ419315",49010,56004,6994
"14680","Ocbimv22010335m.g","KQ417671",109498,123979,14481
"14681","Ocbimv22024888m.g","KQ419648",137663,141876,4213
"14682","Ocbimv22007291m.g","KQ417400",17814,21825,4011
"14683","Ocbimv22014962m.g","KQ418188",82099,89612,7513
"14684","Ocbimv22031401m.g","KQ421230",125537,151085,25548
"14685","Ocbimv22026580m.g","KQ416193",604991,608353,3362
"14686","Ocbimv22037291m.g","KQ422993",367503,371249,3746
"14687","Ocbimv22004787m.g","KQ425437",147331,240714,93383
"14688","Ocbimv22037130m.g","KQ422937",74897,75277,380
"14689","Ocbimv22015367m.g","KQ418231",362490,362847,357
"14690","Ocbimv22033248m.g","KQ421758",1392633,1394171,1538
"14691","Ocbimv22015100m.g","KQ418194",2633115,2640510,7395
"14692","Ocbimv22007094m.g","KQ417377",932000,941644,9644
"14693","Ocbimv22017808m.g","KQ418549",207254,207778,524
"14694","Ocbimv22025451m.g","KQ419803",105577,108318,2741
"14695","Ocbimv22034335m.g","KQ422016",218163,219935,1772
"14696","Ocbimv22010799m.g","KQ417715",157639,162072,4433
"14697","Ocbimv22027214m.g","KQ420220",164258,164781,523
"14698","Ocbimv22032904m.g","KQ421682",25206,41919,16713
"14699","Ocbimv22010969m.g","KQ417729",277540,277989,449
"14700","Ocbimv22032697m.g","KQ421638",19751,32026,12275
"14701","Ocbimv22029452m.g","KQ420752",150732,151598,866
"14702","Ocbimv22011500m.g","KQ417796",410482,412303,1821
"14703","Ocbimv22031883m.g","KQ421371",30067,30632,565
"14704","Ocbimv22002076m.g","KQ416985",90153,92622,2469
"14705","Ocbimv22014751m.g","KQ418175",398456,415691,17235
"14706","Ocbimv22016457m.g","KQ429885",698,10969,10271
"14707","Ocbimv22009526m.g","KQ415865",864142,900519,36377
"14708","Ocbimv22028949m.g","KQ420605",786187,794705,8518
"14709","Ocbimv22004107m.g","KQ417137",65599,65874,275
"14710","Ocbimv22008609m.g","KQ417510",823729,830281,6552
"14711","Ocbimv22036733m.g","KQ416655",371069,375544,4475
"14712","Ocbimv22006272m.g","KQ417309",49263,77792,28529
"14713","Ocbimv22004701m.g","KQ417198",391586,392589,1003
"14714","Ocbimv22003467m.g","KQ425015",414391,526757,112366
"14715","Ocbimv22038643m.g","KQ423430",696110,699093,2983
"14716","Ocbimv22020955m.g","KQ416036",65485,77634,12149
"14717","Ocbimv22036228m.g","KQ416626",408421,446769,38348
"14718","Ocbimv22026558m.g","KQ416193",65804,66060,256
"14719","Ocbimv22034849m.g","KQ422194",97310,98856,1546
"14720","Ocbimv22025399m.g","KQ419790",3821,20221,16400
"14721","Ocbimv22023981m.g","KQ419513",188871,189846,975
"14722","Ocbimv22032831m.g","KQ421664",1125348,1127349,2001
"14723","Ocbimv22024147m.g","KQ433829",20184,21447,1263
"14724","Ocbimv22019764m.g","KQ418811",1027653,1043324,15671
"14725","Ocbimv22027073m.g","KQ420175",115361,122376,7015
"14726","Ocbimv22010305m.g","KQ427350",568,15940,15372
"14727","Ocbimv22005824m.g","KQ417280",67225,67404,179
"14728","Ocbimv22029296m.g","KQ420698",103948,109552,5604
"14729","Ocbimv22008328m.g","KQ417497",693597,777725,84128
"14730","Ocbimv22000582m.g","KQ415778",10500,10808,308
"14731","Ocbimv22013001m.g","KQ428337",28608,49034,20426
"14732","Ocbimv22008193m.g","KQ417482",310008,382407,72399
"14733","Ocbimv22001750m.g","KQ416960",323505,323732,227
"14734","Ocbimv22001675m.g","KQ416953",185603,188843,3240
"14735","Ocbimv22003901m.g","LGKD01525814",1,345,344
"14736","Ocbimv22034612m.g","KQ416539",423692,424372,680
"14737","Ocbimv22038633m.g","KQ423425",119930,120208,278
"14738","Ocbimv22022125m.g","KQ419175",368855,415992,47137
"14739","Ocbimv22037901m.g","KQ423155",56668,56913,245
"14740","Ocbimv22012732m.g","KQ417931",1180331,1183326,2995
"14741","Ocbimv22034736m.g","KQ422138",352690,353280,590
"14742","Ocbimv22017213m.g","KQ418467",3982,4362,380
"14743","Ocbimv22039727m.g","KQ423737",10796,10960,164
"14744","Ocbimv22002754m.g","KQ417032",658687,660531,1844
"14745","Ocbimv22015516m.g","KQ415945",785740,792260,6520
"14746","Ocbimv22025328m.g","KQ419775",4073,8809,4736
"14747","Ocbimv22033421m.g","KQ421809",9671,58390,48719
"14748","Ocbimv22001081m.g","KQ424173",155949,176198,20249
"14749","Ocbimv22021100m.g","KQ419003",451061,451660,599
"14750","Ocbimv22024068m.g","KQ419532",3071,19668,16597
"14751","Ocbimv22023139m.g","KQ416081",191463,192284,821
"14752","Ocbimv22018533m.g","KQ430737",4905,16223,11318
"14753","Ocbimv22019013m.g","KQ418711",143117,143323,206
"14754","Ocbimv22037003m.g","KQ422903",488177,488533,356
"14755","Ocbimv22017053m.g","KQ418445",136567,137355,788
"14756","Ocbimv22020696m.g","KQ416032",79372,82191,2819
"14757","Ocbimv22033953m.g","KQ416501",74796,75350,554
"14758","Ocbimv22011619m.g","KQ417811",42321,58186,15865
"14759","Ocbimv22004611m.g","KQ417183",261705,272273,10568
"14760","Ocbimv22033956m.g","KQ416501",96644,103988,7344
"14761","Ocbimv22002792m.g","KQ417037",95845,97797,1952
"14762","Ocbimv22023340m.g","KQ419395",94565,95905,1340
"14763","Ocbimv22018807m.g","KQ416002",395603,423313,27710
"14764","Ocbimv22038759m.g","KQ416765",96964,98276,1312
"14765","Ocbimv22023533m.g","KQ419425",662236,676567,14331
"14766","Ocbimv22034429m.g","KQ422036",255713,257650,1937
"14767","Ocbimv22028578m.g","KQ420525",202199,223071,20872
"14768","Ocbimv22033609m.g","KQ421847",57145,60734,3589
"14769","Ocbimv22021466m.g","KQ416046",1744430,1746984,2554
"14770","Ocbimv22009663m.g","KQ427059",765148,799584,34436
"14771","Ocbimv22006527m.g","KQ417333",420428,426061,5633
"14772","Ocbimv22030510m.g","KQ421009",525259,525450,191
"14773","Ocbimv22025986m.g","KQ415696",165873,174168,8295
"14774","Ocbimv22029740m.g","KQ420814",237357,237767,410
"14775","Ocbimv22031992m.g","KQ421405",10642,45653,35011
"14776","Ocbimv22004070m.g","KQ425193",3304,3630,326
"14777","Ocbimv22003637m.g","KQ425059",7273,9476,2203
"14778","Ocbimv22006063m.g","KQ417293",341608,359504,17896
"14779","Ocbimv22007360m.g","KQ417408",86254,86571,317
"14780","Ocbimv22001889m.g","KQ424459",1310328,1360548,50220
"14781","Ocbimv22011337m.g","KQ417782",57765,84753,26988
"14782","Ocbimv22018855m.g","KQ430909",346,2237,1891
"14783","Ocbimv22020096m.g","KQ431455",4776,5246,470
"14784","Ocbimv22034567m.g","KQ422077",137584,216747,79163
"14785","Ocbimv22015785m.g","KQ418293",22015,30720,8705
"14786","Ocbimv22021786m.g","KQ419102",51693,52130,437
"14787","Ocbimv22010199m.g","KQ417655",221883,222059,176
"14788","Ocbimv22014053m.g","KQ428735",335299,341724,6425
"14789","Ocbimv22028523m.g","KQ420517",88871,89259,388
"14790","Ocbimv22035876m.g","KQ416608",695539,696839,1300
"14791","Ocbimv22028598m.g","KQ416263",543638,573290,29652
"14792","Ocbimv22035187m.g","KQ422300",41639,83649,42010
"14793","Ocbimv22019733m.g","KQ418807",46873,47711,838
"14794","Ocbimv22024876m.g","KQ419644",355079,355759,680
"14795","Ocbimv22033881m.g","KQ416497",43598,48557,4959
"14796","Ocbimv22003493m.g","KQ425019",35704,36238,534
"14797","Ocbimv22029216m.g","KQ420680",16,387,371
"14798","Ocbimv22037086m.g","KQ422919",1229187,1229450,263
"14799","Ocbimv22001509m.g","KQ424337",250499,252005,1506
"14800","Ocbimv22032761m.g","KQ421655",315458,330575,15117
"14801","Ocbimv22026461m.g","KQ420053",434323,439690,5367
"14802","Ocbimv22018144m.g","KQ418577",5357,5788,431
"14803","Ocbimv22033186m.g","KQ421742",135924,136482,558
"14804","Ocbimv22031411m.g","KQ421233",95062,122531,27469
"14805","Ocbimv22020633m.g","KQ418945",518961,556758,37797
"14806","Ocbimv22001240m.g","KQ424231",705693,733119,27426
"14807","Ocbimv22032158m.g","KQ421462",11448,13077,1629
"14808","Ocbimv22025612m.g","KQ419861",19995,37305,17310
"14809","Ocbimv22007943m.g","KQ426499",143840,157418,13578
"14810","Ocbimv22024642m.g","KQ419605",467747,477150,9403
"14811","Ocbimv22003520m.g","KQ425021",238315,257395,19080
"14812","Ocbimv22020110m.g","KQ418855",627992,629982,1990
"14813","Ocbimv22029062m.g","KQ420639",536271,537045,774
"14814","Ocbimv22035463m.g","KQ422391",68560,68772,212
"14815","Ocbimv22006376m.g","KQ417316",10213,13652,3439
"14816","Ocbimv22034695m.g","KQ416547",95939,100791,4852
"14817","Ocbimv22011374m.g","KQ417791",267478,272489,5011
"14818","Ocbimv22022668m.g","KQ419279",111211,118950,7739
"14819","Ocbimv22030281m.g","KQ420938",3953,4189,236
"14820","Ocbimv22036179m.g","KQ422666",17003,22322,5319
"14821","Ocbimv22003707m.g","KQ417101",346198,356378,10180
"14822","Ocbimv22020364m.g","KQ418900",393288,410284,16996
"14823","Ocbimv22021582m.g","KQ419080",478751,480985,2234
"14824","Ocbimv22016551m.g","KQ418367",387903,391190,3287
"14825","Ocbimv22008281m.g","KQ417493",263221,263421,200
"14826","Ocbimv22001526m.g","KQ424345",17493,19074,1581
"14827","Ocbimv22018253m.g","KQ418587",424637,439705,15068
"14828","Ocbimv22001664m.g","KQ416951",488434,499629,11195
"14829","Ocbimv22035117m.g","KQ416574",370457,371101,644
"14830","Ocbimv22017818m.g","KQ418549",734931,735356,425
"14831","Ocbimv22002185m.g","KQ424569",164882,167735,2853
"14832","Ocbimv22025669m.g","KQ419883",39070,67197,28127
"14833","Ocbimv22016927m.g","KQ430088",9429,37822,28393
"14834","Ocbimv22030091m.g","KQ420886",268917,272722,3805
"14835","Ocbimv22009256m.g","KQ417578",836532,877366,40834
"14836","Ocbimv22019294m.g","KQ431076",50344,50542,198
"14837","Ocbimv22026636m.g","KQ420083",83511,226627,143116
"14838","Ocbimv22025855m.g","KQ419916",6702,32926,26224
"14839","Ocbimv22013520m.g","KQ428540",54787,62788,8001
"14840","Ocbimv22008807m.g","KQ426774",184849,192003,7154
"14841","Ocbimv22013783m.g","KQ428662",168949,169311,362
"14842","Ocbimv22006895m.g","KQ417360",2331,4256,1925
"14843","Ocbimv22004064m.g","KQ425191",191657,191966,309
"14844","Ocbimv22016764m.g","KQ418393",487734,495494,7760
"14845","Ocbimv22001335m.g","KQ424278",43729,57331,13602
"14846","Ocbimv22013952m.g","KQ418073",65121,79290,14169
"14847","Ocbimv22021006m.g","KQ431922",140371,145019,4648
"14848","Ocbimv22005905m.g","KQ417284",111574,111957,383
"14849","Ocbimv22032530m.g","KQ421578",12051,12251,200
"14850","Ocbimv22036951m.g","KQ416666",1447070,1539526,92456
"14851","Ocbimv22014059m.g","KQ415672",189539,293001,103462
"14852","Ocbimv22004086m.g","KQ417134",6256,6486,230
"14853","Ocbimv22022413m.g","KQ416068",86101,86358,257
"14854","Ocbimv22002688m.g","KQ417026",2363,2761,398
"14855","Ocbimv22009084m.g","KQ426865",102422,325861,223439
"14856","Ocbimv22012766m.g","KQ417938",550467,551428,961
"14857","Ocbimv22030129m.g","KQ420902",161893,164084,2191
"14858","Ocbimv22022968m.g","KQ416079",332221,342574,10353
"14859","Ocbimv22025150m.g","KQ416139",143809,144486,677
"14860","Ocbimv22004755m.g","KQ417205",273,707,434
"14861","Ocbimv22028701m.g","KQ416267",41076,41531,455
"14862","Ocbimv22031723m.g","KQ421325",222582,230537,7955
"14863","Ocbimv22034511m.g","KQ422063",240945,241157,212
"14864","Ocbimv22005092m.g","KQ425519",237334,237522,188
"14865","Ocbimv22017010m.g","LGKD01632193",172,690,518
"14866","Ocbimv22036092m.g","KQ416616",2334733,2412436,77703
"14867","Ocbimv22035647m.g","KQ422489",224791,225851,1060
"14868","Ocbimv22033861m.g","KQ421896",264344,265047,703
"14869","Ocbimv22011714m.g","KQ417824",807882,808448,566
"14870","Ocbimv22028198m.g","KQ420442",105616,107894,2278
"14871","Ocbimv22008713m.g","KQ417523",13543,21584,8041
"14872","Ocbimv22039901m.g","KQ416834",195768,205011,9243
"14873","Ocbimv22001789m.g","KQ424420",138601,140754,2153
"14874","Ocbimv22023946m.g","KQ433721",8600,15680,7080
"14875","Ocbimv22032542m.g","KQ421581",92208,144152,51944
"14876","Ocbimv22010478m.g","KQ417681",610811,610960,149
"14877","Ocbimv22010913m.g","KQ417724",709225,709868,643
"14878","Ocbimv22009444m.g","KQ426997",37035,54847,17812
"14879","Ocbimv22034247m.g","KQ422015",73688,84659,10971
"14880","Ocbimv22038854m.g","KQ415768",579627,607406,27779
"14881","Ocbimv22036928m.g","KQ416666",412540,413638,1098
"14882","Ocbimv22011058m.g","KQ417741",971245,991869,20624
"14883","Ocbimv22006704m.g","KQ426075",424979,430251,5272
"14884","Ocbimv22013978m.g","KQ418074",2757,14728,11971
"14885","Ocbimv22017575m.g","KQ418507",49498,53749,4251
"14886","Ocbimv22022548m.g","KQ432838",23974,95308,71334
"14887","Ocbimv22009558m.g","KQ415865",1792420,1794736,2316
"14888","Ocbimv22000801m.g","KQ424072",248005,248977,972
"14889","Ocbimv22014724m.g","KQ429042",24077,24576,499
"14890","Ocbimv22017753m.g","KQ418537",541029,543618,2589
"14891","Ocbimv22035858m.g","KQ422583",8,1548,1540
"14892","Ocbimv22009871m.g","KQ417621",119165,119707,542
"14893","Ocbimv22039375m.g","KQ423634",187579,263268,75689
"14894","Ocbimv22014681m.g","KQ418168",394445,416126,21681
"14895","Ocbimv22009459m.g","KQ427011",19173,50467,31294
"14896","Ocbimv22029681m.g","KQ420800",20236,21989,1753
"14897","Ocbimv22006710m.g","KQ426075",507090,538528,31438
"14898","Ocbimv22000260m.g","KQ423908",115113,115637,524
"14899","Ocbimv22019448m.g","KQ431136",7912,18903,10991
"14900","Ocbimv22024320m.g","KQ419566",633154,635306,2152
"14901","Ocbimv22020081m.g","KQ418849",514743,515242,499
"14902","Ocbimv22014450m.g","KQ415930",296784,329494,32710
"14903","Ocbimv22019218m.g","KQ431058",30768,44103,13335
"14904","Ocbimv22000580m.g","KQ424005",62576,71538,8962
"14905","Ocbimv22009257m.g","KQ417578",857123,858141,1018
"14906","Ocbimv22007269m.g","KQ426278",424,1373,949
"14907","Ocbimv22036153m.g","KQ422659",178503,180848,2345
"14908","Ocbimv22023521m.g","LGKD01689516",41,568,527
"14909","Ocbimv22033480m.g","KQ416483",39710,42490,2780
"14910","Ocbimv22029469m.g","KQ416308",466446,473141,6695
"14911","Ocbimv22016749m.g","KQ415969",53394,53570,176
"14912","Ocbimv22028137m.g","KQ416251",1087308,1112770,25462
"14913","Ocbimv22021869m.g","KQ419115",16108,16340,232
"14914","Ocbimv22010831m.g","KQ417717",118864,173600,54736
"14915","Ocbimv22028250m.g","KQ415659",151663,226137,74474
"14916","Ocbimv22004586m.g","KQ417182",1898,25635,23737
"14917","Ocbimv22004716m.g","KQ417199",233584,250448,16864
"14918","Ocbimv22004580m.g","KQ425371",41954,42801,847
"14919","Ocbimv22039680m.g","KQ416813",1490378,1490959,581
"14920","Ocbimv22011709m.g","KQ417824",504962,505291,329
"14921","Ocbimv22014644m.g","KQ429020",19,1252,1233
"14922","Ocbimv22028386m.g","KQ416257",550670,568921,18251
"14923","Ocbimv22010815m.g","KQ427527",48238,54508,6270
"14924","Ocbimv22011738m.g","KQ427887",19201,19458,257
"14925","Ocbimv22012997m.g","KQ428333",91618,92004,386
"14926","Ocbimv22005079m.g","KQ425516",206908,242711,35803
"14927","Ocbimv22008227m.g","KQ415852",676903,678466,1563
"14928","Ocbimv22037511m.g","KQ416699",52476,77475,24999
"14929","Ocbimv22020698m.g","KQ416032",94655,116277,21622
"14930","Ocbimv22018700m.g","KQ418655",4120,4540,420
"14931","Ocbimv22004357m.g","KQ417152",471174,473934,2760
"14932","Ocbimv22025196m.g","KQ419727",457517,471777,14260
"14933","Ocbimv22020177m.g","KQ418869",87382,87928,546
"14934","Ocbimv22003375m.g","KQ424999",4267,120341,116074
"14935","Ocbimv22004139m.g","KQ425218",56687,62234,5547
"14936","Ocbimv22034149m.g","KQ421988",20043,20840,797
"14937","Ocbimv22035627m.g","KQ422481",180775,188666,7891
"14938","Ocbimv22004185m.g","KQ425220",335643,366406,30763
"14939","Ocbimv22037224m.g","KQ416684",382614,382913,299
"14940","Ocbimv22023118m.g","KQ419350",858631,859660,1029
"14941","Ocbimv22027482m.g","KQ416225",371485,373231,1746
"14942","Ocbimv22006932m.g","KQ426154",166289,178401,12112
"14943","Ocbimv22039602m.g","LGKD01484220",42,209,167
"14944","Ocbimv22006455m.g","KQ425927",66010,66407,397
"14945","Ocbimv22014066m.g","LGKD01606184",294,662,368
"14946","Ocbimv22010706m.g","KQ417704",95345,133824,38479
"14947","Ocbimv22015012m.g","KQ418194",272069,275002,2933
"14948","Ocbimv22006688m.g","KQ426075",173005,202853,29848
"14949","Ocbimv22025684m.g","KQ419886",339987,354229,14242
"14950","Ocbimv22031515m.g","KQ421263",789131,791756,2625
"14951","Ocbimv22039804m.g","KQ423759",36959,38398,1439
"14952","Ocbimv22016782m.g","KQ415970",105860,106090,230
"14953","Ocbimv22020982m.g","LGKD01664232",22,171,149
"14954","Ocbimv22034197m.g","KQ422005",16931,25875,8944
"14955","Ocbimv22038669m.g","KQ423432",547545,554897,7352
"14956","Ocbimv22020637m.g","KQ418945",712803,754300,41497
"14957","Ocbimv22014280m.g","KQ415926",41209,42780,1571
"14958","Ocbimv22010688m.g","KQ415880",5942,6109,167
"14959","Ocbimv22008757m.g","KQ426760",179581,180178,597
"14960","Ocbimv22033911m.g","KQ421906",420530,422988,2458
"14961","Ocbimv22010798m.g","KQ417715",141185,142392,1207
"14962","Ocbimv22038794m.g","KQ415767",797558,797965,407
"14963","Ocbimv22010623m.g","KQ415669",1528458,1531837,3379
"14964","Ocbimv22018495m.g","KQ418627",382918,383268,350
"14965","Ocbimv22029281m.g","KQ420696",456758,462251,5493
"14966","Ocbimv22032813m.g","KQ416451",292820,293828,1008
"14967","Ocbimv22001743m.g","KQ424399",22985,31457,8472
"14968","Ocbimv22024061m.g","LGKD01695337",1,474,473
"14969","Ocbimv22030502m.g","KQ416353",280891,282133,1242
"14970","Ocbimv22027710m.g","KQ420347",87241,87444,203
"14971","Ocbimv22025923m.g","KQ419927",1947351,1947638,287
"14972","Ocbimv22007115m.g","KQ417380",51636,54848,3212
"14973","Ocbimv22000110m.g","KQ423864",201467,202759,1292
"14974","Ocbimv22026110m.g","KQ419989",549988,553384,3396
"14975","Ocbimv22012994m.g","KQ428333",29859,32371,2512
"14976","Ocbimv22012530m.g","KQ417917",722743,724147,1404
"14977","Ocbimv22004830m.g","KQ417209",114935,124738,9803
"14978","Ocbimv22020547m.g","LGKD01661112",15,320,305
"14979","Ocbimv22004223m.g","KQ425237",18412,22986,4574
"14980","Ocbimv22025068m.g","KQ419691",156942,204657,47715
"14981","Ocbimv22023556m.g","KQ419432",98584,99220,636
"14982","Ocbimv22020172m.g","KQ418866",234085,239865,5780
"14983","Ocbimv22035018m.g","KQ416568",3654,22793,19139
"14984","Ocbimv22015811m.g","KQ418295",107544,114014,6470
"14985","Ocbimv22009830m.g","KQ417620",479552,482361,2809
"14986","Ocbimv22012636m.g","KQ428192",32886,60134,27248
"14987","Ocbimv22007519m.g","KQ417420",201975,205718,3743
"14988","Ocbimv22003592m.g","KQ417094",224483,226978,2495
"14989","Ocbimv22001601m.g","KQ424367",204259,210530,6271
"14990","Ocbimv22038850m.g","KQ415768",163310,164926,1616
"14991","Ocbimv22023610m.g","KQ433503",159483,162382,2899
"14992","Ocbimv22039918m.g","KQ423796",38527,39081,554
"14993","Ocbimv22007707m.g","KQ426429",7065,9828,2763
"14994","Ocbimv22012744m.g","KQ417934",1042013,1042779,766
"14995","Ocbimv22011648m.g","KQ427830",260139,285386,25247
"14996","Ocbimv22003591m.g","KQ417094",212029,212741,712
"14997","Ocbimv22022428m.g","KQ419216",83360,83678,318
"14998","Ocbimv22027527m.g","KQ420299",161120,163835,2715
"14999","Ocbimv22037025m.g","KQ422909",257225,300251,43026
"15000","Ocbimv22037320m.g","KQ423001",323411,324098,687
"15001","Ocbimv22021482m.g","KQ419056",137339,148714,11375
"15002","Ocbimv22021255m.g","KQ419020",249739,304287,54548
"15003","Ocbimv22024711m.g","KQ419621",59723,78419,18696
"15004","Ocbimv22000161m.g","KQ416846",137179,147800,10621
"15005","Ocbimv22003435m.g","KQ417087",1048122,1068611,20489
"15006","Ocbimv22011728m.g","KQ427878",8312,26067,17755
"15007","Ocbimv22003213m.g","KQ424906",104959,133319,28360
"15008","Ocbimv22036157m.g","KQ422660",20393,22660,2267
"15009","Ocbimv22001219m.g","KQ424229",351006,353455,2449
"15010","Ocbimv22008045m.g","KQ417476",21699,26890,5191
"15011","Ocbimv22028969m.g","KQ416278",61005,61346,341
"15012","Ocbimv22026832m.g","KQ420126",216673,217050,377
"15013","Ocbimv22036784m.g","KQ416657",115064,116723,1659
"15014","Ocbimv22011110m.g","KQ427639",32308,34296,1988
"15015","Ocbimv22012568m.g","KQ417917",1432024,1432230,206
"15016","Ocbimv22028586m.g","KQ416263",16634,17119,485
"15017","Ocbimv22028582m.g","KQ420525",337049,339210,2161
"15018","Ocbimv22001164m.g","KQ416913",179358,199854,20496
"15019","Ocbimv22029092m.g","KQ420645",51263,52216,953
"15020","Ocbimv22009543m.g","KQ415865",1154150,1169253,15103
"15021","Ocbimv22008219m.g","KQ426584",10031,48614,38583
"15022","Ocbimv22002064m.g","KQ424530",766242,769895,3653
"15023","Ocbimv22026662m.g","KQ416196",164121,171580,7459
"15024","Ocbimv22027090m.g","KQ420178",43631,43948,317
"15025","Ocbimv22030564m.g","KQ421022",245907,249203,3296
"15026","Ocbimv22009497m.g","KQ415865",453841,454170,329
"15027","Ocbimv22012629m.g","KQ417921",1329298,1330396,1098
"15028","Ocbimv22020061m.g","KQ418848",6998,22092,15094
"15029","Ocbimv22018573m.g","KQ418642",3368,3913,545
"15030","Ocbimv22015920m.g","KQ418303",284980,299986,15006
"15031","Ocbimv22021204m.g","KQ432038",149124,197884,48760
"15032","Ocbimv22010601m.g","KQ417698",61281,62875,1594
"15033","Ocbimv22025752m.g","KQ419903",207886,208377,491
"15034","Ocbimv22021592m.g","KQ432245",18384,26451,8067
"15035","Ocbimv22002358m.g","KQ417004",57228,57809,581
"15036","Ocbimv22017634m.g","KQ418518",157424,157786,362
"15037","Ocbimv22000794m.g","KQ424069",31390,33722,2332
"15038","Ocbimv22023189m.g","KQ419368",368975,424923,55948
"15039","Ocbimv22014024m.g","KQ418079",362585,375677,13092
"15040","Ocbimv22007130m.g","KQ417381",104685,111402,6717
"15041","Ocbimv22022310m.g","KQ419194",194735,227129,32394
"15042","Ocbimv22012045m.g","KQ427990",11899,12333,434
"15043","Ocbimv22000298m.g","KQ415775",417229,465197,47968
"15044","Ocbimv22026973m.g","KQ416207",276366,286218,9852
"15045","Ocbimv22005571m.g","KQ425655",79505,105682,26177
"15046","Ocbimv22008356m.g","KQ417498",133699,142979,9280
"15047","Ocbimv22015249m.g","KQ418215",157407,172268,14861
"15048","Ocbimv22038834m.g","KQ416768",158045,237832,79787
"15049","Ocbimv22001258m.g","KQ424243",200976,241091,40115
"15050","Ocbimv22026183m.g","KQ420011",159095,174977,15882
"15051","Ocbimv22038252m.g","KQ423250",350846,355563,4717
"15052","Ocbimv22018480m.g","KQ430703",1841,4200,2359
"15053","Ocbimv22030940m.g","KQ421124",137339,137623,284
"15054","Ocbimv22004931m.g","KQ425475",71345,73503,2158
"15055","Ocbimv22034909m.g","KQ422211",153585,168086,14501
"15056","Ocbimv22012251m.g","KQ428084",314,1256,942
"15057","Ocbimv22025337m.g","KQ419775",309169,310347,1178
"15058","Ocbimv22009591m.g","KQ427035",31115,108296,77181
"15059","Ocbimv22020058m.g","KQ418847",118334,118786,452
"15060","Ocbimv22007371m.g","KQ426313",306411,360792,54381
"15061","Ocbimv22014372m.g","KQ415673",63147,67678,4531
"15062","Ocbimv22007068m.g","KQ417374",226370,249764,23394
"15063","Ocbimv22032359m.g","KQ421523",1568954,1569319,365
"15064","Ocbimv22039875m.g","KQ416832",257535,293958,36423
"15065","Ocbimv22037298m.g","KQ422997",144838,172468,27630
"15066","Ocbimv22006899m.g","KQ426136",22109,23393,1284
"15067","Ocbimv22026103m.g","KQ419989",445750,448318,2568
"15068","Ocbimv22015944m.g","KQ418303",1480542,1496168,15626
"15069","Ocbimv22039422m.g","KQ423654",117558,118296,738
"15070","Ocbimv22034272m.g","KQ422015",385553,458010,72457
"15071","Ocbimv22014040m.g","KQ428727",14889,34143,19254
"15072","Ocbimv22011498m.g","KQ417796",365068,389405,24337
"15073","Ocbimv22016671m.g","KQ418378",81655,81903,248
"15074","Ocbimv22020539m.g","KQ418922",1214167,1214520,353
"15075","Ocbimv22011079m.g","KQ417746",103843,104037,194
"15076","Ocbimv22002724m.g","KQ424762",20380,30026,9646
"15077","Ocbimv22017867m.g","KQ418552",453190,458248,5058
"15078","Ocbimv22012781m.g","KQ428240",1681,18881,17200
"15079","Ocbimv22001571m.g","KQ424361",106547,147658,41111
"15080","Ocbimv22015346m.g","KQ415942",140237,152715,12478
"15081","Ocbimv22010360m.g","KQ427365",9054,9356,302
"15082","Ocbimv22028076m.g","KQ416246",412303,413312,1009
"15083","Ocbimv22015521m.g","KQ415945",824525,828421,3896
"15084","Ocbimv22016933m.g","KQ430090",20019,31344,11325
"15085","Ocbimv22028079m.g","KQ420427",186139,200361,14222
"15086","Ocbimv22004535m.g","KQ415805",2006224,2036052,29828
"15087","Ocbimv22025061m.g","KQ419690",33944,35786,1842
"15088","Ocbimv22037738m.g","KQ416708",286819,290629,3810
"15089","Ocbimv22008031m.g","KQ426535",166781,167119,338
"15090","Ocbimv22039065m.g","KQ423531",407986,417287,9301
"15091","Ocbimv22026411m.g","KQ420047",90885,100488,9603
"15092","Ocbimv22014827m.g","KQ429096",511152,538130,26978
"15093","Ocbimv22013625m.g","KQ418039",778522,789113,10591
"15094","Ocbimv22033719m.g","KQ416494",42070,42894,824
"15095","Ocbimv22025656m.g","KQ419877",119627,120534,907
"15096","Ocbimv22010273m.g","KQ427344",27971,45933,17962
"15097","Ocbimv22007045m.g","KQ417371",155057,179997,24940
"15098","Ocbimv22033028m.g","KQ421720",191796,196084,4288
"15099","Ocbimv22022283m.g","KQ419192",612083,639749,27666
"15100","Ocbimv22000090m.g","KQ416839",152004,160045,8041
"15101","Ocbimv22033624m.g","KQ416489",24931,27404,2473
"15102","Ocbimv22024709m.g","KQ419620",13901,36738,22837
"15103","Ocbimv22009298m.g","KQ417581",81992,93502,11510
"15104","Ocbimv22025836m.g","KQ416171",237218,239401,2183
"15105","Ocbimv22028817m.g","KQ416272",628223,631569,3346
"15106","Ocbimv22024929m.g","KQ419658",227346,227550,204
"15107","Ocbimv22014014m.g","KQ428720",110796,118652,7856
"15108","Ocbimv22003147m.g","KQ424897",249912,250976,1064
"15109","Ocbimv22006893m.g","KQ415836",71498,71665,167
"15110","Ocbimv22006149m.g","KQ417300",835702,847614,11912
"15111","Ocbimv22016545m.g","KQ418367",242774,247326,4552
"15112","Ocbimv22013023m.g","KQ417975",755475,809846,54371
"15113","Ocbimv22007843m.g","KQ417455",82504,103301,20797
"15114","Ocbimv22034737m.g","KQ422138",353527,373766,20239
"15115","Ocbimv22024080m.g","KQ419533",302040,306202,4162
"15116","Ocbimv22001140m.g","KQ424206",44342,46325,1983
"15117","Ocbimv22011562m.g","KQ417804",32737,60360,27623
"15118","Ocbimv22028260m.g","KQ415659",716061,717854,1793
"15119","Ocbimv22007097m.g","KQ417377",1120713,1173592,52879
"15120","Ocbimv22026403m.g","KQ420039",545877,546167,290
"15121","Ocbimv22022931m.g","KQ419327",2552,118070,115518
"15122","Ocbimv22029753m.g","KQ415712",827184,827360,176
"15123","Ocbimv22000845m.g","KQ415664",481169,486722,5553
"15124","Ocbimv22026244m.g","KQ420020",641876,643320,1444
"15125","Ocbimv22010700m.g","KQ417704",11664,19407,7743
"15126","Ocbimv22035244m.g","KQ422340",171255,181038,9783
"15127","Ocbimv22035060m.g","KQ422263",141257,187945,46688
"15128","Ocbimv22021425m.g","KQ432145",2924,3237,313
"15129","Ocbimv22037486m.g","KQ416697",672678,672977,299
"15130","Ocbimv22020312m.g","KQ418888",185950,187741,1791
"15131","Ocbimv22001296m.g","KQ424257",77992,78612,620
"15132","Ocbimv22012580m.g","KQ417917",1700795,1703212,2417
"15133","Ocbimv22017597m.g","KQ415979",37275,77078,39803
"15134","Ocbimv22028909m.g","KQ416274",1407703,1407921,218
"15135","Ocbimv22021360m.g","KQ416042",2068460,2081892,13432
"15136","Ocbimv22006119m.g","KQ417300",65123,95937,30814
"15137","Ocbimv22007137m.g","KQ417381",196311,203890,7579
"15138","Ocbimv22020574m.g","KQ418926",194172,202635,8463
"15139","Ocbimv22034424m.g","KQ416531",1125,20514,19389
"15140","Ocbimv22000070m.g","KQ423846",136207,138165,1958
"15141","Ocbimv22011651m.g","KQ427833",70973,71461,488
"15142","Ocbimv22037665m.g","KQ416705",2061931,2062743,812
"15143","Ocbimv22004239m.g","KQ417143",225501,265334,39833
"15144","Ocbimv22024101m.g","KQ419533",967060,967278,218
"15145","Ocbimv22013144m.g","KQ417988",23797,25275,1478
"15146","Ocbimv22000262m.g","KQ423910",8645,67535,58890
"15147","Ocbimv22026525m.g","KQ416191",294879,295103,224
"15148","Ocbimv22022219m.g","KQ416062",128963,129517,554
"15149","Ocbimv22018162m.g","KQ418580",781006,781224,218
"15150","Ocbimv22034264m.g","KQ422015",248705,325137,76432
"15151","Ocbimv22019595m.g","KQ418789",264090,271789,7699
"15152","Ocbimv22017574m.g","KQ418507",19056,46740,27684
"15153","Ocbimv22013158m.g","LGKD01599657",62,160,98
"15154","Ocbimv22020193m.g","KQ418873",179712,185440,5728
"15155","Ocbimv22024998m.g","KQ419678",1893,3187,1294
"15156","Ocbimv22012614m.g","KQ417921",351324,362253,10929
"15157","Ocbimv22022152m.g","KQ419176",544000,544978,978
"15158","Ocbimv22012777m.g","KQ417939",635800,656244,20444
"15159","Ocbimv22010510m.g","LGKD01579922",197,346,149
"15160","Ocbimv22039525m.g","KQ423686",270087,286745,16658
"15161","Ocbimv22038548m.g","KQ423395",139542,170499,30957
"15162","Ocbimv22000339m.g","KQ416854",510977,511262,285
"15163","Ocbimv22037430m.g","KQ416694",2896540,2943335,46795
"15164","Ocbimv22032951m.g","KQ421693",469089,490725,21636
"15165","Ocbimv22029319m.g","KQ416297",100534,107623,7089
"15166","Ocbimv22023916m.g","KQ433703",3389,4500,1111
"15167","Ocbimv22036909m.g","KQ422894",355872,368453,12581
"15168","Ocbimv22006943m.g","KQ426160",57123,58493,1370
"15169","Ocbimv22001877m.g","KQ424459",43148,65588,22440
"15170","Ocbimv22014571m.g","KQ428991",30884,31996,1112
"15171","Ocbimv22035545m.g","KQ416591",173658,176269,2611
"15172","Ocbimv22034780m.g","KQ422171",43983,44171,188
"15173","Ocbimv22034577m.g","KQ422077",235395,251528,16133
"15174","Ocbimv22031006m.g","KQ421143",484541,486531,1990
"15175","Ocbimv22022342m.g","KQ416065",15873,16100,227
"15176","Ocbimv22034018m.g","KQ421946",391086,437335,46249
"15177","Ocbimv22002028m.g","KQ424515",69540,70460,920
"15178","Ocbimv22003980m.g","KQ425165",117912,118082,170
"15179","Ocbimv22002905m.g","KQ424815",345068,345472,404
"15180","Ocbimv22033698m.g","KQ416491",454577,482652,28075
"15181","Ocbimv22012353m.g","KQ417905",67768,68049,281
"15182","Ocbimv22009056m.g","KQ417555",63914,64441,527
"15183","Ocbimv22011673m.g","KQ417816",95914,113371,17457
"15184","Ocbimv22026824m.g","KQ420123",732159,732713,554
"15185","Ocbimv22021351m.g","KQ416042",1545631,1587836,42205
"15186","Ocbimv22016840m.g","KQ418411",71324,137997,66673
"15187","Ocbimv22009838m.g","KQ417620",684616,687444,2828
"15188","Ocbimv22027751m.g","KQ420357",152819,157456,4637
"15189","Ocbimv22000889m.g","KQ424103",314812,315594,782
"15190","Ocbimv22038327m.g","KQ423283",38883,39756,873
"15191","Ocbimv22026711m.g","KQ420096",378202,388033,9831
"15192","Ocbimv22029305m.g","KQ420703",23032,31546,8514
"15193","Ocbimv22019730m.g","KQ431280",159868,161524,1656
"15194","Ocbimv22009364m.g","KQ417587",175362,176090,728
"15195","Ocbimv22025620m.g","KQ419861",551258,638447,87189
"15196","Ocbimv22002995m.g","KQ424859",205412,215076,9664
"15197","Ocbimv22026210m.g","KQ420017",308448,315194,6746
"15198","Ocbimv22013177m.g","KQ428414",8245,19404,11159
"15199","Ocbimv22009787m.g","KQ427132",353826,412294,58468
"15200","Ocbimv22020725m.g","KQ418956",182861,249817,66956
"15201","Ocbimv22026160m.g","KQ420006",454702,454950,248
"15202","Ocbimv22027866m.g","KQ420383",2845,4484,1639
"15203","Ocbimv22019443m.g","KQ418767",355697,361537,5840
"15204","Ocbimv22015486m.g","KQ418261",98839,98988,149
"15205","Ocbimv22005587m.g","KQ425656",41659,41928,269
"15206","Ocbimv22023037m.g","KQ433192",79470,90083,10613
"15207","Ocbimv22006580m.g","KQ426026",130933,190889,59956
"15208","Ocbimv22037834m.g","KQ423139",358301,359637,1336
"15209","Ocbimv22039948m.g","KQ423808",184773,188192,3419
"15210","Ocbimv22028764m.g","KQ420579",373470,393227,19757
"15211","Ocbimv22039393m.g","LGKD01481694",8,121,113
"15212","Ocbimv22008567m.g","KQ417510",61,18042,17981
"15213","Ocbimv22004866m.g","KQ425457",155836,157973,2137
"15214","Ocbimv22036071m.g","KQ416616",934854,951481,16627
"15215","Ocbimv22016816m.g","KQ418406",7168,58500,51332
"15216","Ocbimv22017519m.g","KQ418504",63473,64706,1233
"15217","Ocbimv22002800m.g","KQ417037",255695,279797,24102
"15218","Ocbimv22009933m.g","KQ417623",372388,384711,12323
"15219","Ocbimv22034687m.g","KQ416547",73515,86013,12498
"15220","Ocbimv22000527m.g","KQ416865",183136,186480,3344
"15221","Ocbimv22020354m.g","KQ418900",109108,123141,14033
"15222","Ocbimv22024329m.g","KQ433953",3,478,475
"15223","Ocbimv22012819m.g","LGKD01596899",1,604,603
"15224","Ocbimv22008566m.g","KQ426704",73784,78319,4535
"15225","Ocbimv22036594m.g","KQ422794",495803,539486,43683
"15226","Ocbimv22031062m.g","KQ416383",11137,26459,15322
"15227","Ocbimv22027554m.g","KQ420301",100894,102820,1926
"15228","Ocbimv22024726m.g","KQ419621",1267889,1268200,311
"15229","Ocbimv22018350m.g","KQ418610",18781,35780,16999
"15230","Ocbimv22015660m.g","KQ418273",350466,350855,389
"15231","Ocbimv22021282m.g","KQ419023",32457,33446,989
"15232","Ocbimv22038820m.g","KQ423474",14957,26546,11589
"15233","Ocbimv22026356m.g","KQ420033",7754,17415,9661
"15234","Ocbimv22037860m.g","KQ423141",25014,54010,28996
"15235","Ocbimv22015237m.g","KQ415940",843590,843817,227
"15236","Ocbimv22004518m.g","LGKD01530975",40,531,491
"15237","Ocbimv22038530m.g","LGKD01472870",1,894,893
"15238","Ocbimv22008881m.g","KQ426791",618342,618779,437
"15239","Ocbimv22008987m.g","KQ426828",105820,217006,111186
"15240","Ocbimv22007842m.g","KQ417455",39380,52231,12851
"15241","Ocbimv22004684m.g","KQ417198",113773,114480,707
"15242","Ocbimv22012198m.g","KQ417887",464279,467375,3096
"15243","Ocbimv22033628m.g","KQ421852",140871,203991,63120
"15244","Ocbimv22014226m.g","KQ418104",757977,758189,212
"15245","Ocbimv22034083m.g","KQ421961",310929,311111,182
"15246","Ocbimv22012937m.g","KQ428301",517,56814,56297
"15247","Ocbimv22007673m.g","KQ426422",3649,4191,542
"15248","Ocbimv22023077m.g","KQ419344",21825,32289,10464
"15249","Ocbimv22026412m.g","KQ420047",103118,113323,10205
"15250","Ocbimv22016126m.g","KQ418320",670468,672592,2124
"15251","Ocbimv22017436m.g","KQ418496",47622,60104,12482
"15252","Ocbimv22015924m.g","KQ418303",925323,925700,377
"15253","Ocbimv22032563m.g","KQ421593",636,123539,122903
"15254","Ocbimv22038479m.g","KQ416745",397865,457473,59608
"15255","Ocbimv22010768m.g","KQ427511",88895,90267,1372
"15256","Ocbimv22023611m.g","KQ419441",47638,48128,490
"15257","Ocbimv22002187m.g","KQ424569",185806,188186,2380
"15258","Ocbimv22037230m.g","KQ416684",487027,552837,65810
"15259","Ocbimv22010593m.g","KQ417694",37976,38370,394
"15260","Ocbimv22001535m.g","KQ424350",290609,293534,2925
"15261","Ocbimv22011802m.g","KQ415893",27972,28160,188
"15262","Ocbimv22011100m.g","KQ417747",738018,738416,398
"15263","Ocbimv22028240m.g","KQ416254",258796,259731,935
"15264","Ocbimv22038392m.g","KQ423307",1,289,288
"15265","Ocbimv22032246m.g","KQ421495",23640,24068,428
"15266","Ocbimv22004726m.g","KQ425428",735,998,263
"15267","Ocbimv22017590m.g","LGKD01636764",3,200,197
"15268","Ocbimv22002374m.g","KQ415792",275798,300066,24268
"15269","Ocbimv22026242m.g","KQ420017",1161787,1198270,36483
"15270","Ocbimv22034548m.g","KQ416536",522852,523517,665
"15271","Ocbimv22014716m.g","KQ429040",197614,198363,749
"15272","Ocbimv22022440m.g","KQ419216",173447,181825,8378
"15273","Ocbimv22015649m.g","KQ429437",1858,2013,155
"15274","Ocbimv22001369m.g","KQ424289",54,17126,17072
"15275","Ocbimv22018773m.g","KQ418671",89573,96430,6857
"15276","Ocbimv22009577m.g","KQ427029",90391,90657,266
"15277","Ocbimv22016050m.g","LGKD01623921",191,1774,1583
"15278","Ocbimv22022869m.g","KQ419315",56106,57096,990
"15279","Ocbimv22028289m.g","KQ420458",123416,128268,4852
"15280","Ocbimv22036544m.g","KQ422789",343,18889,18546
"15281","Ocbimv22033688m.g","KQ416490",1261087,1261239,152
"15282","Ocbimv22021755m.g","KQ419094",334794,337205,2411
"15283","Ocbimv22034512m.g","KQ422066",1,68222,68221
"15284","Ocbimv22027754m.g","KQ420358",18273,21722,3449
"15285","Ocbimv22019310m.g","KQ418747",634418,635146,728
"15286","Ocbimv22015171m.g","KQ418202",106208,106730,522
"15287","Ocbimv22009426m.g","KQ417591",1534318,1565302,30984
"15288","Ocbimv22012017m.g","KQ427969",4098,7184,3086
"15289","Ocbimv22006687m.g","KQ426075",107637,142553,34916
"15290","Ocbimv22010952m.g","KQ417726",416625,454933,38308
"15291","Ocbimv22008929m.g","KQ417540",515737,517053,1316
"15292","Ocbimv22006960m.g","KQ426166",8338,8673,335
"15293","Ocbimv22013362m.g","KQ428462",105831,134222,28391
"15294","Ocbimv22024556m.g","KQ434044",3748,4440,692
"15295","Ocbimv22033224m.g","KQ421758",251994,256186,4192
"15296","Ocbimv22018387m.g","KQ418612",385001,445366,60365
"15297","Ocbimv22013415m.g","KQ418021",137909,138541,632
"15298","Ocbimv22037674m.g","KQ416705",3110213,3134550,24337
"15299","Ocbimv22038661m.g","KQ423432",230751,246923,16172
"15300","Ocbimv22017024m.g","KQ418437",34648,35427,779
"15301","Ocbimv22008036m.g","KQ417473",14156,25202,11046
"15302","Ocbimv22012983m.g","KQ415913",90903,100942,10039
"15303","Ocbimv22005446m.g","KQ417252",1618355,1654299,35944
"15304","Ocbimv22020147m.g","KQ431482",14884,147596,132712
"15305","Ocbimv22000998m.g","KQ416902",385947,386447,500
"15306","Ocbimv22027549m.g","KQ420301",6834,9584,2750
"15307","Ocbimv22020228m.g","KQ431542",32950,36558,3608
"15308","Ocbimv22021548m.g","KQ432227",11045,11758,713
"15309","Ocbimv22010289m.g","KQ417665",776449,776637,188
"15310","Ocbimv22016459m.g","KQ418358",48391,48786,395
"15311","Ocbimv22000800m.g","KQ424072",221647,239696,18049
"15312","Ocbimv22011646m.g","KQ427830",230357,230551,194
"15313","Ocbimv22014801m.g","KQ429084",149709,202790,53081
"15314","Ocbimv22005319m.g","KQ417240",320960,322986,2026
"15315","Ocbimv22001682m.g","KQ424384",3,38438,38435
"15316","Ocbimv22005803m.g","KQ415823",1151569,1163778,12209
"15317","Ocbimv22033371m.g","KQ421801",51736,51942,206
"15318","Ocbimv22015647m.g","KQ418271",360070,360294,224
"15319","Ocbimv22026484m.g","KQ420055",844214,845382,1168
"15320","Ocbimv22034906m.g","KQ422211",136281,139264,2983
"15321","Ocbimv22016313m.g","KQ418338",271159,280355,9196
"15322","Ocbimv22012649m.g","KQ417923",35914,36096,182
"15323","Ocbimv22037793m.g","KQ423135",12890,81205,68315
"15324","Ocbimv22004606m.g","KQ417183",117534,119220,1686
"15325","Ocbimv22010803m.g","KQ417715",340003,362750,22747
"15326","Ocbimv22032717m.g","KQ416447",108751,109238,487
"15327","Ocbimv22031880m.g","KQ421370",179876,193621,13745
"15328","Ocbimv22020459m.g","KQ431703",113168,118234,5066
"15329","Ocbimv22022915m.g","KQ419326",271362,273707,2345
"15330","Ocbimv22034357m.g","KQ422019",287381,287581,200
"15331","Ocbimv22031771m.g","KQ421342",119747,130616,10869
"15332","Ocbimv22010847m.g","KQ417719",348737,368374,19637
"15333","Ocbimv22019450m.g","KQ418768",76629,76994,365
"15334","Ocbimv22011512m.g","KQ417796",712411,723839,11428
"15335","Ocbimv22037913m.g","KQ423164",254128,254334,206
"15336","Ocbimv22024781m.g","KQ419630",14655,17347,2692
"15337","Ocbimv22010131m.g","KQ427271",23224,80630,57406
"15338","Ocbimv22013454m.g","KQ428518",132381,144978,12597
"15339","Ocbimv22015860m.g","KQ418297",374568,375224,656
"15340","Ocbimv22018963m.g","KQ418702",657792,658241,449
"15341","Ocbimv22015017m.g","KQ418194",296242,297447,1205
"15342","Ocbimv22005931m.g","KQ425758",4982,17350,12368
"15343","Ocbimv22023182m.g","KQ419368",218079,219187,1108
"15344","Ocbimv22032607m.g","KQ421605",140458,154296,13838
"15345","Ocbimv22020097m.g","KQ416019",315503,317128,1625
"15346","Ocbimv22015961m.g","KQ429629",115158,128461,13303
"15347","Ocbimv22016298m.g","KQ429801",7768,8292,524
"15348","Ocbimv22035828m.g","KQ416602",582793,583377,584
"15349","Ocbimv22002717m.g","KQ424758",709,1183,474
"15350","Ocbimv22032136m.g","KQ421460",87148,87411,263
"15351","Ocbimv22031409m.g","KQ421232",184610,184873,263
"15352","Ocbimv22028670m.g","KQ420549",87971,106838,18867
"15353","Ocbimv22027124m.g","KQ420194",304883,305170,287
"15354","Ocbimv22030113m.g","KQ420892",188655,191446,2791
"15355","Ocbimv22014490m.g","KQ428965",46293,58468,12175
"15356","Ocbimv22032630m.g","KQ421620",248720,249031,311
"15357","Ocbimv22006888m.g","KQ426134",84139,170033,85894
"15358","Ocbimv22039742m.g","KQ423737",105855,106205,350
"15359","Ocbimv22030197m.g","KQ420923",398,3101,2703
"15360","Ocbimv22032042m.g","KQ421413",13166,22349,9183
"15361","Ocbimv22039776m.g","KQ423748",2239,15636,13397
"15362","Ocbimv22028588m.g","KQ416263",19124,19309,185
"15363","Ocbimv22007018m.g","KQ417370",505936,513724,7788
"15364","Ocbimv22003666m.g","KQ417100",229406,234974,5568
"15365","Ocbimv22033910m.g","KQ421906",410716,420091,9375
"15366","Ocbimv22025148m.g","KQ419709",105061,106434,1373
"15367","Ocbimv22029479m.g","KQ416308",702547,708560,6013
"15368","Ocbimv22012631m.g","KQ417921",1353045,1353811,766
"15369","Ocbimv22039550m.g","KQ416802",323340,324751,1411
"15370","Ocbimv22003583m.g","KQ425034",154474,155358,884
"15371","Ocbimv22016714m.g","KQ418388",46814,73220,26406
"15372","Ocbimv22021081m.g","KQ419000",128,3038,2910
"15373","Ocbimv22022332m.g","KQ419199",349426,354654,5228
"15374","Ocbimv22028178m.g","KQ420441",75883,160348,84465
"15375","Ocbimv22025931m.g","KQ419930",446190,473761,27571
"15376","Ocbimv22029472m.g","KQ416308",556527,567892,11365
"15377","Ocbimv22005970m.g","KQ425767",66057,112029,45972
"15378","Ocbimv22033582m.g","KQ421838",139908,146000,6092
"15379","Ocbimv22023242m.g","LGKD01686867",41,523,482
"15380","Ocbimv22006172m.g","KQ417300",2396278,2399590,3312
"15381","Ocbimv22022504m.g","KQ432802",6151,6862,711
"15382","Ocbimv22017493m.g","KQ418502",31789,56990,25201
"15383","Ocbimv22019436m.g","KQ418767",168745,169548,803
"15384","Ocbimv22009301m.g","KQ417581",106492,106737,245
"15385","Ocbimv22023459m.g","KQ419414",357650,359871,2221
"15386","Ocbimv22019864m.g","LGKD01654613",342,509,167
"15387","Ocbimv22038517m.g","KQ423384",137399,138235,836
"15388","Ocbimv22009998m.g","KQ427202",154994,159968,4974
"15389","Ocbimv22014818m.g","KQ429096",407395,415254,7859
"15390","Ocbimv22007820m.g","KQ426461",875175,925789,50614
"15391","Ocbimv22006925m.g","KQ426150",16431,17967,1536
"15392","Ocbimv22009382m.g","KQ426986",71243,72494,1251
"15393","Ocbimv22000361m.g","KQ423941",39904,53706,13802
"15394","Ocbimv22007352m.g","KQ417407",15374,15562,188
"15395","Ocbimv22022801m.g","KQ419300",527299,592493,65194
"15396","Ocbimv22016602m.g","KQ418370",9958,23071,13113
"15397","Ocbimv22023127m.g","KQ419353",65210,65473,263
"15398","Ocbimv22020031m.g","KQ418843",270476,271093,617
"15399","Ocbimv22026779m.g","KQ420113",98884,99910,1026
"15400","Ocbimv22033232m.g","KQ421758",549116,551382,2266
"15401","Ocbimv22001503m.g","KQ424337",93657,102893,9236
"15402","Ocbimv22002878m.g","KQ417044",107785,109159,1374
"15403","Ocbimv22005030m.g","KQ417224",324946,326454,1508
"15404","Ocbimv22002915m.g","KQ424828",31955,65786,33831
"15405","Ocbimv22007457m.g","KQ426347",185846,203473,17627
"15406","Ocbimv22018626m.g","KQ430774",6628,7182,554
"15407","Ocbimv22004951m.g","KQ417216",157311,157964,653
"15408","Ocbimv22012079m.g","KQ428013",80527,94353,13826
"15409","Ocbimv22024186m.g","KQ433850",62,1403,1341
"15410","Ocbimv22029772m.g","KQ420820",823730,868237,44507
"15411","Ocbimv22035453m.g","KQ422386",60327,62213,1886
"15412","Ocbimv22039439m.g","KQ416799",101200,101625,425
"15413","Ocbimv22004632m.g","KQ425399",52516,70666,18150
"15414","Ocbimv22008957m.g","KQ426820",15703,16434,731
"15415","Ocbimv22015844m.g","KQ418295",331884,335881,3997
"15416","Ocbimv22022377m.g","KQ432707",665,5920,5255
"15417","Ocbimv22012282m.g","KQ428101",83575,87593,4018
"15418","Ocbimv22016122m.g","KQ418320",565402,581349,15947
"15419","Ocbimv22024192m.g","KQ433854",3604,5371,1767
"15420","Ocbimv22031412m.g","KQ421233",149593,159298,9705
"15421","Ocbimv22009994m.g","KQ427202",101249,124550,23301
"15422","Ocbimv22013987m.g","KQ428717",391590,412915,21325
"15423","Ocbimv22021520m.g","KQ419066",78783,79719,936
"15424","Ocbimv22031074m.g","KQ416384",61434,64552,3118
"15425","Ocbimv22035532m.g","KQ422422",586496,598600,12104
"15426","Ocbimv22035112m.g","KQ422282",44188,45907,1719
"15427","Ocbimv22025900m.g","KQ416175",1095047,1095241,194
"15428","Ocbimv22028871m.g","KQ420595",548262,602717,54455
"15429","Ocbimv22032533m.g","KQ421578",136364,136645,281
"15430","Ocbimv22015499m.g","KQ418263",668807,715808,47001
"15431","Ocbimv22022953m.g","KQ433154",158491,158808,317
"15432","Ocbimv22022199m.g","KQ419184",190156,199467,9311
"15433","Ocbimv22015967m.g","KQ429632",8911,10774,1863
"15434","Ocbimv22005751m.g","KQ415822",16502,19056,2554
"15435","Ocbimv22013638m.g","KQ428581",57616,60299,2683
"15436","Ocbimv22006698m.g","KQ426075",355068,364029,8961
"15437","Ocbimv22001558m.g","KQ424356",81280,81968,688
"15438","Ocbimv22037547m.g","KQ423058",1008670,1109676,101006
"15439","Ocbimv22022980m.g","KQ419333",102187,104413,2226
"15440","Ocbimv22015059m.g","KQ418194",938627,944765,6138
"15441","Ocbimv22027558m.g","KQ420304",6188,9325,3137
"15442","Ocbimv22007303m.g","KQ426287",194653,229512,34859
"15443","Ocbimv22003301m.g","KQ417077",180901,181113,212
"15444","Ocbimv22012505m.g","KQ417917",309531,310039,508
"15445","Ocbimv22019996m.g","KQ418840",1739773,1772340,32567
"15446","Ocbimv22034688m.g","KQ416547",76626,77147,521
"15447","Ocbimv22033009m.g","KQ421716",242311,242879,568
"15448","Ocbimv22022265m.g","KQ416064",2460875,2461045,170
"15449","Ocbimv22027827m.g","KQ420375",1145220,1157341,12121
"15450","Ocbimv22027426m.g","KQ420273",70125,70277,152
"15451","Ocbimv22030463m.g","KQ420992",112788,120105,7317
"15452","Ocbimv22024981m.g","KQ419670",473104,478778,5674
"15453","Ocbimv22039506m.g","KQ423680",150260,170599,20339
"15454","Ocbimv22007367m.g","KQ426313",125181,130720,5539
"15455","Ocbimv22032112m.g","KQ421451",224216,253226,29010
"15456","Ocbimv22007054m.g","KQ417372",15783,98187,82404
"15457","Ocbimv22019377m.g","KQ418758",214910,223773,8863
"15458","Ocbimv22009967m.g","LGKD01574883",251,618,367
"15459","Ocbimv22005438m.g","KQ417252",329046,329459,413
"15460","Ocbimv22002032m.g","KQ424519",10013,30152,20139
"15461","Ocbimv22034886m.g","KQ422208",276772,276942,170
"15462","Ocbimv22027165m.g","KQ416211",114714,115856,1142
"15463","Ocbimv22038141m.g","KQ423217",560505,561539,1034
"15464","Ocbimv22016702m.g","KQ429969",888,2936,2048
"15465","Ocbimv22018859m.g","KQ418693",180321,181949,1628
"15466","Ocbimv22007541m.g","KQ426371",67883,68225,342
"15467","Ocbimv22006076m.g","KQ425807",241411,256087,14676
"15468","Ocbimv22015625m.g","KQ418269",589901,608427,18526
"15469","Ocbimv22003776m.g","KQ417112",184835,197367,12532
"15470","Ocbimv22030142m.g","KQ420909",5174,40599,35425
"15471","Ocbimv22034752m.g","KQ422145",201751,202221,470
"15472","Ocbimv22032823m.g","KQ421661",209326,209643,317
"15473","Ocbimv22009823m.g","KQ417620",323273,331196,7923
"15474","Ocbimv22010881m.g","KQ417722",242046,249761,7715
"15475","Ocbimv22022013m.g","KQ432511",34597,46042,11445
"15476","Ocbimv22039453m.g","KQ423671",116796,130691,13895
"15477","Ocbimv22009960m.g","KQ417627",29297,30924,1627
"15478","Ocbimv22010560m.g","KQ417691",364630,373170,8540
"15479","Ocbimv22001184m.g","KQ424218",17809,21893,4084
"15480","Ocbimv22031544m.g","KQ421273",119114,121141,2027
"15481","Ocbimv22039414m.g","KQ423651",1529267,1535598,6331
"15482","Ocbimv22010405m.g","KQ417676",378785,389069,10284
"15483","Ocbimv22012808m.g","KQ417942",462847,466053,3206
"15484","Ocbimv22005519m.g","KQ417259",102613,109013,6400
"15485","Ocbimv22016096m.g","KQ429708",40263,40556,293
"15486","Ocbimv22038818m.g","KQ416766",149246,150210,964
"15487","Ocbimv22003519m.g","KQ425021",228844,229452,608
"15488","Ocbimv22003485m.g","KQ425015",847922,848819,897
"15489","Ocbimv22005906m.g","KQ417284",156142,156576,434
"15490","Ocbimv22034914m.g","KQ415742",158139,159336,1197
"15491","Ocbimv22010337m.g","KQ417671",173548,174343,795
"15492","Ocbimv22000030m.g","LGKD01487890",24,224,200
"15493","Ocbimv22009431m.g","KQ417591",1629314,1631215,1901
"15494","Ocbimv22030659m.g","KQ421052",56126,115657,59531
"15495","Ocbimv22013544m.g","KQ415918",28029,28382,353
"15496","Ocbimv22037875m.g","KQ423141",149814,156382,6568
"15497","Ocbimv22030530m.g","KQ421014",82970,83359,389
"15498","Ocbimv22001835m.g","KQ424442",5438,7006,1568
"15499","Ocbimv22035462m.g","KQ422391",57658,59635,1977
"15500","Ocbimv22018768m.g","KQ418671",47014,52819,5805
"15501","Ocbimv22029109m.g","KQ420654",63174,64513,1339
"15502","Ocbimv22007146m.g","KQ426214",61406,62435,1029
"15503","Ocbimv22016477m.g","KQ415966",431880,432098,218
"15504","Ocbimv22007451m.g","KQ415842",748710,758400,9690
"15505","Ocbimv22009758m.g","KQ417611",142066,142846,780
"15506","Ocbimv22016928m.g","KQ430089",21137,35602,14465
"15507","Ocbimv22031699m.g","KQ421318",56139,56913,774
"15508","Ocbimv22036390m.g","KQ422743",251002,251669,667
"15509","Ocbimv22001043m.g","KQ424160",34628,35023,395
"15510","Ocbimv22020813m.g","KQ418970",366188,366367,179
"15511","Ocbimv22016444m.g","KQ418355",472331,472729,398
"15512","Ocbimv22015382m.g","KQ429305",5977,8972,2995
"15513","Ocbimv22024775m.g","KQ419629",79836,80090,254
"15514","Ocbimv22026627m.g","KQ420081",205459,267771,62312
"15515","Ocbimv22013005m.g","KQ417972",83142,161682,78540
"15516","Ocbimv22005074m.g","KQ425511",30112,61680,31568
"15517","Ocbimv22011759m.g","KQ417830",42316,42621,305
"15518","Ocbimv22017423m.g","KQ418495",61413,62346,933
"15519","Ocbimv22035727m.g","KQ422521",283126,291658,8532
"15520","Ocbimv22010206m.g","KQ417655",704467,704640,173
"15521","Ocbimv22035767m.g","KQ416600",95580,95771,191
"15522","Ocbimv22027552m.g","KQ420301",48021,81756,33735
"15523","Ocbimv22022023m.g","KQ432511",94733,95943,1210
"15524","Ocbimv22019055m.g","KQ418712",115463,180446,64983
"15525","Ocbimv22003682m.g","KQ425066",12440,12733,293
"15526","Ocbimv22018793m.g","KQ430877",16,1075,1059
"15527","Ocbimv22025798m.g","KQ416168",21721,22584,863
"15528","Ocbimv22035667m.g","KQ422496",94100,95197,1097
"15529","Ocbimv22012453m.g","KQ428165",69019,71792,2773
"15530","Ocbimv22028005m.g","KQ416243",2325,12065,9740
"15531","Ocbimv22026359m.g","KQ420033",62490,94826,32336
"15532","Ocbimv22036400m.g","KQ422748",80647,81057,410
"15533","Ocbimv22016946m.g","KQ430102",168225,203249,35024
"15534","Ocbimv22001358m.g","KQ424287",116214,122025,5811
"15535","Ocbimv22017591m.g","KQ418512",537240,537789,549
"15536","Ocbimv22004164m.g","KQ425220",173449,185648,12199
"15537","Ocbimv22036305m.g","KQ416631",234760,398344,163584
"15538","Ocbimv22032482m.g","KQ416432",96337,101551,5214
"15539","Ocbimv22001169m.g","KQ424211",9603,31125,21522
"15540","Ocbimv22028917m.g","KQ416274",1947127,1995989,48862
"15541","Ocbimv22031517m.g","KQ421263",824696,863540,38844
"15542","Ocbimv22022479m.g","KQ432769",21326,22111,785
"15543","Ocbimv22030171m.g","KQ420915",686920,687234,314
"15544","Ocbimv22015348m.g","KQ429283",309,5699,5390
"15545","Ocbimv22000558m.g","KQ423995",433417,456731,23314
"15546","Ocbimv22026680m.g","KQ416196",862115,862687,572
"15547","Ocbimv22014769m.g","KQ418176",690792,691958,1166
"15548","Ocbimv22006675m.g","KQ415833",406794,415501,8707
"15549","Ocbimv22010212m.g","KQ417656",289058,289300,242
"15550","Ocbimv22011816m.g","KQ415893",522965,538935,15970
"15551","Ocbimv22020165m.g","KQ418863",560768,564646,3878
"15552","Ocbimv22023339m.g","KQ419395",87579,91912,4333
"15553","Ocbimv22032552m.g","KQ421583",35,621,586
"15554","Ocbimv22033066m.g","KQ421721",818796,825361,6565
"15555","Ocbimv22024371m.g","KQ419574",979433,997215,17782
"15556","Ocbimv22011936m.g","KQ427950",143668,143847,179
"15557","Ocbimv22034236m.g","KQ416526",471475,471627,152
"15558","Ocbimv22038649m.g","KQ423430",825765,896585,70820
"15559","Ocbimv22010290m.g","KQ417665",1070559,1070714,155
"15560","Ocbimv22016186m.g","KQ418323",926016,926909,893
"15561","Ocbimv22008617m.g","KQ417510",886429,894941,8512
"15562","Ocbimv22016400m.g","KQ418344",1510,1896,386
"15563","Ocbimv22021960m.g","KQ432471",16321,57738,41417
"15564","Ocbimv22002051m.g","KQ424530",201347,203098,1751
"15565","Ocbimv22030675m.g","KQ421058",293153,294661,1508
"15566","Ocbimv22023277m.g","KQ419391",52394,84053,31659
"15567","Ocbimv22010880m.g","KQ417722",213476,233380,19904
"15568","Ocbimv22011622m.g","KQ427818",44320,46081,1761
"15569","Ocbimv22008993m.g","LGKD01566908",52,382,330
"15570","Ocbimv22033590m.g","KQ421839",425524,426687,1163
"15571","Ocbimv22012273m.g","KQ428096",5198,6971,1773
"15572","Ocbimv22029398m.g","KQ420741",1007060,1007352,292
"15573","Ocbimv22027861m.g","KQ416235",5589,19184,13595
"15574","Ocbimv22012581m.g","KQ417917",1727849,1728031,182
"15575","Ocbimv22013232m.g","KQ418002",584021,587611,3590
"15576","Ocbimv22031560m.g","KQ421275",178013,178545,532
"15577","Ocbimv22016328m.g","LGKD01233649",250,459,209
"15578","Ocbimv22022386m.g","KQ432731",24512,25465,953
"15579","Ocbimv22003646m.g","KQ425062",976,3018,2042
"15580","Ocbimv22025127m.g","LGKD01313444",1,629,628
"15581","Ocbimv22013932m.g","KQ418072",164660,167862,3202
"15582","Ocbimv22025371m.g","KQ416152",423058,429602,6544
"15583","Ocbimv22033967m.g","KQ416503",66053,66382,329
"15584","Ocbimv22007644m.g","KQ417439",84977,107435,22458
"15585","Ocbimv22018458m.g","KQ415992",726173,726520,347
"15586","Ocbimv22001918m.g","KQ424476",18482,20211,1729
"15587","Ocbimv22009991m.g","KQ427200",22831,23058,227
"15588","Ocbimv22039919m.g","KQ423797",11823,12380,557
"15589","Ocbimv22025979m.g","KQ419940",73316,76074,2758
"15590","Ocbimv22012888m.g","KQ428271",9996,10745,749
"15591","Ocbimv22002981m.g","KQ424855",4711,5055,344
"15592","Ocbimv22034439m.g","KQ422036",1353636,1382050,28414
"15593","Ocbimv22029936m.g","KQ416325",7024,64122,57098
"15594","Ocbimv22027316m.g","KQ420258",54897,65653,10756
"15595","Ocbimv22013891m.g","KQ418070",915055,916014,959
"15596","Ocbimv22031890m.g","KQ421373",116865,117929,1064
"15597","Ocbimv22019660m.g","KQ418792",10242,10412,170
"15598","Ocbimv22007363m.g","KQ426313",689,15833,15144
"15599","Ocbimv22009201m.g","KQ417573",466390,480482,14092
"15600","Ocbimv22023547m.g","KQ416091",213505,213816,311
"15601","Ocbimv22019883m.g","KQ418832",180767,216064,35297
"15602","Ocbimv22001520m.g","KQ424343",11975,14551,2576
"15603","Ocbimv22029671m.g","KQ420799",279385,324792,45407
"15604","Ocbimv22014301m.g","KQ418115",895527,896252,725
"15605","Ocbimv22026194m.g","KQ420016",102460,129444,26984
"15606","Ocbimv22004917m.g","KQ417213",739186,804703,65517
"15607","Ocbimv22028069m.g","KQ420424",304685,322936,18251
"15608","Ocbimv22025601m.g","KQ419858",170949,186581,15632
"15609","Ocbimv22039348m.g","KQ423628",70254,80131,9877
"15610","Ocbimv22030737m.g","KQ421082",328067,328357,290
"15611","Ocbimv22018878m.g","KQ430914",106505,106914,409
"15612","Ocbimv22002569m.g","KQ424696",17175,33001,15826
"15613","Ocbimv22009668m.g","KQ417600",607,3428,2821
"15614","Ocbimv22006481m.g","KQ415831",232246,232545,299
"15615","Ocbimv22019212m.g","KQ418734",112014,143582,31568
"15616","Ocbimv22030420m.g","KQ420978",96963,97616,653
"15617","Ocbimv22005304m.g","KQ425573",37155,59639,22484
"15618","Ocbimv22024464m.g","LGKD01698727",264,509,245
"15619","Ocbimv22026497m.g","KQ420059",300761,301369,608
"15620","Ocbimv22004507m.g","KQ417173",2653580,2653951,371
"15621","Ocbimv22019781m.g","KQ431301",2345,8232,5887
"15622","Ocbimv22035164m.g","KQ422291",243018,243332,314
"15623","Ocbimv22020838m.g","KQ418970",2265772,2267946,2174
"15624","Ocbimv22022092m.g","KQ419159",1304,1726,422
"15625","Ocbimv22002759m.g","KQ417033",56995,59132,2137
"15626","Ocbimv22016595m.g","KQ418369",37866,45528,7662
"15627","Ocbimv22003450m.g","KQ425015",69712,70685,973
"15628","Ocbimv22010376m.g","KQ415876",481133,491932,10799
"15629","Ocbimv22038741m.g","KQ416764",319358,322864,3506
"15630","Ocbimv22016394m.g","KQ429831",101421,101813,392
"15631","Ocbimv22006876m.g","KQ426130",205970,206218,248
"15632","Ocbimv22006343m.g","KQ425883",30398,30638,240
"15633","Ocbimv22034437m.g","KQ422036",1051088,1051318,230
"15634","Ocbimv22023514m.g","KQ419420",421875,434514,12639
"15635","Ocbimv22016306m.g","KQ418338",192923,194570,1647
"15636","Ocbimv22021383m.g","LGKD01667500",6,327,321
"15637","Ocbimv22039488m.g","KQ423675",623359,658960,35601
"15638","Ocbimv22031240m.g","KQ421206",60660,89247,28587
"15639","Ocbimv22010959m.g","KQ427570",147207,147740,533
"15640","Ocbimv22036586m.g","KQ422794",245918,266375,20457
"15641","Ocbimv22008073m.g","KQ426560",790,1011,221
"15642","Ocbimv22035650m.g","KQ422493",39668,41616,1948
"15643","Ocbimv22020047m.g","KQ431412",143011,170154,27143
"15644","Ocbimv22006571m.g","KQ417336",1245092,1245340,248
"15645","Ocbimv22029541m.g","KQ420776",221044,238874,17830
"15646","Ocbimv22024069m.g","KQ419532",21807,22571,764
"15647","Ocbimv22016370m.g","KQ415962",870683,870889,206
"15648","Ocbimv22039718m.g","KQ416816",185062,194199,9137
"15649","Ocbimv22000959m.g","KQ415782",451896,455310,3414
"15650","Ocbimv22007280m.g","KQ417397",235660,236463,803
"15651","Ocbimv22029278m.g","KQ420696",389197,396388,7191
"15652","Ocbimv22007428m.g","KQ426341",1610,2187,577
"15653","Ocbimv22007250m.g","KQ426259",446979,447269,290
"15654","Ocbimv22005666m.g","KQ417272",47825,49596,1771
"15655","Ocbimv22030497m.g","KQ416353",130335,168698,38363
"15656","Ocbimv22032377m.g","KQ416430",260466,265428,4962
"15657","Ocbimv22028891m.g","KQ416274",493456,493749,293
"15658","Ocbimv22000344m.g","KQ416854",677336,677728,392
"15659","Ocbimv22004067m.g","KQ425192",12270,21031,8761
"15660","Ocbimv22035832m.g","KQ422569",142967,150242,7275
"15661","Ocbimv22004277m.g","KQ425255",236108,242346,6238
"15662","Ocbimv22030433m.g","KQ416349",52719,63381,10662
"15663","Ocbimv22015135m.g","KQ418196",685715,704543,18828
"15664","Ocbimv22005227m.g","KQ417232",1315461,1410828,95367
"15665","Ocbimv22007690m.g","KQ415846",358546,360934,2388
"15666","Ocbimv22006983m.g","KQ417370",21152,22893,1741
"15667","Ocbimv22018728m.g","LGKD01645566",110,307,197
"15668","Ocbimv22027150m.g","KQ420203",1043530,1043691,161
"15669","Ocbimv22007286m.g","KQ417398",482244,570036,87792
"15670","Ocbimv22034092m.g","KQ421972",501144,504738,3594
"15671","Ocbimv22018782m.g","KQ418676",1573,13966,12393
"15672","Ocbimv22012074m.g","KQ417863",94911,96871,1960
"15673","Ocbimv22028530m.g","KQ420517",339026,371967,32941
"15674","Ocbimv22026782m.g","KQ420117",60891,61297,406
"15675","Ocbimv22004215m.g","KQ425232",76,769,693
"15676","Ocbimv22019186m.g","KQ431041",216,19349,19133
"15677","Ocbimv22036691m.g","KQ422839",84606,158157,73551
"15678","Ocbimv22005967m.g","KQ425764",128767,130376,1609
"15679","Ocbimv22017371m.g","KQ418486",179867,182149,2282
"15680","Ocbimv22010935m.g","KQ417725",447871,456756,8885
"15681","Ocbimv22035148m.g","KQ422290",413529,413867,338
"15682","Ocbimv22007560m.g","KQ417427",42888,43203,315
"15683","Ocbimv22029795m.g","KQ420825",139410,165443,26033
"15684","Ocbimv22008122m.g","KQ417481",98914,104429,5515
"15685","Ocbimv22027039m.g","KQ416209",55497,55799,302
"15686","Ocbimv22038151m.g","KQ423220",400663,400863,200
"15687","Ocbimv22027477m.g","KQ416225",127991,148471,20480
"15688","Ocbimv22018566m.g","KQ418637",221416,278861,57445
"15689","Ocbimv22003937m.g","KQ425151",120507,129509,9002
"15690","Ocbimv22033631m.g","KQ421853",321425,332235,10810
"15691","Ocbimv22005297m.g","KQ425571",268032,269090,1058
"15692","Ocbimv22015071m.g","KQ418194",1277623,1277865,242
"15693","Ocbimv22026678m.g","KQ416196",834098,841270,7172
"15694","Ocbimv22022036m.g","KQ419149",427605,449974,22369
"15695","Ocbimv22009832m.g","KQ417620",498890,509169,10279
"15696","Ocbimv22030140m.g","KQ420908",78515,93286,14771
"15697","Ocbimv22002457m.g","KQ424659",260154,271429,11275
"15698","Ocbimv22036493m.g","KQ422777",135775,137255,1480
"15699","Ocbimv22035429m.g","KQ422381",336251,336791,540
"15700","Ocbimv22012448m.g","KQ428161",15014,15898,884
"15701","Ocbimv22026387m.g","KQ420035",122967,123299,332
"15702","Ocbimv22006080m.g","KQ417294",90811,94192,3381
"15703","Ocbimv22016245m.g","KQ418331",131358,131858,500
"15704","Ocbimv22037608m.g","KQ423077",816023,820251,4228
"15705","Ocbimv22031055m.g","KQ421149",212687,213121,434
"15706","Ocbimv22005714m.g","KQ425728",36436,75652,39216
"15707","Ocbimv22035312m.g","KQ422351",513778,523050,9272
"15708","Ocbimv22031369m.g","KQ416393",183075,183272,197
"15709","Ocbimv22031629m.g","KQ421305",46617,77446,30829
"15710","Ocbimv22008754m.g","KQ426760",75424,77175,1751
"15711","Ocbimv22020780m.g","KQ418964",225472,267095,41623
"15712","Ocbimv22009349m.g","KQ417585",537185,537875,690
"15713","Ocbimv22023941m.g","KQ416106",365587,421148,55561
"15714","Ocbimv22003062m.g","KQ417056",41282,41983,701
"15715","Ocbimv22010292m.g","KQ417665",1294721,1312712,17991
"15716","Ocbimv22002980m.g","KQ417051",2520176,2520337,161
"15717","Ocbimv22025290m.g","KQ419763",37479,37748,269
"15718","Ocbimv22030094m.g","KQ416331",54484,59117,4633
"15719","Ocbimv22013412m.g","KQ418021",37191,57355,20164
"15720","Ocbimv22029817m.g","KQ420828",806479,865054,58575
"15721","Ocbimv22020288m.g","KQ431584",55473,67156,11683
"15722","Ocbimv22030148m.g","KQ420910",183371,184737,1366
"15723","Ocbimv22004667m.g","KQ425412",198701,204944,6243
"15724","Ocbimv22012676m.g","KQ417924",633207,636298,3091
"15725","Ocbimv22011507m.g","KQ417796",461122,477320,16198
"15726","Ocbimv22011191m.g","KQ415884",203336,203569,233
"15727","Ocbimv22020353m.g","KQ418900",78191,78496,305
"15728","Ocbimv22033334m.g","KQ421784",73962,77551,3589
"15729","Ocbimv22017624m.g","KQ430384",13948,16791,2843
"15730","Ocbimv22039974m.g","KQ415773",317361,319040,1679
"15731","Ocbimv22031333m.g","KQ421218",351220,409593,58373
"15732","Ocbimv22017009m.g","KQ418433",118543,156761,38218
"15733","Ocbimv22025209m.g","KQ419728",149508,149702,194
"15734","Ocbimv22007168m.g","KQ417386",1407653,1411456,3803
"15735","Ocbimv22028032m.g","KQ416244",60264,77158,16894
"15736","Ocbimv22024817m.g","KQ419631",646823,648241,1418
"15737","Ocbimv22033536m.g","KQ421825",1,1404,1403
"15738","Ocbimv22017854m.g","KQ418552",245463,246440,977
"15739","Ocbimv22032942m.g","KQ421688",92930,93313,383
"15740","Ocbimv22031972m.g","KQ421391",17466,19012,1546
"15741","Ocbimv22031746m.g","KQ421337",119599,120575,976
"15742","Ocbimv22006735m.g","KQ417345",166629,170238,3609
"15743","Ocbimv22033197m.g","KQ416471",28448,38973,10525
"15744","Ocbimv22015004m.g","KQ418194",105551,115369,9818
"15745","Ocbimv22002879m.g","KQ424814",4046,4441,395
"15746","Ocbimv22006997m.g","KQ417370",100897,109656,8759
"15747","Ocbimv22011388m.g","KQ417791",754759,758426,3667
"15748","Ocbimv22008986m.g","KQ426828",91255,101750,10495
"15749","Ocbimv22035203m.g","KQ422307",15420,18368,2948
"15750","Ocbimv22005122m.g","KQ415813",618715,674287,55572
"15751","Ocbimv22005730m.g","KQ425731",85116,159764,74648
"15752","Ocbimv22021667m.g","KQ416049",359766,376240,16474
"15753","Ocbimv22021089m.g","KQ431983",14852,15154,302
"15754","Ocbimv22004530m.g","KQ415805",1504873,1505178,305
"15755","Ocbimv22024613m.g","KQ416126",143603,145000,1397
"15756","Ocbimv22039881m.g","KQ416832",388804,411662,22858
"15757","Ocbimv22026654m.g","KQ420085",610093,680407,70314
"15758","Ocbimv22027203m.g","KQ420217",475948,488753,12805
"15759","Ocbimv22013499m.g","KQ418031",756183,820073,63890
"15760","Ocbimv22010357m.g","KQ427364",96315,99966,3651
"15761","Ocbimv22030158m.g","KQ420912",73563,73930,367
"15762","Ocbimv22006615m.g","KQ417337",5766,30764,24998
"15763","Ocbimv22037450m.g","KQ423031",62058,72243,10185
"15764","Ocbimv22018583m.g","KQ418642",165666,178437,12771
"15765","Ocbimv22023482m.g","KQ419416",91103,91756,653
"15766","Ocbimv22026312m.g","KQ420023",599201,600160,959
"15767","Ocbimv22025418m.g","KQ419796",34220,46606,12386
"15768","Ocbimv22019960m.g","KQ418839",137947,168150,30203
"15769","Ocbimv22038080m.g","KQ423213",93596,126921,33325
"15770","Ocbimv22013416m.g","KQ418021",160192,160809,617
"15771","Ocbimv22027333m.g","KQ420261",252736,252993,257
"15772","Ocbimv22000964m.g","KQ416899",362310,362894,584
"15773","Ocbimv22038179m.g","KQ423229",5026,5559,533
"15774","Ocbimv22033455m.g","KQ421816",752502,793124,40622
"15775","Ocbimv22015745m.g","KQ418289",15958,16724,766
"15776","Ocbimv22036528m.g","KQ422784",13904,341821,327917
"15777","Ocbimv22033842m.g","KQ421894",44882,52847,7965
"15778","Ocbimv22038312m.g","KQ423276",34136,34339,203
"15779","Ocbimv22014574m.g","KQ428994",44579,47818,3239
"15780","Ocbimv22009600m.g","KQ427052",1269,11435,10166
"15781","Ocbimv22000080m.g","LGKD01488624",9,326,317
"15782","Ocbimv22004138m.g","KQ425218",12865,16090,3225
"15783","Ocbimv22009455m.g","KQ427008",4713,56792,52079
"15784","Ocbimv22013798m.g","KQ418061",271125,293264,22139
"15785","Ocbimv22033205m.g","KQ421752",88685,89218,533
"15786","Ocbimv22009682m.g","KQ415866",15716,16195,479
"15787","Ocbimv22008050m.g","KQ417478",22995,23321,326
"15788","Ocbimv22024688m.g","KQ419615",450175,462924,12749
"15789","Ocbimv22016374m.g","KQ415962",1044387,1044539,152
"15790","Ocbimv22009446m.g","KQ426997",56047,104678,48631
"15791","Ocbimv22013890m.g","KQ418070",551718,552361,643
"15792","Ocbimv22025913m.g","KQ419926",29540,32548,3008
"15793","Ocbimv22025143m.g","KQ419707",53166,60178,7012
"15794","Ocbimv22012020m.g","KQ427973",41064,41558,494
"15795","Ocbimv22008564m.g","KQ426704",25880,30475,4595
"15796","Ocbimv22016642m.g","KQ429934",47228,47491,263
"15797","Ocbimv22017059m.g","KQ430145",30049,30264,215
"15798","Ocbimv22016480m.g","KQ429891",67397,83531,16134
"15799","Ocbimv22004224m.g","KQ417143",26104,39636,13532
"15800","Ocbimv22002140m.g","KQ415788",827832,835962,8130
"15801","Ocbimv22039204m.g","KQ423574",126297,241883,115586
"15802","Ocbimv22007036m.g","KQ417370",633915,637271,3356
"15803","Ocbimv22030469m.g","KQ420992",163539,176800,13261
"15804","Ocbimv22030375m.g","KQ420966",434948,435756,808
"15805","Ocbimv22037451m.g","KQ423031",86434,87324,890
"15806","Ocbimv22035632m.g","KQ422481",217317,218485,1168
"15807","Ocbimv22023683m.g","KQ419458",398923,415676,16753
"15808","Ocbimv22026968m.g","KQ420155",116584,117264,680
"15809","Ocbimv22003205m.g","KQ417063",620457,620827,370
"15810","Ocbimv22026144m.g","KQ420004",42110,43244,1134
"15811","Ocbimv22035733m.g","KQ422521",351990,352211,221
"15812","Ocbimv22027338m.g","KQ420261",1046463,1164448,117985
"15813","Ocbimv22005613m.g","KQ415668",143717,144019,302
"15814","Ocbimv22027389m.g","KQ416223",38339,66543,28204
"15815","Ocbimv22007235m.g","KQ426259",17186,71758,54572
"15816","Ocbimv22033227m.g","KQ421758",352341,376407,24066
"15817","Ocbimv22012685m.g","KQ417925",81039,89845,8806
"15818","Ocbimv22037807m.g","KQ423139",17729,30633,12904
"15819","Ocbimv22006235m.g","KQ417305",53219,53768,549
"15820","Ocbimv22005087m.g","KQ425518",404,52760,52356
"15821","Ocbimv22001238m.g","KQ424231",538198,554975,16777
"15822","Ocbimv22019706m.g","KQ418804",245195,246124,929
"15823","Ocbimv22019032m.g","KQ418711",990576,996613,6037
"15824","Ocbimv22004196m.g","KQ425223",24531,24829,298
"15825","Ocbimv22021858m.g","KQ432355",9047,24790,15743
"15826","Ocbimv22022527m.g","KQ419241",328196,363993,35797
"15827","Ocbimv22032974m.g","KQ421705",313972,314292,320
"15828","Ocbimv22015859m.g","KQ418297",366984,367187,203
"15829","Ocbimv22021712m.g","KQ419090",51082,51318,236
"15830","Ocbimv22001280m.g","KQ424250",400450,402734,2284
"15831","Ocbimv22031008m.g","KQ416382",74795,77372,2577
"15832","Ocbimv22011780m.g","KQ417831",437427,438029,602
"15833","Ocbimv22022757m.g","KQ432989",6,425,419
"15834","Ocbimv22024749m.g","KQ419623",81630,85316,3686
"15835","Ocbimv22001677m.g","KQ416953",262228,262419,191
"15836","Ocbimv22037216m.g","LGKD01458028",461,613,152
"15837","Ocbimv22017589m.g","LGKD01636747",8,196,188
"15838","Ocbimv22001206m.g","KQ424229",59883,60542,659
"15839","Ocbimv22009744m.g","KQ417609",485602,485901,299
"15840","Ocbimv22028063m.g","KQ420424",150759,151418,659
"15841","Ocbimv22029024m.g","LGKD01362677",491,738,247
"15842","Ocbimv22014534m.g","KQ418151",24208,24789,581
"15843","Ocbimv22020028m.g","KQ418843",205072,206937,1865
"15844","Ocbimv22035868m.g","KQ416607",18602,18938,336
"15845","Ocbimv22009406m.g","KQ417591",678168,785202,107034
"15846","Ocbimv22031145m.g","KQ421175",187480,189007,1527
"15847","Ocbimv22028494m.g","KQ420512",47039,47860,821
"15848","Ocbimv22007998m.g","LGKD01559802",13,276,263
"15849","Ocbimv22019059m.g","KQ430958",7496,8383,887
"15850","Ocbimv22032862m.g","KQ416453",278860,296673,17813
"15851","Ocbimv22028658m.g","KQ420545",175991,185132,9141
"15852","Ocbimv22023839m.g","KQ419485",153537,153869,332
"15853","Ocbimv22008151m.g","KQ417481",693123,694426,1303
"15854","Ocbimv22016589m.g","KQ418368",477375,498942,21567
"15855","Ocbimv22036015m.g","KQ422632",461482,463612,2130
"15856","Ocbimv22015898m.g","KQ429620",150426,170374,19948
"15857","Ocbimv22000970m.g","KQ424136",103448,133037,29589
"15858","Ocbimv22037321m.g","KQ423001",336075,341547,5472
"15859","Ocbimv22012832m.g","KQ417945",85003,151810,66807
"15860","Ocbimv22014849m.g","KQ415935",250527,260384,9857
"15861","Ocbimv22025250m.g","KQ419746",33636,37027,3391
"15862","Ocbimv22002036m.g","KQ424525",51111,51287,176
"15863","Ocbimv22036630m.g","KQ416651",1559664,1559954,290
"15864","Ocbimv22016639m.g","KQ418371",250475,251592,1117
"15865","Ocbimv22004307m.g","KQ417147",511651,511806,155
"15866","Ocbimv22010086m.g","KQ417641",272745,273065,320
"15867","Ocbimv22037267m.g","KQ422986",334020,377556,43536
"15868","Ocbimv22021432m.g","KQ419049",10493,18733,8240
"15869","Ocbimv22036104m.g","KQ422641",1077129,1106961,29832
"15870","Ocbimv22029357m.g","KQ420719",9335,13345,4010
"15871","Ocbimv22022905m.g","KQ419324",64775,71436,6661
"15872","Ocbimv22008177m.g","KQ417481",1907487,1907735,248
"15873","Ocbimv22035619m.g","KQ422475",83042,84665,1623
"15874","Ocbimv22007490m.g","KQ415843",177154,182330,5176
"15875","Ocbimv22003109m.g","KQ417059",11080,25360,14280
"15876","Ocbimv22002108m.g","KQ424543",12303,67190,54887
"15877","Ocbimv22019477m.g","KQ416011",515473,521156,5683
"15878","Ocbimv22029883m.g","KQ420830",30512,40349,9837
"15879","Ocbimv22033302m.g","KQ421769",8647,17575,8928
"15880","Ocbimv22001948m.g","KQ424486",673384,673563,179
"15881","Ocbimv22020113m.g","LGKD01656528",339,494,155
"15882","Ocbimv22029877m.g","KQ420828",2070136,2087769,17633
"15883","Ocbimv22001404m.g","KQ424300",68596,69262,666
"15884","Ocbimv22014931m.g","KQ429139",51146,61701,10555
"15885","Ocbimv22019526m.g","KQ416015",240554,240865,311
"15886","Ocbimv22014349m.g","KQ418120",517079,525811,8732
"15887","Ocbimv22032317m.g","KQ421523",236345,236922,577
"15888","Ocbimv22012592m.g","LGKD01595789",6,236,230
"15889","Ocbimv22032283m.g","KQ421512",48621,51490,2869
"15890","Ocbimv22013705m.g","KQ418049",212073,217829,5756
"15891","Ocbimv22036110m.g","KQ416617",781998,782378,380
"15892","Ocbimv22037295m.g","KQ422997",39206,55213,16007
"15893","Ocbimv22001534m.g","KQ424350",235893,236105,212
"15894","Ocbimv22013401m.g","KQ428489",22430,25988,3558
"15895","Ocbimv22015262m.g","KQ418216",600178,601543,1365
"15896","Ocbimv22014187m.g","KQ418098",616071,643913,27842
"15897","Ocbimv22011718m.g","KQ417824",1026914,1062919,36005
"15898","Ocbimv22019337m.g","KQ418751",47688,49147,1459
"15899","Ocbimv22000950m.g","LGKD01496713",174,1536,1362
"15900","Ocbimv22022483m.g","KQ419230",317178,317705,527
"15901","Ocbimv22032176m.g","KQ421467",17159,30067,12908
"15902","Ocbimv22026533m.g","KQ420065",151858,186106,34248
"15903","Ocbimv22012343m.g","KQ415907",1001553,1006990,5437
"15904","Ocbimv22002227m.g","KQ416996",258797,259351,554
"15905","Ocbimv22004707m.g","KQ417199",5428,29943,24515
"15906","Ocbimv22037455m.g","KQ423035",11235,11498,263
"15907","Ocbimv22024564m.g","KQ434054",1157,66419,65262
"15908","Ocbimv22005579m.g","KQ425655",319440,320173,733
"15909","Ocbimv22010610m.g","KQ415669",508082,509706,1624
"15910","Ocbimv22032711m.g","KQ421638",653466,658100,4634
"15911","Ocbimv22021830m.g","KQ415687",815542,816356,814
"15912","Ocbimv22027958m.g","KQ420409",477296,499162,21866
"15913","Ocbimv22018779m.g","KQ418673",139089,139556,467
"15914","Ocbimv22039679m.g","KQ416813",1478864,1479121,257
"15915","Ocbimv22024413m.g","KQ419577",294672,306347,11675
"15916","Ocbimv22022195m.g","KQ419184",53999,105587,51588
"15917","Ocbimv22016678m.g","KQ418380",49154,54045,4891
"15918","Ocbimv22038156m.g","KQ415763",969627,969959,332
"15919","Ocbimv22023531m.g","KQ419425",617695,618926,1231
"15920","Ocbimv22034398m.g","KQ422028",215507,248301,32794
"15921","Ocbimv22002703m.g","KQ417027",342050,368518,26468
"15922","Ocbimv22028428m.g","KQ415705",635535,635900,365
"15923","Ocbimv22033525m.g","KQ421824",125822,177718,51896
"15924","Ocbimv22009710m.g","KQ427096",114732,120939,6207
"15925","Ocbimv22038825m.g","KQ423478",438602,440723,2121
"15926","Ocbimv22034368m.g","KQ422020",401834,402464,630
"15927","Ocbimv22001802m.g","KQ424425",98542,105121,6579
"15928","Ocbimv22007405m.g","KQ417412",29392,45134,15742
"15929","Ocbimv22006429m.g","KQ425920",12566,13439,873
"15930","Ocbimv22032689m.g","KQ416444",530873,637214,106341
"15931","Ocbimv22023471m.g","KQ419414",454405,454668,263
"15932","Ocbimv22017278m.g","KQ418475",218926,219108,182
"15933","Ocbimv22000114m.g","KQ416840",262073,262411,338
"15934","Ocbimv22025874m.g","KQ419919",22820,37460,14640
"15935","Ocbimv22015281m.g","KQ415941",68972,89932,20960
"15936","Ocbimv22015755m.g","KQ429539",17354,48415,31061
"15937","Ocbimv22014336m.g","KQ418119",127517,135465,7948
"15938","Ocbimv22000847m.g","KQ424093",258595,321409,62814
"15939","Ocbimv22026229m.g","KQ420017",668028,698139,30111
"15940","Ocbimv22023753m.g","KQ416096",148652,148912,260
"15941","Ocbimv22017331m.g","KQ418483",145990,159166,13176
"15942","Ocbimv22008097m.g","KQ426567",87599,89901,2302
"15943","Ocbimv22006196m.g","KQ417301",183312,183785,473
"15944","Ocbimv22034629m.g","KQ415738",184395,184616,221
"15945","Ocbimv22012093m.g","KQ428033",8372,67334,58962
"15946","Ocbimv22032478m.g","KQ421550",180424,180729,305
"15947","Ocbimv22038955m.g","KQ423493",923498,941564,18066
"15948","Ocbimv22016434m.g","KQ418353",37887,38084,197
"15949","Ocbimv22015428m.g","KQ429329",5729,7025,1296
"15950","Ocbimv22014540m.g","KQ428981",87658,89445,1787
"15951","Ocbimv22024739m.g","KQ419622",50886,56705,5819
"15952","Ocbimv22000683m.g","KQ424055",342749,343282,533
"15953","Ocbimv22012933m.g","KQ417957",202212,203099,887
"15954","Ocbimv22024902m.g","KQ416131",445079,445945,866
"15955","Ocbimv22011679m.g","KQ417816",444150,449031,4881
"15956","Ocbimv22036789m.g","KQ416657",376050,376862,812
"15957","Ocbimv22030248m.g","KQ420928",47983,48186,203
"15958","Ocbimv22016770m.g","KQ418396",22476,62387,39911
"15959","Ocbimv22012945m.g","KQ428307",106934,108385,1451
"15960","Ocbimv22016425m.g","KQ418351",63455,82611,19156
"15961","Ocbimv22003821m.g","KQ425121",428016,428177,161
"15962","Ocbimv22013910m.g","KQ418071",185276,185515,239
"15963","Ocbimv22016369m.g","KQ415962",776548,777394,846
"15964","Ocbimv22029093m.g","KQ420645",54303,109115,54812
"15965","Ocbimv22007838m.g","KQ417455",14157,22569,8412
"15966","Ocbimv22024361m.g","KQ419574",698256,698732,476
"15967","Ocbimv22019387m.g","KQ431108",120864,121814,950
"15968","Ocbimv22022812m.g","KQ433026",14919,18176,3257
"15969","Ocbimv22025058m.g","KQ416136",1165995,1166390,395
"15970","Ocbimv22008630m.g","KQ426714",67910,69559,1649
"15971","Ocbimv22022516m.g","KQ419239",385771,386635,864
"15972","Ocbimv22026408m.g","KQ420047",51941,81106,29165
"15973","Ocbimv22028129m.g","KQ416251",435876,436247,371
"15974","Ocbimv22010852m.g","KQ417719",413565,490719,77154
"15975","Ocbimv22009034m.g","LGKD01567209",132,1222,1090
"15976","Ocbimv22031981m.g","KQ416415",199055,211844,12789
"15977","Ocbimv22027121m.g","KQ420193",623615,624076,461
"15978","Ocbimv22037235m.g","KQ422973",23781,24570,789
"15979","Ocbimv22026486m.g","KQ420055",917295,918080,785
"15980","Ocbimv22031603m.g","KQ421289",143526,144119,593
"15981","Ocbimv22010152m.g","KQ427280",9478,30209,20731
"15982","Ocbimv22014193m.g","LGKD01607078",1,591,590
"15983","Ocbimv22032557m.g","KQ421587",47835,89862,42027
"15984","Ocbimv22034517m.g","KQ422068",22827,24114,1287
"15985","Ocbimv22014508m.g","KQ418146",228341,229367,1026
"15986","Ocbimv22028487m.g","KQ420503",453874,454266,392
"15987","Ocbimv22028700m.g","KQ420559",42610,43151,541
"15988","Ocbimv22012113m.g","KQ417874",559618,560127,509
"15989","Ocbimv22027064m.g","KQ420173",181454,182215,761
"15990","Ocbimv22033305m.g","KQ421769",86797,87627,830
"15991","Ocbimv22009218m.g","KQ417575",144231,150370,6139
"15992","Ocbimv22025102m.g","KQ416137",646958,648880,1922
"15993","Ocbimv22021158m.g","KQ419009",593585,635941,42356
"15994","Ocbimv22025242m.g","KQ419743",371347,379352,8005
"15995","Ocbimv22025694m.g","KQ419887",50628,55651,5023
"15996","Ocbimv22003918m.g","KQ417124",67681,130628,62947
"15997","Ocbimv22005402m.g","KQ417249",2229385,2229582,197
"15998","Ocbimv22024125m.g","KQ419535",938704,939009,305
"15999","Ocbimv22017290m.g","KQ430242",8412,12561,4149
"16000","Ocbimv22010016m.g","KQ427206",219029,219332,303
"16001","Ocbimv22024465m.g","KQ433996",14247,29671,15424
"16002","Ocbimv22038680m.g","KQ423440",21,2295,2274
"16003","Ocbimv22010396m.g","KQ417676",219701,219943,242
"16004","Ocbimv22026056m.g","KQ415697",1348444,1350561,2117
"16005","Ocbimv22031568m.g","KQ421281",134902,135114,212
"16006","Ocbimv22015670m.g","KQ429463",8204,22855,14651
"16007","Ocbimv22004072m.g","KQ417133",2790,17510,14720
"16008","Ocbimv22005971m.g","KQ425767",75509,76017,508
"16009","Ocbimv22029416m.g","KQ416305",301385,301579,194
"16010","Ocbimv22010602m.g","KQ417698",82325,84645,2320
"16011","Ocbimv22024222m.g","KQ419550",242057,244746,2689
"16012","Ocbimv22032005m.g","KQ421409",957914,972644,14730
"16013","Ocbimv22013307m.g","KQ418009",517614,517869,255
"16014","Ocbimv22009992m.g","KQ427200",120132,120479,347
"16015","Ocbimv22019748m.g","KQ431294",98112,155961,57849
"16016","Ocbimv22015021m.g","KQ418194",370482,388154,17672
"16017","Ocbimv22022395m.g","KQ419215",172661,173159,498
"16018","Ocbimv22039517m.g","KQ423684",9351,48666,39315
"16019","Ocbimv22031093m.g","KQ421158",338694,341147,2453
"16020","Ocbimv22027828m.g","KQ420375",1226627,1238526,11899
"16021","Ocbimv22022396m.g","KQ419215",194899,225058,30159
"16022","Ocbimv22011411m.g","KQ417791",1315777,1320865,5088
"16023","Ocbimv22036828m.g","KQ422866",164610,188321,23711
"16024","Ocbimv22013917m.g","KQ418071",594105,610382,16277
"16025","Ocbimv22023180m.g","KQ419368",149977,204593,54616
"16026","Ocbimv22006613m.g","KQ426030",151352,152043,691
"16027","Ocbimv22001610m.g","KQ416947",336124,336492,368
"16028","Ocbimv22028591m.g","KQ416263",26904,40973,14069
"16029","Ocbimv22030922m.g","KQ421117",1873985,1891046,17061
"16030","Ocbimv22016776m.g","KQ418398",38784,39760,976
"16031","Ocbimv22038974m.g","KQ423497",12635,18670,6035
"16032","Ocbimv22039232m.g","KQ423591",113833,141593,27760
"16033","Ocbimv22021709m.g","KQ419088",361524,361925,401
"16034","Ocbimv22027850m.g","KQ420377",109466,111972,2506
"16035","Ocbimv22037483m.g","KQ416697",478911,479135,224
"16036","Ocbimv22003417m.g","KQ417086",1175513,1177345,1832
"16037","Ocbimv22002393m.g","KQ424656",33218,37552,4334
"16038","Ocbimv22012733m.g","KQ417931",1438168,1438335,167
"16039","Ocbimv22000542m.g","KQ423995",153,85978,85825
"16040","Ocbimv22030494m.g","KQ421003",2405,2743,338
"16041","Ocbimv22024295m.g","KQ416121",1724076,1728038,3962
"16042","Ocbimv22004887m.g","KQ425463",678,9850,9172
"16043","Ocbimv22014222m.g","KQ418103",217043,217351,308
"16044","Ocbimv22037606m.g","KQ423077",799986,800175,189
"16045","Ocbimv22032189m.g","KQ421476",101225,123438,22213
"16046","Ocbimv22003623m.g","KQ417095",57170,85134,27964
"16047","Ocbimv22038655m.g","KQ416758",345331,345564,233
"16048","Ocbimv22004110m.g","KQ417137",181861,182199,338
"16049","Ocbimv22008610m.g","KQ417510",834536,839732,5196
"16050","Ocbimv22016507m.g","KQ429904",64948,74092,9144
"16051","Ocbimv22024493m.g","LGKD01699098",1,1456,1455
"16052","Ocbimv22008843m.g","KQ417537",194019,194528,509
"16053","Ocbimv22027673m.g","KQ416230",392634,393137,503
"16054","Ocbimv22017274m.g","KQ418475",152543,156422,3879
"16055","Ocbimv22005794m.g","KQ415823",900010,902033,2023
"16056","Ocbimv22024909m.g","KQ416131",821542,822479,937
"16057","Ocbimv22002683m.g","KQ424738",95727,107575,11848
"16058","Ocbimv22020433m.g","KQ416027",295274,305610,10336
"16059","Ocbimv22022949m.g","KQ419329",96601,96789,188
"16060","Ocbimv22030971m.g","KQ416379",605258,609915,4657
"16061","Ocbimv22006611m.g","KQ426030",65223,200370,135147
"16062","Ocbimv22027869m.g","KQ416236",20018,21553,1535
"16063","Ocbimv22008594m.g","KQ417510",477362,477731,369
"16064","Ocbimv22017596m.g","KQ415979",7254,7604,350
"16065","Ocbimv22008865m.g","KQ426791",354621,359479,4858
"16066","Ocbimv22039877m.g","KQ416832",302760,303083,323
"16067","Ocbimv22033007m.g","KQ421716",86381,86942,561
"16068","Ocbimv22034365m.g","KQ422020",157152,182818,25666
"16069","Ocbimv22031623m.g","KQ421304",11123,11347,224
"16070","Ocbimv22006806m.g","KQ417352",12779,13198,419
"16071","Ocbimv22032332m.g","KQ421523",530051,534383,4332
"16072","Ocbimv22020055m.g","KQ431437",3006,3423,417
"16073","Ocbimv22021198m.g","KQ416040",513434,514952,1518
"16074","Ocbimv22005991m.g","KQ415827",94037,99187,5150
"16075","Ocbimv22030802m.g","KQ416370",416682,432239,15557
"16076","Ocbimv22028175m.g","KQ416252",88747,106619,17872
"16077","Ocbimv22030901m.g","KQ421117",1317198,1345144,27946
"16078","Ocbimv22007426m.g","KQ426340",38864,58767,19903
"16079","Ocbimv22030655m.g","KQ421050",3448,3978,530
"16080","Ocbimv22026846m.g","KQ420128",60558,61970,1412
"16081","Ocbimv22016265m.g","KQ429784",1371,32203,30832
"16082","Ocbimv22022558m.g","KQ432860",14768,16519,1751
"16083","Ocbimv22039227m.g","KQ423590",121552,123585,2033
"16084","Ocbimv22004443m.g","KQ417160",34566,39054,4488
"16085","Ocbimv22017771m.g","KQ430468",159838,160725,887
"16086","Ocbimv22006137m.g","KQ417300",631245,631869,624
"16087","Ocbimv22039241m.g","KQ423591",285564,325099,39535
"16088","Ocbimv22015365m.g","KQ418230",237619,237855,236
"16089","Ocbimv22031834m.g","KQ421356",409144,567330,158186
"16090","Ocbimv22037762m.g","KQ416710",946796,955962,9166
"16091","Ocbimv22003019m.g","KQ417055",419292,420045,753
"16092","Ocbimv22016995m.g","KQ418431",935275,937796,2521
"16093","Ocbimv22023107m.g","KQ419350",27228,111776,84548
"16094","Ocbimv22022461m.g","KQ419223",157655,221799,64144
"16095","Ocbimv22029831m.g","KQ420828",1062109,1062372,263
"16096","Ocbimv22012965m.g","KQ417963",109947,111270,1323
"16097","Ocbimv22023894m.g","LGKD01693780",318,998,680
"16098","Ocbimv22027517m.g","KQ420296",2333,2539,206
"16099","Ocbimv22038830m.g","KQ416768",50677,76355,25678
"16100","Ocbimv22034729m.g","KQ422133",286667,307060,20393
"16101","Ocbimv22023751m.g","KQ416096",101123,101590,467
"16102","Ocbimv22038278m.g","KQ423259",533203,538908,5705
"16103","Ocbimv22011050m.g","KQ417740",271372,348690,77318
"16104","Ocbimv22012473m.g","KQ417913",184189,213043,28854
"16105","Ocbimv22013285m.g","KQ418007",407832,409828,1996
"16106","Ocbimv22001102m.g","KQ424182",118699,131217,12518
"16107","Ocbimv22014851m.g","KQ418181",2407,7751,5344
"16108","Ocbimv22013349m.g","KQ428460",9552,11770,2218
"16109","Ocbimv22002636m.g","KQ417023",1129151,1149980,20829
"16110","Ocbimv22020456m.g","KQ416029",62307,98420,36113
"16111","Ocbimv22026510m.g","KQ420060",74917,75513,596
"16112","Ocbimv22010159m.g","KQ427290",143367,158241,14874
"16113","Ocbimv22000572m.g","KQ423998",224881,228801,3920
"16114","Ocbimv22037610m.g","KQ423077",961494,962731,1237
"16115","Ocbimv22031440m.g","KQ421244",88802,96418,7616
"16116","Ocbimv22031189m.g","KQ416390",578801,579175,374
"16117","Ocbimv22039272m.g","KQ423600",251597,253398,1801
"16118","Ocbimv22001380m.g","KQ416929",779850,781965,2115
"16119","Ocbimv22025769m.g","KQ416166",838138,838299,161
"16120","Ocbimv22032184m.g","KQ421472",13712,51409,37697
"16121","Ocbimv22002768m.g","KQ424777",61866,62576,710
"16122","Ocbimv22013476m.g","KQ428524",194560,206752,12192
"16123","Ocbimv22032568m.g","KQ421593",147048,178174,31126
"16124","Ocbimv22014479m.g","KQ428960",51931,58216,6285
"16125","Ocbimv22008194m.g","KQ417482",401953,439154,37201
"16126","Ocbimv22006014m.g","KQ425779",381836,389547,7711
"16127","Ocbimv22035728m.g","KQ422521",309432,322065,12633
"16128","Ocbimv22017145m.g","KQ430169",969,3651,2682
"16129","Ocbimv22020153m.g","KQ418863",327945,330399,2454
"16130","Ocbimv22028713m.g","KQ416268",59495,59977,482
"16131","Ocbimv22033841m.g","KQ421894",23535,35241,11706
"16132","Ocbimv22028678m.g","KQ420550",101941,122122,20181
"16133","Ocbimv22029822m.g","KQ420828",884193,886826,2633
"16134","Ocbimv22011241m.g","KQ417767",6189,87326,81137
"16135","Ocbimv22038268m.g","KQ416733",315561,316094,533
"16136","Ocbimv22019198m.g","KQ418732",1065443,1066249,806
"16137","Ocbimv22023429m.g","KQ419409",47699,50832,3133
"16138","Ocbimv22036253m.g","KQ416627",412030,412386,356
"16139","Ocbimv22013827m.g","KQ428683",135,3074,2939
"16140","Ocbimv22039314m.g","KQ416788",44935,45742,807
"16141","Ocbimv22035243m.g","KQ422340",113910,154195,40285
"16142","Ocbimv22026283m.g","KQ420022",645045,662634,17589
"16143","Ocbimv22015112m.g","KQ418195",112795,113139,344
"16144","Ocbimv22015184m.g","KQ418204",15251,15565,314
"16145","Ocbimv22019552m.g","KQ418783",513501,515316,1815
"16146","Ocbimv22009124m.g","KQ426892",41116,41955,839
"16147","Ocbimv22011741m.g","KQ427887",26648,28056,1408
"16148","Ocbimv22019314m.g","KQ418749",104611,125049,20438
"16149","Ocbimv22038823m.g","KQ423478",44839,78923,34084
"16150","Ocbimv22036282m.g","KQ416628",1191543,1196318,4775
"16151","Ocbimv22027047m.g","KQ416209",299914,300421,507
"16152","Ocbimv22022453m.g","LGKD01678073",14,1727,1713
"16153","Ocbimv22025503m.g","KQ419825",296,13042,12746
"16154","Ocbimv22011705m.g","KQ417824",430981,434204,3223
"16155","Ocbimv22024126m.g","KQ433816",6267,9801,3534
"16156","Ocbimv22005422m.g","KQ425601",197944,198984,1040
"16157","Ocbimv22010998m.g","KQ427584",22591,23350,759
"16158","Ocbimv22015422m.g","KQ429328",7934,19037,11103
"16159","Ocbimv22022304m.g","KQ419193",135839,147838,11999
"16160","Ocbimv22005289m.g","KQ425571",9800,65771,55971
"16161","Ocbimv22005348m.g","KQ417247",59529,59738,209
"16162","Ocbimv22034786m.g","KQ416552",36012,46939,10927
"16163","Ocbimv22007931m.g","KQ426495",159399,182233,22834
"16164","Ocbimv22025968m.g","KQ419937",89669,91268,1599
"16165","Ocbimv22016520m.g","KQ418364",143559,189798,46239
"16166","Ocbimv22039301m.g","KQ423609",891903,924454,32551
"16167","Ocbimv22037828m.g","KQ423139",257841,266142,8301
"16168","Ocbimv22036290m.g","KQ422700",27259,27468,209
"16169","Ocbimv22029667m.g","KQ420799",156965,171700,14735
"16170","Ocbimv22009709m.g","KQ427096",61986,63971,1985
"16171","Ocbimv22026052m.g","KQ419973",849997,850458,461
"16172","Ocbimv22030293m.g","KQ420941",297288,297608,320
"16173","Ocbimv22034290m.g","KQ422015",908820,936701,27881
"16174","Ocbimv22011137m.g","KQ417753",19651,20019,368
"16175","Ocbimv22035766m.g","KQ416600",50381,50782,401
"16176","Ocbimv22019688m.g","KQ431257",40895,41753,858
"16177","Ocbimv22007754m.g","KQ415847",793796,804643,10847
"16178","Ocbimv22021696m.g","KQ432282",1416,1640,224
"16179","Ocbimv22023977m.g","KQ419513",121796,176276,54480
"16180","Ocbimv22020900m.g","KQ418974",242223,259447,17224
"16181","Ocbimv22026366m.g","KQ416188",59225,65882,6657
"16182","Ocbimv22008229m.g","KQ426593",964,12393,11429
"16183","Ocbimv22034789m.g","KQ416552",69008,73289,4281
"16184","Ocbimv22014352m.g","KQ418120",526017,555211,29194
"16185","Ocbimv22031077m.g","KQ421155",29166,39823,10657
"16186","Ocbimv22016524m.g","KQ418364",377997,381293,3296
"16187","Ocbimv22023210m.g","LGKD01686475",8,250,242
"16188","Ocbimv22008069m.g","KQ426557",93969,102942,8973
"16189","Ocbimv22008943m.g","KQ426816",129152,130590,1438
"16190","Ocbimv22016410m.g","KQ415964",10638,11980,1342
"16191","Ocbimv22007955m.g","KQ426504",32728,46942,14214
"16192","Ocbimv22016535m.g","KQ418364",724308,724722,414
"16193","Ocbimv22009247m.g","KQ417578",436291,438102,1811
"16194","Ocbimv22026634m.g","KQ420083",23536,50385,26849
"16195","Ocbimv22032298m.g","KQ421516",371729,372016,287
"16196","Ocbimv22018527m.g","KQ418633",247952,248152,200
"16197","Ocbimv22014321m.g","KQ428863",142711,150152,7441
"16198","Ocbimv22007539m.g","KQ426371",1409,22915,21506
"16199","Ocbimv22003229m.g","KQ417066",374153,377805,3652
"16200","Ocbimv22011995m.g","KQ417851",808095,817826,9731
"16201","Ocbimv22005552m.g","LGKD01538976",73,397,324
"16202","Ocbimv22037692m.g","KQ423101",84681,90171,5490
"16203","Ocbimv22028849m.g","KQ420593",136639,137398,759
"16204","Ocbimv22012161m.g","KQ417878",349898,350834,936
"16205","Ocbimv22037102m.g","KQ422922",151906,152982,1076
"16206","Ocbimv22024132m.g","KQ419538",7745,7999,254
"16207","Ocbimv22011967m.g","KQ415895",393435,393884,449
"16208","Ocbimv22023027m.g","KQ416080",498415,503604,5189
"16209","Ocbimv22025981m.g","KQ419942",92320,92631,311
"16210","Ocbimv22023982m.g","KQ419513",191190,228097,36907
"16211","Ocbimv22020999m.g","KQ431922",21351,23387,2036
"16212","Ocbimv22013382m.g","KQ418018",799104,805004,5900
"16213","Ocbimv22026972m.g","KQ416207",161907,162422,515
"16214","Ocbimv22035760m.g","KQ422530",38036,68911,30875
"16215","Ocbimv22004108m.g","KQ417137",132867,133316,449
"16216","Ocbimv22035812m.g","KQ416601",687779,687970,191
"16217","Ocbimv22031142m.g","KQ421175",8063,8374,311
"16218","Ocbimv22039536m.g","KQ423698",39375,39692,317
"16219","Ocbimv22005104m.g","KQ415813",113101,121473,8372
"16220","Ocbimv22000958m.g","KQ415782",436032,436632,600
"16221","Ocbimv22038359m.g","KQ423290",139482,174769,35287
"16222","Ocbimv22031817m.g","KQ415726",720026,721149,1123
"16223","Ocbimv22030018m.g","KQ420885",1926,32645,30719
"16224","Ocbimv22039544m.g","KQ423702",45194,45730,536
"16225","Ocbimv22013820m.g","KQ418063",220707,221300,593
"16226","Ocbimv22034179m.g","KQ416518",457194,496566,39372
"16227","Ocbimv22035501m.g","KQ422411",209778,254329,44551
"16228","Ocbimv22009781m.g","KQ417613",1322672,1322860,188
"16229","Ocbimv22015343m.g","KQ415942",38078,77205,39127
"16230","Ocbimv22022485m.g","KQ416070",37962,40337,2375
"16231","Ocbimv22014545m.g","KQ428981",164467,172487,8020
"16232","Ocbimv22013589m.g","KQ418038",552709,554217,1508
"16233","Ocbimv22023374m.g","KQ419395",285164,285397,233
"16234","Ocbimv22020935m.g","KQ431892",1,2256,2255
"16235","Ocbimv22038100m.g","KQ423214",145702,146406,704
"16236","Ocbimv22022978m.g","KQ419333",65086,95010,29924
"16237","Ocbimv22039306m.g","KQ423610",51131,51586,455
"16238","Ocbimv22031271m.g","KQ421212",319213,319578,365
"16239","Ocbimv22026587m.g","KQ420075",354933,355640,707
"16240","Ocbimv22022191m.g","KQ419180",1121997,1128796,6799
"16241","Ocbimv22019137m.g","KQ418720",185436,185786,350
"16242","Ocbimv22030127m.g","KQ420902",147940,156132,8192
"16243","Ocbimv22016041m.g","KQ418312",392459,393564,1105
"16244","Ocbimv22023296m.g","KQ416087",388824,431742,42918
"16245","Ocbimv22017183m.g","KQ418462",718928,721163,2235
"16246","Ocbimv22028279m.g","KQ420458",9045,9331,286
"16247","Ocbimv22025001m.g","KQ419680",11156,25129,13973
"16248","Ocbimv22037785m.g","KQ416711",134524,135134,610
"16249","Ocbimv22005145m.g","KQ425522",6874,7413,539
"16250","Ocbimv22011017m.g","KQ417734",181046,181216,170
"16251","Ocbimv22035036m.g","KQ422254",14858,21857,6999
"16252","Ocbimv22010989m.g","KQ417731",250283,265338,15055
"16253","Ocbimv22036835m.g","KQ422870",39723,40061,338
"16254","Ocbimv22004910m.g","KQ417213",641079,641912,833
"16255","Ocbimv22011837m.g","KQ415893",1560867,1562078,1211
"16256","Ocbimv22019655m.g","KQ431220",2745,23815,21070
"16257","Ocbimv22025820m.g","KQ419909",305242,305748,506
"16258","Ocbimv22028433m.g","KQ420486",70623,70826,203
"16259","Ocbimv22035693m.g","KQ422516",780225,842909,62684
"16260","Ocbimv22034863m.g","KQ416560",61785,70606,8821
"16261","Ocbimv22004452m.g","KQ425308",21685,23684,1999
"16262","Ocbimv22039327m.g","KQ416788",176488,184876,8388
"16263","Ocbimv22015510m.g","KQ415945",205794,206688,894
"16264","Ocbimv22031469m.g","KQ416399",328859,330676,1817
"16265","Ocbimv22011706m.g","KQ417824",452107,452779,672
"16266","Ocbimv22026793m.g","KQ420117",869519,869890,371
"16267","Ocbimv22022315m.g","KQ419195",33421,33615,194
"16268","Ocbimv22030647m.g","KQ421046",16807,70995,54188
"16269","Ocbimv22019323m.g","KQ418749",278115,286171,8056
"16270","Ocbimv22008068m.g","KQ426557",69208,88540,19332
"16271","Ocbimv22026996m.g","KQ420160",85536,86030,494
"16272","Ocbimv22036820m.g","KQ416659",91711,92057,346
"16273","Ocbimv22021668m.g","KQ416049",385713,406392,20679
"16274","Ocbimv22036079m.g","KQ416616",1103024,1104283,1259
"16275","Ocbimv22015515m.g","KQ415945",750392,772814,22422
"16276","Ocbimv22033155m.g","KQ421737",279894,280356,462
"16277","Ocbimv22030577m.g","KQ416357",423710,454058,30348
"16278","Ocbimv22031089m.g","KQ421158",147799,207103,59304
"16279","Ocbimv22008952m.g","KQ417543",1243,11903,10660
"16280","Ocbimv22017255m.g","KQ430226",11026,33041,22015
"16281","Ocbimv22003468m.g","KQ425015",479271,481242,1971
"16282","Ocbimv22000611m.g","KQ424022",31421,32719,1298
"16283","Ocbimv22038806m.g","KQ423471",4021,5702,1681
"16284","Ocbimv22021652m.g","KQ432266",6688,12284,5596
"16285","Ocbimv22031559m.g","KQ421275",125715,125966,251
"16286","Ocbimv22034303m.g","KQ422015",1199929,1200206,277
"16287","Ocbimv22022809m.g","KQ419300",720155,724993,4838
"16288","Ocbimv22024368m.g","KQ419574",884763,885604,841
"16289","Ocbimv22013497m.g","KQ418031",389045,389404,359
"16290","Ocbimv22012778m.g","KQ417939",642251,644564,2313
"16291","Ocbimv22022795m.g","KQ416075",109688,109954,266
"16292","Ocbimv22015712m.g","KQ415947",118456,134958,16502
"16293","Ocbimv22024647m.g","KQ419606",31757,32905,1148
"16294","Ocbimv22001784m.g","KQ424418",30586,31742,1156
"16295","Ocbimv22002384m.g","KQ417007",222010,222222,212
"16296","Ocbimv22030592m.g","KQ421034",141570,142003,433
"16297","Ocbimv22030374m.g","KQ420966",325987,326181,194
"16298","Ocbimv22022840m.g","KQ433053",55,5394,5339
"16299","Ocbimv22031241m.g","KQ421206",105768,106061,293
"16300","Ocbimv22011611m.g","LGKD01588251",70,240,170
"16301","Ocbimv22021424m.g","KQ419047",52471,52836,365
"16302","Ocbimv22036421m.g","KQ416641",521736,521939,203
"16303","Ocbimv22001298m.g","LGKD01500875",2,367,365
"16304","Ocbimv22036074m.g","KQ416616",954296,955454,1158
"16305","Ocbimv22028614m.g","KQ416264",319620,417099,97479
"16306","Ocbimv22020095m.g","KQ431453",1203,3926,2723
"16307","Ocbimv22033542m.g","KQ416484",88298,88878,580
"16308","Ocbimv22024495m.g","KQ419590",29083,29888,805
"16309","Ocbimv22032261m.g","KQ421506",37479,42305,4826
"16310","Ocbimv22014286m.g","KQ428853",7136,17354,10218
"16311","Ocbimv22026193m.g","KQ420016",27036,36482,9446
"16312","Ocbimv22036852m.g","KQ416662",20242,35807,15565
"16313","Ocbimv22009289m.g","KQ417579",320569,320811,242
"16314","Ocbimv22013149m.g","KQ417989",376774,377175,401
"16315","Ocbimv22037424m.g","KQ416694",2779965,2808432,28467
"16316","Ocbimv22034295m.g","KQ422015",1030912,1040885,9973
"16317","Ocbimv22002223m.g","KQ416996",120479,159784,39305
"16318","Ocbimv22030945m.g","KQ421127",38915,39106,191
"16319","Ocbimv22029202m.g","KQ420675",256589,259803,3214
"16320","Ocbimv22003979m.g","KQ425163",229966,231643,1677
"16321","Ocbimv22017859m.g","KQ418552",300515,305790,5275
"16322","Ocbimv22001368m.g","KQ424288",17200,17664,464
"16323","Ocbimv22012119m.g","KQ428046",4198,18979,14781
"16324","Ocbimv22012450m.g","KQ428165",38140,45749,7609
"16325","Ocbimv22032594m.g","KQ421603",158796,179835,21039
"16326","Ocbimv22030685m.g","KQ421067",8042,30025,21983
"16327","Ocbimv22033843m.g","KQ421894",66809,97579,30770
"16328","Ocbimv22016591m.g","KQ418368",722884,782900,60016
"16329","Ocbimv22009524m.g","KQ415865",779294,783339,4045
"16330","Ocbimv22036870m.g","KQ422886",8536,87287,78751
"16331","Ocbimv22015023m.g","KQ418194",385092,385419,327
"16332","Ocbimv22011545m.g","KQ427776",4853,5661,808
"16333","Ocbimv22031465m.g","KQ416399",275017,294418,19401
"16334","Ocbimv22007219m.g","KQ426253",24493,37725,13232
"16335","Ocbimv22021567m.g","KQ419078",360383,418609,58226
"16336","Ocbimv22014475m.g","KQ428956",16946,20968,4022
"16337","Ocbimv22026725m.g","KQ420104",80497,81251,754
"16338","Ocbimv22022986m.g","KQ419334",3189,6008,2819
"16339","Ocbimv22032467m.g","KQ421549",227099,237279,10180
"16340","Ocbimv22018408m.g","KQ430684",720122,743591,23469
"16341","Ocbimv22028122m.g","KQ416251",48470,109424,60954
"16342","Ocbimv22019680m.g","KQ431254",5404,76898,71494
"16343","Ocbimv22032593m.g","KQ421603",142136,142426,290
"16344","Ocbimv22036510m.g","KQ422783",41731,49376,7645
"16345","Ocbimv22036923m.g","KQ422894",473188,502090,28902
"16346","Ocbimv22028839m.g","KQ420592",69713,70857,1144
"16347","Ocbimv22001159m.g","KQ416913",153034,159102,6068
"16348","Ocbimv22024893m.g","KQ416131",64061,64303,242
"16349","Ocbimv22009279m.g","KQ426944",457361,457573,212
"16350","Ocbimv22029147m.g","KQ416288",82161,83667,1506
"16351","Ocbimv22016517m.g","KQ429908",64990,65379,389
"16352","Ocbimv22020371m.g","KQ418900",533241,538410,5169
"16353","Ocbimv22005558m.g","KQ425654",27098,59650,32552
"16354","Ocbimv22019002m.g","KQ418710",572198,576569,4371
"16355","Ocbimv22013711m.g","KQ418051",181037,181219,182
"16356","Ocbimv22026139m.g","KQ420000",15831,17330,1499
"16357","Ocbimv22024421m.g","KQ419577",396743,405476,8733
"16358","Ocbimv22027506m.g","KQ420294",141071,181288,40217
"16359","Ocbimv22031765m.g","KQ416405",12255,17788,5533
"16360","Ocbimv22024223m.g","KQ419550",270931,274427,3496
"16361","Ocbimv22030875m.g","KQ416373",1067084,1081602,14518
"16362","Ocbimv22005586m.g","KQ417263",42290,43566,1276
"16363","Ocbimv22004393m.g","KQ425290",54239,55654,1415
"16364","Ocbimv22000301m.g","KQ415775",589137,709750,120613
"16365","Ocbimv22023933m.g","KQ419500",880830,937126,56296
"16366","Ocbimv22010900m.g","KQ417723",226970,227426,456
"16367","Ocbimv22001861m.g","KQ416971",340052,350543,10491
"16368","Ocbimv22004479m.g","KQ425333",75061,81627,6566
"16369","Ocbimv22002118m.g","KQ424551",143729,143929,200
"16370","Ocbimv22002658m.g","KQ417023",1654902,1709874,54972
"16371","Ocbimv22032221m.g","KQ421487",19837,21499,1662
"16372","Ocbimv22004954m.g","KQ417216",208182,208755,573
"16373","Ocbimv22031399m.g","KQ416395",378279,378709,430
"16374","Ocbimv22033907m.g","KQ421906",242514,259359,16845
"16375","Ocbimv22008812m.g","KQ426774",220942,222156,1214
"16376","Ocbimv22003013m.g","KQ417054",227434,275235,47801
"16377","Ocbimv22004663m.g","KQ425412",125312,125813,501
"16378","Ocbimv22017685m.g","KQ430417",58677,59958,1281
"16379","Ocbimv22010820m.g","KQ427527",97126,107351,10225
"16380","Ocbimv22029708m.g","KQ416318",76090,76482,392
"16381","Ocbimv22031397m.g","KQ416395",192374,193492,1118
"16382","Ocbimv22039029m.g","KQ423515",206225,206425,200
"16383","Ocbimv22010282m.g","KQ427344",118339,118686,347
"16384","Ocbimv22004350m.g","KQ425271",79135,79371,236
"16385","Ocbimv22033251m.g","KQ421758",1400115,1403269,3154
"16386","Ocbimv22025670m.g","KQ419883",72910,124805,51895
"16387","Ocbimv22009715m.g","KQ427096",176836,184183,7347
"16388","Ocbimv22037612m.g","KQ423077",976053,1034702,58649
"16389","Ocbimv22010265m.g","KQ427339",37092,37897,805
"16390","Ocbimv22029607m.g","KQ420780",116105,123533,7428
"16391","Ocbimv22003762m.g","KQ425096",20412,21321,909
"16392","Ocbimv22021609m.g","KQ432245",129559,143978,14419
"16393","Ocbimv22016247m.g","KQ418331",139049,217759,78710
"16394","Ocbimv22034827m.g","KQ422187",593259,609113,15854
"16395","Ocbimv22007152m.g","KQ426215",62752,65016,2264
"16396","Ocbimv22011744m.g","KQ427887",120476,129038,8562
"16397","Ocbimv22008186m.g","KQ417482",161017,162471,1454
"16398","Ocbimv22021292m.g","KQ419026",97505,99613,2108
"16399","Ocbimv22036085m.g","KQ416616",1752814,1753620,806
"16400","Ocbimv22030797m.g","KQ416370",306489,355083,48594
"16401","Ocbimv22010540m.g","KQ417688",18809,70639,51830
"16402","Ocbimv22018942m.g","KQ418702",97331,241912,144581
"16403","Ocbimv22021956m.g","KQ419138",92061,138742,46681
"16404","Ocbimv22003621m.g","KQ417095",22844,42756,19912
"16405","Ocbimv22025396m.g","KQ419788",219199,219568,369
"16406","Ocbimv22028103m.g","KQ416249",153594,153773,179
"16407","Ocbimv22030709m.g","KQ421078",124785,217988,93203
"16408","Ocbimv22001880m.g","KQ424459",242706,254510,11804
"16409","Ocbimv22034184m.g","KQ416518",576867,577238,371
"16410","Ocbimv22002954m.g","KQ424852",137240,140877,3637
"16411","Ocbimv22010608m.g","KQ415669",21314,32684,11370
"16412","Ocbimv22034641m.g","KQ422097",425491,425724,233
"16413","Ocbimv22026506m.g","KQ420059",844865,845715,850
"16414","Ocbimv22034803m.g","KQ416556",125396,164848,39452
"16415","Ocbimv22011725m.g","KQ417827",5871,17683,11812
"16416","Ocbimv22005522m.g","KQ425644",33563,94552,60989
"16417","Ocbimv22026253m.g","KQ420022",154385,159557,5172
"16418","Ocbimv22003712m.g","KQ417103",164449,240894,76445
"16419","Ocbimv22022693m.g","KQ419281",583264,596808,13544
"16420","Ocbimv22016590m.g","KQ418368",638460,639850,1390
"16421","Ocbimv22005699m.g","KQ417274",198135,241898,43763
"16422","Ocbimv22032499m.g","KQ421564",119084,121609,2525
"16423","Ocbimv22037314m.g","KQ416685",345063,347425,2362
"16424","Ocbimv22028237m.g","KQ416254",63833,64706,873
"16425","Ocbimv22033503m.g","KQ421821",397680,422632,24952
"16426","Ocbimv22038881m.g","KQ423486",32119,116222,84103
"16427","Ocbimv22019421m.g","KQ418762",41032,41396,364
"16428","Ocbimv22026712m.g","KQ420096",389815,400069,10254
"16429","Ocbimv22014690m.g","KQ418168",480390,485845,5455
"16430","Ocbimv22018444m.g","KQ415992",427308,441446,14138
"16431","Ocbimv22023585m.g","KQ433487",23216,24127,911
"16432","Ocbimv22004428m.g","KQ425304",24680,33417,8737
"16433","Ocbimv22004902m.g","KQ417213",342389,344172,1783
"16434","Ocbimv22016363m.g","KQ415962",400773,408124,7351
"16435","Ocbimv22035697m.g","KQ422516",914511,917558,3047
"16436","Ocbimv22015864m.g","KQ418297",423528,429657,6129
"16437","Ocbimv22016105m.g","KQ429708",272377,287899,15522
"16438","Ocbimv22035037m.g","KQ422254",26177,36988,10811
"16439","Ocbimv22031620m.g","KQ415725",91049,91306,257
"16440","Ocbimv22011322m.g","KQ417780",488048,490077,2029
"16441","Ocbimv22028923m.g","KQ416274",2057166,2057466,300
"16442","Ocbimv22008654m.g","KQ417518",589862,600634,10772
"16443","Ocbimv22002708m.g","KQ424755",37168,37419,251
"16444","Ocbimv22023838m.g","KQ419485",48732,49442,710
"16445","Ocbimv22005061m.g","KQ425510",43159,67289,24130
"16446","Ocbimv22001607m.g","KQ416947",20993,21160,167
"16447","Ocbimv22012774m.g","KQ417939",140230,147043,6813
"16448","Ocbimv22035713m.g","KQ422521",135974,157965,21991
"16449","Ocbimv22004531m.g","KQ415805",1597597,1598184,587
"16450","Ocbimv22007797m.g","KQ426457",32341,42200,9859
"16451","Ocbimv22008726m.g","KQ417528",5156,5561,405
"16452","Ocbimv22034052m.g","KQ416508",577284,593315,16031
"16453","Ocbimv22001127m.g","KQ424192",72871,75145,2274
"16454","Ocbimv22006332m.g","KQ425878",56930,62860,5930
"16455","Ocbimv22009427m.g","KQ417591",1572804,1582096,9292
"16456","Ocbimv22026882m.g","KQ420133",24573,92628,68055
"16457","Ocbimv22010616m.g","KQ415669",558130,559479,1349
"16458","Ocbimv22026734m.g","KQ416198",297999,306382,8383
"16459","Ocbimv22034232m.g","KQ416526",296642,302479,5837
"16460","Ocbimv22006233m.g","KQ417305",31393,52013,20620
"16461","Ocbimv22004119m.g","KQ425206",50838,73057,22219
"16462","Ocbimv22038091m.g","KQ423213",243522,244519,997
"16463","Ocbimv22022662m.g","KQ419279",33167,37041,3874
"16464","Ocbimv22017463m.g","KQ418498",570531,577507,6976
"16465","Ocbimv22019663m.g","KQ416016",45502,80114,34612
"16466","Ocbimv22007798m.g","KQ426457",53207,66077,12870
"16467","Ocbimv22005992m.g","KQ415827",192616,192849,233
"16468","Ocbimv22025507m.g","KQ419828",64346,64750,404
"16469","Ocbimv22019690m.g","KQ431265",47,2647,2600
"16470","Ocbimv22013155m.g","KQ428390",1877,2160,283
"16471","Ocbimv22009118m.g","KQ426892",3778,5265,1487
"16472","Ocbimv22003777m.g","KQ417112",200147,213700,13553
"16473","Ocbimv22016407m.g","KQ429843",14815,15618,803
"16474","Ocbimv22002752m.g","KQ417032",600236,628611,28375
"16475","Ocbimv22034097m.g","KQ421974",54340,58646,4306
"16476","Ocbimv22014295m.g","KQ418115",294479,294739,260
"16477","Ocbimv22006491m.g","LGKD01546108",55,192,137
"16478","Ocbimv22024382m.g","KQ433973",50065,57622,7557
"16479","Ocbimv22022501m.g","KQ419233",492739,492981,242
"16480","Ocbimv22017285m.g","KQ418476",72522,75720,3198
"16481","Ocbimv22019713m.g","KQ418804",695725,696213,488
"16482","Ocbimv22039925m.g","KQ423797",192677,206001,13324
"16483","Ocbimv22026029m.g","KQ419958",138947,139198,251
"16484","Ocbimv22027283m.g","KQ420241",388781,391082,2301
"16485","Ocbimv22019008m.g","KQ418710",1464663,1465043,380
"16486","Ocbimv22028131m.g","KQ416251",517171,517443,272
"16487","Ocbimv22035800m.g","KQ422556",241375,263889,22514
"16488","Ocbimv22001648m.g","KQ416950",2010676,2012526,1850
"16489","Ocbimv22012227m.g","KQ417891",449695,450000,305
"16490","Ocbimv22000044m.g","KQ423834",100097,102087,1990
"16491","Ocbimv22016855m.g","KQ418413",126502,133627,7125
"16492","Ocbimv22003409m.g","KQ417086",572450,589984,17534
"16493","Ocbimv22034501m.g","KQ422062",332622,393124,60502
"16494","Ocbimv22032492m.g","KQ421559",21243,21466,223
"16495","Ocbimv22038197m.g","KQ416731",123219,128095,4876
"16496","Ocbimv22026988m.g","KQ420159",8602,73539,64937
"16497","Ocbimv22032423m.g","KQ421533",511426,517787,6361
"16498","Ocbimv22006016m.g","KQ425779",391610,424991,33381
"16499","Ocbimv22021810m.g","KQ432338",430,1006,576
"16500","Ocbimv22018357m.g","KQ418610",96950,97225,275
"16501","Ocbimv22002967m.g","KQ417051",1954796,1969629,14833
"16502","Ocbimv22013214m.g","KQ418002",286864,292685,5821
"16503","Ocbimv22008653m.g","KQ417518",580345,588996,8651
"16504","Ocbimv22017720m.g","LGKD01638221",290,736,446
"16505","Ocbimv22011702m.g","KQ417824",388057,420484,32427
"16506","Ocbimv22008825m.g","KQ426780",316,1276,960
"16507","Ocbimv22035285m.g","KQ422349",177570,178658,1088
"16508","Ocbimv22020846m.g","KQ418970",2333598,2337659,4061
"16509","Ocbimv22029099m.g","KQ420648",22962,23984,1022
"16510","Ocbimv22016279m.g","KQ418336",88,1695,1607
"16511","Ocbimv22034749m.g","KQ422143",111910,112554,644
"16512","Ocbimv22009012m.g","KQ417552",74880,96802,21922
"16513","Ocbimv22038319m.g","KQ423280",172368,244776,72408
"16514","Ocbimv22024994m.g","KQ419674",13228,44597,31369
"16515","Ocbimv22035669m.g","KQ422496",407020,408349,1329
"16516","Ocbimv22009805m.g","KQ417617",359666,359857,191
"16517","Ocbimv22005759m.g","KQ417276",106688,124419,17731
"16518","Ocbimv22019515m.g","LGKD01651613",518,673,155
"16519","Ocbimv22025613m.g","KQ419861",97572,98754,1182
"16520","Ocbimv22023826m.g","KQ416099",3038,7996,4958
"16521","Ocbimv22039116m.g","KQ416779",764200,784238,20038
"16522","Ocbimv22035815m.g","KQ422558",56946,57822,876
"16523","Ocbimv22037219m.g","KQ422970",69449,71360,1911
"16524","Ocbimv22012644m.g","KQ428192",189000,189822,822
"16525","Ocbimv22034228m.g","KQ416526",104892,107882,2990
"16526","Ocbimv22033365m.g","KQ421800",89367,89828,461
"16527","Ocbimv22036846m.g","KQ422875",39269,39730,461
"16528","Ocbimv22010208m.g","KQ427309",80651,102805,22154
"16529","Ocbimv22009024m.g","KQ426846",1396,22771,21375
"16530","Ocbimv22023244m.g","KQ433290",3,380,377
"16531","Ocbimv22003477m.g","KQ425015",697336,699192,1856
"16532","Ocbimv22012346m.g","KQ428122",3318,6128,2810
"16533","Ocbimv22036225m.g","KQ416626",303681,337183,33502
"16534","Ocbimv22000444m.g","KQ423968",41091,41847,756
"16535","Ocbimv22037838m.g","KQ423139",387001,388258,1257
"16536","Ocbimv22019203m.g","KQ418734",26074,27141,1067
"16537","Ocbimv22009128m.g","KQ426892",72275,77000,4725
"16538","Ocbimv22005265m.g","KQ425561",263278,263589,311
"16539","Ocbimv22017062m.g","KQ418447",39134,40084,950
"16540","Ocbimv22025032m.g","KQ416136",457028,457274,246
"16541","Ocbimv22014062m.g","KQ415672",520041,520309,268
"16542","Ocbimv22013475m.g","KQ428524",181150,181572,422
"16543","Ocbimv22012170m.g","KQ428057",41496,50029,8533
"16544","Ocbimv22012616m.g","KQ417921",395507,396746,1239
"16545","Ocbimv22018866m.g","KQ418693",378337,390428,12091
"16546","Ocbimv22006142m.g","KQ417300",751457,757257,5800
"16547","Ocbimv22012894m.g","KQ428273",18145,19234,1089
"16548","Ocbimv22021311m.g","KQ419027",137593,138795,1202
"16549","Ocbimv22030387m.g","KQ420970",182312,184189,1877
"16550","Ocbimv22026519m.g","KQ420063",168300,168656,356
"16551","Ocbimv22007453m.g","KQ415842",1404506,1405183,677
"16552","Ocbimv22002775m.g","KQ424779",4471,16080,11609
"16553","Ocbimv22029339m.g","KQ420711",765791,767634,1843
"16554","Ocbimv22019354m.g","KQ418754",270447,271284,837
"16555","Ocbimv22038583m.g","KQ416753",239582,240532,950
"16556","Ocbimv22029867m.g","KQ420828",1900877,1938754,37877
"16557","Ocbimv22011905m.g","KQ427949",64426,68257,3831
"16558","Ocbimv22003020m.g","KQ417055",423268,457197,33929
"16559","Ocbimv22034402m.g","KQ422029",64457,66040,1583
"16560","Ocbimv22002148m.g","KQ424561",16644,21092,4448
"16561","Ocbimv22036463m.g","KQ422771",96706,136499,39793
"16562","Ocbimv22028267m.g","KQ415659",1826618,1907100,80482
"16563","Ocbimv22017391m.g","KQ418489",16235,16559,324
"16564","Ocbimv22011704m.g","KQ417824",421744,426731,4987
"16565","Ocbimv22011587m.g","KQ417807",118097,120658,2561
"16566","Ocbimv22006307m.g","KQ425871",39048,110939,71891
"16567","Ocbimv22014772m.g","KQ418176",844478,938673,94195
"16568","Ocbimv22038913m.g","KQ416771",1480418,1521342,40924
"16569","Ocbimv22036219m.g","KQ416626",118379,165510,47131
"16570","Ocbimv22011116m.g","KQ427644",461238,461513,275
"16571","Ocbimv22019199m.g","KQ418733",3870,43687,39817
"16572","Ocbimv22030371m.g","KQ420966",184630,255282,70652
"16573","Ocbimv22024364m.g","KQ419574",765679,766221,542
"16574","Ocbimv22033031m.g","KQ421720",292305,294128,1823
"16575","Ocbimv22015702m.g","KQ418279",58072,58497,425
"16576","Ocbimv22021169m.g","KQ415686",403773,411294,7521
"16577","Ocbimv22020361m.g","KQ418900",356652,357720,1068
"16578","Ocbimv22030799m.g","KQ416370",355544,390970,35426
"16579","Ocbimv22028151m.g","KQ420439",15492,48950,33458
"16580","Ocbimv22000808m.g","KQ416885",671422,672774,1352
"16581","Ocbimv22021524m.g","KQ419066",173083,173292,209
"16582","Ocbimv22035547m.g","KQ415751",57751,58419,668
"16583","Ocbimv22018620m.g","KQ418644",976993,977235,242
"16584","Ocbimv22007030m.g","KQ417370",592987,600896,7909
"16585","Ocbimv22007855m.g","KQ417455",300197,310801,10604
"16586","Ocbimv22011439m.g","KQ427746",521446,525809,4363
"16587","Ocbimv22022687m.g","KQ419281",525467,527251,1784
"16588","Ocbimv22006514m.g","KQ417330",139234,140997,1763
"16589","Ocbimv22022050m.g","KQ419152",188234,189560,1326
"16590","Ocbimv22020202m.g","KQ418873",393662,417515,23853
"16591","Ocbimv22038678m.g","KQ423438",40010,40375,365
"16592","Ocbimv22018418m.g","KQ430684",768461,775198,6737
"16593","Ocbimv22029069m.g","KQ420640",173318,195285,21967
"16594","Ocbimv22013192m.g","KQ428420",223013,231723,8710
"16595","Ocbimv22028609m.g","KQ416263",798614,798799,185
"16596","Ocbimv22039430m.g","KQ423659",4049,17454,13405
"16597","Ocbimv22008372m.g","KQ417498",838194,843381,5187
"16598","Ocbimv22007407m.g","KQ417412",68876,90236,21360
"16599","Ocbimv22032769m.g","KQ421656",12969,39125,26156
"16600","Ocbimv22015756m.g","KQ429539",54939,56791,1852
"16601","Ocbimv22010716m.g","KQ427476",164305,165018,713
"16602","Ocbimv22028274m.g","KQ415659",2046707,2047126,419
"16603","Ocbimv22022140m.g","KQ419175",594608,603256,8648
"16604","Ocbimv22028585m.g","KQ416263",8985,11232,2247
"16605","Ocbimv22021373m.g","KQ432100",1,296,295
"16606","Ocbimv22033124m.g","KQ421731",335211,351464,16253
"16607","Ocbimv22039059m.g","KQ423531",236564,261448,24884
"16608","Ocbimv22009416m.g","KQ417591",1136050,1136202,152
"16609","Ocbimv22006472m.g","KQ417326",3016,43570,40554
"16610","Ocbimv22016055m.g","KQ415951",112999,113214,215
"16611","Ocbimv22000923m.g","LGKD01496187",2,478,476
"16612","Ocbimv22021890m.g","KQ432399",14178,93516,79338
"16613","Ocbimv22019214m.g","KQ418734",164608,251296,86688
"16614","Ocbimv22004162m.g","KQ425220",142376,156196,13820
"16615","Ocbimv22004381m.g","KQ425284",59597,139121,79524
"16616","Ocbimv22004712m.g","KQ417199",117364,119499,2135
"16617","Ocbimv22025668m.g","KQ419882",170819,202727,31908
"16618","Ocbimv22016083m.g","LGKD01624288",7,408,401
"16619","Ocbimv22004550m.g","KQ425356",9524,9757,233
"16620","Ocbimv22018965m.g","KQ418703",8924,9106,182
"16621","Ocbimv22019292m.g","KQ431076",20879,44777,23898
"16622","Ocbimv22025194m.g","KQ419727",328217,458425,130208
"16623","Ocbimv22009383m.g","KQ426986",72507,73230,723
"16624","Ocbimv22003390m.g","KQ425002",396159,396413,254
"16625","Ocbimv22035246m.g","KQ422341",70650,71291,641
"16626","Ocbimv22023636m.g","KQ419448",192341,219082,26741
"16627","Ocbimv22032034m.g","KQ421411",443815,488173,44358
"16628","Ocbimv22006745m.g","KQ426095",148020,178751,30731
"16629","Ocbimv22000925m.g","KQ416895",568118,569118,1000
"16630","Ocbimv22030167m.g","KQ420915",349277,352396,3119
"16631","Ocbimv22020329m.g","KQ418895",138573,145279,6706
"16632","Ocbimv22024066m.g","LGKD01695507",220,381,161
"16633","Ocbimv22000031m.g","KQ423829",95522,96082,560
"16634","Ocbimv22000645m.g","KQ416872",314840,322589,7749
"16635","Ocbimv22021087m.g","KQ431981",936,1094,158
"16636","Ocbimv22024230m.g","KQ416117",3107,44378,41271
"16637","Ocbimv22013253m.g","KQ428426",79662,90197,10535
"16638","Ocbimv22020848m.g","KQ418970",2343970,2349084,5114
"16639","Ocbimv22028100m.g","KQ416249",97793,98089,296
"16640","Ocbimv22023780m.g","KQ416096",1311610,1314728,3118
"16641","Ocbimv22012707m.g","KQ417929",2111,9663,7552
"16642","Ocbimv22003337m.g","KQ424979",10302,20958,10656
"16643","Ocbimv22021765m.g","KQ419098",29468,29749,281
"16644","Ocbimv22013583m.g","KQ418038",420540,434770,14230
"16645","Ocbimv22033137m.g","KQ421733",66988,95052,28064
"16646","Ocbimv22027201m.g","KQ420217",323269,323627,358
"16647","Ocbimv22017299m.g","KQ418479",151764,153257,1493
"16648","Ocbimv22018096m.g","KQ418571",648390,676684,28294
"16649","Ocbimv22027194m.g","KQ420215",182606,185125,2519
"16650","Ocbimv22009517m.g","KQ415865",743340,744203,863
"16651","Ocbimv22026382m.g","KQ416188",413764,455923,42159
"16652","Ocbimv22028933m.g","KQ420604",13080,14483,1403
"16653","Ocbimv22007705m.g","KQ426423",167234,170722,3488
"16654","Ocbimv22036624m.g","KQ416651",961780,969795,8015
"16655","Ocbimv22021111m.g","KQ419008",47108,47934,826
"16656","Ocbimv22012572m.g","KQ417917",1466502,1466765,263
"16657","Ocbimv22013058m.g","KQ417977",310333,323496,13163
"16658","Ocbimv22030501m.g","KQ416353",265466,266482,1016
"16659","Ocbimv22018649m.g","KQ418649",547326,555067,7741
"16660","Ocbimv22026944m.g","KQ420146",304392,371960,67568
"16661","Ocbimv22030951m.g","KQ421131",2416,54903,52487
"16662","Ocbimv22039749m.g","LGKD01484914",1,252,251
"16663","Ocbimv22034442m.g","KQ416532",15706,18167,2461
"16664","Ocbimv22018321m.g","KQ430648",3006,3376,370
"16665","Ocbimv22022681m.g","KQ419281",258014,259315,1301
"16666","Ocbimv22034995m.g","KQ416567",64664,69980,5316
"16667","Ocbimv22018105m.g","KQ430572",316385,316948,563
"16668","Ocbimv22006170m.g","KQ417300",2392781,2393654,873
"16669","Ocbimv22012790m.g","KQ428240",110429,111142,713
"16670","Ocbimv22009508m.g","KQ415865",630619,648022,17403
"16671","Ocbimv22001352m.g","KQ416924",671167,673901,2734
"16672","Ocbimv22001684m.g","KQ424384",68813,107610,38797
"16673","Ocbimv22013861m.g","KQ428698",2396,87043,84647
"16674","Ocbimv22037714m.g","KQ423110",172315,190818,18503
"16675","Ocbimv22014029m.g","KQ418079",652330,654073,1743
"16676","Ocbimv22022961m.g","KQ416079",234395,280047,45652
"16677","Ocbimv22007680m.g","KQ415846",112836,113841,1005
"16678","Ocbimv22013160m.g","LGKD01599781",49,207,158
"16679","Ocbimv22038272m.g","KQ423259",433059,450528,17469
"16680","Ocbimv22037728m.g","KQ423122",42385,62651,20266
"16681","Ocbimv22007600m.g","KQ415844",28885,35258,6373
"16682","Ocbimv22021240m.g","KQ419018",456854,457177,323
"16683","Ocbimv22001460m.g","KQ416934",69803,112662,42859
"16684","Ocbimv22015664m.g","KQ418273",625427,625843,416
"16685","Ocbimv22013419m.g","KQ418021",328319,400800,72481
"16686","Ocbimv22002138m.g","KQ415788",748660,753122,4462
"16687","Ocbimv22036485m.g","KQ422772",97842,98594,752
"16688","Ocbimv22036976m.g","KQ422897",58738,59058,320
"16689","Ocbimv22019502m.g","KQ416013",190427,221912,31485
"16690","Ocbimv22014881m.g","KQ415936",273268,306236,32968
"16691","Ocbimv22014523m.g","KQ415932",979740,980603,863
"16692","Ocbimv22036243m.g","KQ416627",187921,188256,335
"16693","Ocbimv22032425m.g","KQ421533",546506,550994,4488
"16694","Ocbimv22009397m.g","KQ417590",64091,93429,29338
"16695","Ocbimv22015587m.g","KQ415946",83561,104739,21178
"16696","Ocbimv22010837m.g","KQ427538",53788,55608,1820
"16697","Ocbimv22012911m.g","KQ417953",34296,57124,22828
"16698","Ocbimv22004424m.g","KQ415804",448949,449349,400
"16699","Ocbimv22013585m.g","KQ418038",470458,485972,15514
"16700","Ocbimv22022807m.g","KQ419300",672995,700741,27746
"16701","Ocbimv22029804m.g","KQ420828",366,11171,10805
"16702","Ocbimv22014976m.g","KQ429141",351,2448,2097
"16703","Ocbimv22005081m.g","KQ425516",262723,262992,269
"16704","Ocbimv22011420m.g","KQ415885",1388478,1426418,37940
"16705","Ocbimv22007816m.g","KQ426461",356154,368470,12316
"16706","Ocbimv22023509m.g","KQ419420",188713,192621,3908
"16707","Ocbimv22036732m.g","KQ416655",348509,357372,8863
"16708","Ocbimv22031000m.g","KQ421143",101048,107169,6121
"16709","Ocbimv22013261m.g","KQ428426",183384,183893,509
"16710","Ocbimv22033254m.g","KQ421758",1453024,1464373,11349
"16711","Ocbimv22009955m.g","LGKD01574704",3292,4431,1139
"16712","Ocbimv22026328m.g","KQ420027",82700,85208,2508
"16713","Ocbimv22023259m.g","KQ419380",917600,918079,479
"16714","Ocbimv22038142m.g","KQ423217",618052,653138,35086
"16715","Ocbimv22013685m.g","KQ418048",24475,28974,4499
"16716","Ocbimv22005741m.g","KQ425732",214952,225940,10988
"16717","Ocbimv22029958m.g","KQ420859",296379,307841,11462
"16718","Ocbimv22019789m.g","KQ431314",23597,44552,20955
"16719","Ocbimv22014427m.g","KQ418133",363062,363541,479
"16720","Ocbimv22016089m.g","KQ415954",208657,208851,194
"16721","Ocbimv22010057m.g","KQ427240",37,381,344
"16722","Ocbimv22010395m.g","KQ417676",53341,53661,320
"16723","Ocbimv22015085m.g","KQ418194",1693281,1693916,635
"16724","Ocbimv22029366m.g","KQ420728",245722,246249,527
"16725","Ocbimv22020406m.g","KQ418908",378468,412669,34201
"16726","Ocbimv22028320m.g","KQ420475",70676,77796,7120
"16727","Ocbimv22038444m.g","KQ423341",35618,36664,1046
"16728","Ocbimv22037261m.g","KQ422986",107434,108843,1409
"16729","Ocbimv22024630m.g","KQ419605",257526,272705,15179
"16730","Ocbimv22004270m.g","KQ425253",146392,146547,155
"16731","Ocbimv22031769m.g","KQ421342",63835,64694,859
"16732","Ocbimv22020425m.g","KQ416027",1615,42315,40700
"16733","Ocbimv22019950m.g","KQ431382",1451,3478,2027
"16734","Ocbimv22021023m.g","KQ418994",193856,195046,1190
"16735","Ocbimv22023364m.g","KQ419395",247600,252849,5249
"16736","Ocbimv22013700m.g","KQ418049",134515,139093,4578
"16737","Ocbimv22038904m.g","KQ416771",1027990,1029340,1350
"16738","Ocbimv22030885m.g","KQ421116",287758,307944,20186
"16739","Ocbimv22019546m.g","KQ418783",454192,464073,9881
"16740","Ocbimv22014009m.g","KQ418075",1002651,1002827,176
"16741","Ocbimv22001693m.g","KQ416955",432064,479405,47341
"16742","Ocbimv22001359m.g","KQ424287",141633,141848,215
"16743","Ocbimv22017271m.g","KQ430232",262036,268326,6290
"16744","Ocbimv22036737m.g","KQ422844",5037,12424,7387
"16745","Ocbimv22037248m.g","KQ422975",83235,83492,257
"16746","Ocbimv22013578m.g","KQ418038",366577,394737,28160
"16747","Ocbimv22025770m.g","KQ416166",904903,905094,191
"16748","Ocbimv22005698m.g","KQ417274",109390,180844,71454
"16749","Ocbimv22034552m.g","KQ416536",1134485,1136483,1998
"16750","Ocbimv22023559m.g","KQ419432",121423,124608,3185
"16751","Ocbimv22009943m.g","KQ417625",247847,248718,871
"16752","Ocbimv22038576m.g","KQ416752",14112,26907,12795
"16753","Ocbimv22028667m.g","KQ420548",34570,34971,401
"16754","Ocbimv22011973m.g","KQ415895",591752,627855,36103
"16755","Ocbimv22022852m.g","KQ419311",507296,508568,1272
"16756","Ocbimv22014342m.g","KQ418120",240935,247186,6251
"16757","Ocbimv22003715m.g","KQ425069",48581,116993,68412
"16758","Ocbimv22029234m.g","KQ420690",7983,37376,29393
"16759","Ocbimv22030443m.g","KQ416350",83945,84930,985
"16760","Ocbimv22006901m.g","KQ426136",28063,118395,90332
"16761","Ocbimv22034763m.g","KQ422162",473518,473754,236
"16762","Ocbimv22033789m.g","KQ421871",412953,413424,471
"16763","Ocbimv22011235m.g","KQ417764",78924,119222,40298
"16764","Ocbimv22007111m.g","KQ417379",167283,168875,1592
"16765","Ocbimv22003784m.g","KQ417112",603778,649691,45913
"16766","Ocbimv22014560m.g","KQ418153",134751,135130,379
"16767","Ocbimv22006111m.g","KQ425828",38171,39577,1406
"16768","Ocbimv22013329m.g","KQ418012",281697,305227,23530
"16769","Ocbimv22022384m.g","KQ432717",16962,43692,26730
"16770","Ocbimv22024728m.g","KQ419621",1335047,1336534,1487
"16771","Ocbimv22034019m.g","KQ421946",449616,455346,5730
"16772","Ocbimv22037678m.g","KQ423096",17886,18170,284
"16773","Ocbimv22020439m.g","KQ431681",1078,24104,23026
"16774","Ocbimv22026270m.g","KQ420022",512595,513884,1289
"16775","Ocbimv22020983m.g","KQ431914",1667,2217,550
"16776","Ocbimv22002769m.g","KQ424777",84760,85948,1188
"16777","Ocbimv22031682m.g","KQ421308",534842,550766,15924
"16778","Ocbimv22019374m.g","KQ418757",122279,125318,3039
"16779","Ocbimv22008249m.g","KQ426602",167685,205273,37588
"16780","Ocbimv22039871m.g","KQ416832",185252,188001,2749
"16781","Ocbimv22007140m.g","KQ426206",73123,84139,11016
"16782","Ocbimv22004527m.g","KQ415805",1382871,1383158,287
"16783","Ocbimv22020601m.g","KQ431749",3458,20656,17198
"16784","Ocbimv22033870m.g","KQ421896",362697,368001,5304
"16785","Ocbimv22009692m.g","KQ417604",253207,253758,551
"16786","Ocbimv22006423m.g","KQ425915",53973,87878,33905
"16787","Ocbimv22002866m.g","KQ424811",255020,283454,28434
"16788","Ocbimv22022909m.g","KQ419324",324477,327342,2865
"16789","Ocbimv22015784m.g","LGKD01230051",28,249,221
"16790","Ocbimv22000373m.g","KQ423941",320588,325739,5151
"16791","Ocbimv22025924m.g","KQ419928",2283,7027,4744
"16792","Ocbimv22036834m.g","KQ422870",943,50384,49441
"16793","Ocbimv22034844m.g","KQ422191",91443,99454,8011
"16794","Ocbimv22001086m.g","KQ416908",581005,581364,359
"16795","Ocbimv22007317m.g","KQ417403",98102,98426,324
"16796","Ocbimv22013036m.g","KQ428349",304923,330526,25603
"16797","Ocbimv22003871m.g","KQ417118",335114,370973,35859
"16798","Ocbimv22024829m.g","KQ416129",491315,491800,485
"16799","Ocbimv22034508m.g","KQ422063",46391,50029,3638
"16800","Ocbimv22031266m.g","KQ416391",144903,149929,5026
"16801","Ocbimv22012929m.g","KQ417955",80684,131712,51028
"16802","Ocbimv22019181m.g","KQ418729",120737,123128,2391
"16803","Ocbimv22005789m.g","KQ415823",577379,577738,359
"16804","Ocbimv22002113m.g","KQ424547",9350,10372,1022
"16805","Ocbimv22005415m.g","KQ417249",2634818,2635168,350
"16806","Ocbimv22021800m.g","KQ419103",600439,601133,694
"16807","Ocbimv22035539m.g","KQ422425",343,2705,2362
"16808","Ocbimv22016544m.g","KQ418367",235674,237816,2142
"16809","Ocbimv22022094m.g","KQ432562",11184,51775,40591
"16810","Ocbimv22019646m.g","KQ431217",10594,66262,55668
"16811","Ocbimv22002983m.g","KQ424855",97804,98019,215
"16812","Ocbimv22011509m.g","KQ417796",480694,480906,212
"16813","Ocbimv22005250m.g","KQ425553",16972,19957,2985
"16814","Ocbimv22039253m.g","KQ423593",15097,107119,92022
"16815","Ocbimv22023138m.g","KQ416081",185683,188005,2322
"16816","Ocbimv22032628m.g","KQ421619",41133,57366,16233
"16817","Ocbimv22013859m.g","KQ415921",347982,356910,8928
"16818","Ocbimv22019505m.g","KQ416013",465129,465618,489
"16819","Ocbimv22009476m.g","KQ417596",730912,731464,552
"16820","Ocbimv22026957m.g","KQ420150",150524,171260,20736
"16821","Ocbimv22039515m.g","KQ423680",267641,271287,3646
"16822","Ocbimv22031821m.g","KQ421356",16095,49280,33185
"16823","Ocbimv22038118m.g","KQ423217",104822,139959,35137
"16824","Ocbimv22014492m.g","KQ428966",1,3947,3946
"16825","Ocbimv22027421m.g","KQ420271",172169,173831,1662
"16826","Ocbimv22033345m.g","KQ416475",125538,126118,580
"16827","Ocbimv22008161m.g","KQ417481",1154955,1155158,203
"16828","Ocbimv22029152m.g","KQ420669",23065,23298,233
"16829","Ocbimv22011584m.g","LGKD01588064",44,208,164
"16830","Ocbimv22028443m.g","KQ420489",801,10230,9429
"16831","Ocbimv22031108m.g","KQ416385",1193105,1195327,2222
"16832","Ocbimv22004150m.g","KQ425219",26887,29462,2575
"16833","Ocbimv22012077m.g","KQ428009",13659,98402,84743
"16834","Ocbimv22036855m.g","KQ416662",50294,79955,29661
"16835","Ocbimv22031229m.g","KQ421203",33189,36546,3357
"16836","Ocbimv22026372m.g","KQ416188",134086,135050,964
"16837","Ocbimv22029733m.g","KQ420814",33900,75790,41890
"16838","Ocbimv22036689m.g","KQ422839",46048,56215,10167
"16839","Ocbimv22027696m.g","KQ416231",102054,106582,4528
"16840","Ocbimv22001753m.g","KQ416961",18691,74634,55943
"16841","Ocbimv22026774m.g","KQ420113",34537,88743,54206
"16842","Ocbimv22014561m.g","KQ418153",146066,146257,191
"16843","Ocbimv22035275m.g","KQ422349",74453,76883,2430
"16844","Ocbimv22027304m.g","KQ420252",259296,274301,15005
"16845","Ocbimv22024395m.g","KQ415693",421770,446765,24995
"16846","Ocbimv22001254m.g","KQ424243",108718,143626,34908
"16847","Ocbimv22004093m.g","LGKD01141981",492,4499,4007
"16848","Ocbimv22013887m.g","KQ418070",71140,79008,7868
"16849","Ocbimv22027752m.g","KQ420357",161910,167552,5642
"16850","Ocbimv22038710m.g","KQ423448",1645,28146,26501
"16851","Ocbimv22008576m.g","KQ417510",214548,226755,12207
"16852","Ocbimv22010143m.g","KQ427275",662663,664178,1515
"16853","Ocbimv22039082m.g","KQ423541",23327,28250,4923
"16854","Ocbimv22002678m.g","KQ424738",33107,40597,7490
"16855","Ocbimv22026901m.g","KQ420138",1119255,1120178,923
"16856","Ocbimv22035381m.g","KQ422366",57906,60488,2582
"16857","Ocbimv22010898m.g","KQ427563",101984,102500,516
"16858","Ocbimv22022327m.g","KQ419199",31013,53904,22891
"16859","Ocbimv22007413m.g","KQ426334",42190,42982,792
"16860","Ocbimv22031607m.g","KQ416402",11245,33861,22616
"16861","Ocbimv22027418m.g","KQ420270",136289,159541,23252
"16862","Ocbimv22006372m.g","KQ425894",216970,244293,27323
"16863","Ocbimv22012691m.g","LGKD01596174",52,315,263
"16864","Ocbimv22012853m.g","KQ417945",797370,797678,308
"16865","Ocbimv22026815m.g","KQ420119",101764,102120,356
"16866","Ocbimv22012135m.g","KQ415902",266331,266483,152
"16867","Ocbimv22008686m.g","KQ426728",21622,23256,1634
"16868","Ocbimv22038717m.g","KQ423450",18,2397,2379
"16869","Ocbimv22011652m.g","KQ427833",96252,97465,1213
"16870","Ocbimv22038158m.g","KQ415763",1263271,1263858,587
"16871","Ocbimv22038719m.g","KQ423454",32680,59219,26539
"16872","Ocbimv22023686m.g","KQ433567",630,791,161
"16873","Ocbimv22025487m.g","KQ419818",268966,272647,3681
"16874","Ocbimv22011600m.g","KQ427795",9136,12541,3405
"16875","Ocbimv22030587m.g","KQ421031",151895,152257,362
"16876","Ocbimv22000036m.g","KQ423831",170510,248788,78278
"16877","Ocbimv22039606m.g","KQ423717",32940,33344,404
"16878","Ocbimv22014651m.g","KQ429026",121693,121983,290
"16879","Ocbimv22002189m.g","KQ424569",264061,264383,322
"16880","Ocbimv22031004m.g","KQ421143",260134,364334,104200
"16881","Ocbimv22039282m.g","KQ416787",151490,178548,27058
"16882","Ocbimv22012094m.g","KQ428033",35772,36065,293
"16883","Ocbimv22024958m.g","KQ419666",270197,272061,1864
"16884","Ocbimv22016914m.g","KQ418422",824602,825048,446
"16885","Ocbimv22016587m.g","KQ418368",434208,435402,1194
"16886","Ocbimv22017764m.g","LGKD01638742",15,326,311
"16887","Ocbimv22000890m.g","KQ424103",396802,413279,16477
"16888","Ocbimv22032934m.g","KQ421686",57957,80523,22566
"16889","Ocbimv22029522m.g","KQ420768",1,1027,1026
"16890","Ocbimv22000001m.g","KQ423819",92753,98310,5557
"16891","Ocbimv22003705m.g","KQ417101",300488,325291,24803
"16892","Ocbimv22030850m.g","KQ416373",58578,60938,2360
"16893","Ocbimv22014266m.g","LGKD01607770",11,196,185
"16894","Ocbimv22018518m.g","KQ415994",218698,218895,197
"16895","Ocbimv22021604m.g","KQ432245",94165,97944,3779
"16896","Ocbimv22031484m.g","KQ421260",47957,63091,15134
"16897","Ocbimv22019901m.g","LGKD01655122",2,337,335
"16898","Ocbimv22039100m.g","KQ416779",109488,119379,9891
"16899","Ocbimv22005083m.g","KQ425517",89603,93272,3669
"16900","Ocbimv22020545m.g","LGKD01661088",38,253,215
"16901","Ocbimv22010039m.g","KQ417633",319637,319822,185
"16902","Ocbimv22026904m.g","KQ420140",20423,58005,37582
"16903","Ocbimv22012197m.g","KQ417887",430516,456960,26444
"16904","Ocbimv22006248m.g","KQ417305",434420,445226,10806
"16905","Ocbimv22037747m.g","KQ416708",428688,467495,38807
"16906","Ocbimv22031156m.g","KQ421177",140912,141781,869
"16907","Ocbimv22027842m.g","KQ420375",1448000,1460635,12635
"16908","Ocbimv22006655m.g","KQ417340",9464,14176,4712
"16909","Ocbimv22013857m.g","KQ415921",284679,326114,41435
"16910","Ocbimv22039643m.g","KQ423718",11874,12110,236
"16911","Ocbimv22038337m.g","KQ415764",267481,267651,170
"16912","Ocbimv22011730m.g","KQ427878",28571,28927,356
"16913","Ocbimv22028241m.g","KQ416254",400648,400872,224
"16914","Ocbimv22028889m.g","KQ416274",379495,436159,56664
"16915","Ocbimv22007232m.g","KQ426258",31103,36398,5295
"16916","Ocbimv22007254m.g","KQ426269",16702,16854,152
"16917","Ocbimv22015602m.g","KQ415946",869086,870412,1326
"16918","Ocbimv22026794m.g","KQ420117",1003431,1003787,356
"16919","Ocbimv22011713m.g","KQ417824",705498,781896,76398
"16920","Ocbimv22032293m.g","KQ421514",430419,430682,263
"16921","Ocbimv22012259m.g","KQ417896",1111,2130,1019
"16922","Ocbimv22016332m.g","KQ429811",322,2736,2414
"16923","Ocbimv22026364m.g","KQ416188",28006,58670,30664
"16924","Ocbimv22033293m.g","KQ421766",53208,64419,11211
"16925","Ocbimv22002382m.g","KQ417007",151924,152298,374
"16926","Ocbimv22015882m.g","KQ429605",35678,41123,5445
"16927","Ocbimv22019951m.g","KQ431382",8951,9824,873
"16928","Ocbimv22024092m.g","KQ419533",419375,448046,28671
"16929","Ocbimv22031164m.g","KQ421185",182868,184182,1314
"16930","Ocbimv22034475m.g","KQ422053",33000,37175,4175
"16931","Ocbimv22014318m.g","KQ428863",109364,114072,4708
"16932","Ocbimv22021527m.g","KQ419071",1701,3150,1449
"16933","Ocbimv22013468m.g","KQ428523",3900,12668,8768
"16934","Ocbimv22039674m.g","KQ416813",902034,902255,221
"16935","Ocbimv22034268m.g","KQ422015",337106,355645,18539
"16936","Ocbimv22001393m.g","KQ416930",333505,336208,2703
"16937","Ocbimv22015676m.g","KQ429470",122733,130694,7961
"16938","Ocbimv22016809m.g","KQ418403",138249,139038,789
"16939","Ocbimv22009735m.g","KQ417609",147081,149141,2060
"16940","Ocbimv22032106m.g","KQ421451",69718,118008,48290
"16941","Ocbimv22031328m.g","KQ421218",281989,282291,302
"16942","Ocbimv22037169m.g","KQ422947",17029,17863,834
"16943","Ocbimv22030996m.g","KQ421143",1379,1806,427
"16944","Ocbimv22030764m.g","KQ421085",53377,75597,22220
"16945","Ocbimv22025091m.g","KQ416137",458782,460822,2040
"16946","Ocbimv22031711m.g","KQ421325",69201,82000,12799
"16947","Ocbimv22024923m.g","KQ419657",1144531,1146759,2228
"16948","Ocbimv22009594m.g","KQ427040",42635,44228,1593
"16949","Ocbimv22018755m.g","KQ416000",192883,193854,971
"16950","Ocbimv22007928m.g","KQ417462",103,15139,15036
"16951","Ocbimv22008893m.g","KQ426792",155066,166673,11607
"16952","Ocbimv22010911m.g","KQ417724",419042,419482,440
"16953","Ocbimv22015581m.g","KQ418267",1052086,1052984,898
"16954","Ocbimv22020344m.g","KQ431632",709,975,266
"16955","Ocbimv22000576m.g","KQ423998",256985,258409,1424
"16956","Ocbimv22003685m.g","KQ425066",71379,90002,18623
"16957","Ocbimv22018289m.g","KQ430628",59671,72909,13238
"16958","Ocbimv22026504m.g","KQ420059",796521,797451,930
"16959","Ocbimv22009590m.g","KQ427033",121826,164980,43154
"16960","Ocbimv22016395m.g","KQ429831",115178,115360,182
"16961","Ocbimv22024591m.g","KQ419601",801958,810963,9005
"16962","Ocbimv22038213m.g","KQ416731",625517,626363,846
"16963","Ocbimv22002143m.g","KQ415788",1013333,1014811,1478
"16964","Ocbimv22023893m.g","KQ419494",88971,89727,756
"16965","Ocbimv22039794m.g","KQ423753",25,847,822
"16966","Ocbimv22014189m.g","KQ418098",701201,709095,7894
"16967","Ocbimv22032864m.g","KQ421669",56242,70521,14279
"16968","Ocbimv22013465m.g","KQ418025",117976,118925,949
"16969","Ocbimv22001726m.g","KQ416957",40707,45775,5068
"16970","Ocbimv22002247m.g","LGKD01510232",37,144,107
"16971","Ocbimv22007546m.g","KQ426371",256314,275308,18994
"16972","Ocbimv22017746m.g","KQ418537",234188,241885,7697
"16973","Ocbimv22037209m.g","KQ416683",150004,164294,14290
"16974","Ocbimv22028036m.g","KQ416244",132309,133638,1329
"16975","Ocbimv22001738m.g","KQ416959",7657,7926,269
"16976","Ocbimv22023876m.g","KQ419491",24169,79386,55217
"16977","Ocbimv22020585m.g","KQ418926",359905,360299,394
"16978","Ocbimv22001729m.g","KQ416957",51522,55196,3674
"16979","Ocbimv22026076m.g","KQ419989",44841,60961,16120
"16980","Ocbimv22010978m.g","KQ417730",133013,220441,87428
"16981","Ocbimv22031904m.g","KQ421376",55294,55455,161
"16982","Ocbimv22010617m.g","KQ415669",668503,698092,29589
"16983","Ocbimv22028316m.g","KQ420471",145874,153478,7604
"16984","Ocbimv22007492m.g","KQ415843",203054,206090,3036
"16985","Ocbimv22005131m.g","KQ415813",1256867,1257091,224
"16986","Ocbimv22027193m.g","KQ420215",175352,180580,5228
"16987","Ocbimv22024041m.g","KQ416109",2111643,2112885,1242
"16988","Ocbimv22001885m.g","KQ424459",1224708,1276235,51527
"16989","Ocbimv22011948m.g","KQ417847",1092585,1094702,2117
"16990","Ocbimv22000929m.g","KQ424119",14562,16392,1830
"16991","Ocbimv22019816m.g","KQ431332",49090,90172,41082
"16992","Ocbimv22008361m.g","KQ417498",431461,432472,1011
"16993","Ocbimv22027534m.g","KQ420299",992258,1013400,21142
"16994","Ocbimv22031068m.g","KQ421152",12755,14743,1988
"16995","Ocbimv22014602m.g","KQ428999",53054,62156,9102
"16996","Ocbimv22030382m.g","KQ420970",29310,46056,16746
"16997","Ocbimv22009840m.g","KQ417620",697311,704726,7415
"16998","Ocbimv22027737m.g","KQ420350",325634,340818,15184
"16999","Ocbimv22003902m.g","KQ425143",232698,237873,5175
"17000","Ocbimv22004495m.g","KQ417173",249195,249440,245
"17001","Ocbimv22036656m.g","KQ422819",313474,350402,36928
"17002","Ocbimv22009773m.g","KQ417613",107976,108476,500
"17003","Ocbimv22027363m.g","KQ420265",437044,458970,21926
"17004","Ocbimv22025225m.g","KQ419741",52421,140222,87801
"17005","Ocbimv22009415m.g","KQ417591",993046,1019439,26393
"17006","Ocbimv22024521m.g","KQ419592",26812,27906,1094
"17007","Ocbimv22009984m.g","KQ417629",438359,439022,663
"17008","Ocbimv22022177m.g","KQ419180",550980,551333,353
"17009","Ocbimv22021371m.g","LGKD01667216",257,439,182
"17010","Ocbimv22026582m.g","KQ420075",78431,78631,200
"17011","Ocbimv22024873m.g","KQ419644",217955,219507,1552
"17012","Ocbimv22018547m.g","KQ430740",48530,50281,1751
"17013","Ocbimv22018399m.g","KQ430684",176023,184542,8519
"17014","Ocbimv22039391m.g","KQ423638",203408,207004,3596
"17015","Ocbimv22007062m.g","KQ417374",35062,35334,272
"17016","Ocbimv22017074m.g","KQ430159",16654,16866,212
"17017","Ocbimv22006163m.g","KQ417300",1304377,1305335,958
"17018","Ocbimv22003323m.g","KQ417080",155125,155937,812
"17019","Ocbimv22019281m.g","KQ418740",710800,724465,13665
"17020","Ocbimv22011461m.g","KQ427754",33088,42874,9786
"17021","Ocbimv22025080m.g","KQ416137",375048,377238,2190
"17022","Ocbimv22032685m.g","KQ416444",216101,222233,6132
"17023","Ocbimv22033605m.g","KQ415732",65929,72480,6551
"17024","Ocbimv22015126m.g","KQ418196",303950,304610,660
"17025","Ocbimv22009958m.g","KQ427182",67913,114018,46105
"17026","Ocbimv22018760m.g","KQ418668",33656,64329,30673
"17027","Ocbimv22009581m.g","KQ427029",412813,413461,648
"17028","Ocbimv22029661m.g","KQ416315",361097,407474,46377
"17029","Ocbimv22008844m.g","KQ417537",199858,200274,416
"17030","Ocbimv22022779m.g","KQ433008",306896,343094,36198
"17031","Ocbimv22037567m.g","KQ423069",43050,43591,541
"17032","Ocbimv22013164m.g","LGKD01599871",8,127,119
"17033","Ocbimv22005884m.g","KQ417281",576657,611533,34876
"17034","Ocbimv22011065m.g","KQ427615",28367,30635,2268
"17035","Ocbimv22023019m.g","KQ416080",330180,330365,185
"17036","Ocbimv22039035m.g","KQ423517",39599,40305,706
"17037","Ocbimv22021724m.g","KQ416053",24664,35631,10967
"17038","Ocbimv22000034m.g","KQ423831",90748,100028,9280
"17039","Ocbimv22027174m.g","KQ420209",56,29651,29595
"17040","Ocbimv22013574m.g","KQ418038",259415,265131,5716
"17041","Ocbimv22021937m.g","KQ416055",11,2698,2687
"17042","Ocbimv22022976m.g","KQ433172",4082,13962,9880
"17043","Ocbimv22038245m.g","KQ416732",285925,287275,1350
"17044","Ocbimv22002958m.g","KQ424852",231091,244127,13036
"17045","Ocbimv22012279m.g","KQ428101",36761,37997,1236
"17046","Ocbimv22005610m.g","KQ425676",883736,883969,233
"17047","Ocbimv22025715m.g","KQ419887",1065229,1066466,1237
"17048","Ocbimv22016841m.g","KQ418413",4519,5902,1383
"17049","Ocbimv22039854m.g","KQ423780",625457,632391,6934
"17050","Ocbimv22015550m.g","KQ429416",72750,134588,61838
"17051","Ocbimv22027444m.g","KQ420279",119278,119945,667
"17052","Ocbimv22006696m.g","KQ426075",345438,351376,5938
"17053","Ocbimv22011389m.g","KQ417791",846184,847108,924
"17054","Ocbimv22003958m.g","KQ425160",354060,466111,112051
"17055","Ocbimv22027897m.g","KQ420393",191852,192520,668
"17056","Ocbimv22039528m.g","KQ423692",149296,149619,323
"17057","Ocbimv22012290m.g","LGKD01594225",2,334,332
"17058","Ocbimv22024614m.g","KQ416126",298659,490274,191615
"17059","Ocbimv22031262m.g","KQ421208",6160,6558,398
"17060","Ocbimv22000566m.g","KQ423998",20891,22705,1814
"17061","Ocbimv22024522m.g","KQ419592",35058,35776,718
"17062","Ocbimv22025097m.g","KQ416137",478463,479306,843
"17063","Ocbimv22007674m.g","KQ426422",18805,21909,3104
"17064","Ocbimv22010615m.g","KQ415669",550793,551287,494
"17065","Ocbimv22017442m.g","KQ418496",376971,377258,287
"17066","Ocbimv22026840m.g","KQ420126",539666,568694,29028
"17067","Ocbimv22015161m.g","KQ418201",49693,69450,19757
"17068","Ocbimv22015028m.g","KQ418194",445280,447062,1782
"17069","Ocbimv22003850m.g","KQ415798",77429,78115,686
"17070","Ocbimv22018211m.g","KQ415990",1516500,1617512,101012
"17071","Ocbimv22032480m.g","KQ416432",36797,60941,24144
"17072","Ocbimv22001988m.g","KQ416979",794625,794915,290
"17073","Ocbimv22001353m.g","KQ416924",794806,795830,1024
"17074","Ocbimv22035478m.g","KQ422401",41562,48584,7022
"17075","Ocbimv22028227m.g","KQ420447",28231,37997,9766
"17076","Ocbimv22034982m.g","KQ422233",473316,474673,1357
"17077","Ocbimv22031187m.g","KQ416390",358099,359123,1024
"17078","Ocbimv22000762m.g","KQ416879",71189,71644,455
"17079","Ocbimv22033237m.g","KQ421758",773651,792357,18706
"17080","Ocbimv22028913m.g","KQ416274",1873502,1876433,2931
"17081","Ocbimv22036296m.g","KQ416631",9753,37306,27553
"17082","Ocbimv22021437m.g","KQ419049",70132,73684,3552
"17083","Ocbimv22004982m.g","KQ417219",209979,287863,77884
"17084","Ocbimv22001950m.g","LGKD01507531",563,988,425
"17085","Ocbimv22034626m.g","KQ415738",96176,97946,1770
"17086","Ocbimv22012564m.g","KQ417917",1354100,1354930,830
"17087","Ocbimv22019562m.g","KQ418783",871883,876567,4684
"17088","Ocbimv22019180m.g","KQ418729",87192,116062,28870
"17089","Ocbimv22024616m.g","KQ416126",615456,640120,24664
"17090","Ocbimv22032381m.g","KQ416430",281113,281930,817
"17091","Ocbimv22012501m.g","KQ417917",274942,275827,885
"17092","Ocbimv22009743m.g","KQ417609",482243,482503,260
"17093","Ocbimv22022669m.g","KQ419279",116385,116633,248
"17094","Ocbimv22036809m.g","KQ416658",623737,626702,2965
"17095","Ocbimv22017552m.g","KQ415978",147150,178631,31481
"17096","Ocbimv22032428m.g","KQ421533",605742,615023,9281
"17097","Ocbimv22003815m.g","KQ417113",477038,500399,23361
"17098","Ocbimv22010184m.g","KQ417653",652919,653187,268
"17099","Ocbimv22014194m.g","KQ418100",5135,5371,236
"17100","Ocbimv22011128m.g","KQ427653",6506,7640,1134
"17101","Ocbimv22031269m.g","KQ421212",87998,130250,42252
"17102","Ocbimv22038015m.g","KQ416719",461083,462490,1407
"17103","Ocbimv22019023m.g","KQ418711",635150,646862,11712
"17104","Ocbimv22020468m.g","KQ431711",57839,58081,242
"17105","Ocbimv22005432m.g","LGKD01537589",328,504,176
"17106","Ocbimv22038509m.g","KQ423384",13849,14112,263
"17107","Ocbimv22005333m.g","KQ417245",8711,8860,149
"17108","Ocbimv22007141m.g","KQ417382",5867,6100,233
"17109","Ocbimv22035176m.g","KQ422295",46224,83447,37223
"17110","Ocbimv22003443m.g","KQ417087",1477317,1477727,410
"17111","Ocbimv22026952m.g","KQ420148",348451,349204,753
"17112","Ocbimv22025884m.g","KQ416175",428782,440180,11398
"17113","Ocbimv22018137m.g","KQ418576",194764,195735,971
"17114","Ocbimv22012084m.g","KQ428020",9682,14865,5183
"17115","Ocbimv22021972m.g","LGKD01673429",1,837,836
"17116","Ocbimv22004597m.g","KQ417182",562828,588925,26097
"17117","Ocbimv22007006m.g","KQ417370",215860,314807,98947
"17118","Ocbimv22036172m.g","LGKD01448846",215,376,161
"17119","Ocbimv22031842m.g","KQ421356",831475,849917,18442
"17120","Ocbimv22008300m.g","KQ417496",243733,244199,466
"17121","Ocbimv22013018m.g","KQ428339",3545,4957,1412
"17122","Ocbimv22034171m.g","KQ416518",324029,339230,15201
"17123","Ocbimv22034633m.g","KQ422095",40605,40986,381
"17124","Ocbimv22036776m.g","KQ422859",73326,97243,23917
"17125","Ocbimv22019782m.g","KQ431304",17617,17967,350
"17126","Ocbimv22011882m.g","KQ417844",1086558,1087773,1215
"17127","Ocbimv22022404m.g","KQ419215",413046,440919,27873
"17128","Ocbimv22027860m.g","KQ420381",17302,18744,1442
"17129","Ocbimv22024628m.g","KQ419605",211677,241200,29523
"17130","Ocbimv22039079m.g","KQ423536",473306,484655,11349
"17131","Ocbimv22025629m.g","KQ419863",97049,99698,2649
"17132","Ocbimv22002264m.g","KQ424594",42410,67872,25462
"17133","Ocbimv22033491m.g","KQ421821",328673,331252,2579
"17134","Ocbimv22027104m.g","KQ420182",127724,127888,164
"17135","Ocbimv22036749m.g","KQ422849",127710,129959,2249
"17136","Ocbimv22021991m.g","KQ419141",219830,237532,17702
"17137","Ocbimv22004980m.g","KQ417219",157798,205189,47391
"17138","Ocbimv22028897m.g","KQ416274",641237,758478,117241
"17139","Ocbimv22028595m.g","KQ416263",448234,448581,347
"17140","Ocbimv22026934m.g","KQ416205",627461,631218,3757
"17141","Ocbimv22002359m.g","KQ424646",3072,37133,34061
"17142","Ocbimv22023229m.g","KQ419376",680306,687348,7042
"17143","Ocbimv22016625m.g","KQ415967",190285,193787,3502
"17144","Ocbimv22025294m.g","KQ419763",91620,104683,13063
"17145","Ocbimv22022287m.g","KQ419192",682766,709611,26845
"17146","Ocbimv22030302m.g","KQ420942",137631,173627,35996
"17147","Ocbimv22011988m.g","KQ417851",251572,263365,11793
"17148","Ocbimv22024833m.g","KQ419638",139351,143586,4235
"17149","Ocbimv22038321m.g","KQ423281",161734,164262,2528
"17150","Ocbimv22039872m.g","KQ416832",200551,222260,21709
"17151","Ocbimv22023999m.g","LGKD01694632",167,343,176
"17152","Ocbimv22008348m.g","KQ417497",1963887,2032778,68891
"17153","Ocbimv22021694m.g","KQ416051",1746930,1758031,11101
"17154","Ocbimv22015906m.g","KQ418303",53547,92429,38882
"17155","Ocbimv22039636m.g","KQ416810",1125108,1125572,464
"17156","Ocbimv22012021m.g","KQ427973",46977,59675,12698
"17157","Ocbimv22033393m.g","KQ416479",821509,827490,5981
"17158","Ocbimv22005069m.g","KQ425510",329847,360696,30849
"17159","Ocbimv22004867m.g","KQ425458",2,646,644
"17160","Ocbimv22012842m.g","KQ417945",496822,499260,2438
"17161","Ocbimv22007721m.g","KQ417446",286036,294726,8690
"17162","Ocbimv22024870m.g","KQ419644",30881,52582,21701
"17163","Ocbimv22031582m.g","KQ416401",261551,262473,922
"17164","Ocbimv22007120m.g","KQ417381",37826,43907,6081
"17165","Ocbimv22034526m.g","KQ422069",148878,186449,37571
"17166","Ocbimv22001326m.g","KQ415784",545668,545856,188
"17167","Ocbimv22035813m.g","KQ416601",770607,771002,395
"17168","Ocbimv22036123m.g","KQ422647",112671,144954,32283
"17169","Ocbimv22008379m.g","KQ426620",38184,38705,521
"17170","Ocbimv22036480m.g","KQ416642",624534,624878,344
"17171","Ocbimv22017748m.g","KQ418537",361671,362057,386
"17172","Ocbimv22034422m.g","KQ416530",359354,359935,581
"17173","Ocbimv22009959m.g","KQ417627",1180,7067,5887
"17174","Ocbimv22008797m.g","KQ426774",131269,132159,890
"17175","Ocbimv22003883m.g","KQ425134",521604,522179,575
"17176","Ocbimv22003988m.g","KQ425169",13434,13994,560
"17177","Ocbimv22026600m.g","KQ420078",159833,188922,29089
"17178","Ocbimv22036445m.g","KQ422765",223077,313053,89976
"17179","Ocbimv22020618m.g","KQ431775",20,718,698
"17180","Ocbimv22010794m.g","KQ417715",14201,29522,15321
"17181","Ocbimv22030512m.g","KQ421009",675495,675860,365
"17182","Ocbimv22029081m.g","KQ420642",214200,254462,40262
"17183","Ocbimv22015951m.g","KQ418303",1626256,1643678,17422
"17184","Ocbimv22034812m.g","KQ422179",9080,77444,68364
"17185","Ocbimv22015722m.g","LGKD01621278",149,529,380
"17186","Ocbimv22024058m.g","KQ419527",200761,201795,1034
"17187","Ocbimv22034123m.g","KQ421984",13607,27244,13637
"17188","Ocbimv22020629m.g","KQ431792",4,476,472
"17189","Ocbimv22015941m.g","KQ418303",1408690,1412537,3847
"17190","Ocbimv22030719m.g","KQ421078",275926,286548,10622
"17191","Ocbimv22007403m.g","KQ417412",13843,15334,1491
"17192","Ocbimv22019593m.g","KQ418789",220481,237743,17262
"17193","Ocbimv22033474m.g","KQ416482",216805,217389,584
"17194","Ocbimv22015688m.g","KQ429470",377112,377771,659
"17195","Ocbimv22020435m.g","KQ416027",446831,447492,661
"17196","Ocbimv22010409m.g","KQ417676",750848,752474,1626
"17197","Ocbimv22000024m.g","KQ423826",39896,54095,14199
"17198","Ocbimv22005010m.g","KQ417224",11807,13561,1754
"17199","Ocbimv22008022m.g","KQ417470",1213162,1213602,440
"17200","Ocbimv22025562m.g","KQ419844",5825,9350,3525
"17201","Ocbimv22000151m.g","KQ423870",65133,65414,281
"17202","Ocbimv22015337m.g","KQ418224",32828,33666,838
"17203","Ocbimv22016379m.g","KQ415962",1462106,1464637,2531
"17204","Ocbimv22018808m.g","KQ416002",609135,610402,1267
"17205","Ocbimv22003526m.g","KQ425021",418536,419324,788
"17206","Ocbimv22002248m.g","KQ424584",579,1388,809
"17207","Ocbimv22039732m.g","KQ423737",54171,57096,2925
"17208","Ocbimv22024950m.g","KQ419661",443366,443824,458
"17209","Ocbimv22012483m.g","KQ417917",22044,22814,770
"17210","Ocbimv22022536m.g","KQ432835",40408,40635,227
"17211","Ocbimv22017501m.g","KQ430326",15655,17035,1380
"17212","Ocbimv22026649m.g","KQ420085",366680,380408,13728
"17213","Ocbimv22003344m.g","KQ424987",22521,22815,294
"17214","Ocbimv22012256m.g","KQ417894",147477,148335,858
"17215","Ocbimv22015987m.g","KQ418306",46820,49719,2899
"17216","Ocbimv22033196m.g","KQ416471",1302,1718,416
"17217","Ocbimv22029028m.g","KQ416281",27829,28122,293
"17218","Ocbimv22034900m.g","KQ422210",33918,81997,48079
"17219","Ocbimv22017731m.g","KQ415982",406851,407078,227
"17220","Ocbimv22025008m.g","KQ419683",133908,136480,2572
"17221","Ocbimv22026559m.g","KQ416193",71316,71908,592
"17222","Ocbimv22034480m.g","KQ422055",49318,49615,297
"17223","Ocbimv22006770m.g","KQ426101",74484,93826,19342
"17224","Ocbimv22036060m.g","KQ416616",145603,146097,494
"17225","Ocbimv22030126m.g","KQ420902",144685,147877,3192
"17226","Ocbimv22018577m.g","KQ418642",71611,88157,16546
"17227","Ocbimv22027748m.g","KQ420357",46515,58255,11740
"17228","Ocbimv22039090m.g","KQ423546",28907,31641,2734
"17229","Ocbimv22031729m.g","KQ421328",444840,445085,245
"17230","Ocbimv22013956m.g","KQ418073",189099,192401,3302
"17231","Ocbimv22030338m.g","KQ420953",202,1672,1470
"17232","Ocbimv22026114m.g","KQ419989",687539,687832,293
"17233","Ocbimv22023014m.g","KQ419338",329893,365766,35873
"17234","Ocbimv22016414m.g","KQ415964",82124,91781,9657
"17235","Ocbimv22021190m.g","KQ416040",255232,256355,1123
"17236","Ocbimv22020927m.g","KQ418975",403825,403992,167
"17237","Ocbimv22022467m.g","KQ419223",533625,533924,299
"17238","Ocbimv22032906m.g","KQ421682",44316,55231,10915
"17239","Ocbimv22023154m.g","KQ433242",170448,188659,18211
"17240","Ocbimv22021366m.g","KQ432092",51113,90539,39426
"17241","Ocbimv22029318m.g","KQ416297",77578,87861,10283
"17242","Ocbimv22020378m.g","KQ418901",505,48521,48016
"17243","Ocbimv22003607m.g","KQ425044",41111,42815,1704
"17244","Ocbimv22021407m.g","KQ416044",57331,57848,517
"17245","Ocbimv22008735m.g","KQ417528",310338,325855,15517
"17246","Ocbimv22020300m.g","LGKD01658790",6,155,149
"17247","Ocbimv22004608m.g","KQ417183",151162,151386,224
"17248","Ocbimv22032472m.g","KQ421549",508567,562473,53906
"17249","Ocbimv22033292m.g","KQ421766",52653,53031,378
"17250","Ocbimv22010604m.g","KQ417698",167687,168031,344
"17251","Ocbimv22030021m.g","KQ420885",80429,82026,1597
"17252","Ocbimv22034135m.g","KQ421984",187331,199515,12184
"17253","Ocbimv22014674m.g","KQ418168",192693,210240,17547
"17254","Ocbimv22033295m.g","KQ421766",71355,72354,999
"17255","Ocbimv22028410m.g","KQ416257",1216322,1233396,17074
"17256","Ocbimv22016436m.g","KQ418354",96895,98714,1819
"17257","Ocbimv22008589m.g","KQ417510",394176,431995,37819
"17258","Ocbimv22022444m.g","KQ419216",240389,272066,31677
"17259","Ocbimv22031470m.g","KQ416399",345148,360017,14869
"17260","Ocbimv22025637m.g","KQ419868",130837,133767,2930
"17261","Ocbimv22008506m.g","KQ417506",524019,524488,469
"17262","Ocbimv22015376m.g","KQ415674",1090751,1101271,10520
"17263","Ocbimv22020680m.g","KQ418950",37610,84289,46679
"17264","Ocbimv22019790m.g","KQ431314",50643,52770,2127
"17265","Ocbimv22023548m.g","LGKD01689921",19,473,454
"17266","Ocbimv22033850m.g","KQ421894",194648,203565,8917
"17267","Ocbimv22009348m.g","KQ417585",354892,356352,1460
"17268","Ocbimv22027839m.g","KQ420375",1368093,1377269,9176
"17269","Ocbimv22027848m.g","KQ420377",70722,71255,533
"17270","Ocbimv22020907m.g","KQ418974",317116,319446,2330
"17271","Ocbimv22034496m.g","KQ422062",238627,238971,344
"17272","Ocbimv22039237m.g","KQ423591",204620,268360,63740
"17273","Ocbimv22038008m.g","KQ416719",349589,367869,18280
"17274","Ocbimv22035351m.g","KQ416582",25814,26898,1084
"17275","Ocbimv22033407m.g","KQ421805",15756,17145,1389
"17276","Ocbimv22037461m.g","KQ415759",25853,26219,366
"17277","Ocbimv22036859m.g","KQ416662",428457,428771,314
"17278","Ocbimv22006468m.g","KQ417324",397870,418274,20404
"17279","Ocbimv22011159m.g","KQ427657",51,1750,1699
"17280","Ocbimv22021368m.g","KQ432093",45126,53771,8645
"17281","Ocbimv22025388m.g","KQ419787",29080,84211,55131
"17282","Ocbimv22037943m.g","KQ423175",355587,355946,359
"17283","Ocbimv22016632m.g","KQ415967",844911,845351,440
"17284","Ocbimv22024363m.g","KQ419574",762527,762820,293
"17285","Ocbimv22029528m.g","KQ420770",109967,113371,3404
"17286","Ocbimv22034928m.g","KQ422216",416,49605,49189
"17287","Ocbimv22002182m.g","KQ424569",108758,125724,16966
"17288","Ocbimv22034409m.g","KQ422031",256368,256926,558
"17289","Ocbimv22018197m.g","KQ415990",796954,822463,25509
"17290","Ocbimv22032204m.g","KQ416425",3693,16999,13306
"17291","Ocbimv22024683m.g","KQ419615",115413,130027,14614
"17292","Ocbimv22012179m.g","KQ417881",115944,117059,1115
"17293","Ocbimv22009156m.g","KQ426902",187476,187760,284
"17294","Ocbimv22027166m.g","KQ416211",115556,129787,14231
"17295","Ocbimv22012192m.g","LGKD01593557",1,452,451
"17296","Ocbimv22004258m.g","KQ425245",102566,104065,1499
"17297","Ocbimv22031782m.g","KQ421343",227266,227987,721
"17298","Ocbimv22007447m.g","KQ415842",102537,102728,191
"17299","Ocbimv22024759m.g","KQ419623",144091,146599,2508
"17300","Ocbimv22005509m.g","KQ425636",178931,179534,603
"17301","Ocbimv22019506m.g","KQ416013",639052,684062,45010
"17302","Ocbimv22017595m.g","KQ430375",8534,18551,10017
"17303","Ocbimv22014655m.g","KQ429026",431644,431841,197
"17304","Ocbimv22018538m.g","KQ415995",127737,130364,2627
"17305","Ocbimv22039669m.g","KQ416813",133389,137836,4447
"17306","Ocbimv22033065m.g","KQ421721",794128,806663,12535
"17307","Ocbimv22014251m.g","KQ418107",2383,49545,47162
"17308","Ocbimv22030899m.g","KQ421117",1273930,1276489,2559
"17309","Ocbimv22013954m.g","KQ418073",122339,149060,26721
"17310","Ocbimv22006152m.g","KQ417300",915293,916233,940
"17311","Ocbimv22018264m.g","KQ430613",35720,42697,6977
"17312","Ocbimv22028482m.g","KQ420502",211068,221887,10819
"17313","Ocbimv22000854m.g","KQ424093",933242,959201,25959
"17314","Ocbimv22006718m.g","KQ415834",4073,46138,42065
"17315","Ocbimv22019756m.g","KQ431294",375227,408340,33113
"17316","Ocbimv22003295m.g","KQ424942",154802,155254,452
"17317","Ocbimv22021444m.g","KQ419049",181343,257558,76215
"17318","Ocbimv22020818m.g","KQ418970",516096,529892,13796
"17319","Ocbimv22032030m.g","KQ421411",334495,343212,8717
"17320","Ocbimv22031446m.g","KQ421244",221122,221768,646
"17321","Ocbimv22002972m.g","KQ417051",2042812,2055131,12319
"17322","Ocbimv22016758m.g","KQ418393",128112,139781,11669
"17323","Ocbimv22021322m.g","KQ419029",115473,116740,1267
"17324","Ocbimv22030544m.g","KQ421018",212145,212827,682
"17325","Ocbimv22035420m.g","KQ422378",47062,47286,224
"17326","Ocbimv22029962m.g","KQ420861",10107,10634,527
"17327","Ocbimv22035784m.g","KQ422536",1627,2040,413
"17328","Ocbimv22006113m.g","KQ417298",210639,214972,4333
"17329","Ocbimv22017300m.g","KQ430251",1593,14235,12642
"17330","Ocbimv22005484m.g","KQ417255",272658,275257,2599
"17331","Ocbimv22033770m.g","KQ421866",234507,234818,311
"17332","Ocbimv22020171m.g","KQ418866",228094,228354,260
"17333","Ocbimv22016093m.g","KQ415954",749579,750046,467
"17334","Ocbimv22001731m.g","KQ424397",11274,25373,14099
"17335","Ocbimv22024193m.g","KQ433854",5635,6422,787
"17336","Ocbimv22011089m.g","KQ417747",202178,202819,641
"17337","Ocbimv22012941m.g","KQ428307",39090,40496,1406
"17338","Ocbimv22032385m.g","KQ421525",14219,27075,12856
"17339","Ocbimv22028696m.g","KQ420556",234853,235095,242
"17340","Ocbimv22004997m.g","KQ415811",197577,214204,16627
"17341","Ocbimv22010696m.g","KQ427468",12005,13408,1403
"17342","Ocbimv22013152m.g","KQ417989",728257,728577,320
"17343","Ocbimv22030785m.g","KQ421086",238531,262332,23801
"17344","Ocbimv22027794m.g","KQ416233",488255,529979,41724
"17345","Ocbimv22019011m.g","KQ418711",6667,7840,1173
"17346","Ocbimv22023004m.g","KQ419337",281027,287920,6893
"17347","Ocbimv22009954m.g","KQ427179",309783,310004,221
"17348","Ocbimv22003060m.g","KQ424870",10645,11061,416
"17349","Ocbimv22002868m.g","LGKD01133283",2,262,260
"17350","Ocbimv22032794m.g","KQ421658",587531,622000,34469
"17351","Ocbimv22018292m.g","KQ418596",62236,69611,7375
"17352","Ocbimv22000441m.g","KQ423963",344903,345835,932
"17353","Ocbimv22013992m.g","KQ428718",66211,67099,888
"17354","Ocbimv22020164m.g","KQ418863",556184,556366,182
"17355","Ocbimv22014912m.g","KQ418187",347568,382476,34908
"17356","Ocbimv22017008m.g","KQ418433",118433,235824,117391
"17357","Ocbimv22012027m.g","LGKD01591863",28,366,338
"17358","Ocbimv22034635m.g","KQ422095",275225,278059,2834
"17359","Ocbimv22006191m.g","KQ417301",119271,122480,3209
"17360","Ocbimv22008367m.g","KQ417498",749048,755464,6416
"17361","Ocbimv22010119m.g","KQ417645",20409,20576,167
"17362","Ocbimv22032792m.g","KQ421658",568426,568662,236
"17363","Ocbimv22003095m.g","KQ424880",88154,91235,3081
"17364","Ocbimv22001451m.g","KQ416933",640913,698929,58016
"17365","Ocbimv22013448m.g","KQ428515",157607,157978,371
"17366","Ocbimv22012111m.g","KQ417874",365632,365913,281
"17367","Ocbimv22009425m.g","KQ417591",1461589,1533622,72033
"17368","Ocbimv22002347m.g","KQ424639",76772,76936,164
"17369","Ocbimv22032402m.g","KQ421531",149215,154886,5671
"17370","Ocbimv22039299m.g","KQ423609",827436,842521,15085
"17371","Ocbimv22033804m.g","KQ421878",84056,137728,53672
"17372","Ocbimv22014512m.g","KQ415932",329824,330081,257
"17373","Ocbimv22032825m.g","KQ421663",85833,87954,2121
"17374","Ocbimv22009572m.g","KQ427028",425569,427683,2114
"17375","Ocbimv22026467m.g","KQ420053",927853,928402,549
"17376","Ocbimv22008752m.g","KQ426760",43609,44740,1131
"17377","Ocbimv22014830m.g","KQ429096",539991,573925,33934
"17378","Ocbimv22037754m.g","KQ416709",23589,41736,18147
"17379","Ocbimv22020678m.g","KQ418949",380004,423081,43077
"17380","Ocbimv22028575m.g","KQ420524",242122,275486,33364
"17381","Ocbimv22027786m.g","KQ416233",150754,176941,26187
"17382","Ocbimv22023351m.g","KQ419395",148521,153623,5102
"17383","Ocbimv22005306m.g","KQ425573",80977,82425,1448
"17384","Ocbimv22016500m.g","KQ418363",26775,26990,215
"17385","Ocbimv22007429m.g","KQ417413",2,1040,1038
"17386","Ocbimv22003163m.g","KQ417062",57210,57832,622
"17387","Ocbimv22026802m.g","KQ420118",40798,40989,191
"17388","Ocbimv22022541m.g","KQ419243",90183,90572,389
"17389","Ocbimv22015528m.g","KQ415945",918819,919717,898
"17390","Ocbimv22019507m.g","LGKD01651478",972,1226,254
"17391","Ocbimv22003368m.g","KQ424997",28066,29022,956
"17392","Ocbimv22025168m.g","KQ416141",567654,569916,2262
"17393","Ocbimv22036280m.g","KQ416628",1138088,1138294,206
"17394","Ocbimv22001819m.g","KQ416966",17207,84263,67056
"17395","Ocbimv22009175m.g","KQ415862",640394,662359,21965
"17396","Ocbimv22015075m.g","KQ418194",1325191,1328343,3152
"17397","Ocbimv22013275m.g","KQ428432",27954,28103,149
"17398","Ocbimv22028328m.g","KQ420475",332302,348602,16300
"17399","Ocbimv22015654m.g","KQ418272",146300,146661,361
"17400","Ocbimv22003373m.g","KQ424997",58361,58621,260
"17401","Ocbimv22021805m.g","KQ419106",36304,37670,1366
"17402","Ocbimv22031357m.g","KQ421221",210786,212569,1783
"17403","Ocbimv22032925m.g","KQ421685",169225,171360,2135
"17404","Ocbimv22011639m.g","KQ427828",37389,38669,1280
"17405","Ocbimv22004266m.g","KQ415802",110711,117750,7039
"17406","Ocbimv22029497m.g","KQ420765",49633,58738,9105
"17407","Ocbimv22029433m.g","KQ416306",827665,827976,311
"17408","Ocbimv22036451m.g","KQ422765",489317,489469,152
"17409","Ocbimv22023920m.g","KQ419500",394124,394534,410
"17410","Ocbimv22034227m.g","KQ422014",131683,136426,4743
"17411","Ocbimv22014118m.g","KQ418092",42098,42529,431
"17412","Ocbimv22018046m.g","KQ415682",561441,561842,401
"17413","Ocbimv22023759m.g","KQ416096",1067227,1067726,499
"17414","Ocbimv22020741m.g","KQ418958",72323,72676,353
"17415","Ocbimv22025070m.g","KQ416137",29558,54714,25156
"17416","Ocbimv22020941m.g","KQ418982",60954,61237,283
"17417","Ocbimv22008975m.g","KQ417544",897809,899207,1398
"17418","Ocbimv22017326m.g","KQ418483",100494,139293,38799
"17419","Ocbimv22027890m.g","LGKD01351005",8,647,639
"17420","Ocbimv22019229m.g","KQ418737",7199,12037,4838
"17421","Ocbimv22010174m.g","KQ427304",3289,7987,4698
"17422","Ocbimv22019147m.g","KQ431020",7197,21318,14121
"17423","Ocbimv22023437m.g","KQ419409",558006,574540,16534
"17424","Ocbimv22020253m.g","KQ431559",13271,27081,13810
"17425","Ocbimv22032486m.g","KQ421555",291,2138,1847
"17426","Ocbimv22005680m.g","KQ417272",249990,250726,736
"17427","Ocbimv22020284m.g","KQ418883",110440,110747,307
"17428","Ocbimv22010339m.g","KQ415875",22260,33552,11292
"17429","Ocbimv22014845m.g","KQ415935",184765,192493,7728
"17430","Ocbimv22036682m.g","KQ422834",43182,43965,783
"17431","Ocbimv22004094m.g","KQ425199",8609,9776,1167
"17432","Ocbimv22028796m.g","KQ416272",489387,536936,47549
"17433","Ocbimv22034913m.g","KQ415742",122223,123092,869
"17434","Ocbimv22035118m.g","KQ416574",430111,432821,2710
"17435","Ocbimv22011563m.g","KQ417804",117431,119107,1676
"17436","Ocbimv22034007m.g","KQ421945",50831,50998,167
"17437","Ocbimv22019038m.g","KQ418711",1035916,1038072,2156
"17438","Ocbimv22031835m.g","KQ421356",436252,436605,353
"17439","Ocbimv22021685m.g","KQ416051",587904,588357,453
"17440","Ocbimv22038039m.g","KQ423207",18631,22012,3381
"17441","Ocbimv22030808m.g","KQ421092",122941,152511,29570
"17442","Ocbimv22005352m.g","KQ425592",4019,32430,28411
"17443","Ocbimv22033070m.g","KQ421721",913637,946826,33189
"17444","Ocbimv22021461m.g","KQ416046",558657,568801,10144
"17445","Ocbimv22005463m.g","KQ425611",218517,219554,1037
"17446","Ocbimv22011053m.g","KQ417740",401498,404731,3233
"17447","Ocbimv22032861m.g","KQ416453",255813,266536,10723
"17448","Ocbimv22013563m.g","KQ418038",42190,46631,4441
"17449","Ocbimv22007888m.g","KQ417458",279060,279728,668
"17450","Ocbimv22006040m.g","KQ417291",2185,8970,6785
"17451","Ocbimv22014224m.g","KQ418104",162316,162574,258
"17452","Ocbimv22022097m.g","KQ419162",131466,135498,4032
"17453","Ocbimv22027614m.g","KQ420313",745362,847767,102405
"17454","Ocbimv22035823m.g","KQ416602",180446,180643,197
"17455","Ocbimv22021020m.g","KQ418994",63243,88325,25082
"17456","Ocbimv22036593m.g","KQ422794",385265,385880,615
"17457","Ocbimv22022324m.g","KQ419197",505033,505311,278
"17458","Ocbimv22037986m.g","KQ416717",266360,297098,30738
"17459","Ocbimv22022688m.g","KQ419281",542701,554611,11910
"17460","Ocbimv22021538m.g","KQ432217",190,1692,1502
"17461","Ocbimv22028798m.g","KQ416272",558530,559238,708
"17462","Ocbimv22036272m.g","KQ416628",635187,639428,4241
"17463","Ocbimv22022572m.g","KQ432874",1,498,497
"17464","Ocbimv22005866m.g","KQ417280",316320,326635,10315
"17465","Ocbimv22027598m.g","KQ420313",312280,330988,18708
"17466","Ocbimv22019691m.g","KQ418800",4688,6577,1889
"17467","Ocbimv22029207m.g","KQ416291",17625,18731,1106
"17468","Ocbimv22029239m.g","KQ420690",223065,227814,4749
"17469","Ocbimv22021125m.g","KQ416039",1276494,1277024,530
"17470","Ocbimv22007197m.g","KQ426235",56294,56656,362
"17471","Ocbimv22028541m.g","KQ416260",206365,206922,557
"17472","Ocbimv22006401m.g","KQ417318",446302,470440,24138
"17473","Ocbimv22008303m.g","KQ417496",246110,247813,1703
"17474","Ocbimv22001529m.g","KQ424349",132,664,532
"17475","Ocbimv22022965m.g","KQ416079",321245,321583,338
"17476","Ocbimv22010788m.g","KQ427521",292031,293621,1590
"17477","Ocbimv22007976m.g","KQ426514",6985,60732,53747
"17478","Ocbimv22020691m.g","KQ418954",433758,434872,1114
"17479","Ocbimv22013662m.g","KQ428587",23886,60677,36791
"17480","Ocbimv22002202m.g","KQ416995",213104,225144,12040
"17481","Ocbimv22036942m.g","KQ416666",996442,997688,1246
"17482","Ocbimv22016130m.g","KQ418320",734165,734429,264
"17483","Ocbimv22025554m.g","KQ419838",122662,123033,371
"17484","Ocbimv22025504m.g","KQ419825",21544,21934,390
"17485","Ocbimv22004453m.g","KQ425308",24612,28176,3564
"17486","Ocbimv22038284m.g","KQ423260",185782,263717,77935
"17487","Ocbimv22002294m.g","KQ417001",608040,622078,14038
"17488","Ocbimv22033327m.g","KQ421780",138634,139209,575
"17489","Ocbimv22032592m.g","KQ421603",107724,138435,30711
"17490","Ocbimv22006639m.g","KQ426045",141037,151351,10314
"17491","Ocbimv22005775m.g","KQ415823",2418,51317,48899
"17492","Ocbimv22014748m.g","KQ418175",382749,385948,3199
"17493","Ocbimv22022319m.g","KQ419197",200728,201252,524
"17494","Ocbimv22005458m.g","KQ417253",74103,105586,31483
"17495","Ocbimv22020973m.g","KQ418986",35821,36428,607
"17496","Ocbimv22034318m.g","KQ422015",1507220,1517210,9990
"17497","Ocbimv22001019m.g","KQ424157",232379,244007,11628
"17498","Ocbimv22011077m.g","LGKD01584584",12,1382,1370
"17499","Ocbimv22003212m.g","KQ424906",31918,92808,60890
"17500","Ocbimv22039135m.g","KQ416780",127615,130786,3171
"17501","Ocbimv22034449m.g","KQ416533",9370,21040,11670
"17502","Ocbimv22001130m.g","KQ424197",12812,13626,814
"17503","Ocbimv22027453m.g","KQ420287",454226,460202,5976
"17504","Ocbimv22007994m.g","KQ426525",59439,59596,157
"17505","Ocbimv22016226m.g","KQ429756",22066,54801,32735
"17506","Ocbimv22017043m.g","KQ418444",129508,157422,27914
"17507","Ocbimv22003811m.g","KQ417113",380190,380770,580
"17508","Ocbimv22025121m.g","KQ416138",91311,222917,131606
"17509","Ocbimv22024892m.g","KQ419649",29400,78367,48967
"17510","Ocbimv22036844m.g","KQ422875",23047,24358,1311
"17511","Ocbimv22006042m.g","KQ417291",52402,94589,42187
"17512","Ocbimv22021947m.g","KQ419137",25544,25912,368
"17513","Ocbimv22023914m.g","KQ419499",15574,75638,60064
"17514","Ocbimv22031671m.g","KQ421308",150383,164353,13970
"17515","Ocbimv22000621m.g","KQ416870",49054,51879,2825
"17516","Ocbimv22009206m.g","KQ417574",177568,177897,329
"17517","Ocbimv22001983m.g","KQ415787",1069932,1070776,844
"17518","Ocbimv22007611m.g","KQ417438",37201,76330,39129
"17519","Ocbimv22017353m.g","KQ418483",416188,417372,1184
"17520","Ocbimv22018955m.g","KQ418702",350774,383035,32261
"17521","Ocbimv22023754m.g","KQ416096",208105,208611,506
"17522","Ocbimv22015392m.g","KQ418239",7610,7852,242
"17523","Ocbimv22024281m.g","KQ416121",128702,128860,158
"17524","Ocbimv22035411m.g","KQ422367",440366,440743,377
"17525","Ocbimv22027182m.g","KQ416213",209819,225674,15855
"17526","Ocbimv22037735m.g","KQ423122",77281,77974,693
"17527","Ocbimv22031901m.g","KQ421375",57225,65767,8542
"17528","Ocbimv22000270m.g","KQ423910",178360,203751,25391
"17529","Ocbimv22004334m.g","KQ417149",515506,516600,1094
"17530","Ocbimv22003022m.g","KQ417055",576053,584737,8684
"17531","Ocbimv22006665m.g","KQ417342",123836,128750,4914
"17532","Ocbimv22025476m.g","KQ419815",580,16499,15919
"17533","Ocbimv22019681m.g","KQ431254",168413,203083,34670
"17534","Ocbimv22009141m.g","KQ415861",214420,214827,407
"17535","Ocbimv22009586m.g","KQ427030",22938,23225,287
"17536","Ocbimv22007602m.g","KQ415844",72159,72357,198
"17537","Ocbimv22026569m.g","KQ416193",478889,490807,11918
"17538","Ocbimv22024880m.g","KQ419646",412,6056,5644
"17539","Ocbimv22031616m.g","KQ421300",21071,21357,286
"17540","Ocbimv22007210m.g","KQ426247",50928,56501,5573
"17541","Ocbimv22020301m.g","KQ431589",12814,16915,4101
"17542","Ocbimv22031092m.g","KQ421158",315728,317313,1585
"17543","Ocbimv22023868m.g","KQ433683",2135,3400,1265
"17544","Ocbimv22029103m.g","KQ420650",2554,3399,845
"17545","Ocbimv22030357m.g","KQ420962",41935,42608,673
"17546","Ocbimv22012366m.g","KQ428131",4608,29928,25320
"17547","Ocbimv22015970m.g","KQ415949",80612,82237,1625
"17548","Ocbimv22017440m.g","KQ418496",180552,271070,90518
"17549","Ocbimv22034678m.g","KQ416547",24262,25044,782
"17550","Ocbimv22029713m.g","KQ420813",457294,457890,596
"17551","Ocbimv22011566m.g","KQ427781",39456,39809,353
"17552","Ocbimv22036385m.g","KQ422736",562935,563408,473
"17553","Ocbimv22034689m.g","KQ416547",77187,77339,152
"17554","Ocbimv22038441m.g","KQ423338",282713,284067,1354
"17555","Ocbimv22014606m.g","KQ429000",38799,39108,309
"17556","Ocbimv22011445m.g","KQ427751",10255,14904,4649
"17557","Ocbimv22002788m.g","KQ424785",144109,206812,62703
"17558","Ocbimv22029428m.g","KQ420747",696150,696440,290
"17559","Ocbimv22025560m.g","KQ419843",423,7001,6578
"17560","Ocbimv22030234m.g","KQ420925",60557,67844,7287
"17561","Ocbimv22032727m.g","KQ421646",49915,51400,1485
"17562","Ocbimv22022018m.g","KQ432511",58938,62303,3365
"17563","Ocbimv22004265m.g","KQ415802",41,544,503
"17564","Ocbimv22019379m.g","KQ431105",13466,30927,17461
"17565","Ocbimv22028943m.g","KQ420605",442554,442801,247
"17566","Ocbimv22021238m.g","KQ419018",396480,397433,953
"17567","Ocbimv22015788m.g","KQ418293",132841,190971,58130
"17568","Ocbimv22033217m.g","KQ421758",125122,137044,11922
"17569","Ocbimv22004279m.g","KQ425255",288584,295098,6514
"17570","Ocbimv22008663m.g","KQ426725",33838,94844,61006
"17571","Ocbimv22002026m.g","KQ424513",215657,217298,1641
"17572","Ocbimv22037988m.g","KQ416717",318707,323615,4908
"17573","Ocbimv22007261m.g","KQ417395",193913,207944,14031
"17574","Ocbimv22007759m.g","KQ415847",854741,875118,20377
"17575","Ocbimv22021683m.g","KQ416051",485153,543209,58056
"17576","Ocbimv22012720m.g","KQ417929",338724,352331,13607
"17577","Ocbimv22033176m.g","KQ421741",9819,90125,80306
"17578","Ocbimv22017710m.g","KQ415981",816550,818903,2353
"17579","Ocbimv22010917m.g","KQ417725",42624,62081,19457
"17580","Ocbimv22026970m.g","KQ416207",74822,75931,1109
"17581","Ocbimv22034342m.g","KQ422016",278668,279027,359
"17582","Ocbimv22038760m.g","KQ416765",101033,159019,57986
"17583","Ocbimv22015136m.g","KQ418196",926187,926696,509
"17584","Ocbimv22007913m.g","KQ417459",303749,311491,7742
"17585","Ocbimv22022600m.g","LGKD01290088",1,261,260
"17586","Ocbimv22029881m.g","KQ420829",4182,17035,12853
"17587","Ocbimv22034983m.g","KQ422234",1385,3380,1995
"17588","Ocbimv22038639m.g","KQ423430",122177,125452,3275
"17589","Ocbimv22036007m.g","KQ422631",22250,22837,587
"17590","Ocbimv22036897m.g","KQ422894",99307,100611,1304
"17591","Ocbimv22029358m.g","KQ420719",49638,50087,449
"17592","Ocbimv22007191m.g","KQ426234",17917,32113,14196
"17593","Ocbimv22018621m.g","KQ418644",1009104,1009463,359
"17594","Ocbimv22036210m.g","KQ422680",81220,82587,1367
"17595","Ocbimv22006430m.g","KQ425920",32466,43181,10715
"17596","Ocbimv22030273m.g","KQ415716",1193613,1194023,410
"17597","Ocbimv22031042m.g","KQ421147",1509,10187,8678
"17598","Ocbimv22035969m.g","KQ422621",42287,44503,2216
"17599","Ocbimv22031840m.g","KQ421356",744817,792404,47587
"17600","Ocbimv22009225m.g","KQ426929",3215,5423,2208
"17601","Ocbimv22017148m.g","KQ430169",51941,52330,389
"17602","Ocbimv22014108m.g","LGKD01606499",521,832,311
"17603","Ocbimv22014345m.g","KQ418120",450467,458443,7976
"17604","Ocbimv22001704m.g","KQ424387",513185,513655,470
"17605","Ocbimv22007349m.g","KQ415841",345076,378891,33815
"17606","Ocbimv22028735m.g","KQ416270",1928268,1929364,1096
"17607","Ocbimv22034231m.g","KQ416526",235061,252608,17547
"17608","Ocbimv22034224m.g","KQ422014",92713,97843,5130
"17609","Ocbimv22015978m.g","KQ415949",940409,940567,158
"17610","Ocbimv22016043m.g","KQ418312",411123,411603,480
"17611","Ocbimv22020121m.g","KQ431468",58406,63691,5285
"17612","Ocbimv22009917m.g","KQ427161",806,1261,455
"17613","Ocbimv22004722m.g","KQ425427",5307,5486,179
"17614","Ocbimv22010701m.g","KQ417704",19516,24372,4856
"17615","Ocbimv22024111m.g","KQ419534",330581,342057,11476
"17616","Ocbimv22033222m.g","KQ421758",183690,191717,8027
"17617","Ocbimv22026274m.g","KQ420022",558206,569586,11380
"17618","Ocbimv22035178m.g","KQ422295",124832,131242,6410
"17619","Ocbimv22016341m.g","KQ429822",41101,43364,2263
"17620","Ocbimv22016356m.g","KQ429827",637,4594,3957
"17621","Ocbimv22010810m.g","KQ427524",29422,33424,4002
"17622","Ocbimv22000385m.g","KQ423941",569078,587569,18491
"17623","Ocbimv22005197m.g","KQ425544",20746,50827,30081
"17624","Ocbimv22033807m.g","KQ421878",262232,326029,63797
"17625","Ocbimv22028408m.g","KQ416257",1194753,1201328,6575
"17626","Ocbimv22029447m.g","KQ416306",1935348,1935893,545
"17627","Ocbimv22038021m.g","KQ416719",784203,784622,419
"17628","Ocbimv22021396m.g","KQ432116",48423,54034,5611
"17629","Ocbimv22003892m.g","KQ417119",236964,276478,39514
"17630","Ocbimv22001062m.g","KQ424172",14462,40316,25854
"17631","Ocbimv22019453m.g","KQ418769",42387,67242,24855
"17632","Ocbimv22036038m.g","KQ416614",942280,984921,42641
"17633","Ocbimv22013754m.g","KQ418059",6621,7326,705
"17634","Ocbimv22012194m.g","KQ428072",1,9645,9644
"17635","Ocbimv22039274m.g","KQ423600",330559,330792,233
"17636","Ocbimv22023366m.g","KQ419395",259234,264028,4794
"17637","Ocbimv22024291m.g","KQ416121",1276160,1304992,28832
"17638","Ocbimv22029617m.g","KQ420787",9474,24773,15299
"17639","Ocbimv22035294m.g","KQ422351",42204,88087,45883
"17640","Ocbimv22030251m.g","KQ420928",323902,324111,209
"17641","Ocbimv22007883m.g","KQ417458",153586,158815,5229
"17642","Ocbimv22011269m.g","KQ417771",1478133,1478884,751
"17643","Ocbimv22010106m.g","KQ427263",1251,69963,68712
"17644","Ocbimv22031712m.g","KQ421325",84000,96534,12534
"17645","Ocbimv22039294m.g","KQ423609",701928,702161,233
"17646","Ocbimv22007248m.g","KQ426259",335564,335875,311
"17647","Ocbimv22037734m.g","KQ423122",71981,80861,8880
"17648","Ocbimv22001250m.g","KQ424242",10324,10563,239
"17649","Ocbimv22022149m.g","KQ419176",268068,268898,830
"17650","Ocbimv22028918m.g","KQ416274",1996022,2007135,11113
"17651","Ocbimv22023428m.g","KQ419409",3069,47569,44500
"17652","Ocbimv22038064m.g","KQ423210",127126,129468,2342
"17653","Ocbimv22039953m.g","KQ423809",10649,26963,16314
"17654","Ocbimv22026548m.g","KQ416192",110034,110900,866
"17655","Ocbimv22004573m.g","KQ425367",57437,57696,259
"17656","Ocbimv22025759m.g","KQ416166",479434,480447,1013
"17657","Ocbimv22033498m.g","KQ421821",353238,389411,36173
"17658","Ocbimv22024661m.g","KQ419607",629612,633378,3766
"17659","Ocbimv22019777m.g","KQ418812",393783,410871,17088
"17660","Ocbimv22034219m.g","KQ422009",673966,675621,1655
"17661","Ocbimv22029396m.g","KQ420741",719893,720319,426
"17662","Ocbimv22022231m.g","KQ432637",8914,9411,497
"17663","Ocbimv22022057m.g","KQ432540",7454,8080,626
"17664","Ocbimv22025933m.g","KQ419930",494972,498353,3381
"17665","Ocbimv22033313m.g","KQ421769",131329,131877,548
"17666","Ocbimv22006057m.g","KQ417293",181675,181898,223
"17667","Ocbimv22034466m.g","KQ422050",749563,750249,686
"17668","Ocbimv22030991m.g","KQ416380",430412,481977,51565
"17669","Ocbimv22012032m.g","KQ427980",3493,10749,7256
"17670","Ocbimv22027357m.g","KQ420265",4091,25081,20990
"17671","Ocbimv22008928m.g","KQ417540",506698,511537,4839
"17672","Ocbimv22009500m.g","KQ415865",468967,471216,2249
"17673","Ocbimv22039808m.g","KQ416826",107570,111774,4204
"17674","Ocbimv22011868m.g","KQ427941",126248,126532,284
"17675","Ocbimv22039344m.g","KQ423624",84187,84597,410
"17676","Ocbimv22006322m.g","KQ425876",38682,76284,37602
"17677","Ocbimv22022689m.g","KQ419281",562291,563483,1192
"17678","Ocbimv22030314m.g","KQ420944",58813,60196,1383
"17679","Ocbimv22002777m.g","KQ424779",209381,209728,347
"17680","Ocbimv22020182m.g","KQ418870",30004,31404,1400
"17681","Ocbimv22029762m.g","KQ420820",296498,297527,1029
"17682","Ocbimv22008413m.g","KQ426634",174951,175601,650
"17683","Ocbimv22039551m.g","KQ416802",381706,383587,1881
"17684","Ocbimv22005790m.g","KQ415823",623413,677381,53968
"17685","Ocbimv22011666m.g","KQ415889",97500,98147,647
"17686","Ocbimv22020385m.g","KQ418902",41613,77332,35719
"17687","Ocbimv22026016m.g","KQ419957",37236,37729,493
"17688","Ocbimv22029458m.g","KQ420753",116068,119869,3801
"17689","Ocbimv22001768m.g","KQ416962",81528,84960,3432
"17690","Ocbimv22034625m.g","KQ422092",110378,110756,378
"17691","Ocbimv22010790m.g","KQ427521",343916,384975,41059
"17692","Ocbimv22022512m.g","KQ419238",47365,50282,2917
"17693","Ocbimv22030179m.g","KQ416337",201960,312072,110112
"17694","Ocbimv22035906m.g","KQ422598",66136,66567,431
"17695","Ocbimv22001126m.g","KQ424192",29063,29593,530
"17696","Ocbimv22030894m.g","KQ421117",505468,505635,167
"17697","Ocbimv22029385m.g","KQ416303",90709,125362,34653
"17698","Ocbimv22014760m.g","KQ418175",816800,819389,2589
"17699","Ocbimv22034901m.g","KQ422210",96810,124029,27219
"17700","Ocbimv22032523m.g","KQ421575",39045,66046,27001
"17701","Ocbimv22012457m.g","KQ428165",108771,122038,13267
"17702","Ocbimv22020829m.g","KQ418970",1494384,1517073,22689
"17703","Ocbimv22034254m.g","KQ422015",97084,98220,1136
"17704","Ocbimv22033710m.g","KQ421860",326958,346423,19465
"17705","Ocbimv22023664m.g","LGKD01691681",287,496,209
"17706","Ocbimv22035280m.g","KQ422349",125207,131595,6388
"17707","Ocbimv22015549m.g","KQ429416",41324,43738,2414
"17708","Ocbimv22024827m.g","KQ416129",177578,178329,751
"17709","Ocbimv22023121m.g","KQ419350",978895,979780,885
"17710","Ocbimv22009219m.g","KQ417575",180259,181971,1712
"17711","Ocbimv22003951m.g","KQ425160",44036,71991,27955
"17712","Ocbimv22008728m.g","KQ417528",68158,90731,22573
"17713","Ocbimv22006067m.g","KQ425805",89356,90455,1099
"17714","Ocbimv22023438m.g","KQ419409",608317,608940,623
"17715","Ocbimv22010921m.g","KQ417725",126186,152796,26610
"17716","Ocbimv22005787m.g","KQ415823",515842,516270,428
"17717","Ocbimv22015255m.g","KQ418216",326157,345715,19558
"17718","Ocbimv22013344m.g","KQ418015",209567,211404,1837
"17719","Ocbimv22002034m.g","KQ424524",278414,278761,347
"17720","Ocbimv22005821m.g","KQ417280",60676,63117,2441
"17721","Ocbimv22007003m.g","KQ417370",205173,213905,8732
"17722","Ocbimv22034070m.g","KQ416508",941239,969771,28532
"17723","Ocbimv22025163m.g","KQ416141",58092,58511,419
"17724","Ocbimv22015430m.g","KQ429332",150970,163524,12554
"17725","Ocbimv22019849m.g","KQ418821",738489,739328,839
"17726","Ocbimv22001004m.g","KQ424146",417465,418322,857
"17727","Ocbimv22009813m.g","KQ417620",76833,78806,1973
"17728","Ocbimv22023082m.g","KQ419345",128979,132365,3386
"17729","Ocbimv22023041m.g","LGKD01685167",1,192,191
"17730","Ocbimv22033268m.g","KQ421758",1811650,1812549,899
"17731","Ocbimv22021725m.g","KQ416053",431180,434935,3755
"17732","Ocbimv22037495m.g","KQ423047",169777,175528,5751
"17733","Ocbimv22036931m.g","KQ416666",657668,781349,123681
"17734","Ocbimv22000165m.g","KQ416846",322747,329365,6618
"17735","Ocbimv22012296m.g","KQ428113",28210,28401,191
"17736","Ocbimv22035946m.g","KQ416612",1022653,1024437,1784
"17737","Ocbimv22027825m.g","KQ420375",1090060,1123058,32998
"17738","Ocbimv22004143m.g","KQ417140",99146,116952,17806
"17739","Ocbimv22023276m.g","KQ419391",14802,18517,3715
"17740","Ocbimv22027641m.g","KQ420326",31418,32251,833
"17741","Ocbimv22013836m.g","KQ418066",209302,216122,6820
"17742","Ocbimv22023733m.g","KQ433602",1143,3606,2463
"17743","Ocbimv22032143m.g","KQ421460",175995,182809,6814
"17744","Ocbimv22002469m.g","KQ415666",54931,56037,1106
"17745","Ocbimv22009706m.g","KQ427095",103926,104273,347
"17746","Ocbimv22023075m.g","KQ433203",32225,33015,790
"17747","Ocbimv22000562m.g","KQ416867",5008,5210,202
"17748","Ocbimv22013174m.g","KQ428413",11425,12170,745
"17749","Ocbimv22032436m.g","KQ421540",94758,95390,632
"17750","Ocbimv22033563m.g","KQ421832",71400,92355,20955
"17751","Ocbimv22002400m.g","KQ424657",72811,73713,902
"17752","Ocbimv22010511m.g","KQ427406",4924,5300,376
"17753","Ocbimv22012984m.g","KQ415913",127267,172793,45526
"17754","Ocbimv22037152m.g","KQ416677",615951,618826,2875
"17755","Ocbimv22037644m.g","KQ416705",28071,29110,1039
"17756","Ocbimv22038600m.g","KQ423414",153317,153844,527
"17757","Ocbimv22036180m.g","KQ422667",19946,53353,33407
"17758","Ocbimv22033376m.g","KQ416479",261309,261521,212
"17759","Ocbimv22026921m.g","KQ416205",49397,59424,10027
"17760","Ocbimv22019056m.g","KQ418712",230974,231729,755
"17761","Ocbimv22034020m.g","KQ421946",479626,531331,51705
"17762","Ocbimv22029203m.g","KQ420676",1566,2257,691
"17763","Ocbimv22018238m.g","KQ415990",2499663,2506774,7111
"17764","Ocbimv22006489m.g","KQ425942",146401,189800,43399
"17765","Ocbimv22002512m.g","KQ417012",47595,50837,3242
"17766","Ocbimv22014330m.g","KQ418119",24038,26092,2054
"17767","Ocbimv22036353m.g","KQ422717",286913,295598,8685
"17768","Ocbimv22015025m.g","KQ418194",414375,423839,9464
"17769","Ocbimv22029816m.g","KQ420828",793752,800133,6381
"17770","Ocbimv22002099m.g","KQ424540",42681,45150,2469
"17771","Ocbimv22002809m.g","KQ417037",459221,492511,33290
"17772","Ocbimv22029058m.g","KQ420639",270429,271448,1019
"17773","Ocbimv22031781m.g","KQ421343",126502,126726,224
"17774","Ocbimv22000480m.g","KQ416864",127556,147279,19723
"17775","Ocbimv22008408m.g","KQ426633",40381,81085,40704
"17776","Ocbimv22008627m.g","KQ426707",4718,40676,35958
"17777","Ocbimv22013913m.g","KQ418071",245664,245843,179
"17778","Ocbimv22021147m.g","KQ419009",335637,361875,26238
"17779","Ocbimv22037543m.g","KQ423058",861501,913270,51769
"17780","Ocbimv22027061m.g","LGKD01339393",1,261,260
"17781","Ocbimv22039103m.g","KQ416779",437262,437796,534
"17782","Ocbimv22022104m.g","LGKD01675190",8,487,479
"17783","Ocbimv22039800m.g","LGKD01485561",3,785,782
"17784","Ocbimv22000195m.g","KQ423891",59425,59640,215
"17785","Ocbimv22035397m.g","KQ422367",4666,5011,345
"17786","Ocbimv22013124m.g","KQ428380",16167,21424,5257
"17787","Ocbimv22005688m.g","KQ425717",86218,86939,721
"17788","Ocbimv22010060m.g","KQ417639",19748,20837,1089
"17789","Ocbimv22006331m.g","KQ425878",54287,54624,337
"17790","Ocbimv22019579m.g","KQ418789",121555,214594,93039
"17791","Ocbimv22030165m.g","KQ420915",62912,89552,26640
"17792","Ocbimv22008075m.g","KQ426561",38300,44160,5860
"17793","Ocbimv22019304m.g","KQ418747",51570,118074,66504
"17794","Ocbimv22022343m.g","KQ416065",53115,53594,479
"17795","Ocbimv22010940m.g","KQ417725",491057,492475,1418
"17796","Ocbimv22037459m.g","KQ423038",53672,54698,1026
"17797","Ocbimv22022556m.g","KQ432843",20756,29948,9192
"17798","Ocbimv22025845m.g","KQ419912",80023,84519,4496
"17799","Ocbimv22032696m.g","KQ421638",2210,18074,15864
"17800","Ocbimv22032326m.g","KQ421523",455754,480162,24408
"17801","Ocbimv22038875m.g","KQ423482",117022,151477,34455
"17802","Ocbimv22002304m.g","KQ424627",142076,145888,3812
"17803","Ocbimv22027505m.g","KQ420294",103168,103744,576
"17804","Ocbimv22034718m.g","KQ422124",75297,76812,1515
"17805","Ocbimv22013381m.g","KQ418018",792529,792995,466
"17806","Ocbimv22028396m.g","KQ416257",772757,784430,11673
"17807","Ocbimv22025734m.g","KQ419895",34034,48215,14181
"17808","Ocbimv22004583m.g","KQ425371",136287,136457,170
"17809","Ocbimv22000378m.g","KQ423941",461004,466355,5351
"17810","Ocbimv22037827m.g","KQ423139",253471,254535,1064
"17811","Ocbimv22009292m.g","KQ417579",424175,424459,284
"17812","Ocbimv22022759m.g","KQ432990",1808,32710,30902
"17813","Ocbimv22012254m.g","LGKD01593965",59,379,320
"17814","Ocbimv22001639m.g","KQ416950",1453174,1453887,713
"17815","Ocbimv22013371m.g","KQ428468",198534,198815,281
"17816","Ocbimv22029336m.g","KQ420711",670836,709123,38287
"17817","Ocbimv22006638m.g","KQ426043",308059,321231,13172
"17818","Ocbimv22016803m.g","KQ418402",83418,136087,52669
"17819","Ocbimv22022674m.g","KQ432952",8604,8858,254
"17820","Ocbimv22009836m.g","KQ417620",642308,643100,792
"17821","Ocbimv22009820m.g","KQ417620",272918,286234,13316
"17822","Ocbimv22029890m.g","KQ420838",2557,3036,479
"17823","Ocbimv22002323m.g","KQ424629",104561,108738,4177
"17824","Ocbimv22023816m.g","LGKD01692992",25,243,218
"17825","Ocbimv22029809m.g","KQ420828",78283,83426,5143
"17826","Ocbimv22019556m.g","KQ418783",583345,584022,677
"17827","Ocbimv22018063m.g","KQ418561",233246,254433,21187
"17828","Ocbimv22001040m.g","KQ424158",19786,20121,335
"17829","Ocbimv22034471m.g","KQ416534",481272,496144,14872
"17830","Ocbimv22037944m.g","LGKD01465426",102,356,254
"17831","Ocbimv22024903m.g","KQ416131",472249,560049,87800
"17832","Ocbimv22039404m.g","KQ423651",605934,684132,78198
"17833","Ocbimv22017111m.g","KQ418450",229463,229777,314
"17834","Ocbimv22029885m.g","KQ420830",109656,166031,56375
"17835","Ocbimv22038192m.g","KQ423231",247766,257001,9235
"17836","Ocbimv22028529m.g","KQ420517",300591,302531,1940
"17837","Ocbimv22012258m.g","LGKD01594022",286,489,203
"17838","Ocbimv22037576m.g","KQ423072",110842,111450,608
"17839","Ocbimv22000134m.g","KQ416841",1930609,1930842,233
"17840","Ocbimv22030306m.g","KQ420942",300850,301086,236
"17841","Ocbimv22035542m.g","KQ422426",164998,180492,15494
"17842","Ocbimv22023739m.g","KQ419470",530022,556337,26315
"17843","Ocbimv22002716m.g","KQ424757",41856,42107,251
"17844","Ocbimv22021347m.g","KQ416042",1103724,1104134,410
"17845","Ocbimv22019839m.g","KQ418821",540177,543603,3426
"17846","Ocbimv22008026m.g","KQ417471",30894,33076,2182
"17847","Ocbimv22022392m.g","KQ419215",100679,105893,5214
"17848","Ocbimv22025789m.g","KQ419904",185963,188527,2564
"17849","Ocbimv22029448m.g","KQ416306",2299785,2316575,16790
"17850","Ocbimv22011852m.g","KQ417843",133532,133768,236
"17851","Ocbimv22004672m.g","KQ425415",40600,40791,191
"17852","Ocbimv22020912m.g","KQ418974",994931,995122,191
"17853","Ocbimv22017211m.g","KQ430210",37168,62843,25675
"17854","Ocbimv22005497m.g","KQ425624",142599,143320,721
"17855","Ocbimv22031982m.g","KQ416415",517281,517676,395
"17856","Ocbimv22029992m.g","KQ420876",76551,76934,383
"17857","Ocbimv22039357m.g","KQ423631",138950,144779,5829
"17858","Ocbimv22029637m.g","KQ420791",2946,3987,1041
"17859","Ocbimv22014749m.g","KQ418175",385974,386835,861
"17860","Ocbimv22028254m.g","KQ415659",394741,397038,2297
"17861","Ocbimv22007351m.g","KQ415841",371102,373472,2370
"17862","Ocbimv22010774m.g","KQ427511",170444,170737,293
"17863","Ocbimv22027818m.g","KQ420375",990357,1083137,92780
"17864","Ocbimv22004809m.g","KQ417208",172685,191651,18966
"17865","Ocbimv22003586m.g","KQ417094",5401,5751,350
"17866","Ocbimv22024858m.g","KQ419643",12510,29117,16607
"17867","Ocbimv22020892m.g","KQ418974",102646,102954,308
"17868","Ocbimv22009807m.g","KQ417618",50367,53316,2949
"17869","Ocbimv22006998m.g","KQ417370",116054,120471,4417
"17870","Ocbimv22031455m.g","KQ416399",324,45092,44768
"17871","Ocbimv22031836m.g","KQ421356",659601,660197,596
"17872","Ocbimv22022825m.g","LGKD01682865",22,723,701
"17873","Ocbimv22030873m.g","KQ416373",999990,1001808,1818
"17874","Ocbimv22008270m.g","KQ417492",553298,593885,40587
"17875","Ocbimv22007057m.g","KQ417372",128262,145730,17468
"17876","Ocbimv22003537m.g","KQ417090",987398,987712,314
"17877","Ocbimv22014275m.g","KQ418112",189647,189811,164
"17878","Ocbimv22039725m.g","KQ423737",2952,13945,10993
"17879","Ocbimv22004619m.g","KQ425383",78637,102167,23530
"17880","Ocbimv22028862m.g","KQ420593",673629,683555,9926
"17881","Ocbimv22027213m.g","KQ420220",125547,155099,29552
"17882","Ocbimv22027768m.g","KQ420362",130723,130881,158
"17883","Ocbimv22021565m.g","KQ419078",295474,301968,6494
"17884","Ocbimv22024890m.g","KQ419648",191776,192042,266
"17885","Ocbimv22028292m.g","KQ420462",162096,162290,194
"17886","Ocbimv22037952m.g","KQ423179",59500,60748,1248
"17887","Ocbimv22012730m.g","KQ417931",1150628,1151650,1022
"17888","Ocbimv22030959m.g","KQ416378",528730,529230,500
"17889","Ocbimv22016218m.g","KQ418328",480236,565421,85185
"17890","Ocbimv22024989m.g","KQ419672",260438,261504,1066
"17891","Ocbimv22033077m.g","KQ421724",242623,261650,19027
"17892","Ocbimv22017791m.g","KQ418545",112346,213754,101408
"17893","Ocbimv22004788m.g","KQ425437",240843,241157,314
"17894","Ocbimv22007138m.g","KQ426206",10713,11207,494
"17895","Ocbimv22012191m.g","KQ428068",32310,32615,305
"17896","Ocbimv22014711m.g","KQ418169",40097,56416,16319
"17897","Ocbimv22016324m.g","KQ418338",527650,531040,3390
"17898","Ocbimv22035638m.g","KQ422481",245454,245666,212
"17899","Ocbimv22039801m.g","KQ423759",17538,17870,332
"17900","Ocbimv22003173m.g","KQ417062",134767,146672,11905
"17901","Ocbimv22020608m.g","KQ418937",14844,14996,152
"17902","Ocbimv22025625m.g","KQ419863",15517,15714,197
"17903","Ocbimv22017757m.g","KQ418537",898433,964253,65820
"17904","Ocbimv22021834m.g","KQ415687",1005989,1034352,28363
"17905","Ocbimv22015230m.g","LGKD01616206",8,199,191
"17906","Ocbimv22027887m.g","KQ420388",252842,255945,3103
"17907","Ocbimv22026264m.g","KQ420022",440415,441379,964
"17908","Ocbimv22001665m.g","KQ416951",639907,641505,1598
"17909","Ocbimv22008542m.g","KQ426672",8882,9088,206
"17910","Ocbimv22014867m.g","LGKD01613662",35,676,641
"17911","Ocbimv22008370m.g","KQ417498",824584,833688,9104
"17912","Ocbimv22004348m.g","KQ425271",11516,11710,194
"17913","Ocbimv22033372m.g","KQ421802",12129,12335,206
"17914","Ocbimv22006303m.g","KQ425868",71909,99319,27410
"17915","Ocbimv22016448m.g","KQ415965",596614,596940,326
"17916","Ocbimv22025990m.g","KQ419945",1788,3432,1644
"17917","Ocbimv22018708m.g","KQ418658",2332,21478,19146
"17918","Ocbimv22018354m.g","KQ418610",80278,85420,5142
"17919","Ocbimv22035235m.g","KQ422338",201296,202044,748
"17920","Ocbimv22037685m.g","KQ423101",15677,21227,5550
"17921","Ocbimv22000338m.g","KQ416854",481258,481503,245
"17922","Ocbimv22002258m.g","KQ424587",13928,19731,5803
"17923","Ocbimv22019027m.g","KQ418711",768098,768977,879
"17924","Ocbimv22021472m.g","KQ416046",2106656,2119687,13031
"17925","Ocbimv22035208m.g","KQ422311",103023,112054,9031
"17926","Ocbimv22003691m.g","KQ425066",283122,327886,44764
"17927","Ocbimv22011422m.g","KQ415885",1444631,1445792,1161
"17928","Ocbimv22021196m.g","KQ416040",424435,498728,74293
"17929","Ocbimv22000862m.g","KQ424096",95120,110334,15214
"17930","Ocbimv22033889m.g","KQ421899",83691,83873,182
"17931","Ocbimv22027586m.g","KQ420311",62653,63243,590
"17932","Ocbimv22026044m.g","KQ419973",123590,175598,52008
"17933","Ocbimv22023552m.g","KQ419432",29032,30733,1701
"17934","Ocbimv22001617m.g","KQ416949",364625,368430,3805
"17935","Ocbimv22027952m.g","KQ420409",329294,330103,809
"17936","Ocbimv22012840m.g","KQ417945",448051,450720,2669
"17937","Ocbimv22000411m.g","KQ423958",219549,219788,239
"17938","Ocbimv22017248m.g","KQ418469",748045,773692,25647
"17939","Ocbimv22026902m.g","KQ420138",1125998,1127533,1535
"17940","Ocbimv22004326m.g","KQ417149",73011,74810,1799
"17941","Ocbimv22025293m.g","KQ419763",71716,86193,14477
"17942","Ocbimv22022545m.g","KQ432836",85375,85635,260
"17943","Ocbimv22039762m.g","KQ423740",1038,12497,11459
"17944","Ocbimv22010419m.g","KQ427377",83848,85203,1355
"17945","Ocbimv22010120m.g","KQ417645",119452,119625,173
"17946","Ocbimv22013761m.g","KQ418059",213157,215179,2022
"17947","Ocbimv22001433m.g","KQ416933",134579,145958,11379
"17948","Ocbimv22017365m.g","KQ418485",97176,138712,41536
"17949","Ocbimv22023852m.g","KQ416102",31374,31610,236
"17950","Ocbimv22006387m.g","KQ417317",34328,35931,1603
"17951","Ocbimv22008138m.g","KQ417481",216114,254181,38067
"17952","Ocbimv22022134m.g","KQ419175",517344,518976,1632
"17953","Ocbimv22027385m.g","KQ420268",568838,619638,50800
"17954","Ocbimv22036569m.g","KQ422794",2208,16356,14148
"17955","Ocbimv22012199m.g","KQ417887",478904,480187,1283
"17956","Ocbimv22016510m.g","KQ429904",117745,139714,21969
"17957","Ocbimv22010625m.g","KQ415669",1696315,1703127,6812
"17958","Ocbimv22031651m.g","KQ421305",535104,547086,11982
"17959","Ocbimv22014628m.g","KQ418159",111211,133219,22008
"17960","Ocbimv22027758m.g","KQ420358",210429,238661,28232
"17961","Ocbimv22032582m.g","KQ421602",16254,61167,44913
"17962","Ocbimv22021436m.g","KQ419049",56534,63567,7033
"17963","Ocbimv22028047m.g","KQ416244",213915,215737,1822
"17964","Ocbimv22013064m.g","KQ428357",2696,2983,287
"17965","Ocbimv22028403m.g","KQ416257",1085671,1085955,284
"17966","Ocbimv22031442m.g","KQ421244",120322,121780,1458
"17967","Ocbimv22000705m.g","KQ416877",306136,307679,1543
"17968","Ocbimv22033234m.g","KQ421758",637655,767211,129556
"17969","Ocbimv22021233m.g","KQ419018",20576,28354,7778
"17970","Ocbimv22020952m.g","KQ418982",556241,556426,185
"17971","Ocbimv22033122m.g","KQ421731",323322,334135,10813
"17972","Ocbimv22022474m.g","KQ419225",22071,41069,18998
"17973","Ocbimv22034089m.g","KQ421972",50045,52437,2392
"17974","Ocbimv22013677m.g","KQ418044",221290,222849,1559
"17975","Ocbimv22019573m.g","KQ418785",150358,178770,28412
"17976","Ocbimv22010225m.g","KQ417658",12584,16578,3994
"17977","Ocbimv22034756m.g","KQ422146",44658,44927,269
"17978","Ocbimv22009934m.g","KQ417623",432227,432400,173
"17979","Ocbimv22006936m.g","KQ417364",410240,410518,278
"17980","Ocbimv22014156m.g","KQ428781",37142,37312,170
"17981","Ocbimv22039703m.g","KQ416815",1,1438,1437
"17982","Ocbimv22033883m.g","KQ416497",66360,70883,4523
"17983","Ocbimv22010531m.g","KQ417687",1277015,1288427,11412
"17984","Ocbimv22021823m.g","KQ415687",498556,518335,19779
"17985","Ocbimv22014307m.g","KQ428859",21666,55558,33892
"17986","Ocbimv22024720m.g","KQ419621",756184,756650,466
"17987","Ocbimv22006315m.g","KQ425873",330241,330498,257
"17988","Ocbimv22011649m.g","KQ427832",4756,5553,797
"17989","Ocbimv22035648m.g","KQ422491",213891,214049,158
"17990","Ocbimv22038206m.g","KQ416731",555187,563577,8390
"17991","Ocbimv22006902m.g","KQ426136",54989,55884,895
"17992","Ocbimv22010866m.g","KQ427554",19570,34431,14861
"17993","Ocbimv22035628m.g","KQ422481",192491,193726,1235
"17994","Ocbimv22014126m.g","KQ418093",16601,16948,347
"17995","Ocbimv22036116m.g","KQ416618",112724,113172,448
"17996","Ocbimv22019274m.g","KQ418739",743611,750911,7300
"17997","Ocbimv22006676m.g","KQ415833",421954,425600,3646
"17998","Ocbimv22030440m.g","KQ420990",95137,95976,839
"17999","Ocbimv22012059m.g","KQ417858",147277,193340,46063
"18000","Ocbimv22033930m.g","KQ416499",134666,171721,37055
"18001","Ocbimv22025264m.g","KQ419751",147406,179258,31852
"18002","Ocbimv22029575m.g","KQ420777",163622,174321,10699
"18003","Ocbimv22012221m.g","KQ415905",706384,707906,1522
"18004","Ocbimv22018484m.g","LGKD01643500",326,775,449
"18005","Ocbimv22036003m.g","KQ422631",7264,7452,188
"18006","Ocbimv22034213m.g","KQ422009",279607,280084,477
"18007","Ocbimv22000930m.g","KQ424119",17860,18328,468
"18008","Ocbimv22031917m.g","KQ421376",1173819,1174564,745
"18009","Ocbimv22003569m.g","KQ417091",259706,259972,266
"18010","Ocbimv22015478m.g","KQ429381",3840,5325,1485
"18011","Ocbimv22009473m.g","KQ417596",721470,722316,846
"18012","Ocbimv22038731m.g","KQ416764",96636,112522,15886
"18013","Ocbimv22025065m.g","KQ419691",14830,86017,71187
"18014","Ocbimv22028968m.g","KQ416278",60726,60938,212
"18015","Ocbimv22017724m.g","KQ430440",72,3090,3018
"18016","Ocbimv22014497m.g","KQ418142",175674,177734,2060
"18017","Ocbimv22033212m.g","KQ421754",108018,108967,949
"18018","Ocbimv22015523m.g","KQ415945",843804,846092,2288
"18019","Ocbimv22034865m.g","KQ416560",75333,79143,3810
"18020","Ocbimv22018739m.g","LGKD01645714",1,690,689
"18021","Ocbimv22039445m.g","KQ416799",1766506,1767306,800
"18022","Ocbimv22007145m.g","KQ426211",23,1513,1490
"18023","Ocbimv22023969m.g","KQ419510",92809,93324,515
"18024","Ocbimv22018598m.g","KQ418644",622602,636282,13680
"18025","Ocbimv22033775m.g","KQ421869",79412,79750,338
"18026","Ocbimv22007681m.g","KQ415846",113929,119555,5626
"18027","Ocbimv22031870m.g","KQ421368",8062,14101,6039
"18028","Ocbimv22015452m.g","KQ429351",30108,79165,49057
"18029","Ocbimv22015718m.g","KQ429509",1753,4193,2440
"18030","Ocbimv22015312m.g","KQ429259",73508,74591,1083
"18031","Ocbimv22023030m.g","KQ419340",35097,35507,410
"18032","Ocbimv22019356m.g","KQ418755",63049,98736,35687
"18033","Ocbimv22025985m.g","KQ415696",142749,144444,1695
"18034","Ocbimv22035421m.g","KQ422378",91223,91930,707
"18035","Ocbimv22026348m.g","KQ420031",214158,219955,5797
"18036","Ocbimv22021913m.g","KQ419129",24113,106862,82749
"18037","Ocbimv22018383m.g","KQ418612",152727,153939,1212
"18038","Ocbimv22004114m.g","KQ417137",213220,213691,471
"18039","Ocbimv22024203m.g","KQ419549",13125,22794,9669
"18040","Ocbimv22021802m.g","LGKD01671024",15,224,209
"18041","Ocbimv22024360m.g","KQ419574",620713,659154,38441
"18042","Ocbimv22035902m.g","KQ422595",434857,452045,17188
"18043","Ocbimv22030897m.g","KQ421117",1254849,1255384,535
"18044","Ocbimv22009636m.g","KQ427059",156853,172651,15798
"18045","Ocbimv22024154m.g","KQ419541",262652,295760,33108
"18046","Ocbimv22031013m.g","KQ416382",1556572,1556745,173
"18047","Ocbimv22015848m.g","KQ418296",5542,5739,197
"18048","Ocbimv22019620m.g","KQ418789",350775,361359,10584
"18049","Ocbimv22014819m.g","KQ429096",438891,464244,25353
"18050","Ocbimv22024538m.g","KQ419593",67557,68570,1013
"18051","Ocbimv22021500m.g","KQ432186",1767,4245,2478
"18052","Ocbimv22023194m.g","KQ419368",605530,611021,5491
"18053","Ocbimv22000491m.g","KQ416864",592229,592612,383
"18054","Ocbimv22012716m.g","KQ417929",248066,272617,24551
"18055","Ocbimv22001384m.g","KQ416929",1128552,1129829,1277
"18056","Ocbimv22019698m.g","KQ418800",99985,163435,63450
"18057","Ocbimv22008289m.g","KQ426610",253191,298904,45713
"18058","Ocbimv22036287m.g","KQ422697",256476,256760,284
"18059","Ocbimv22008736m.g","KQ417528",326035,469432,143397
"18060","Ocbimv22012816m.g","KQ417942",1418909,1422142,3233
"18061","Ocbimv22037649m.g","KQ416705",322952,370292,47340
"18062","Ocbimv22008291m.g","KQ426610",322218,335197,12979
"18063","Ocbimv22025372m.g","KQ416152",479622,502713,23091
"18064","Ocbimv22017888m.g","LGKD01639673",1,427,426
"18065","Ocbimv22004577m.g","KQ425371",8246,14589,6343
"18066","Ocbimv22026335m.g","KQ420029",166245,300226,133981
"18067","Ocbimv22012186m.g","KQ428063",50917,62894,11977
"18068","Ocbimv22038523m.g","KQ423384",275742,275927,185
"18069","Ocbimv22011463m.g","KQ417793",5450,6374,924
"18070","Ocbimv22017403m.g","KQ418493",847,4406,3559
"18071","Ocbimv22002007m.g","KQ424513",4493,16671,12178
"18072","Ocbimv22005267m.g","KQ415814",99684,130352,30668
"18073","Ocbimv22010300m.g","KQ417666",436569,437937,1368
"18074","Ocbimv22019269m.g","KQ418739",529747,531741,1994
"18075","Ocbimv22032388m.g","KQ421526",619377,619910,533
"18076","Ocbimv22033985m.g","KQ421938",9051,158319,149268
"18077","Ocbimv22002222m.g","KQ424575",262754,276669,13915
"18078","Ocbimv22021273m.g","KQ416041",337670,337957,287
"18079","Ocbimv22004233m.g","KQ417143",83426,84875,1449
"18080","Ocbimv22023758m.g","KQ416096",710092,715714,5622
"18081","Ocbimv22034522m.g","KQ422068",88473,89435,962
"18082","Ocbimv22028496m.g","KQ420512",57313,63178,5865
"18083","Ocbimv22037225m.g","KQ416684",407678,432131,24453
"18084","Ocbimv22002000m.g","KQ416979",1355124,1407699,52575
"18085","Ocbimv22031219m.g","KQ421200",375167,380045,4878
"18086","Ocbimv22029900m.g","KQ416321",401889,402047,158
"18087","Ocbimv22036212m.g","KQ422680",178276,178860,584
"18088","Ocbimv22001723m.g","KQ416957",22545,24740,2195
"18089","Ocbimv22023096m.g","KQ419348",68894,92721,23827
"18090","Ocbimv22036792m.g","KQ416657",457359,461154,3795
"18091","Ocbimv22004275m.g","KQ425255",14334,40824,26490
"18092","Ocbimv22000626m.g","KQ416870",167067,197466,30399
"18093","Ocbimv22010328m.g","KQ417670",151496,213343,61847
"18094","Ocbimv22016439m.g","KQ418355",167910,169380,1470
"18095","Ocbimv22019090m.g","KQ430963",68068,68602,534
"18096","Ocbimv22022437m.g","KQ419216",149609,151557,1948
"18097","Ocbimv22002667m.g","KQ424728",78031,79376,1345
"18098","Ocbimv22000505m.g","KQ415777",299960,300580,620
"18099","Ocbimv22038855m.g","KQ415768",606288,609228,2940
"18100","Ocbimv22011301m.g","KQ417777",201960,209430,7470
"18101","Ocbimv22022345m.g","KQ432686",23793,39859,16066
"18102","Ocbimv22030941m.g","KQ416376",22184,23982,1798
"18103","Ocbimv22004249m.g","KQ417143",541407,541715,308
"18104","Ocbimv22021861m.g","KQ419113",61185,61778,593
"18105","Ocbimv22039741m.g","KQ423737",101090,104843,3753
"18106","Ocbimv22034666m.g","KQ416546",4592,16693,12101
"18107","Ocbimv22015570m.g","KQ418267",585254,585796,542
"18108","Ocbimv22005924m.g","KQ417284",467656,470439,2783
"18109","Ocbimv22031434m.g","KQ421241",628136,639571,11435
"18110","Ocbimv22027646m.g","KQ420329",219092,270742,51650
"18111","Ocbimv22002422m.g","KQ417009",1233331,1268724,35393
"18112","Ocbimv22015501m.g","KQ418263",761672,761845,173
"18113","Ocbimv22034427m.g","KQ416531",162835,210955,48120
"18114","Ocbimv22039112m.g","KQ416779",610642,611431,789
"18115","Ocbimv22009520m.g","KQ415865",757180,758740,1560
"18116","Ocbimv22010865m.g","KQ427554",12862,18846,5984
"18117","Ocbimv22036275m.g","KQ416628",835089,835280,191
"18118","Ocbimv22022266m.g","KQ416064",2461723,2461932,209
"18119","Ocbimv22039255m.g","KQ423593",136581,136943,362
"18120","Ocbimv22002824m.g","KQ417038",119040,119340,300
"18121","Ocbimv22031524m.g","KQ421265",198952,199978,1026
"18122","Ocbimv22012923m.g","LGKD01597705",225,452,227
"18123","Ocbimv22030472m.g","KQ420992",208988,254508,45520
"18124","Ocbimv22008082m.g","KQ426561",108013,108324,311
"18125","Ocbimv22020606m.g","KQ418936",610985,611206,221
"18126","Ocbimv22030487m.g","KQ420999",13825,29178,15353
"18127","Ocbimv22012257m.g","KQ417895",27447,112292,84845
"18128","Ocbimv22035281m.g","KQ422349",135173,135754,581
"18129","Ocbimv22000817m.g","KQ424081",132644,132967,323
"18130","Ocbimv22022880m.g","KQ419318",364827,377883,13056
"18131","Ocbimv22030835m.g","KQ421108",73614,75134,1520
"18132","Ocbimv22034400m.g","KQ422028",397766,399024,1258
"18133","Ocbimv22009504m.g","KQ415865",494000,494200,200
"18134","Ocbimv22035782m.g","KQ422532",40996,42837,1841
"18135","Ocbimv22010296m.g","KQ427346",20520,20669,149
"18136","Ocbimv22020213m.g","KQ418873",603790,624770,20980
"18137","Ocbimv22015897m.g","KQ429620",119799,120361,562
"18138","Ocbimv22037766m.g","KQ423129",135803,165381,29578
"18139","Ocbimv22019971m.g","KQ418839",558824,568000,9176
"18140","Ocbimv22032422m.g","KQ421533",487000,500309,13309
"18141","Ocbimv22005346m.g","KQ425586",100909,104308,3399
"18142","Ocbimv22006804m.g","KQ417350",89238,121852,32614
"18143","Ocbimv22014242m.g","KQ428817",34169,64584,30415
"18144","Ocbimv22007970m.g","KQ417466",1830844,1865162,34318
"18145","Ocbimv22006077m.g","KQ417294",52086,62847,10761
"18146","Ocbimv22025212m.g","KQ419735",39840,90795,50955
"18147","Ocbimv22013333m.g","KQ418012",486481,486693,212
"18148","Ocbimv22023074m.g","KQ419343",155208,158318,3110
"18149","Ocbimv22028866m.g","KQ420595",368148,368425,277
"18150","Ocbimv22026330m.g","KQ420027",174502,183412,8910
"18151","Ocbimv22010606m.g","KQ417699",85649,87789,2140
"18152","Ocbimv22038281m.g","KQ423259",553197,624029,70832
"18153","Ocbimv22008428m.g","KQ417501",186658,187168,510
"18154","Ocbimv22036609m.g","KQ416648",70751,80825,10074
"18155","Ocbimv22035529m.g","KQ422422",313211,322937,9726
"18156","Ocbimv22005934m.g","KQ417285",25119,32330,7211
"18157","Ocbimv22001310m.g","KQ424264",336303,338250,1947
"18158","Ocbimv22014102m.g","KQ428760",76818,132508,55690
"18159","Ocbimv22024669m.g","KQ419607",790156,834298,44142
"18160","Ocbimv22035870m.g","KQ416607",97904,100224,2320
"18161","Ocbimv22006449m.g","LGKD01545635",242,442,200
"18162","Ocbimv22014954m.g","KQ418188",40589,47410,6821
"18163","Ocbimv22017814m.g","KQ418549",699769,700415,646
"18164","Ocbimv22020558m.g","KQ418924",232279,234249,1970
"18165","Ocbimv22024970m.g","KQ419670",119720,149469,29749
"18166","Ocbimv22037970m.g","KQ423187",15294,19488,4194
"18167","Ocbimv22005088m.g","KQ425518",64241,68941,4700
"18168","Ocbimv22039870m.g","KQ416832",85417,89592,4175
"18169","Ocbimv22026601m.g","KQ420078",228735,243699,14964
"18170","Ocbimv22008040m.g","KQ417475",191719,192024,305
"18171","Ocbimv22001491m.g","KQ424324",1778,31496,29718
"18172","Ocbimv22025213m.g","KQ419735",560458,560718,260
"18173","Ocbimv22021308m.g","KQ419027",118968,119941,973
"18174","Ocbimv22022683m.g","KQ419281",390878,428739,37861
"18175","Ocbimv22024005m.g","KQ419520",92864,93703,839
"18176","Ocbimv22020143m.g","KQ431479",16682,24710,8028
"18177","Ocbimv22023539m.g","KQ419428",3508,40104,36596
"18178","Ocbimv22037554m.g","KQ423061",58176,60036,1860
"18179","Ocbimv22012233m.g","KQ417892",162167,177271,15104
"18180","Ocbimv22025081m.g","KQ416137",413010,414873,1863
"18181","Ocbimv22033062m.g","KQ421721",701919,703702,1783
"18182","Ocbimv22011715m.g","KQ417824",839150,839537,387
"18183","Ocbimv22029778m.g","KQ416320",4570,4752,182
"18184","Ocbimv22006114m.g","KQ417298",211848,212039,191
"18185","Ocbimv22036829m.g","KQ422866",197023,219362,22339
"18186","Ocbimv22010010m.g","KQ427204",266146,297968,31822
"18187","Ocbimv22009536m.g","KQ415865",987611,1004502,16891
"18188","Ocbimv22036559m.g","KQ416645",3150,28139,24989
"18189","Ocbimv22024946m.g","KQ419660",303656,303957,301
"18190","Ocbimv22028112m.g","KQ416249",825515,826021,506
"18191","Ocbimv22031022m.g","KQ421144",200560,226826,26266
"18192","Ocbimv22001318m.g","KQ424265",57260,171527,114267
"18193","Ocbimv22036930m.g","KQ416666",627970,630146,2176
"18194","Ocbimv22000608m.g","KQ424018",32009,37418,5409
"18195","Ocbimv22021610m.g","KQ432245",129560,135785,6225
"18196","Ocbimv22006167m.g","KQ417300",2135373,2136703,1330
"18197","Ocbimv22014236m.g","KQ428812",8502,8957,455
"18198","Ocbimv22020318m.g","KQ431609",26354,48100,21746
"18199","Ocbimv22039690m.g","KQ423731",13214,14307,1093
"18200","Ocbimv22002488m.g","KQ424671",244352,257480,13128
"18201","Ocbimv22007609m.g","KQ417438",11892,13189,1297
"18202","Ocbimv22003876m.g","KQ417118",509734,611877,102143
"18203","Ocbimv22004682m.g","KQ417198",96497,127735,31238
"18204","Ocbimv22007828m.g","KQ426466",58977,149996,91019
"18205","Ocbimv22019433m.g","KQ418767",652,921,269
"18206","Ocbimv22000740m.g","KQ416877",1189474,1200411,10937
"18207","Ocbimv22020921m.g","KQ418974",2024133,2025855,1722
"18208","Ocbimv22007764m.g","KQ415847",978857,990880,12023
"18209","Ocbimv22001776m.g","KQ424412",14345,15704,1359
"18210","Ocbimv22016565m.g","LGKD01628518",203,391,188
"18211","Ocbimv22025677m.g","KQ419886",152208,189173,36965
"18212","Ocbimv22000860m.g","KQ424096",54374,55101,727
"18213","Ocbimv22011696m.g","KQ427861",2825,11196,8371
"18214","Ocbimv22027425m.g","KQ420273",14833,107610,92777
"18215","Ocbimv22016002m.g","KQ429654",1516,33360,31844
"18216","Ocbimv22010712m.g","KQ427473",11017,13286,2269
"18217","Ocbimv22008191m.g","KQ417482",265723,268860,3137
"18218","Ocbimv22015103m.g","KQ418194",2769559,2771377,1818
"18219","Ocbimv22009035m.g","KQ426850",35043,81097,46054
"18220","Ocbimv22024131m.g","LGKD01696053",1,228,227
"18221","Ocbimv22008384m.g","LGKD01562180",228,596,368
"18222","Ocbimv22001302m.g","KQ424264",5644,5811,167
"18223","Ocbimv22003773m.g","KQ417110",284887,285616,729
"18224","Ocbimv22023029m.g","KQ419339",36456,38581,2125
"18225","Ocbimv22003806m.g","KQ425115",361245,378342,17097
"18226","Ocbimv22029972m.g","KQ420865",223302,246567,23265
"18227","Ocbimv22006776m.g","KQ426101",207863,227898,20035
"18228","Ocbimv22003553m.g","KQ417090",1766748,1770238,3490
"18229","Ocbimv22032805m.g","KQ421658",724589,726617,2028
"18230","Ocbimv22030551m.g","KQ416354",324700,325017,317
"18231","Ocbimv22003782m.g","KQ417112",426630,426842,212
"18232","Ocbimv22036204m.g","KQ422675",22892,31678,8786
"18233","Ocbimv22039308m.g","KQ416788",8472,17423,8951
"18234","Ocbimv22034435m.g","KQ422036",929026,930440,1414
"18235","Ocbimv22015981m.g","KQ415949",1279482,1279832,350
"18236","Ocbimv22023018m.g","KQ416080",76048,76661,613
"18237","Ocbimv22023455m.g","KQ419414",342491,344485,1994
"18238","Ocbimv22007287m.g","KQ417398",999308,1085837,86529
"18239","Ocbimv22020783m.g","KQ418964",360294,412640,52346
"18240","Ocbimv22014466m.g","KQ428946",32216,89901,57685
"18241","Ocbimv22033266m.g","KQ421758",1806216,1807481,1265
"18242","Ocbimv22025772m.g","KQ416166",1126636,1126839,203
"18243","Ocbimv22017049m.g","KQ418444",420856,443632,22776
"18244","Ocbimv22035408m.g","KQ422367",366857,370227,3370
"18245","Ocbimv22033634m.g","KQ421853",886477,900354,13877
"18246","Ocbimv22028850m.g","KQ420593",142426,150537,8111
"18247","Ocbimv22011179m.g","KQ427660",54432,64915,10483
"18248","Ocbimv22037127m.g","KQ422930",132836,150182,17346
"18249","Ocbimv22027977m.g","KQ420414",659497,659764,267
"18250","Ocbimv22024736m.g","KQ419622",19744,31474,11730
"18251","Ocbimv22021385m.g","KQ432116",3,5437,5434
"18252","Ocbimv22008454m.g","KQ415854",300256,301492,1236
"18253","Ocbimv22015329m.g","KQ418223",80326,85043,4717
"18254","Ocbimv22008098m.g","KQ426567",96231,99455,3224
"18255","Ocbimv22031137m.g","KQ421173",146372,159682,13310
"18256","Ocbimv22007105m.g","KQ426196",73299,74062,763
"18257","Ocbimv22009130m.g","KQ426892",81784,83070,1286
"18258","Ocbimv22001386m.g","KQ416930",179411,179691,280
"18259","Ocbimv22033815m.g","KQ421880",168661,177927,9266
"18260","Ocbimv22000216m.g","KQ423900",51977,180258,128281
"18261","Ocbimv22024765m.g","KQ419623",194303,202873,8570
"18262","Ocbimv22031457m.g","KQ416399",77342,96397,19055
"18263","Ocbimv22020343m.g","KQ431632",456,677,221
"18264","Ocbimv22033263m.g","KQ421758",1720329,1721469,1140
"18265","Ocbimv22020272m.g","KQ418881",1079741,1079975,234
"18266","Ocbimv22005828m.g","KQ417280",95410,99596,4186
"18267","Ocbimv22037087m.g","KQ422919",1367101,1368904,1803
"18268","Ocbimv22012883m.g","LGKD01597238",11,573,562
"18269","Ocbimv22026529m.g","KQ420065",93697,110060,16363
"18270","Ocbimv22009523m.g","KQ415865",769814,772081,2267
"18271","Ocbimv22037310m.g","KQ416685",2546,20924,18378
"18272","Ocbimv22009874m.g","KQ417621",184143,194478,10335
"18273","Ocbimv22025726m.g","KQ419890",2070,2828,758
"18274","Ocbimv22026322m.g","KQ420026",192938,199042,6104
"18275","Ocbimv22023819m.g","KQ419484",27615,35669,8054
"18276","Ocbimv22002610m.g","KQ417023",206339,255024,48685
"18277","Ocbimv22001210m.g","KQ424229",188184,217832,29648
"18278","Ocbimv22032549m.g","KQ416437",160448,162404,1956
"18279","Ocbimv22029539m.g","KQ420776",112378,113198,820
"18280","Ocbimv22009575m.g","KQ427028",449996,451584,1588
"18281","Ocbimv22004938m.g","KQ425476",41648,42656,1008
"18282","Ocbimv22018167m.g","KQ418582",15475,16794,1319
"18283","Ocbimv22027679m.g","KQ420336",24664,24777,113
"18284","Ocbimv22034531m.g","KQ422073",237121,245887,8766
"18285","Ocbimv22023170m.g","KQ419366",248379,260773,12394
"18286","Ocbimv22008954m.g","KQ417543",21710,22641,931
"18287","Ocbimv22021261m.g","KQ432063",97978,98523,545
"18288","Ocbimv22001629m.g","KQ416950",541629,542601,972
"18289","Ocbimv22030290m.g","LGKD01377593",2,699,697
"18290","Ocbimv22007037m.g","KQ417370",637723,638155,432
"18291","Ocbimv22029764m.g","KQ420820",302903,376889,73986
"18292","Ocbimv22018537m.g","KQ415995",118812,126319,7507
"18293","Ocbimv22037334m.g","KQ423002",136102,136281,179
"18294","Ocbimv22035169m.g","KQ415662",177750,178274,524
"18295","Ocbimv22012811m.g","KQ417942",546963,547229,266
"18296","Ocbimv22009639m.g","KQ427059",265628,266984,1356
"18297","Ocbimv22024584m.g","KQ419601",704268,725178,20910
"18298","Ocbimv22002242m.g","KQ416999",508103,509670,1567
"18299","Ocbimv22020142m.g","KQ431479",6352,16057,9705
"18300","Ocbimv22006995m.g","KQ417370",95846,100134,4288
"18301","Ocbimv22032191m.g","KQ421476",123541,143134,19593
"18302","Ocbimv22036695m.g","KQ416653",118460,150244,31784
"18303","Ocbimv22018725m.g","LGKD01645375",229,408,179
"18304","Ocbimv22028727m.g","KQ416270",793435,803757,10322
"18305","Ocbimv22038803m.g","KQ423466",15592,18854,3262
"18306","Ocbimv22018305m.g","KQ418599",184418,208602,24184
"18307","Ocbimv22010487m.g","KQ417681",1114290,1176597,62307
"18308","Ocbimv22008048m.g","KQ426542",15648,22960,7312
"18309","Ocbimv22024008m.g","KQ419520",141582,185049,43467
"18310","Ocbimv22001589m.g","KQ416946",195920,196571,651
"18311","Ocbimv22010036m.g","KQ427221",21386,22112,726
"18312","Ocbimv22008112m.g","KQ426567",226951,249274,22323
"18313","Ocbimv22024029m.g","KQ419523",78108,79518,1410
"18314","Ocbimv22026452m.g","KQ420052",225649,234828,9179
"18315","Ocbimv22038672m.g","KQ423435",355810,356123,313
"18316","Ocbimv22003436m.g","KQ417087",1071475,1073683,2208
"18317","Ocbimv22039151m.g","KQ423555",191190,242563,51373
"18318","Ocbimv22006597m.g","KQ426027",78590,83040,4450
"18319","Ocbimv22015310m.g","KQ418217",131732,132356,624
"18320","Ocbimv22028916m.g","KQ416274",1940849,1944808,3959
"18321","Ocbimv22028442m.g","KQ420488",171556,184176,12620
"18322","Ocbimv22025890m.g","KQ416175",604156,609089,4933
"18323","Ocbimv22016894m.g","KQ418420",65883,80712,14829
"18324","Ocbimv22024717m.g","KQ419621",557790,557939,149
"18325","Ocbimv22008015m.g","KQ415849",316331,334125,17794
"18326","Ocbimv22019879m.g","KQ418829",86704,87197,493
"18327","Ocbimv22036100m.g","KQ422641",336051,336750,699
"18328","Ocbimv22005295m.g","KQ425571",210545,222625,12080
"18329","Ocbimv22037946m.g","KQ423179",8368,9894,1526
"18330","Ocbimv22029012m.g","KQ416279",739300,760363,21063
"18331","Ocbimv22017560m.g","KQ418506",113743,114668,925
"18332","Ocbimv22021935m.g","KQ419135",1394,1961,567
"18333","Ocbimv22036663m.g","KQ422824",45,224,179
"18334","Ocbimv22008418m.g","KQ417500",15874,30756,14882
"18335","Ocbimv22038451m.g","KQ423342",187383,187746,363
"18336","Ocbimv22017142m.g","KQ418454",11503,12614,1111
"18337","Ocbimv22022972m.g","KQ416079",365476,385830,20354
"18338","Ocbimv22035082m.g","KQ422274",72492,94905,22413
"18339","Ocbimv22022625m.g","KQ432932",38081,79337,41256
"18340","Ocbimv22017637m.g","KQ418520",126149,137870,11721
"18341","Ocbimv22024513m.g","LGKD01308140",93,789,696
"18342","Ocbimv22022914m.g","KQ419326",238976,265703,26727
"18343","Ocbimv22039070m.g","KQ423536",250301,250787,486
"18344","Ocbimv22019571m.g","KQ418785",36787,37581,794
"18345","Ocbimv22011024m.g","KQ427597",16754,17155,401
"18346","Ocbimv22022583m.g","KQ416072",196040,196264,224
"18347","Ocbimv22015251m.g","KQ418215",153500,246358,92858
"18348","Ocbimv22032573m.g","KQ421596",73864,74169,305
"18349","Ocbimv22007921m.g","KQ417459",597669,627043,29374
"18350","Ocbimv22019500m.g","KQ416013",77413,77577,164
"18351","Ocbimv22024497m.g","KQ419590",64230,71842,7612
"18352","Ocbimv22033534m.g","KQ421824",679246,679859,613
"18353","Ocbimv22013180m.g","KQ418000",24714,29936,5222
"18354","Ocbimv22032351m.g","KQ421523",1356896,1380573,23677
"18355","Ocbimv22027735m.g","KQ420350",259125,290742,31617
"18356","Ocbimv22031045m.g","KQ421147",30610,33619,3009
"18357","Ocbimv22021393m.g","KQ432116",38277,43359,5082
"18358","Ocbimv22025341m.g","KQ416150",8553,19454,10901
"18359","Ocbimv22034371m.g","KQ422021",98668,150274,51606
"18360","Ocbimv22032759m.g","KQ421655",210603,210827,224
"18361","Ocbimv22005414m.g","KQ417249",2634099,2638323,4224
"18362","Ocbimv22000904m.g","KQ415781",562085,596963,34878
"18363","Ocbimv22005008m.g","KQ415811",1533250,1553499,20249
"18364","Ocbimv22029604m.g","KQ420780",74619,77341,2722
"18365","Ocbimv22013484m.g","KQ415916",212484,253522,41038
"18366","Ocbimv22002998m.g","KQ424859",343101,496053,152952
"18367","Ocbimv22033475m.g","KQ416482",240461,295727,55266
"18368","Ocbimv22038299m.g","KQ416735",21480,33169,11689
"18369","Ocbimv22021060m.g","KQ431974",91742,92131,389
"18370","Ocbimv22029835m.g","KQ420828",1172629,1176530,3901
"18371","Ocbimv22007471m.g","KQ426356",24739,49028,24289
"18372","Ocbimv22013432m.g","KQ418022",309118,315237,6119
"18373","Ocbimv22019224m.g","KQ431061",16293,17206,913
"18374","Ocbimv22034079m.g","KQ421958",212083,227866,15783
"18375","Ocbimv22022822m.g","KQ433034",7962,24988,17026
"18376","Ocbimv22019438m.g","KQ418767",293385,327678,34293
"18377","Ocbimv22015965m.g","KQ429631",244,914,670
"18378","Ocbimv22021195m.g","KQ416040",393685,396444,2759
"18379","Ocbimv22033309m.g","KQ421769",106433,108058,1625
"18380","Ocbimv22013202m.g","KQ415914",362999,363166,167
"18381","Ocbimv22003751m.g","KQ417105",352031,353597,1566
"18382","Ocbimv22026812m.g","KQ420119",21482,51449,29967
"18383","Ocbimv22032980m.g","KQ421706",104759,112325,7566
"18384","Ocbimv22002859m.g","KQ424805",231200,233158,1958
"18385","Ocbimv22010447m.g","KQ427392",189373,201998,12625
"18386","Ocbimv22004582m.g","KQ425371",118855,122034,3179
"18387","Ocbimv22016877m.g","KQ418416",39132,100948,61816
"18388","Ocbimv22023358m.g","KQ419395",199802,207068,7266
"18389","Ocbimv22030145m.g","KQ420909",49224,51508,2284
"18390","Ocbimv22014308m.g","KQ428859",25995,29366,3371
"18391","Ocbimv22006046m.g","KQ425801",5843,6436,593
"18392","Ocbimv22022120m.g","KQ419175",132726,154111,21385
"18393","Ocbimv22020077m.g","KQ418849",259065,259988,923
"18394","Ocbimv22013837m.g","KQ418068",6611,7069,458
"18395","Ocbimv22029010m.g","KQ416279",715549,724305,8756
"18396","Ocbimv22027167m.g","KQ416211",172816,176640,3824
"18397","Ocbimv22016393m.g","KQ429831",92447,119025,26578
"18398","Ocbimv22018403m.g","KQ430684",361905,489688,127783
"18399","Ocbimv22029192m.g","KQ420673",424551,456508,31957
"18400","Ocbimv22011978m.g","KQ417850",75846,76570,724
"18401","Ocbimv22016920m.g","KQ418423",204633,204866,233
"18402","Ocbimv22003819m.g","KQ425121",147876,150729,2853
"18403","Ocbimv22019678m.g","KQ418796",371113,373393,2280
"18404","Ocbimv22013252m.g","KQ428426",71056,79475,8419
"18405","Ocbimv22004332m.g","KQ417149",471379,489986,18607
"18406","Ocbimv22028195m.g","KQ420442",91173,91721,548
"18407","Ocbimv22027348m.g","KQ416222",139160,141086,1926
"18408","Ocbimv22031406m.g","KQ421232",97243,97649,406
"18409","Ocbimv22020729m.g","KQ431815",9397,48506,39109
"18410","Ocbimv22016391m.g","KQ429831",21588,23510,1922
"18411","Ocbimv22026168m.g","KQ420009",108647,183539,74892
"18412","Ocbimv22023931m.g","KQ419500",866675,872473,5798
"18413","Ocbimv22000266m.g","KQ423910",77751,98036,20285
"18414","Ocbimv22023853m.g","KQ416102",67988,68647,659
"18415","Ocbimv22009990m.g","KQ427199",67878,68180,302
"18416","Ocbimv22004501m.g","KQ417173",1078806,1079216,410
"18417","Ocbimv22018097m.g","KQ418571",694652,740176,45524
"18418","Ocbimv22022064m.g","KQ419156",3117,3380,263
"18419","Ocbimv22008527m.g","KQ426665",70058,70297,239
"18420","Ocbimv22025265m.g","KQ419752",25896,26504,608
"18421","Ocbimv22001493m.g","KQ424324",52331,57096,4765
"18422","Ocbimv22017039m.g","KQ418443",119799,149404,29605
"18423","Ocbimv22031172m.g","KQ421192",118450,171025,52575
"18424","Ocbimv22007857m.g","KQ417455",324790,325083,293
"18425","Ocbimv22034840m.g","KQ422190",110347,113306,2959
"18426","Ocbimv22006495m.g","KQ425955",19757,43596,23839
"18427","Ocbimv22032145m.g","KQ421460",199370,203604,4234
"18428","Ocbimv22005114m.g","KQ415813",488950,540231,51281
"18429","Ocbimv22005597m.g","KQ425667",58412,60280,1868
"18430","Ocbimv22012435m.g","KQ417911",704757,705101,344
"18431","Ocbimv22001331m.g","KQ424269",17204,114570,97366
"18432","Ocbimv22010475m.g","KQ417681",352611,352889,278
"18433","Ocbimv22003458m.g","KQ425015",189641,194575,4934
"18434","Ocbimv22011131m.g","KQ427653",31445,46248,14803
"18435","Ocbimv22004836m.g","KQ417209",150761,155908,5147
"18436","Ocbimv22017196m.g","KQ430195",4284,8227,3943
"18437","Ocbimv22014591m.g","KQ428995",260458,264823,4365
"18438","Ocbimv22028568m.g","KQ420524",163823,186468,22645
"18439","Ocbimv22010348m.g","KQ427363",1512,3445,1933
"18440","Ocbimv22023799m.g","KQ419478",25698,113790,88092
"18441","Ocbimv22005089m.g","KQ425518",70201,87635,17434
"18442","Ocbimv22039078m.g","KQ423536",469787,472503,2716
"18443","Ocbimv22023983m.g","KQ419513",228239,229999,1760
"18444","Ocbimv22038857m.g","KQ415768",633676,634101,425
"18445","Ocbimv22009450m.g","KQ426998",23507,37894,14387
"18446","Ocbimv22015124m.g","KQ418196",220367,246896,26529
"18447","Ocbimv22031481m.g","KQ421259",42098,47000,4902
"18448","Ocbimv22038380m.g","KQ416738",431814,432194,380
"18449","Ocbimv22010121m.g","KQ417645",289308,316307,26999
"18450","Ocbimv22017499m.g","KQ430324",53631,53858,227
"18451","Ocbimv22023782m.g","KQ416096",1352871,1359913,7042
"18452","Ocbimv22026887m.g","KQ420136",35439,37868,2429
"18453","Ocbimv22001472m.g","KQ424311",146,304,158
"18454","Ocbimv22016381m.g","KQ415962",1645300,1645476,176
"18455","Ocbimv22030572m.g","KQ421027",39576,39872,296
"18456","Ocbimv22029075m.g","KQ420642",153392,153881,489
"18457","Ocbimv22024197m.g","LGKD01696833",13,1157,1144
"18458","Ocbimv22016901m.g","KQ418420",423691,426372,2681
"18459","Ocbimv22034972m.g","KQ422233",155988,156635,647
"18460","Ocbimv22000463m.g","KQ423971",61435,61683,248
"18461","Ocbimv22038569m.g","KQ423405",96460,96681,221
"18462","Ocbimv22016199m.g","LGKD01625411",17,145,128
"18463","Ocbimv22031112m.g","KQ416385",1449635,1458809,9174
"18464","Ocbimv22014383m.g","KQ418125",45202,46785,1583
"18465","Ocbimv22023403m.g","KQ419401",228772,232882,4110
"18466","Ocbimv22006592m.g","KQ426027",14740,18773,4033
"18467","Ocbimv22027212m.g","KQ420220",95150,97281,2131
"18468","Ocbimv22001824m.g","KQ416966",909253,909573,320
"18469","Ocbimv22015487m.g","KQ429392",46,1723,1677
"18470","Ocbimv22001225m.g","KQ424229",559452,562411,2959
"18471","Ocbimv22002814m.g","KQ417037",938874,939164,290
"18472","Ocbimv22031594m.g","KQ421286",35773,35952,179
"18473","Ocbimv22012494m.g","KQ417917",208505,229732,21227
"18474","Ocbimv22016944m.g","KQ430102",75816,75974,158
"18475","Ocbimv22022883m.g","KQ419318",415095,446777,31682
"18476","Ocbimv22036807m.g","KQ416658",413287,413460,173
"18477","Ocbimv22005903m.g","KQ417284",52935,53453,518
"18478","Ocbimv22030992m.g","KQ416380",490954,492389,1435
"18479","Ocbimv22010177m.g","KQ417653",310240,311604,1364
"18480","Ocbimv22008944m.g","KQ426816",136394,181804,45410
"18481","Ocbimv22000367m.g","KQ423941",192751,211366,18615
"18482","Ocbimv22037534m.g","KQ423058",116683,117253,570
"18483","Ocbimv22004344m.g","KQ425268",145558,145904,346
"18484","Ocbimv22036702m.g","KQ416654",4139,42756,38617
"18485","Ocbimv22014905m.g","KQ418187",254288,273583,19295
"18486","Ocbimv22007041m.g","KQ417371",44115,46436,2321
"18487","Ocbimv22032707m.g","KQ421638",416848,482063,65215
"18488","Ocbimv22003793m.g","KQ417112",926618,926896,278
"18489","Ocbimv22036564m.g","KQ416645",266984,275298,8314
"18490","Ocbimv22036596m.g","KQ422794",540384,542769,2385
"18491","Ocbimv22015580m.g","KQ418267",930218,930658,440
"18492","Ocbimv22011446m.g","KQ427751",27395,30030,2635
"18493","Ocbimv22017849m.g","KQ418552",173446,182241,8795
"18494","Ocbimv22038681m.g","KQ423440",14491,14984,493
"18495","Ocbimv22031666m.g","KQ421308",37373,56194,18821
"18496","Ocbimv22034837m.g","KQ416559",166808,167976,1168
"18497","Ocbimv22035335m.g","KQ416581",17308,23179,5871
"18498","Ocbimv22000915m.g","KQ424114",37553,55905,18352
"18499","Ocbimv22025443m.g","KQ419801",202888,204836,1948
"18500","Ocbimv22009137m.g","KQ415861",137246,144515,7269
"18501","Ocbimv22026493m.g","KQ416189",348373,351691,3318
"18502","Ocbimv22027277m.g","KQ420241",104988,105567,579
"18503","Ocbimv22025748m.g","KQ415694",1087042,1087482,440
"18504","Ocbimv22026599m.g","KQ420078",145924,147310,1386
"18505","Ocbimv22021741m.g","KQ432301",1922,78502,76580
"18506","Ocbimv22002801m.g","KQ417037",285332,287783,2451
"18507","Ocbimv22012136m.g","KQ415902",311370,341241,29871
"18508","Ocbimv22038457m.g","KQ416743",34104,34402,298
"18509","Ocbimv22023250m.g","KQ419380",279696,280031,335
"18510","Ocbimv22028357m.g","KQ420477",283722,284270,548
"18511","Ocbimv22002846m.g","KQ417042",10935,46414,35479
"18512","Ocbimv22022703m.g","KQ416073",193195,194175,980
"18513","Ocbimv22024908m.g","KQ416131",774709,775236,527
"18514","Ocbimv22006086m.g","KQ417294",156575,168775,12200
"18515","Ocbimv22006868m.g","KQ426126",395961,397076,1115
"18516","Ocbimv22029020m.g","KQ420626",651868,689874,38006
"18517","Ocbimv22020198m.g","KQ418873",267961,283036,15075
"18518","Ocbimv22024626m.g","KQ419605",196910,198912,2002
"18519","Ocbimv22025335m.g","KQ419775",255050,263035,7985
"18520","Ocbimv22003119m.g","KQ417060",60615,61436,821
"18521","Ocbimv22000594m.g","KQ424015",254147,290805,36658
"18522","Ocbimv22017149m.g","KQ418456",7815,8632,817
"18523","Ocbimv22011532m.g","KQ417798",415632,431029,15397
"18524","Ocbimv22024891m.g","KQ419649",3783,27422,23639
"18525","Ocbimv22010380m.g","KQ415876",945282,945664,382
"18526","Ocbimv22036967m.g","KQ416666",2275209,2285630,10421
"18527","Ocbimv22016069m.g","KQ418317",849,53150,52301
"18528","Ocbimv22010826m.g","KQ427529",88605,88850,245
"18529","Ocbimv22029163m.g","KQ420672",248802,249264,462
"18530","Ocbimv22003993m.g","KQ425172",37563,40104,2541
"18531","Ocbimv22023692m.g","KQ419460",160426,177948,17522
"18532","Ocbimv22023468m.g","KQ419414",438306,438608,302
"18533","Ocbimv22038698m.g","KQ423444",319754,319963,209
"18534","Ocbimv22026937m.g","KQ416206",80000,80356,356
"18535","Ocbimv22007199m.g","KQ426236",2050,5767,3717
"18536","Ocbimv22038692m.g","KQ423444",225278,229760,4482
"18537","Ocbimv22036642m.g","KQ422818",3693,6077,2384
"18538","Ocbimv22011162m.g","KQ427657",9960,13400,3440
"18539","Ocbimv22005689m.g","KQ417274",824,1117,293
"18540","Ocbimv22024878m.g","KQ419644",383232,422787,39555
"18541","Ocbimv22021692m.g","KQ416051",1253405,1255804,2399
"18542","Ocbimv22008588m.g","KQ417510",377703,390383,12680
"18543","Ocbimv22020893m.g","KQ418974",171235,193346,22111
"18544","Ocbimv22034090m.g","KQ421972",210838,211047,209
"18545","Ocbimv22037184m.g","KQ416681",9592,41196,31604
"18546","Ocbimv22007730m.g","KQ417447",254069,254409,340
"18547","Ocbimv22011312m.g","KQ417780",233471,250916,17445
"18548","Ocbimv22001248m.g","KQ424239",269466,269615,149
"18549","Ocbimv22021203m.g","KQ432038",140394,141186,792
"18550","Ocbimv22032534m.g","KQ421578",251010,251531,521
"18551","Ocbimv22023311m.g","KQ416087",1403054,1403455,401
"18552","Ocbimv22015829m.g","KQ418295",219425,236177,16752
"18553","Ocbimv22006028m.g","KQ425781",65717,133183,67466
"18554","Ocbimv22034800m.g","KQ422177",136831,138533,1702
"18555","Ocbimv22022849m.g","KQ433066",2970,4856,1886
"18556","Ocbimv22037387m.g","KQ416694",1066936,1168153,101217
"18557","Ocbimv22035057m.g","KQ422263",89401,91151,1750
"18558","Ocbimv22025325m.g","KQ419774",39965,58508,18543
"18559","Ocbimv22038040m.g","KQ423207",43513,43698,185
"18560","Ocbimv22004770m.g","KQ417205",30707,166589,135882
"18561","Ocbimv22004622m.g","KQ415807",94878,95675,797
"18562","Ocbimv22014814m.g","KQ429096",351360,351714,354
"18563","Ocbimv22005257m.g","KQ417236",56088,63375,7287
"18564","Ocbimv22014668m.g","KQ418166",278251,278803,552
"18565","Ocbimv22019906m.g","KQ418834",20735,26382,5647
"18566","Ocbimv22028510m.g","KQ420516",161139,162266,1127
"18567","Ocbimv22022648m.g","KQ419277",108405,132372,23967
"18568","Ocbimv22027263m.g","KQ420240",98326,110444,12118
"18569","Ocbimv22016559m.g","KQ418367",611525,655743,44218
"18570","Ocbimv22003566m.g","KQ425032",20188,20518,330
"18571","Ocbimv22022272m.g","KQ419192",293938,296058,2120
"18572","Ocbimv22024978m.g","KQ419670",457179,457901,722
"18573","Ocbimv22018148m.g","KQ418577",172739,173477,738
"18574","Ocbimv22018445m.g","KQ415992",454423,467643,13220
"18575","Ocbimv22037447m.g","KQ416696",130825,130989,164
"18576","Ocbimv22039243m.g","KQ423591",302133,302768,635
"18577","Ocbimv22003946m.g","KQ425157",4725,19359,14634
"18578","Ocbimv22006359m.g","KQ425894",29286,36069,6783
"18579","Ocbimv22020212m.g","KQ418873",489963,600454,110491
"18580","Ocbimv22016737m.g","KQ418390",11399,84223,72824
"18581","Ocbimv22034606m.g","KQ422087",97901,99643,1742
"18582","Ocbimv22016994m.g","KQ418431",909975,933382,23407
"18583","Ocbimv22009376m.g","KQ417588",293098,293268,170
"18584","Ocbimv22014021m.g","KQ418079",296235,354858,58623
"18585","Ocbimv22018953m.g","KQ418702",296541,299290,2749
"18586","Ocbimv22009674m.g","KQ417601",45812,46213,401
"18587","Ocbimv22024672m.g","KQ419607",938440,938997,557
"18588","Ocbimv22039102m.g","KQ416779",406501,406734,233
"18589","Ocbimv22039038m.g","KQ415769",203464,282846,79382
"18590","Ocbimv22020654m.g","KQ418945",983168,983782,614
"18591","Ocbimv22019275m.g","KQ418740",13943,35354,21411
"18592","Ocbimv22002992m.g","KQ424859",151227,158982,7755
"18593","Ocbimv22015243m.g","KQ418214",189013,189613,600
"18594","Ocbimv22012234m.g","KQ417892",163085,164436,1351
"18595","Ocbimv22017413m.g","KQ418493",75726,78245,2519
"18596","Ocbimv22008851m.g","KQ426790",103243,117004,13761
"18597","Ocbimv22038465m.g","KQ423354",132321,132488,167
"18598","Ocbimv22004317m.g","KQ417147",1789362,1789592,230
"18599","Ocbimv22008357m.g","KQ417498",134120,134912,792
"18600","Ocbimv22022007m.g","KQ432511",10361,17514,7153
"18601","Ocbimv22027700m.g","KQ420346",177537,198210,20673
"18602","Ocbimv22008426m.g","KQ417501",177768,178091,323
"18603","Ocbimv22034989m.g","KQ422234",44573,46593,2020
"18604","Ocbimv22033278m.g","KQ421759",568785,569599,814
"18605","Ocbimv22003490m.g","KQ425015",1101261,1101542,281
"18606","Ocbimv22018905m.g","KQ430924",175600,182471,6871
"18607","Ocbimv22036747m.g","KQ422849",110783,120778,9995
"18608","Ocbimv22034615m.g","KQ416540",179545,181055,1510
"18609","Ocbimv22011722m.g","KQ417826",433849,434724,875
"18610","Ocbimv22008409m.g","KQ426634",2831,66585,63754
"18611","Ocbimv22015806m.g","KQ418295",73781,76457,2676
"18612","Ocbimv22036764m.g","KQ416656",35330,36191,861
"18613","Ocbimv22022810m.g","KQ419300",741706,779260,37554
"18614","Ocbimv22032090m.g","KQ421440",25832,27232,1400
"18615","Ocbimv22009777m.g","KQ417613",700783,701178,395
"18616","Ocbimv22007099m.g","KQ426195",27247,33699,6452
"18617","Ocbimv22031202m.g","KQ421200",72649,87611,14962
"18618","Ocbimv22022129m.g","KQ419175",422085,445934,23849
"18619","Ocbimv22025512m.g","KQ419829",58598,62066,3468
"18620","Ocbimv22014115m.g","KQ428763",73787,74941,1154
"18621","Ocbimv22025303m.g","KQ419765",290,640,350
"18622","Ocbimv22013631m.g","KQ418040",196855,197406,551
"18623","Ocbimv22000434m.g","KQ423963",125601,131165,5564
"18624","Ocbimv22008287m.g","KQ426610",170748,182695,11947
"18625","Ocbimv22014075m.g","KQ418087",701199,712013,10814
"18626","Ocbimv22033037m.g","KQ416466",200748,202413,1665
"18627","Ocbimv22016413m.g","KQ415964",45237,62974,17737
"18628","Ocbimv22039676m.g","KQ416813",1093915,1095148,1233
"18629","Ocbimv22032913m.g","KQ421684",56251,57800,1549
"18630","Ocbimv22030300m.g","KQ420942",104915,115981,11066
"18631","Ocbimv22007153m.g","KQ417385",38181,44033,5852
"18632","Ocbimv22028447m.g","KQ420490",53321,53662,341
"18633","Ocbimv22016151m.g","KQ418322",810790,822576,11786
"18634","Ocbimv22005863m.g","KQ417280",304204,307378,3174
"18635","Ocbimv22015349m.g","KQ418225",6244,6798,554
"18636","Ocbimv22031005m.g","KQ421143",480800,481171,371
"18637","Ocbimv22035687m.g","KQ422516",494465,500165,5700
"18638","Ocbimv22023033m.g","KQ419340",188004,188234,230
"18639","Ocbimv22033317m.g","KQ421769",148617,153369,4752
"18640","Ocbimv22024662m.g","KQ419607",693686,707166,13480
"18641","Ocbimv22010928m.g","KQ417725",269826,281665,11839
"18642","Ocbimv22005537m.g","KQ425649",50879,56561,5682
"18643","Ocbimv22022228m.g","KQ419186",228362,232996,4634
"18644","Ocbimv22023291m.g","KQ433324",18172,22953,4781
"18645","Ocbimv22006305m.g","LGKD01544269",3,194,191
"18646","Ocbimv22038369m.g","KQ423295",212805,235422,22617
"18647","Ocbimv22030900m.g","KQ421117",1286705,1289737,3032
"18648","Ocbimv22021954m.g","KQ419138",85650,86311,661
"18649","Ocbimv22010990m.g","KQ417731",269511,287267,17756
"18650","Ocbimv22019246m.g","KQ431067",23633,25627,1994
"18651","Ocbimv22005276m.g","KQ417238",50492,51531,1039
"18652","Ocbimv22039446m.g","KQ423671",8995,29792,20797
"18653","Ocbimv22007502m.g","KQ417417",90183,136863,46680
"18654","Ocbimv22000995m.g","KQ416902",208254,209772,1518
"18655","Ocbimv22018163m.g","KQ418580",878812,879096,284
"18656","Ocbimv22032242m.g","KQ421487",226534,227077,543
"18657","Ocbimv22017617m.g","KQ418513",2507,2743,236
"18658","Ocbimv22025638m.g","KQ419868",291621,291974,353
"18659","Ocbimv22018912m.g","KQ430924",181559,339441,157882
"18660","Ocbimv22030562m.g","KQ421022",206153,226541,20388
"18661","Ocbimv22039561m.g","KQ416802",556187,572840,16653
"18662","Ocbimv22014934m.g","KQ429139",109584,110198,614
"18663","Ocbimv22021085m.g","KQ419000",125635,143678,18043
"18664","Ocbimv22038911m.g","KQ416771",1461291,1467296,6005
"18665","Ocbimv22003829m.g","KQ425128",92383,167913,75530
"18666","Ocbimv22004400m.g","KQ417158",332967,347978,15011
"18667","Ocbimv22035811m.g","KQ416601",630427,631983,1556
"18668","Ocbimv22022984m.g","LGKD01684914",326,784,458
"18669","Ocbimv22000831m.g","KQ424085",203202,204442,1240
"18670","Ocbimv22004255m.g","KQ425245",25144,89566,64422
"18671","Ocbimv22000990m.g","KQ416902",41972,96275,54303
"18672","Ocbimv22024854m.g","KQ419640",183243,185143,1900
"18673","Ocbimv22016460m.g","KQ418359",55697,77581,21884
"18674","Ocbimv22010758m.g","KQ417713",911647,934799,23152
"18675","Ocbimv22028929m.g","KQ416274",2105522,2106022,500
"18676","Ocbimv22032887m.g","KQ421675",406347,412072,5725
"18677","Ocbimv22013304m.g","KQ418009",334029,338037,4008
"18678","Ocbimv22014836m.g","KQ429098",72070,72396,326
"18679","Ocbimv22039182m.g","KQ416784",410003,411712,1709
"18680","Ocbimv22012399m.g","KQ417910",662259,662570,311
"18681","Ocbimv22029483m.g","KQ416308",907786,909214,1428
"18682","Ocbimv22039655m.g","KQ416811",290704,291620,916
"18683","Ocbimv22008241m.g","KQ426602",21048,27402,6354
"18684","Ocbimv22036103m.g","KQ422641",934597,934861,264
"18685","Ocbimv22011514m.g","KQ417796",729975,749770,19795
"18686","Ocbimv22007595m.g","KQ426396",30536,31425,889
"18687","Ocbimv22000224m.g","KQ423900",64938,65758,820
"18688","Ocbimv22021272m.g","KQ416041",175004,176858,1854
"18689","Ocbimv22039733m.g","KQ423737",60868,62247,1379
"18690","Ocbimv22028029m.g","KQ416244",21254,29946,8692
"18691","Ocbimv22016316m.g","KQ418338",289513,310191,20678
"18692","Ocbimv22037729m.g","KQ423122",54174,55271,1097
"18693","Ocbimv22027189m.g","KQ420215",22138,23213,1075
"18694","Ocbimv22028912m.g","KQ416274",1798413,1907609,109196
"18695","Ocbimv22034444m.g","KQ422044",76658,113711,37053
"18696","Ocbimv22029955m.g","KQ420859",272475,273017,542
"18697","Ocbimv22031705m.g","KQ421324",190204,219826,29622
"18698","Ocbimv22021611m.g","KQ432245",129852,130873,1021
"18699","Ocbimv22039258m.g","KQ423598",32439,45511,13072
"18700","Ocbimv22003234m.g","KQ424913",95158,110090,14932
"18701","Ocbimv22021549m.g","KQ432229",6082,11521,5439
"18702","Ocbimv22031019m.g","KQ421144",101242,111263,10021
"18703","Ocbimv22019135m.g","KQ418719",700742,701245,503
"18704","Ocbimv22000139m.g","KQ423868",105615,140411,34796
"18705","Ocbimv22002421m.g","KQ417009",1202935,1206820,3885
"18706","Ocbimv22018483m.g","KQ430708",53867,68262,14395
"18707","Ocbimv22002881m.g","KQ424814",17935,42640,24705
"18708","Ocbimv22028592m.g","KQ416263",36331,36771,440
"18709","Ocbimv22005453m.g","KQ417253",14455,16817,2362
"18710","Ocbimv22011519m.g","KQ417796",799279,814826,15547
"18711","Ocbimv22006909m.g","KQ426140",74362,114771,40409
"18712","Ocbimv22033970m.g","KQ416503",275087,275248,161
"18713","Ocbimv22010923m.g","KQ417725",174202,175065,863
"18714","Ocbimv22002200m.g","KQ416995",182220,187607,5387
"18715","Ocbimv22020979m.g","KQ418988",131664,170510,38846
"18716","Ocbimv22022430m.g","KQ419216",99010,108044,9034
"18717","Ocbimv22005724m.g","KQ425728",252329,257748,5419
"18718","Ocbimv22037571m.g","KQ416702",127166,143584,16418
"18719","Ocbimv22019148m.g","KQ431020",26453,28228,1775
"18720","Ocbimv22012632m.g","KQ417921",1418362,1426337,7975
"18721","Ocbimv22005660m.g","KQ417271",326436,336025,9589
"18722","Ocbimv22025410m.g","KQ419790",109574,134364,24790
"18723","Ocbimv22032179m.g","KQ421469",31050,60820,29770
"18724","Ocbimv22011996m.g","KQ417851",833229,833420,191
"18725","Ocbimv22029348m.g","KQ420714",176895,194823,17928
"18726","Ocbimv22007708m.g","KQ417444",5727,32312,26585
"18727","Ocbimv22028560m.g","KQ416261",433706,440350,6644
"18728","Ocbimv22039087m.g","KQ423544",5025,5363,338
"18729","Ocbimv22001135m.g","KQ424203",85170,86732,1562
"18730","Ocbimv22003795m.g","KQ417112",1080780,1081124,344
"18731","Ocbimv22020026m.g","KQ418843",115360,146672,31312
"18732","Ocbimv22001963m.g","KQ424504",9678,10058,380
"18733","Ocbimv22005969m.g","KQ425765",159727,171555,11828
"18734","Ocbimv22004397m.g","KQ417157",50359,54922,4563
"18735","Ocbimv22033015m.g","KQ421718",236105,238624,2519
"18736","Ocbimv22027371m.g","KQ420267",335377,335640,263
"18737","Ocbimv22027972m.g","KQ420414",236284,236550,266
"18738","Ocbimv22008872m.g","KQ426791",415721,420386,4665
"18739","Ocbimv22008816m.g","KQ426774",248793,253494,4701
"18740","Ocbimv22014679m.g","KQ418168",259353,306407,47054
"18741","Ocbimv22028473m.g","KQ420499",172249,172903,654
"18742","Ocbimv22036286m.g","KQ422695",23401,30459,7058
"18743","Ocbimv22010098m.g","KQ427255",19323,19646,323
"18744","Ocbimv22005734m.g","KQ425732",102994,103890,896
"18745","Ocbimv22017828m.g","KQ430486",47875,73011,25136
"18746","Ocbimv22033791m.g","KQ421871",408853,496609,87756
"18747","Ocbimv22006029m.g","KQ425782",549,66331,65782
"18748","Ocbimv22019234m.g","KQ418737",49619,62017,12398
"18749","Ocbimv22035075m.g","KQ416570",65677,66105,428
"18750","Ocbimv22025859m.g","KQ419916",47287,65366,18079
"18751","Ocbimv22006589m.g","KQ426027",2065,2931,866
"18752","Ocbimv22006918m.g","KQ417362",140744,142259,1515
"18753","Ocbimv22023958m.g","KQ419507",165616,167261,1645
"18754","Ocbimv22007070m.g","KQ417376",82,447,365
"18755","Ocbimv22021209m.g","KQ432038",278985,289007,10022
"18756","Ocbimv22032852m.g","KQ416453",5259,7186,1927
"18757","Ocbimv22004482m.g","KQ425333",141241,141396,155
"18758","Ocbimv22030550m.g","KQ416354",80354,81258,904
"18759","Ocbimv22002489m.g","KQ424671",246563,248152,1589
"18760","Ocbimv22014121m.g","KQ418092",114300,123259,8959
"18761","Ocbimv22004592m.g","KQ417182",233919,257532,23613
"18762","Ocbimv22021986m.g","KQ419141",185372,186708,1336
"18763","Ocbimv22009412m.g","KQ417591",945743,951691,5948
"18764","Ocbimv22025545m.g","KQ416158",28,2986,2958
"18765","Ocbimv22024847m.g","KQ419640",109226,119377,10151
"18766","Ocbimv22002071m.g","KQ424530",1205917,1232433,26516
"18767","Ocbimv22033571m.g","KQ421836",356354,357214,860
"18768","Ocbimv22037751m.g","KQ416708",524151,524696,545
"18769","Ocbimv22011380m.g","KQ417791",535576,541744,6168
"18770","Ocbimv22007653m.g","KQ426410",10561,10797,236
"18771","Ocbimv22014935m.g","KQ429139",137926,145072,7146
"18772","Ocbimv22012549m.g","KQ417917",1025692,1040928,15236
"18773","Ocbimv22000200m.g","KQ416849",15836,16311,475
"18774","Ocbimv22018166m.g","KQ418581",13465,13902,437
"18775","Ocbimv22039853m.g","KQ423780",570119,603302,33183
"18776","Ocbimv22026637m.g","KQ420083",352870,355504,2634
"18777","Ocbimv22032858m.g","KQ416453",185941,186377,436
"18778","Ocbimv22038246m.g","KQ423248",276954,277607,653
"18779","Ocbimv22000963m.g","KQ416899",352938,353252,314
"18780","Ocbimv22019264m.g","KQ418739",357882,542196,184314
"18781","Ocbimv22007475m.g","KQ415843",1207,1934,727
"18782","Ocbimv22025861m.g","KQ419916",54041,54542,501
"18783","Ocbimv22037020m.g","KQ422909",118120,122314,4194
"18784","Ocbimv22002639m.g","KQ417023",1239923,1241376,1453
"18785","Ocbimv22001939m.g","KQ424481",4877,7633,2756
"18786","Ocbimv22039712m.g","KQ416816",20604,24542,3938
"18787","Ocbimv22021001m.g","KQ431922",82676,84891,2215
"18788","Ocbimv22023456m.g","KQ419414",346917,347980,1063
"18789","Ocbimv22002172m.g","KQ416992",171914,237280,65366
"18790","Ocbimv22033000m.g","KQ421712",660108,660560,452
"18791","Ocbimv22000500m.g","KQ415777",225803,379010,153207
"18792","Ocbimv22025714m.g","KQ419887",999890,1019405,19515
"18793","Ocbimv22006440m.g","KQ417319",110135,126538,16403
"18794","Ocbimv22032807m.g","KQ421659",17,322,305
"18795","Ocbimv22033219m.g","KQ421758",140439,148039,7600
"18796","Ocbimv22010244m.g","KQ417660",529190,532057,2867
"18797","Ocbimv22018960m.g","KQ418702",427965,477879,49914
"18798","Ocbimv22006713m.g","KQ426075",545345,546586,1241
"18799","Ocbimv22007173m.g","KQ426221",35875,57060,21185
"18800","Ocbimv22029128m.g","KQ420660",206578,209872,3294
"18801","Ocbimv22016366m.g","KQ415962",711512,713112,1600
"18802","Ocbimv22017523m.g","KQ418504",189894,193839,3945
"18803","Ocbimv22014925m.g","KQ418187",681409,701333,19924
"18804","Ocbimv22026190m.g","KQ420015",188803,189207,404
"18805","Ocbimv22024554m.g","KQ419593",134745,136373,1628
"18806","Ocbimv22010464m.g","KQ427400",19333,47112,27779
"18807","Ocbimv22026682m.g","KQ416196",1112801,1113751,950
"18808","Ocbimv22036549m.g","KQ416644",644860,701373,56513
"18809","Ocbimv22004347m.g","KQ425270",43,27993,27950
"18810","Ocbimv22011573m.g","KQ417806",32453,32602,149
"18811","Ocbimv22025398m.g","KQ419789",38982,39158,176
"18812","Ocbimv22031956m.g","KQ421389",347161,347965,804
"18813","Ocbimv22016188m.g","KQ429735",3,1442,1439
"18814","Ocbimv22037018m.g","KQ422909",78856,81025,2169
"18815","Ocbimv22027015m.g","KQ420162",769902,770084,182
"18816","Ocbimv22021016m.g","KQ431945",993,3184,2191
"18817","Ocbimv22035953m.g","KQ416612",1501276,1619152,117876
"18818","Ocbimv22007366m.g","KQ426313",64173,81957,17784
"18819","Ocbimv22034618m.g","KQ416540",442353,443032,679
"18820","Ocbimv22027932m.g","KQ420404",682120,716175,34055
"18821","Ocbimv22011669m.g","KQ417816",42870,87656,44786
"18822","Ocbimv22013176m.g","KQ428414",4245,4550,305
"18823","Ocbimv22014682m.g","KQ418168",445774,477851,32077
"18824","Ocbimv22004576m.g","KQ425369",9184,10803,1619
"18825","Ocbimv22017411m.g","KQ418493",61625,70788,9163
"18826","Ocbimv22002130m.g","KQ415788",406071,406871,800
"18827","Ocbimv22037072m.g","KQ416671",403993,406909,2916
"18828","Ocbimv22016887m.g","LGKD01631311",1606,2595,989
"18829","Ocbimv22023578m.g","KQ419434",58631,58852,221
"18830","Ocbimv22015736m.g","KQ429530",124262,124642,380
"18831","Ocbimv22033858m.g","KQ421896",232901,233348,447
"18832","Ocbimv22011745m.g","KQ427887",133581,156883,23302
"18833","Ocbimv22020133m.g","KQ418859",162682,166144,3462
"18834","Ocbimv22002061m.g","KQ424530",648724,685086,36362
"18835","Ocbimv22027548m.g","KQ420300",81,1024,943
"18836","Ocbimv22016574m.g","KQ418368",200199,211928,11729
"18837","Ocbimv22020784m.g","KQ418964",968926,980652,11726
"18838","Ocbimv22028012m.g","KQ416243",1649636,1667620,17984
"18839","Ocbimv22034992m.g","KQ416567",19054,26336,7282
"18840","Ocbimv22021586m.g","KQ432245",7973,9019,1046
"18841","Ocbimv22001962m.g","KQ424504",780,2553,1773
"18842","Ocbimv22038260m.g","KQ423251",68776,91141,22365
"18843","Ocbimv22035866m.g","KQ422588",87047,87241,194
"18844","Ocbimv22032355m.g","KQ421523",1426919,1434893,7974
"18845","Ocbimv22028199m.g","KQ420444",51982,59911,7929
"18846","Ocbimv22008577m.g","KQ417510",227758,235033,7275
"18847","Ocbimv22027246m.g","KQ420228",270,494,224
"18848","Ocbimv22029533m.g","KQ420776",8211,19303,11092
"18849","Ocbimv22026546m.g","KQ420071",24650,25232,582
"18850","Ocbimv22023576m.g","LGKD01690022",582,1370,788
"18851","Ocbimv22029717m.g","KQ420813",549066,575575,26509
"18852","Ocbimv22026684m.g","KQ416196",1204254,1206346,2092
"18853","Ocbimv22039952m.g","KQ423809",323,4734,4411
"18854","Ocbimv22037484m.g","KQ416697",524027,525900,1873
"18855","Ocbimv22016918m.g","KQ430081",40174,78742,38568
"18856","Ocbimv22016875m.g","KQ430064",177965,181477,3512
"18857","Ocbimv22012055m.g","KQ417858",5830,6492,662
"18858","Ocbimv22036752m.g","KQ422849",176785,180309,3524
"18859","Ocbimv22006539m.g","KQ425992",253110,256166,3056
"18860","Ocbimv22020663m.g","KQ418948",1890,2338,448
"18861","Ocbimv22025077m.g","KQ416137",263108,265187,2079
"18862","Ocbimv22007923m.g","KQ417459",647348,648244,896
"18863","Ocbimv22030749m.g","KQ421083",429145,462672,33527
"18864","Ocbimv22015600m.g","KQ415946",702100,766905,64805
"18865","Ocbimv22032929m.g","KQ421685",187562,190076,2514
"18866","Ocbimv22035135m.g","KQ416575",141986,143059,1073
"18867","Ocbimv22020730m.g","KQ418957",69037,70218,1181
"18868","Ocbimv22012460m.g","KQ428165",126981,141079,14098
"18869","Ocbimv22003136m.g","KQ417061",239924,240115,191
"18870","Ocbimv22004290m.g","KQ417146",70238,101213,30975
"18871","Ocbimv22027550m.g","KQ420301",40094,41850,1756
"18872","Ocbimv22023760m.g","KQ416096",1125578,1130608,5030
"18873","Ocbimv22008416m.g","LGKD01562528",18,170,152
"18874","Ocbimv22023202m.g","KQ419368",974539,974745,206
"18875","Ocbimv22029987m.g","KQ420872",138305,139156,851
"18876","Ocbimv22024118m.g","KQ419535",594855,595379,524
"18877","Ocbimv22033705m.g","KQ416492",133332,144830,11498
"18878","Ocbimv22007242m.g","KQ426259",91611,123597,31986
"18879","Ocbimv22022856m.g","KQ433074",166103,166874,771
"18880","Ocbimv22036993m.g","KQ422903",5652,6149,497
"18881","Ocbimv22035360m.g","KQ416583",37967,49612,11645
"18882","Ocbimv22034504m.g","KQ422062",460816,491008,30192
"18883","Ocbimv22017270m.g","KQ430232",167796,207252,39456
"18884","Ocbimv22020672m.g","KQ418949",155117,155362,245
"18885","Ocbimv22001360m.g","KQ416925",9085,13121,4036
"18886","Ocbimv22022020m.g","KQ432511",72773,74604,1831
"18887","Ocbimv22001093m.g","KQ424178",21941,22878,937
"18888","Ocbimv22005433m.g","KQ417252",1591,29103,27512
"18889","Ocbimv22002446m.g","KQ424659",121014,124714,3700
"18890","Ocbimv22009409m.g","KQ417591",820408,824407,3999
"18891","Ocbimv22025833m.g","KQ416171",440,16204,15764
"18892","Ocbimv22003552m.g","KQ417090",1765153,1765356,203
"18893","Ocbimv22012809m.g","KQ417942",468288,474162,5874
"18894","Ocbimv22018824m.g","KQ430889",65331,66056,725
"18895","Ocbimv22005248m.g","KQ417234",565834,567192,1358
"18896","Ocbimv22012301m.g","KQ428115",172740,174702,1962
"18897","Ocbimv22004217m.g","KQ425236",38791,39087,296
"18898","Ocbimv22016045m.g","KQ429672",1182,1394,212
"18899","Ocbimv22023084m.g","KQ419345",138912,139263,351
"18900","Ocbimv22021847m.g","KQ415687",1176259,1176589,330
"18901","Ocbimv22001783m.g","KQ424418",22585,23250,665
"18902","Ocbimv22032985m.g","KQ416463",112964,113340,376
"18903","Ocbimv22013830m.g","KQ428687",4099,8730,4631
"18904","Ocbimv22012886m.g","KQ428271",1611,2369,758
"18905","Ocbimv22014806m.g","KQ429093",7062,9910,2848
"18906","Ocbimv22013171m.g","KQ417996",342187,347753,5566
"18907","Ocbimv22032216m.g","KQ421482",130471,133521,3050
"18908","Ocbimv22010474m.g","KQ417681",298134,302840,4706
"18909","Ocbimv22038454m.g","KQ416742",3199,80334,77135
"18910","Ocbimv22010951m.g","KQ417726",367480,367997,517
"18911","Ocbimv22028462m.g","KQ420496",19806,68795,48989
"18912","Ocbimv22024313m.g","LGKD01697716",1,380,379
"18913","Ocbimv22000303m.g","KQ423916",2304,84290,81986
"18914","Ocbimv22032581m.g","KQ421602",12954,13780,826
"18915","Ocbimv22019492m.g","KQ431164",8472,13968,5496
"18916","Ocbimv22021849m.g","KQ415687",1322023,1325978,3955
"18917","Ocbimv22035712m.g","KQ422521",120858,127759,6901
"18918","Ocbimv22008111m.g","KQ426567",214681,218610,3929
"18919","Ocbimv22023436m.g","KQ419409",484653,485069,416
"18920","Ocbimv22030108m.g","KQ420892",111052,119394,8342
"18921","Ocbimv22026949m.g","KQ420146",570874,571386,512
"18922","Ocbimv22019791m.g","KQ431314",52818,81228,28410
"18923","Ocbimv22028574m.g","KQ420524",235609,238461,2852
"18924","Ocbimv22037847m.g","KQ423139",569615,569875,260
"18925","Ocbimv22026246m.g","KQ420021",391964,392749,785
"18926","Ocbimv22019991m.g","KQ418840",1377487,1377885,398
"18927","Ocbimv22035044m.g","KQ415746",79109,104901,25792
"18928","Ocbimv22021257m.g","KQ419020",377670,380850,3180
"18929","Ocbimv22023735m.g","LGKD01692292",4,402,398
"18930","Ocbimv22018640m.g","KQ418649",107207,130609,23402
"18931","Ocbimv22021121m.g","KQ416039",1004925,1005407,482
"18932","Ocbimv22014633m.g","KQ418159",635144,635644,500
"18933","Ocbimv22023657m.g","KQ419456",100449,101256,807
"18934","Ocbimv22032956m.g","KQ421694",133021,138605,5584
"18935","Ocbimv22030135m.g","KQ420903",38800,50161,11361
"18936","Ocbimv22017682m.g","KQ430417",31036,32204,1168
"18937","Ocbimv22002120m.g","KQ415788",5694,7161,1467
"18938","Ocbimv22034882m.g","KQ422206",77363,81127,3764
"18939","Ocbimv22030182m.g","KQ420917",49881,78775,28894
"18940","Ocbimv22009826m.g","KQ417620",341599,350688,9089
"18941","Ocbimv22013693m.g","KQ428612",127779,127919,140
"18942","Ocbimv22026489m.g","KQ416189",156976,231940,74964
"18943","Ocbimv22008189m.g","KQ417482",232449,242960,10511
"18944","Ocbimv22010024m.g","KQ415869",111651,113296,1645
"18945","Ocbimv22007544m.g","KQ426371",215616,242333,26717
"18946","Ocbimv22000786m.g","KQ424065",202988,205131,2143
"18947","Ocbimv22010260m.g","KQ415873",356097,430009,73912
"18948","Ocbimv22034077m.g","KQ416508",1095930,1108794,12864
"18949","Ocbimv22034131m.g","KQ421984",152871,160370,7499
"18950","Ocbimv22038019m.g","KQ416719",738319,783991,45672
"18951","Ocbimv22006716m.g","KQ426076",11239,11439,200
"18952","Ocbimv22008854m.g","KQ426791",229760,230074,314
"18953","Ocbimv22003695m.g","KQ425067",77159,79832,2673
"18954","Ocbimv22010920m.g","KQ417725",102015,117639,15624
"18955","Ocbimv22007289m.g","KQ417398",1091037,1093472,2435
"18956","Ocbimv22003347m.g","KQ424990",14499,14952,453
"18957","Ocbimv22002802m.g","KQ417037",289351,295048,5697
"18958","Ocbimv22000555m.g","KQ423995",356703,380685,23982
"18959","Ocbimv22009015m.g","KQ426843",43305,45991,2686
"18960","Ocbimv22027923m.g","KQ420404",422494,504523,82029
"18961","Ocbimv22009197m.g","KQ417572",231192,231563,371
"18962","Ocbimv22038092m.g","KQ423213",253220,253876,656
"18963","Ocbimv22009957m.g","KQ427182",8419,44411,35992
"18964","Ocbimv22033913m.g","KQ421906",445018,477980,32962
"18965","Ocbimv22000304m.g","KQ423917",61708,83943,22235
"18966","Ocbimv22026386m.g","KQ420035",102343,102555,212
"18967","Ocbimv22023528m.g","KQ419425",458230,459360,1130
"18968","Ocbimv22036444m.g","KQ422765",222070,222365,295
"18969","Ocbimv22004417m.g","KQ415804",290066,320601,30535
"18970","Ocbimv22022954m.g","KQ433154",158893,164619,5726
"18971","Ocbimv22014322m.g","LGKD01608290",23,443,420
"18972","Ocbimv22028890m.g","KQ416274",444132,444435,303
"18973","Ocbimv22006261m.g","KQ417305",582483,585292,2809
"18974","Ocbimv22032971m.g","KQ421702",1048556,1048999,443
"18975","Ocbimv22017169m.g","KQ418459",296475,313035,16560
"18976","Ocbimv22034453m.g","KQ416533",70285,73498,3213
"18977","Ocbimv22037831m.g","KQ423139",294576,360912,66336
"18978","Ocbimv22004651m.g","KQ425409",7137,23022,15885
"18979","Ocbimv22001211m.g","KQ424229",206469,208017,1548
"18980","Ocbimv22020469m.g","KQ418918",865,23989,23124
"18981","Ocbimv22033818m.g","KQ421880",222560,224404,1844
"18982","Ocbimv22023540m.g","LGKD01689792",191,394,203
"18983","Ocbimv22009505m.g","KQ415865",552671,555209,2538
"18984","Ocbimv22035489m.g","KQ422403",62182,63313,1131
"18985","Ocbimv22024422m.g","KQ419577",412315,423549,11234
"18986","Ocbimv22030658m.g","KQ421051",402058,402210,152
"18987","Ocbimv22004790m.g","KQ417206",7904,38347,30443
"18988","Ocbimv22024845m.g","KQ419640",99474,101575,2101
"18989","Ocbimv22008684m.g","KQ426727",286130,326044,39914
"18990","Ocbimv22008862m.g","KQ426791",338736,344934,6198
"18991","Ocbimv22006379m.g","KQ417316",18704,35395,16691
"18992","Ocbimv22033632m.g","KQ421853",383541,383750,209
"18993","Ocbimv22033280m.g","KQ421759",786872,795302,8430
"18994","Ocbimv22007992m.g","KQ417469",33327,55538,22211
"18995","Ocbimv22033351m.g","KQ421794",229,924,695
"18996","Ocbimv22000994m.g","KQ416902",206986,216999,10013
"18997","Ocbimv22005344m.g","KQ425586",12766,12945,179
"18998","Ocbimv22003790m.g","KQ417112",750551,808561,58010
"18999","Ocbimv22029077m.g","KQ420642",161032,161521,489
"19000","Ocbimv22026265m.g","KQ420022",441433,456349,14916
"19001","Ocbimv22002531m.g","KQ424678",106921,107413,492
"19002","Ocbimv22038308m.g","KQ423275",228863,229993,1130
"19003","Ocbimv22032154m.g","KQ421461",15065,22387,7322
"19004","Ocbimv22023085m.g","KQ419345",179879,240066,60187
"19005","Ocbimv22000194m.g","KQ423891",58047,58649,602
"19006","Ocbimv22005856m.g","KQ417280",241814,242380,566
"19007","Ocbimv22030895m.g","KQ421117",717381,728435,11054
"19008","Ocbimv22032487m.g","KQ421555",5847,11486,5639
"19009","Ocbimv22028155m.g","KQ420439",205269,211037,5768
"19010","Ocbimv22022499m.g","KQ419233",165895,166485,590
"19011","Ocbimv22015952m.g","KQ418303",1652652,1688600,35948
"19012","Ocbimv22036617m.g","KQ416650",21085,24119,3034
"19013","Ocbimv22038715m.g","KQ423448",73272,76641,3369
"19014","Ocbimv22017309m.g","KQ415681",1189776,1191902,2126
"19015","Ocbimv22022334m.g","KQ432684",7878,9723,1845
"19016","Ocbimv22023346m.g","KQ419395",119644,128494,8850
"19017","Ocbimv22019133m.g","KQ418719",564132,564976,844
"19018","Ocbimv22003329m.g","KQ417081",89942,91453,1511
"19019","Ocbimv22033411m.g","KQ421805",97300,162436,65136
"19020","Ocbimv22010654m.g","KQ427464",156629,158458,1829
"19021","Ocbimv22012903m.g","KQ428275",2145,38127,35982
"19022","Ocbimv22021666m.g","KQ416049",343022,355916,12894
"19023","Ocbimv22004135m.g","KQ425217",8534,12861,4327
"19024","Ocbimv22016398m.g","LGKD01626960",37,156,119
"19025","Ocbimv22011490m.g","KQ417795",446041,446517,476
"19026","Ocbimv22015799m.g","KQ429582",49159,49548,389
"19027","Ocbimv22023707m.g","KQ419461",45551,45715,164
"19028","Ocbimv22004647m.g","KQ417192",696525,699154,2629
"19029","Ocbimv22035049m.g","KQ422261",1662,44379,42717
"19030","Ocbimv22036203m.g","KQ422675",13841,16187,2346
"19031","Ocbimv22011956m.g","KQ417847",1331163,1351798,20635
"19032","Ocbimv22024054m.g","KQ433771",94912,98018,3106
"19033","Ocbimv22013128m.g","KQ417985",358066,359009,943
"19034","Ocbimv22024185m.g","KQ433849",162,1816,1654
"19035","Ocbimv22010890m.g","KQ417722",483887,484120,233
"19036","Ocbimv22017700m.g","KQ430417",284900,292150,7250
"19037","Ocbimv22012946m.g","KQ428307",108423,108817,394
"19038","Ocbimv22005745m.g","KQ425732",258381,270699,12318
"19039","Ocbimv22021207m.g","KQ432038",208990,253078,44088
"19040","Ocbimv22035525m.g","KQ422418",56128,77725,21597
"19041","Ocbimv22014181m.g","KQ418098",128046,131464,3418
"19042","Ocbimv22027388m.g","KQ420268",630207,701575,71368
"19043","Ocbimv22014841m.g","KQ415935",114005,115304,1299
"19044","Ocbimv22021550m.g","LGKD01278824",19,1197,1178
"19045","Ocbimv22016720m.g","KQ418389",100640,118618,17978
"19046","Ocbimv22032888m.g","KQ421676",64229,65910,1681
"19047","Ocbimv22033246m.g","KQ421758",948954,949384,430
"19048","Ocbimv22022701m.g","KQ416073",95838,96158,320
"19049","Ocbimv22038787m.g","KQ423464",325215,326729,1514
"19050","Ocbimv22009174m.g","KQ415862",522713,564666,41953
"19051","Ocbimv22037544m.g","KQ423058",925292,949142,23850
"19052","Ocbimv22024113m.g","LGKD01695698",3,432,429
"19053","Ocbimv22012993m.g","KQ428333",2740,18632,15892
"19054","Ocbimv22015390m.g","LGKD01617818",27,230,203
"19055","Ocbimv22006467m.g","KQ417324",393532,399056,5524
"19056","Ocbimv22039519m.g","KQ416801",73270,73713,443
"19057","Ocbimv22012617m.g","KQ417921",519575,520919,1344
"19058","Ocbimv22027343m.g","KQ420261",1257470,1262646,5176
"19059","Ocbimv22039775m.g","KQ423746",240466,241979,1513
"19060","Ocbimv22032364m.g","KQ421524",35117,36913,1796
"19061","Ocbimv22022739m.g","KQ416074",584364,596453,12089
"19062","Ocbimv22035762m.g","KQ422530",146583,147519,936
"19063","Ocbimv22018638m.g","KQ418649",35985,90618,54633
"19064","Ocbimv22014871m.g","KQ429123",4084,25723,21639
"19065","Ocbimv22028698m.g","KQ420558",26817,27155,338
"19066","Ocbimv22033261m.g","KQ421758",1670799,1698643,27844
"19067","Ocbimv22032527m.g","KQ421575",79914,90148,10234
"19068","Ocbimv22028096m.g","KQ420429",90119,109145,19026
"19069","Ocbimv22005882m.g","KQ417280",423638,429156,5518
"19070","Ocbimv22015252m.g","KQ418215",246369,247900,1531
"19071","Ocbimv22025622m.g","KQ419861",675317,675661,344
"19072","Ocbimv22004002m.g","KQ417131",2030,3453,1423
"19073","Ocbimv22030968m.g","KQ416379",405192,405455,263
"19074","Ocbimv22011894m.g","KQ415894",31841,39254,7413
"19075","Ocbimv22006668m.g","KQ417342",410175,410863,688
"19076","Ocbimv22032391m.g","KQ421529",254531,255066,535
"19077","Ocbimv22014245m.g","KQ428820",7133,18455,11322
"19078","Ocbimv22000549m.g","KQ423995",192161,193271,1110
"19079","Ocbimv22002844m.g","KQ424801",256458,283216,26758
"19080","Ocbimv22012836m.g","KQ417945",199516,214526,15010
"19081","Ocbimv22010689m.g","KQ415880",172006,172407,401
"19082","Ocbimv22019933m.g","KQ431380",29,11146,11117
"19083","Ocbimv22002592m.g","KQ424712",117554,141192,23638
"19084","Ocbimv22030150m.g","KQ420910",290916,291686,770
"19085","Ocbimv22018431m.g","KQ415992",57750,71316,13566
"19086","Ocbimv22003874m.g","KQ417118",422185,422490,305
"19087","Ocbimv22038229m.g","KQ423235",23078,32329,9251
"19088","Ocbimv22000319m.g","KQ415776",793741,794593,852
"19089","Ocbimv22020230m.g","LGKD01658094",3,374,371
"19090","Ocbimv22006098m.g","KQ417295",297018,297254,236
"19091","Ocbimv22031876m.g","KQ421370",18938,83069,64131
"19092","Ocbimv22020377m.g","LGKD01659638",106,516,410
"19093","Ocbimv22005743m.g","KQ425732",230024,235539,5515
"19094","Ocbimv22033387m.g","KQ416479",553051,602803,49752
"19095","Ocbimv22002417m.g","KQ417009",762956,805496,42540
"19096","Ocbimv22034166m.g","KQ416518",28022,28195,173
"19097","Ocbimv22035214m.g","KQ422314",37238,38694,1456
"19098","Ocbimv22023418m.g","LGKD01688334",14,857,843
"19099","Ocbimv22006559m.g","KQ417336",70778,74140,3362
"19100","Ocbimv22004613m.g","KQ417183",421336,467839,46503
"19101","Ocbimv22006236m.g","KQ417305",66712,89767,23055
"19102","Ocbimv22001692m.g","KQ416955",259748,319820,60072
"19103","Ocbimv22021097m.g","KQ419003",282980,284584,1604
"19104","Ocbimv22038317m.g","KQ423277",81243,82152,909
"19105","Ocbimv22000146m.g","KQ423870",45203,49203,4000
"19106","Ocbimv22037910m.g","KQ416715",532724,536936,4212
"19107","Ocbimv22038067m.g","KQ416724",72550,118350,45800
"19108","Ocbimv22001694m.g","KQ416955",484666,528560,43894
"19109","Ocbimv22005563m.g","KQ425654",147509,151791,4282
"19110","Ocbimv22016867m.g","KQ418413",415275,415569,294
"19111","Ocbimv22011830m.g","KQ415893",1075217,1090847,15630
"19112","Ocbimv22011968m.g","KQ415895",398478,399102,624
"19113","Ocbimv22038772m.g","KQ416765",562938,564550,1612
"19114","Ocbimv22031768m.g","KQ416405",769485,769847,362
"19115","Ocbimv22028962m.g","KQ420618",17587,29504,11917
"19116","Ocbimv22018703m.g","KQ418657",151807,152046,239
"19117","Ocbimv22002132m.g","KQ415788",496199,497387,1188
"19118","Ocbimv22014909m.g","KQ418187",275248,288348,13100
"19119","Ocbimv22014442m.g","KQ428930",11016,11249,233
"19120","Ocbimv22019731m.g","KQ418807",3956,33564,29608
"19121","Ocbimv22028290m.g","KQ420458",128361,128543,182
"19122","Ocbimv22030272m.g","KQ415716",1149089,1149508,419
"19123","Ocbimv22001334m.g","KQ424278",39823,40179,356
"19124","Ocbimv22023851m.g","KQ433676",41006,43199,2193
"19125","Ocbimv22025566m.g","KQ419844",33307,36501,3194
"19126","Ocbimv22013328m.g","KQ418012",272381,276203,3822
"19127","Ocbimv22026570m.g","KQ416193",492234,495656,3422
"19128","Ocbimv22005001m.g","KQ415811",300194,315270,15076
"19129","Ocbimv22025917m.g","KQ419927",57443,57713,270
"19130","Ocbimv22039815m.g","KQ423766",64676,65455,779
"19131","Ocbimv22028485m.g","KQ420502",239174,246307,7133
"19132","Ocbimv22036291m.g","KQ422703",1030,2493,1463
"19133","Ocbimv22033505m.g","KQ421821",472743,497075,24332
"19134","Ocbimv22037306m.g","KQ422999",857,1240,383
"19135","Ocbimv22034996m.g","KQ416567",75375,75882,507
"19136","Ocbimv22033921m.g","KQ421906",599542,617870,18328
"19137","Ocbimv22034805m.g","KQ422178",218527,254595,36068
"19138","Ocbimv22022080m.g","KQ419158",1308109,1309413,1304
"19139","Ocbimv22013806m.g","KQ418061",469262,469468,206
"19140","Ocbimv22018159m.g","KQ418580",585201,586155,954
"19141","Ocbimv22009338m.g","KQ417583",240376,240924,548
"19142","Ocbimv22018344m.g","KQ418609",777293,793348,16055
"19143","Ocbimv22008717m.g","KQ415858",364643,366593,1950
"19144","Ocbimv22009250m.g","KQ417578",523580,523975,395
"19145","Ocbimv22038884m.g","KQ423486",145332,163041,17709
"19146","Ocbimv22013238m.g","KQ418003",136581,137251,670
"19147","Ocbimv22020636m.g","KQ418945",674492,689358,14866
"19148","Ocbimv22038973m.g","KQ423497",1297,12506,11209
"19149","Ocbimv22037558m.g","KQ416701",146518,147641,1123
"19150","Ocbimv22027267m.g","KQ420240",267546,268304,758
"19151","Ocbimv22016116m.g","KQ418320",270762,282482,11720
"19152","Ocbimv22022598m.g","KQ432898",5678,5875,197
"19153","Ocbimv22021183m.g","KQ432030",99,494,395
"19154","Ocbimv22024536m.g","KQ419593",51986,62970,10984
"19155","Ocbimv22013032m.g","KQ428349",194589,204721,10132
"19156","Ocbimv22031845m.g","KQ421357",2093,2421,328
"19157","Ocbimv22038456m.g","KQ416743",32656,33626,970
"19158","Ocbimv22001536m.g","KQ424351",186672,188217,1545
"19159","Ocbimv22022147m.g","KQ419176",186388,186600,212
"19160","Ocbimv22023918m.g","KQ419500",390783,391160,377
"19161","Ocbimv22039347m.g","KQ423628",54324,59762,5438
"19162","Ocbimv22015153m.g","KQ418200",506063,545922,39859
"19163","Ocbimv22031043m.g","KQ421147",6257,6923,666
"19164","Ocbimv22024959m.g","KQ419666",282499,282660,161
"19165","Ocbimv22009542m.g","KQ415865",1081584,1098675,17091
"19166","Ocbimv22001035m.g","KQ424157",655731,658100,2369
"19167","Ocbimv22036073m.g","KQ416616",951563,975259,23696
"19168","Ocbimv22016973m.g","KQ418431",184255,186358,2103
"19169","Ocbimv22025828m.g","KQ419909",364355,367916,3561
"19170","Ocbimv22035601m.g","KQ422458",90407,93640,3233
"19171","Ocbimv22004813m.g","KQ417208",204059,204398,339
"19172","Ocbimv22034237m.g","KQ416526",522643,597951,75308
"19173","Ocbimv22034859m.g","KQ416560",35430,40900,5470
"19174","Ocbimv22009903m.g","KQ417622",547593,550031,2438
"19175","Ocbimv22003079m.g","KQ424877",266080,268554,2474
"19176","Ocbimv22029126m.g","KQ420660",148499,162638,14139
"19177","Ocbimv22011386m.g","KQ417791",710181,727162,16981
"19178","Ocbimv22014604m.g","KQ429000",27642,49143,21501
"19179","Ocbimv22025984m.g","KQ419944",73273,73743,470
"19180","Ocbimv22008620m.g","KQ417510",910192,935457,25265
"19181","Ocbimv22010122m.g","KQ417645",326115,327888,1773
"19182","Ocbimv22033641m.g","KQ421854",256894,257091,197
"19183","Ocbimv22007665m.g","KQ426417",5551,9169,3618
"19184","Ocbimv22016251m.g","KQ418333",25829,27379,1550
"19185","Ocbimv22020825m.g","KQ418970",1144718,1154807,10089
"19186","Ocbimv22030817m.g","KQ416371",8983,9132,149
"19187","Ocbimv22022341m.g","KQ416065",14944,15213,269
"19188","Ocbimv22020653m.g","KQ418945",964924,974678,9754
"19189","Ocbimv22035535m.g","KQ422423",97271,97894,623
"19190","Ocbimv22009809m.g","KQ427141",124,357,233
"19191","Ocbimv22015710m.g","LGKD01620971",69,260,191
"19192","Ocbimv22034280m.g","KQ422015",762694,770092,7398
"19193","Ocbimv22034168m.g","KQ416518",127024,127278,254
"19194","Ocbimv22035238m.g","KQ422338",255830,270800,14970
"19195","Ocbimv22022998m.g","KQ419337",109276,113120,3844
"19196","Ocbimv22003976m.g","KQ425163",82987,85492,2505
"19197","Ocbimv22024256m.g","LGKD01697188",7,341,334
"19198","Ocbimv22023848m.g","KQ433674",20457,21816,1359
"19199","Ocbimv22034813m.g","KQ422179",107892,166296,58404
"19200","Ocbimv22005144m.g","KQ417230",116932,117246,314
"19201","Ocbimv22029411m.g","KQ416305",3418,3654,236
"19202","Ocbimv22022829m.g","KQ419305",148675,148869,194
"19203","Ocbimv22029858m.g","KQ420828",1768978,1796168,27190
"19204","Ocbimv22038207m.g","KQ416731",577273,588578,11305
"19205","Ocbimv22027053m.g","KQ420169",1177516,1177794,278
"19206","Ocbimv22036241m.g","KQ416627",71272,109841,38569
"19207","Ocbimv22031348m.g","KQ421220",92563,92847,284
"19208","Ocbimv22004032m.g","KQ425190",40428,43571,3143
"19209","Ocbimv22018327m.g","LGKD01642525",36,912,876
"19210","Ocbimv22013680m.g","KQ418045",146279,148785,2506
"19211","Ocbimv22027637m.g","KQ415703",222148,248473,26325
"19212","Ocbimv22028208m.g","KQ420444",292410,296839,4429
"19213","Ocbimv22002549m.g","KQ424684",4414,37978,33564
"19214","Ocbimv22021327m.g","KQ419030",60909,62380,1471
"19215","Ocbimv22016783m.g","KQ415970",265839,266012,173
"19216","Ocbimv22009589m.g","KQ427033",58685,86215,27530
"19217","Ocbimv22030185m.g","KQ420917",232588,266761,34173
"19218","Ocbimv22026481m.g","KQ420055",677604,678493,889
"19219","Ocbimv22035315m.g","KQ422351",548178,585024,36846
"19220","Ocbimv22011267m.g","KQ417771",1290051,1304491,14440
"19221","Ocbimv22035041m.g","KQ415746",25950,27124,1174
"19222","Ocbimv22012154m.g","KQ417877",1029697,1042960,13263
"19223","Ocbimv22024757m.g","KQ419623",133856,134758,902
"19224","Ocbimv22035581m.g","KQ422446",34951,45902,10951
"19225","Ocbimv22024545m.g","KQ419593",91804,105332,13528
"19226","Ocbimv22024699m.g","KQ419616",247943,261464,13521
"19227","Ocbimv22032907m.g","KQ421682",61625,85316,23691
"19228","Ocbimv22034866m.g","KQ416560",84399,104147,19748
"19229","Ocbimv22022832m.g","KQ419306",155,3109,2954
"19230","Ocbimv22004339m.g","KQ425267",27054,48472,21418
"19231","Ocbimv22039284m.g","KQ423602",4176,46282,42106
"19232","Ocbimv22027489m.g","KQ415702",35863,49747,13884
"19233","Ocbimv22018716m.g","KQ418660",42318,73417,31099
"19234","Ocbimv22007406m.g","KQ417412",50714,67427,16713
"19235","Ocbimv22009330m.g","KQ426953",64868,65545,677
"19236","Ocbimv22031605m.g","KQ416402",291,1494,1203
"19237","Ocbimv22039956m.g","KQ423809",40631,41086,455
"19238","Ocbimv22008462m.g","KQ415854",434720,445512,10792
"19239","Ocbimv22013596m.g","KQ418038",641573,676991,35418
"19240","Ocbimv22010691m.g","KQ415880",328041,328599,558
"19241","Ocbimv22022380m.g","KQ419212",338690,340112,1422
"19242","Ocbimv22038828m.g","KQ423478",444495,445117,622
"19243","Ocbimv22013687m.g","KQ428611",29221,74961,45740
"19244","Ocbimv22013968m.g","KQ428715",106216,107885,1669
"19245","Ocbimv22006885m.g","KQ426134",424,28164,27740
"19246","Ocbimv22022995m.g","KQ419337",945,25472,24527
"19247","Ocbimv22039508m.g","KQ423680",203156,211312,8156
"19248","Ocbimv22023042m.g","KQ433194",5251,59082,53831
"19249","Ocbimv22001263m.g","KQ424244",261791,304505,42714
"19250","Ocbimv22035448m.g","KQ422385",102273,167616,65343
"19251","Ocbimv22022137m.g","KQ419175",541844,548410,6566
"19252","Ocbimv22020776m.g","KQ418964",183585,184709,1124
"19253","Ocbimv22020358m.g","KQ418900",235010,241614,6604
"19254","Ocbimv22009587m.g","KQ427030",46521,64151,17630
"19255","Ocbimv22022162m.g","KQ419180",257988,259249,1261
"19256","Ocbimv22020810m.g","KQ418970",95175,152837,57662
"19257","Ocbimv22027570m.g","KQ420308",29863,36607,6744
"19258","Ocbimv22022165m.g","KQ419180",265013,303828,38815
"19259","Ocbimv22036394m.g","KQ422744",987,8162,7175
"19260","Ocbimv22029503m.g","KQ416311",66608,91356,24748
"19261","Ocbimv22037250m.g","KQ422977",188224,224394,36170
"19262","Ocbimv22018712m.g","KQ415997",7096,9310,2214
"19263","Ocbimv22032450m.g","KQ421547",11713,13758,2045
"19264","Ocbimv22021799m.g","KQ419103",576664,577154,490
"19265","Ocbimv22026151m.g","KQ420004",238103,239376,1273
"19266","Ocbimv22039015m.g","KQ423507",50668,90413,39745
"19267","Ocbimv22014642m.g","KQ418160",689508,692794,3286
"19268","Ocbimv22010872m.g","KQ417721",1037516,1037725,209
"19269","Ocbimv22038963m.g","KQ423494",18707,64270,45563
"19270","Ocbimv22015289m.g","LGKD01616575",100,453,353
"19271","Ocbimv22021848m.g","KQ415687",1184453,1218340,33887
"19272","Ocbimv22030346m.g","KQ420958",432696,466425,33729
"19273","Ocbimv22033082m.g","KQ421724",437666,438990,1324
"19274","Ocbimv22024996m.g","KQ419674",119061,120344,1283
"19275","Ocbimv22026809m.g","KQ416203",1312060,1312407,347
"19276","Ocbimv22008321m.g","KQ417497",227682,238675,10993
"19277","Ocbimv22027781m.g","KQ420370",198525,198818,293
"19278","Ocbimv22039130m.g","KQ423547",10844,11626,782
"19279","Ocbimv22031577m.g","KQ416401",33198,39029,5831
"19280","Ocbimv22029727m.g","KQ420813",701817,739326,37509
"19281","Ocbimv22019858m.g","KQ418823",12171,13436,1265
"19282","Ocbimv22037684m.g","KQ423101",5128,8907,3779
"19283","Ocbimv22009333m.g","KQ426953",132099,132848,749
"19284","Ocbimv22037604m.g","KQ423077",694247,698514,4267
"19285","Ocbimv22010089m.g","KQ417641",291096,303858,12762
"19286","Ocbimv22022447m.g","KQ419216",407299,409132,1833
"19287","Ocbimv22020003m.g","KQ418840",1971593,1972039,446
"19288","Ocbimv22004930m.g","KQ425475",53761,54282,521
"19289","Ocbimv22034923m.g","KQ415742",537907,539841,1934
"19290","Ocbimv22011989m.g","KQ417851",418838,461297,42459
"19291","Ocbimv22003068m.g","KQ424877",117642,117960,318
"19292","Ocbimv22036442m.g","KQ422765",106373,186985,80612
"19293","Ocbimv22039386m.g","KQ423638",123500,131447,7947
"19294","Ocbimv22007788m.g","KQ426456",280694,310230,29536
"19295","Ocbimv22022222m.g","KQ416062",250470,250634,164
"19296","Ocbimv22022539m.g","KQ419243",75042,159121,84079
"19297","Ocbimv22030741m.g","KQ416368",722151,723901,1750
"19298","Ocbimv22021894m.g","KQ419123",113270,113692,422
"19299","Ocbimv22033786m.g","KQ421871",371759,387945,16186
"19300","Ocbimv22016138m.g","KQ418322",195748,230340,34592
"19301","Ocbimv22038622m.g","KQ423422",393636,393818,182
"19302","Ocbimv22012846m.g","KQ417945",597352,608267,10915
"19303","Ocbimv22009713m.g","KQ427096",142707,145336,2629
"19304","Ocbimv22016580m.g","KQ418368",319261,336046,16785
"19305","Ocbimv22033566m.g","KQ415731",2915,16958,14043
"19306","Ocbimv22013403m.g","KQ428492",286,32039,31753
"19307","Ocbimv22038154m.g","KQ415763",261940,262381,441
"19308","Ocbimv22025632m.g","KQ416162",20668,64283,43615
"19309","Ocbimv22034292m.g","KQ422015",974819,982166,7347
"19310","Ocbimv22023904m.g","KQ419497",126780,128239,1459
"19311","Ocbimv22006518m.g","KQ425980",8944,10143,1199
"19312","Ocbimv22010224m.g","KQ417658",5426,5749,323
"19313","Ocbimv22026718m.g","KQ420101",46240,46764,524
"19314","Ocbimv22032249m.g","KQ421502",11432,74340,62908
"19315","Ocbimv22008745m.g","KQ426757",1314,1911,597
"19316","Ocbimv22037373m.g","KQ416694",180400,186424,6024
"19317","Ocbimv22014630m.g","KQ418159",161548,162977,1429
"19318","Ocbimv22033932m.g","KQ416499",204119,216851,12732
"19319","Ocbimv22019312m.g","KQ418747",727321,737966,10645
"19320","Ocbimv22033810m.g","KQ421878",290565,291020,455
"19321","Ocbimv22008349m.g","KQ417497",1994583,1994903,320
"19322","Ocbimv22026233m.g","KQ420017",926968,936558,9590
"19323","Ocbimv22008855m.g","KQ426791",235772,237780,2008
"19324","Ocbimv22022573m.g","KQ432875",19760,20429,669
"19325","Ocbimv22033655m.g","KQ421858",180954,182560,1606
"19326","Ocbimv22039046m.g","KQ423520",97155,97406,251
"19327","Ocbimv22021341m.g","KQ432088",9090,29842,20752
"19328","Ocbimv22028308m.g","KQ420468",66645,78400,11755
"19329","Ocbimv22007795m.g","KQ426456",598548,600973,2425
"19330","Ocbimv22007606m.g","KQ426400",7125,7304,179
"19331","Ocbimv22008834m.g","KQ417537",62932,63265,333
"19332","Ocbimv22025796m.g","KQ419905",179400,228015,48615
"19333","Ocbimv22000302m.g","KQ415775",718837,732559,13722
"19334","Ocbimv22027216m.g","KQ420220",185728,186745,1017
"19335","Ocbimv22013531m.g","KQ428553",645,1016,371
"19336","Ocbimv22014729m.g","KQ418171",75484,77625,2141
"19337","Ocbimv22009611m.g","LGKD01572066",115,420,305
"19338","Ocbimv22036258m.g","KQ416628",10751,16537,5786
"19339","Ocbimv22031541m.g","KQ421273",3374,28420,25046
"19340","Ocbimv22007374m.g","KQ426313",367811,447522,79711
"19341","Ocbimv22019465m.g","KQ431144",5036,7408,2372
"19342","Ocbimv22029832m.g","KQ420828",1119374,1167551,48177
"19343","Ocbimv22018356m.g","KQ418610",95763,96330,567
"19344","Ocbimv22028284m.g","KQ420458",53281,56272,2991
"19345","Ocbimv22028838m.g","KQ420591",153986,181218,27232
"19346","Ocbimv22025556m.g","KQ419838",130369,131810,1441
"19347","Ocbimv22015414m.g","KQ429326",236373,280673,44300
"19348","Ocbimv22014610m.g","KQ429009",655,1439,784
"19349","Ocbimv22035461m.g","KQ422391",51007,51729,722
"19350","Ocbimv22013219m.g","KQ418002",347973,351592,3619
"19351","Ocbimv22003132m.g","LGKD01518858",35,226,191
"19352","Ocbimv22032911m.g","KQ421684",32472,41634,9162
"19353","Ocbimv22036863m.g","KQ416662",897893,926324,28431
"19354","Ocbimv22008483m.g","KQ426645",27662,27817,155
"19355","Ocbimv22002001m.g","KQ416979",1486130,1487752,1622
"19356","Ocbimv22017462m.g","KQ418498",336675,364559,27884
"19357","Ocbimv22021328m.g","KQ419031",37649,100195,62546
"19358","Ocbimv22022649m.g","KQ419277",141284,146894,5610
"19359","Ocbimv22026765m.g","KQ420112",77459,77628,169
"19360","Ocbimv22005125m.g","KQ415813",727437,728363,926
"19361","Ocbimv22017313m.g","KQ415681",1734106,1739281,5175
"19362","Ocbimv22035122m.g","KQ422284",80553,80765,212
"19363","Ocbimv22005036m.g","KQ417225",33330,53643,20313
"19364","Ocbimv22029847m.g","KQ420828",1434828,1437048,2220
"19365","Ocbimv22003897m.g","KQ425137",362754,363228,474
"19366","Ocbimv22008236m.g","KQ417490",212912,213076,164
"19367","Ocbimv22029812m.g","KQ420828",498510,498755,245
"19368","Ocbimv22021330m.g","KQ419031",250234,250437,203
"19369","Ocbimv22003744m.g","KQ417105",248332,328432,80100
"19370","Ocbimv22008769m.g","KQ426766",1689,1838,149
"19371","Ocbimv22038711m.g","KQ423448",5981,6151,170
"19372","Ocbimv22027405m.g","KQ416223",791164,791391,227
"19373","Ocbimv22025579m.g","KQ419849",204458,205147,689
"19374","Ocbimv22003273m.g","KQ424932",376719,397622,20903
"19375","Ocbimv22032586m.g","KQ421602",154016,162139,8123
"19376","Ocbimv22025568m.g","KQ419844",69668,85876,16208
"19377","Ocbimv22021953m.g","LGKD01673025",397,609,212
"19378","Ocbimv22038448m.g","KQ423342",128171,159718,31547
"19379","Ocbimv22028953m.g","KQ420607",321167,321343,176
"19380","Ocbimv22001859m.g","KQ416971",320371,320831,460
"19381","Ocbimv22032770m.g","KQ421656",39708,40973,1265
"19382","Ocbimv22020091m.g","KQ431445",88304,91683,3379
"19383","Ocbimv22026584m.g","KQ420075",186903,189364,2461
"19384","Ocbimv22031364m.g","KQ421221",744974,745264,290
"19385","Ocbimv22027569m.g","KQ420308",23952,29407,5455
"19386","Ocbimv22009237m.g","KQ426942",12461,13210,749
"19387","Ocbimv22021179m.g","KQ415686",749522,755873,6351
"19388","Ocbimv22023128m.g","KQ419353",387572,389797,2225
"19389","Ocbimv22003383m.g","KQ424999",316540,359896,43356
"19390","Ocbimv22024725m.g","KQ419621",992777,992956,179
"19391","Ocbimv22027509m.g","KQ420294",306644,306829,185
"19392","Ocbimv22007389m.g","KQ426315",243574,275694,32120
"19393","Ocbimv22027011m.g","KQ420162",613355,656505,43150
"19394","Ocbimv22031064m.g","KQ416383",72973,204845,131872
"19395","Ocbimv22029138m.g","KQ420662",677441,685579,8138
"19396","Ocbimv22010144m.g","KQ427275",748328,748537,209
"19397","Ocbimv22002049m.g","KQ424530",174681,179090,4409
"19398","Ocbimv22015583m.g","KQ429429",68013,68162,149
"19399","Ocbimv22010255m.g","KQ415873",248177,248722,545
"19400","Ocbimv22001975m.g","KQ415787",175396,176074,678
"19401","Ocbimv22029371m.g","KQ420731",77259,77462,203
"19402","Ocbimv22016256m.g","KQ418333",188499,190326,1827
"19403","Ocbimv22008452m.g","KQ415854",174400,177082,2682
"19404","Ocbimv22009366m.g","KQ417587",377578,377779,201
"19405","Ocbimv22024610m.g","KQ419601",1571790,1600990,29200
"19406","Ocbimv22015133m.g","KQ418196",580826,581196,370
"19407","Ocbimv22028098m.g","KQ420429",122936,128965,6029
"19408","Ocbimv22035120m.g","KQ422284",40854,74576,33722
"19409","Ocbimv22010437m.g","KQ427386",9685,11234,1549
"19410","Ocbimv22039531m.g","KQ423695",20203,21035,832
"19411","Ocbimv22022857m.g","KQ419312",110957,111130,173
"19412","Ocbimv22006336m.g","KQ425878",98763,159470,60707
"19413","Ocbimv22020675m.g","KQ418949",294931,316244,21313
"19414","Ocbimv22011372m.g","KQ417791",220686,221135,449
"19415","Ocbimv22034542m.g","KQ416536",327396,328889,1493
"19416","Ocbimv22039858m.g","KQ423780",883527,885109,1582
"19417","Ocbimv22039607m.g","KQ423717",65535,75574,10039
"19418","Ocbimv22006830m.g","KQ417358",55231,62206,6975
"19419","Ocbimv22014447m.g","KQ418137",183086,183496,410
"19420","Ocbimv22030927m.g","KQ421118",47388,141210,93822
"19421","Ocbimv22033821m.g","KQ421886",1466,1786,320
"19422","Ocbimv22032446m.g","KQ416431",168733,169758,1025
"19423","Ocbimv22026801m.g","KQ420118",30987,33590,2603
"19424","Ocbimv22038487m.g","KQ423370",17266,17475,209
"19425","Ocbimv22033535m.g","KQ421824",716165,736325,20160
"19426","Ocbimv22036075m.g","KQ416616",977736,1050544,72808
"19427","Ocbimv22034692m.g","KQ416547",78780,78971,191
"19428","Ocbimv22011848m.g","KQ427922",2747,46493,43746
"19429","Ocbimv22008638m.g","KQ417515",101215,101373,158
"19430","Ocbimv22036679m.g","KQ415756",35735,39280,3545
"19431","Ocbimv22009311m.g","KQ417582",270555,270728,173
"19432","Ocbimv22025486m.g","KQ419818",265239,268886,3647
"19433","Ocbimv22027562m.g","KQ420305",89046,89765,719
"19434","Ocbimv22002152m.g","KQ416990",49337,49799,462
"19435","Ocbimv22022112m.g","KQ432594",1469,2134,665
"19436","Ocbimv22036151m.g","KQ422659",153447,153995,548
"19437","Ocbimv22019644m.g","KQ418789",605991,609744,3753
"19438","Ocbimv22021661m.g","KQ416049",244403,257975,13572
"19439","Ocbimv22016121m.g","KQ418320",493027,494334,1307
"19440","Ocbimv22001773m.g","KQ416962",120426,124038,3612
"19441","Ocbimv22015317m.g","KQ418220",21812,29985,8173
"19442","Ocbimv22016311m.g","KQ418338",252062,265880,13818
"19443","Ocbimv22021618m.g","KQ419081",2194,8051,5857
"19444","Ocbimv22038510m.g","KQ423384",16393,22197,5804
"19445","Ocbimv22028156m.g","KQ420439",215729,217480,1751
"19446","Ocbimv22027723m.g","KQ420347",377148,379575,2427
"19447","Ocbimv22013903m.g","KQ428707",293121,293576,455
"19448","Ocbimv22009852m.g","KQ417620",1039866,1040261,395
"19449","Ocbimv22007134m.g","KQ417381",177775,183124,5349
"19450","Ocbimv22033451m.g","KQ421816",627708,632565,4857
"19451","Ocbimv22004097m.g","KQ425202",189,40965,40776
"19452","Ocbimv22010526m.g","KQ417687",695715,696014,299
"19453","Ocbimv22020853m.g","KQ418970",2382425,2392714,10289
"19454","Ocbimv22027439m.g","KQ420277",124682,125152,470
"19455","Ocbimv22017378m.g","KQ418487",72294,72473,179
"19456","Ocbimv22003129m.g","KQ424891",93444,93860,416
"19457","Ocbimv22003287m.g","KQ417076",145166,146702,1536
"19458","Ocbimv22018328m.g","LGKD01642547",32,199,167
"19459","Ocbimv22033901m.g","KQ421906",71733,104974,33241
"19460","Ocbimv22002332m.g","KQ424629",268680,300615,31935
"19461","Ocbimv22029785m.g","KQ420822",1243,4210,2967
"19462","Ocbimv22014555m.g","KQ418152",782484,809665,27181
"19463","Ocbimv22036465m.g","KQ422771",127247,131637,4390
"19464","Ocbimv22039429m.g","KQ423655",410304,410870,566
"19465","Ocbimv22039934m.g","KQ423798",153123,153384,261
"19466","Ocbimv22034211m.g","KQ422009",160050,160205,155
"19467","Ocbimv22015467m.g","KQ429368",6299,50097,43798
"19468","Ocbimv22016922m.g","KQ418423",287310,287537,227
"19469","Ocbimv22009554m.g","KQ415865",1753944,1776190,22246
"19470","Ocbimv22023558m.g","KQ419432",118048,120192,2144
"19471","Ocbimv22024527m.g","KQ434034",62749,70269,7520
"19472","Ocbimv22009716m.g","KQ427096",184196,194468,10272
"19473","Ocbimv22021584m.g","KQ432245",1,5112,5111
"19474","Ocbimv22031704m.g","KQ421324",176368,176671,303
"19475","Ocbimv22014917m.g","KQ418187",429703,430318,615
"19476","Ocbimv22024657m.g","KQ419607",471708,472270,562
"19477","Ocbimv22019718m.g","KQ418804",912651,913645,994
"19478","Ocbimv22034339m.g","KQ422016",237168,246934,9766
"19479","Ocbimv22036783m.g","KQ416657",19048,87132,68084
"19480","Ocbimv22014928m.g","KQ418187",708656,747895,39239
"19481","Ocbimv22028552m.g","KQ416260",1121854,1122216,362
"19482","Ocbimv22004323m.g","KQ425263",198662,207340,8678
"19483","Ocbimv22003921m.g","KQ417125",149037,158044,9007
"19484","Ocbimv22010530m.g","KQ417687",1250624,1251304,680
"19485","Ocbimv22034599m.g","KQ422084",303958,329446,25488
"19486","Ocbimv22022401m.g","KQ419215",329895,358578,28683
"19487","Ocbimv22022859m.g","KQ419312",833327,833620,293
"19488","Ocbimv22037647m.g","KQ416705",239682,240005,323
"19489","Ocbimv22003714m.g","KQ425069",4274,46273,41999
"19490","Ocbimv22019937m.g","KQ418838",25249,45662,20413
"19491","Ocbimv22029747m.g","KQ415712",426492,426716,224
"19492","Ocbimv22018069m.g","KQ418562",325000,325657,657
"19493","Ocbimv22003809m.g","KQ417113",97929,98531,602
"19494","Ocbimv22003304m.g","KQ417078",117902,118162,260
"19495","Ocbimv22030819m.g","KQ416371",504535,505887,1352
"19496","Ocbimv22028721m.g","KQ416270",479009,479693,684
"19497","Ocbimv22002342m.g","KQ415791",429099,442323,13224
"19498","Ocbimv22010018m.g","KQ427207",44537,51755,7218
"19499","Ocbimv22037669m.g","KQ416705",2421645,2422295,650
"19500","Ocbimv22001309m.g","KQ424264",330139,335068,4929
"19501","Ocbimv22010123m.g","KQ417645",330943,341686,10743
"19502","Ocbimv22002065m.g","KQ424530",771792,774304,2512
"19503","Ocbimv22016515m.g","KQ429907",2041,2722,681
"19504","Ocbimv22015936m.g","KQ418303",1252918,1257511,4593
"19505","Ocbimv22031104m.g","KQ416385",254529,254807,278
"19506","Ocbimv22027445m.g","KQ420279",134177,134665,488
"19507","Ocbimv22002348m.g","KQ424640",35295,35705,410
"19508","Ocbimv22035921m.g","KQ422606",84575,94284,9709
"19509","Ocbimv22037026m.g","KQ422909",314330,327031,12701
"19510","Ocbimv22004996m.g","KQ415811",174497,193144,18647
"19511","Ocbimv22012006m.g","KQ415896",212986,215694,2708
"19512","Ocbimv22002278m.g","KQ424614",40449,41092,643
"19513","Ocbimv22009212m.g","KQ417574",1989327,1989482,155
"19514","Ocbimv22018602m.g","KQ418644",817650,832491,14841
"19515","Ocbimv22009602m.g","KQ427052",29536,30859,1323
"19516","Ocbimv22031885m.g","KQ421372",226977,376409,149432
"19517","Ocbimv22011219m.g","KQ417763",266366,291563,25197
"19518","Ocbimv22032297m.g","KQ421516",70720,71083,363
"19519","Ocbimv22008814m.g","KQ426774",236861,241988,5127
"19520","Ocbimv22026556m.g","KQ416192",390127,391671,1544
"19521","Ocbimv22016318m.g","KQ418338",336483,367826,31343
"19522","Ocbimv22006521m.g","KQ425980",82225,83244,1019
"19523","Ocbimv22001454m.g","KQ416933",730044,759559,29515
"19524","Ocbimv22027315m.g","KQ420256",26866,55019,28153
"19525","Ocbimv22012314m.g","KQ415907",179614,182881,3267
"19526","Ocbimv22021445m.g","KQ419049",257868,310902,53034
"19527","Ocbimv22009170m.g","KQ415862",100583,100789,206
"19528","Ocbimv22037444m.g","LGKD01460642",3,287,284
"19529","Ocbimv22014437m.g","KQ418134",177698,183091,5393
"19530","Ocbimv22036827m.g","KQ422866",135392,157504,22112
"19531","Ocbimv22030320m.g","KQ420948",788,3589,2801
"19532","Ocbimv22000677m.g","KQ424055",115747,116153,406
"19533","Ocbimv22025728m.g","KQ419891",109078,110177,1099
"19534","Ocbimv22016992m.g","KQ418431",891566,904591,13025
"19535","Ocbimv22003113m.g","KQ417059",43990,55654,11664
"19536","Ocbimv22031205m.g","KQ421200",134800,149659,14859
"19537","Ocbimv22001943m.g","LGKD01507162",1052,1569,517
"19538","Ocbimv22023243m.g","LGKD01686867",771,1037,266
"19539","Ocbimv22011903m.g","KQ427949",28560,40333,11773
"19540","Ocbimv22019707m.g","KQ418804",403328,403537,209
"19541","Ocbimv22006099m.g","KQ425817",435,1404,969
"19542","Ocbimv22009705m.g","KQ427095",90543,95817,5274
"19543","Ocbimv22036824m.g","KQ416660",141104,153388,12284
"19544","Ocbimv22024299m.g","KQ419563",109697,111567,1870
"19545","Ocbimv22036467m.g","KQ422771",164698,166452,1754
"19546","Ocbimv22035683m.g","KQ422516",437337,450342,13005
"19547","Ocbimv22004369m.g","KQ415803",392155,392442,287
"19548","Ocbimv22035869m.g","KQ416607",94081,95806,1725
"19549","Ocbimv22039142m.g","KQ423549",8349,13645,5296
"19550","Ocbimv22000247m.g","KQ423905",122823,161972,39149
"19551","Ocbimv22037012m.g","LGKD01100198",7,210,203
"19552","Ocbimv22018175m.g","KQ430594",20640,79466,58826
"19553","Ocbimv22039025m.g","KQ423514",6789,6944,155
"19554","Ocbimv22011685m.g","KQ417819",66210,67781,1571
"19555","Ocbimv22021989m.g","KQ419141",207345,214375,7030
"19556","Ocbimv22029776m.g","KQ420820",984291,1003967,19676
"19557","Ocbimv22030548m.g","KQ416354",21566,21871,305
"19558","Ocbimv22023622m.g","KQ419445",129418,131672,2254
"19559","Ocbimv22011469m.g","KQ417793",172840,173190,350
"19560","Ocbimv22006792m.g","KQ426107",209501,242850,33349
"19561","Ocbimv22013664m.g","KQ418043",26658,53200,26542
"19562","Ocbimv22025124m.g","KQ419697",102562,118293,15731
"19563","Ocbimv22005445m.g","KQ417252",1482396,1482617,221
"19564","Ocbimv22039124m.g","KQ416779",846164,874222,28058
"19565","Ocbimv22038184m.g","KQ423231",168716,169297,581
"19566","Ocbimv22034223m.g","KQ422014",82324,83992,1668
"19567","Ocbimv22025978m.g","KQ419940",54597,62381,7784
"19568","Ocbimv22000716m.g","KQ416877",497567,508988,11421
"19569","Ocbimv22017375m.g","KQ418486",621600,621752,152
"19570","Ocbimv22035356m.g","KQ416582",141126,148973,7847
"19571","Ocbimv22036911m.g","KQ422894",368556,375267,6711
"19572","Ocbimv22012280m.g","KQ428101",47056,59895,12839
"19573","Ocbimv22034864m.g","KQ416560",70957,71580,623
"19574","Ocbimv22009783m.g","KQ427129",107981,143131,35150
"19575","Ocbimv22000190m.g","KQ423889",109801,110655,854
"19576","Ocbimv22032104m.g","KQ416421",35558,36465,907
"19577","Ocbimv22019119m.g","KQ430983",18242,63255,45013
"19578","Ocbimv22033142m.g","KQ421736",15799,28070,12271
"19579","Ocbimv22029170m.g","KQ420672",415410,432911,17501
"19580","Ocbimv22031794m.g","KQ416408",112215,112403,188
"19581","Ocbimv22027050m.g","KQ420169",721712,722073,361
"19582","Ocbimv22035523m.g","KQ422418",21211,22266,1055
"19583","Ocbimv22011148m.g","KQ427654",113207,133964,20757
"19584","Ocbimv22026104m.g","KQ419989",451035,461856,10821
"19585","Ocbimv22037937m.g","KQ423172",23686,24416,730
"19586","Ocbimv22013971m.g","KQ428715",134518,137954,3436
"19587","Ocbimv22014127m.g","KQ418093",22290,26709,4419
"19588","Ocbimv22020494m.g","KQ418919",540210,550490,10280
"19589","Ocbimv22024750m.g","KQ419623",86416,88609,2193
"19590","Ocbimv22024780m.g","KQ419630",9506,9955,449
"19591","Ocbimv22033090m.g","KQ421725",19463,19726,263
"19592","Ocbimv22008309m.g","KQ426613",10076,13237,3161
"19593","Ocbimv22022471m.g","KQ416069",260579,260989,410
"19594","Ocbimv22037992m.g","KQ423192",99647,170373,70726
"19595","Ocbimv22026886m.g","KQ420135",18,679,661
"19596","Ocbimv22011008m.g","KQ427587",133129,134227,1098
"19597","Ocbimv22025819m.g","KQ419909",244071,258447,14376
"19598","Ocbimv22018313m.g","KQ418600",631357,633199,1842
"19599","Ocbimv22016629m.g","KQ415967",373723,373992,269
"19600","Ocbimv22015215m.g","KQ429209",42501,49610,7109
"19601","Ocbimv22021007m.g","KQ431922",151968,164108,12140
"19602","Ocbimv22039537m.g","KQ423702",211,3359,3148
"19603","Ocbimv22034739m.g","LGKD01088307",492,731,239
"19604","Ocbimv22005032m.g","KQ417224",350611,355581,4970
"19605","Ocbimv22004782m.g","KQ425437",32066,33832,1766
"19606","Ocbimv22026577m.g","KQ416193",576389,591300,14911
"19607","Ocbimv22019395m.g","KQ416010",335349,337497,2148
"19608","Ocbimv22022335m.g","KQ419200",147551,147790,239
"19609","Ocbimv22001392m.g","KQ416930",311761,324388,12627
"19610","Ocbimv22010271m.g","KQ427344",5128,28430,23302
"19611","Ocbimv22023641m.g","KQ419448",267373,267534,161
"19612","Ocbimv22019003m.g","KQ418710",663528,664491,963
"19613","Ocbimv22027224m.g","KQ420221",126495,126878,383
"19614","Ocbimv22016527m.g","KQ418364",528115,528438,323
"19615","Ocbimv22011161m.g","KQ427657",6800,9669,2869
"19616","Ocbimv22012316m.g","KQ415907",194044,194199,155
"19617","Ocbimv22018591m.g","KQ418644",431633,431851,218
"19618","Ocbimv22006398m.g","KQ417318",377397,416285,38888
"19619","Ocbimv22006176m.g","KQ417300",2841955,2845875,3920
"19620","Ocbimv22022160m.g","KQ419179",65360,65554,194
"19621","Ocbimv22030760m.g","KQ421084",8734,8973,239
"19622","Ocbimv22012951m.g","KQ417960",421680,422375,695
"19623","Ocbimv22010181m.g","KQ417653",632732,633544,812
"19624","Ocbimv22023844m.g","KQ416101",26104,27100,996
"19625","Ocbimv22030095m.g","KQ416331",75655,78481,2826
"19626","Ocbimv22017477m.g","KQ430313",50724,63513,12789
"19627","Ocbimv22038295m.g","KQ423266",66065,67459,1394
"19628","Ocbimv22009745m.g","LGKD01573185",11,355,344
"19629","Ocbimv22016435m.g","KQ418354",77057,95540,18483
"19630","Ocbimv22014791m.g","KQ429073",18715,28801,10086
"19631","Ocbimv22031550m.g","KQ421273",496158,569067,72909
"19632","Ocbimv22024692m.g","KQ419615",532251,551201,18950
"19633","Ocbimv22028720m.g","KQ420564",2363,18320,15957
"19634","Ocbimv22011895m.g","KQ415894",58656,70085,11429
"19635","Ocbimv22035670m.g","KQ422500",68696,68968,272
"19636","Ocbimv22019238m.g","KQ418738",38760,72285,33525
"19637","Ocbimv22017733m.g","KQ415982",1003131,1003514,383
"19638","Ocbimv22032709m.g","KQ421638",482205,513981,31776
"19639","Ocbimv22030811m.g","KQ421092",181608,206439,24831
"19640","Ocbimv22024721m.g","KQ419621",794039,794422,383
"19641","Ocbimv22014921m.g","KQ418187",593240,593433,193
"19642","Ocbimv22036768m.g","KQ416656",55813,57069,1256
"19643","Ocbimv22011938m.g","KQ417847",443569,452244,8675
"19644","Ocbimv22014167m.g","KQ418097",3575,9439,5864
"19645","Ocbimv22000814m.g","LGKD01494840",66,464,398
"19646","Ocbimv22021232m.g","KQ419018",5262,10178,4916
"19647","Ocbimv22009997m.g","KQ427202",137280,153508,16228
"19648","Ocbimv22016430m.g","KQ418351",482873,483298,425
"19649","Ocbimv22030976m.g","KQ421139",3763,3987,224
"19650","Ocbimv22031822m.g","KQ421356",56661,70507,13846
"19651","Ocbimv22027186m.g","KQ416213",269635,271167,1532
"19652","Ocbimv22023734m.g","KQ433603",3193,4153,960
"19653","Ocbimv22017259m.g","KQ418472",103584,108225,4641
"19654","Ocbimv22030936m.g","KQ421122",17301,17501,200
"19655","Ocbimv22015887m.g","KQ418299",77965,78487,522
"19656","Ocbimv22010413m.g","LGKD01579081",216,386,170
"19657","Ocbimv22001518m.g","KQ424342",73213,74167,954
"19658","Ocbimv22036259m.g","KQ416628",17268,18350,1082
"19659","Ocbimv22016886m.g","KQ418418",49938,51099,1161
"19660","Ocbimv22018506m.g","KQ430731",8204,8557,353
"19661","Ocbimv22013365m.g","KQ418016",9903,39870,29967
"19662","Ocbimv22013170m.g","KQ417996",304850,339773,34923
"19663","Ocbimv22016692m.g","KQ418385",184365,184538,173
"19664","Ocbimv22009490m.g","KQ415865",376123,376895,772
"19665","Ocbimv22029182m.g","KQ420672",622226,644293,22067
"19666","Ocbimv22027116m.g","KQ420188",77594,79036,1442
"19667","Ocbimv22023604m.g","KQ416092",261237,280868,19631
"19668","Ocbimv22004302m.g","KQ417147",134072,139031,4959
"19669","Ocbimv22016679m.g","KQ418380",52294,52660,366
"19670","Ocbimv22009597m.g","KQ427044",1,349,348
"19671","Ocbimv22006447m.g","KQ417320",107546,115147,7601
"19672","Ocbimv22033541m.g","KQ416484",37896,64219,26323
"19673","Ocbimv22029193m.g","KQ420673",456842,458076,1234
"19674","Ocbimv22027464m.g","KQ416225",54527,55621,1094
"19675","Ocbimv22012207m.g","LGKD01593688",3,462,459
"19676","Ocbimv22035053m.g","KQ422261",122388,131342,8954
"19677","Ocbimv22002597m.g","KQ424714",59117,114199,55082
"19678","Ocbimv22038836m.g","KQ416768",237937,297759,59822
"19679","Ocbimv22002533m.g","KQ424678",122882,137066,14184
"19680","Ocbimv22031437m.g","KQ421244",65586,66118,532
"19681","Ocbimv22011124m.g","KQ427649",241798,243122,1324
"19682","Ocbimv22035061m.g","KQ422263",171439,177907,6468
"19683","Ocbimv22005152m.g","KQ425531",442176,466008,23832
"19684","Ocbimv22027698m.g","KQ420346",66477,91531,25054
"19685","Ocbimv22026884m.g","KQ420133",205896,224175,18279
"19686","Ocbimv22034464m.g","KQ422050",656657,656938,281
"19687","Ocbimv22000755m.g","KQ424060",71152,97679,26527
"19688","Ocbimv22027995m.g","KQ420415",497356,499486,2130
"19689","Ocbimv22019401m.g","KQ418760",289810,324093,34283
"19690","Ocbimv22021697m.g","KQ432284",143110,165652,22542
"19691","Ocbimv22008044m.g","KQ417476",12841,14202,1361
"19692","Ocbimv22029905m.g","KQ420841",69263,122045,52782
"19693","Ocbimv22036170m.g","KQ422662",212933,229363,16430
"19694","Ocbimv22018635m.g","KQ418648",133958,163834,29876
"19695","Ocbimv22015773m.g","KQ429552",22885,25829,2944
"19696","Ocbimv22008363m.g","KQ417498",603087,612263,9176
"19697","Ocbimv22024301m.g","KQ419564",18331,27834,9503
"19698","Ocbimv22028998m.g","KQ416279",223387,223980,593
"19699","Ocbimv22036230m.g","KQ416626",701692,702880,1188
"19700","Ocbimv22039280m.g","KQ416787",127185,134273,7088
"19701","Ocbimv22013175m.g","KQ428413",18023,19015,992
"19702","Ocbimv22009484m.g","KQ415865",68417,84451,16034
"19703","Ocbimv22027864m.g","KQ416235",107503,109002,1499
"19704","Ocbimv22008047m.g","KQ417476",53169,53384,215
"19705","Ocbimv22021447m.g","KQ419049",395470,395973,503
"19706","Ocbimv22030214m.g","KQ420924",250289,258221,7932
"19707","Ocbimv22012096m.g","KQ417873",70889,71434,545
"19708","Ocbimv22020658m.g","KQ418946",149351,149989,638
"19709","Ocbimv22019454m.g","KQ418769",562113,583677,21564
"19710","Ocbimv22022078m.g","KQ419158",411033,423323,12290
"19711","Ocbimv22027663m.g","KQ420334",45462,93981,48519
"19712","Ocbimv22000667m.g","KQ416875",107052,109097,2045
"19713","Ocbimv22000838m.g","KQ424091",6033,20878,14845
"19714","Ocbimv22024441m.g","KQ419579",14644,29933,15289
"19715","Ocbimv22034102m.g","KQ421975",13886,17843,3957
"19716","Ocbimv22011549m.g","KQ417800",64107,69568,5461
"19717","Ocbimv22015146m.g","KQ418200",404417,412489,8072
"19718","Ocbimv22026275m.g","KQ420022",592294,619579,27285
"19719","Ocbimv22001706m.g","KQ416956",14616,14786,170
"19720","Ocbimv22022001m.g","KQ416058",5079,5722,643
"19721","Ocbimv22014139m.g","KQ428774",74913,75104,191
"19722","Ocbimv22037089m.g","KQ422919",1566170,1585080,18910
"19723","Ocbimv22020335m.g","KQ418896",4194,4869,675
"19724","Ocbimv22019311m.g","KQ418747",711418,711690,272
"19725","Ocbimv22016082m.g","LGKD01624263",17,232,215
"19726","Ocbimv22033439m.g","KQ421816",57555,59330,1775
"19727","Ocbimv22024407m.g","KQ419577",27434,29655,2221
"19728","Ocbimv22014122m.g","KQ418092",130429,137199,6770
"19729","Ocbimv22027171m.g","KQ420208",77626,116884,39258
"19730","Ocbimv22036119m.g","KQ422647",26718,55324,28606
"19731","Ocbimv22016061m.g","KQ415952",129879,131912,2033
"19732","Ocbimv22024460m.g","KQ419582",65621,72158,6537
"19733","Ocbimv22034607m.g","KQ416539",131257,131560,303
"19734","Ocbimv22023212m.g","KQ419372",149960,150406,446
"19735","Ocbimv22002225m.g","KQ416996",196291,216594,20303
"19736","Ocbimv22037331m.g","KQ423002",34310,44843,10533
"19737","Ocbimv22028621m.g","KQ416264",896896,897306,410
"19738","Ocbimv22037131m.g","KQ422937",80252,80974,722
"19739","Ocbimv22034653m.g","KQ416544",179071,180379,1308
"19740","Ocbimv22011377m.g","KQ417791",510625,510979,354
"19741","Ocbimv22013793m.g","KQ418061",27713,84673,56960
"19742","Ocbimv22001937m.g","KQ416974",1084214,1086620,2406
"19743","Ocbimv22026757m.g","KQ420109",249063,250111,1048
"19744","Ocbimv22010238m.g","KQ427326",20096,20362,266
"19745","Ocbimv22031566m.g","KQ421280",158487,158891,404
"19746","Ocbimv22017227m.g","KQ418469",427650,435145,7495
"19747","Ocbimv22024109m.g","KQ419534",216181,294178,77997
"19748","Ocbimv22001083m.g","KQ416908",6111,90935,84824
"19749","Ocbimv22014691m.g","KQ418168",484347,485520,1173
"19750","Ocbimv22034753m.g","KQ422145",293448,293615,167
"19751","Ocbimv22005058m.g","KQ425509",45705,64168,18463
"19752","Ocbimv22000168m.g","KQ416846",357876,358389,513
"19753","Ocbimv22005625m.g","KQ425688",1347,1652,305
"19754","Ocbimv22012039m.g","KQ427981",688,2695,2007
"19755","Ocbimv22026597m.g","KQ420078",2235,73866,71631
"19756","Ocbimv22035419m.g","KQ422378",21229,21450,221
"19757","Ocbimv22023534m.g","KQ419425",732441,879910,147469
"19758","Ocbimv22023944m.g","KQ433721",149,3048,2899
"19759","Ocbimv22016420m.g","KQ429859",8994,11315,2321
"19760","Ocbimv22005658m.g","KQ417271",233975,253368,19393
"19761","Ocbimv22034965m.g","KQ422230",96177,96560,383
"19762","Ocbimv22016165m.g","KQ429719",123442,129034,5592
"19763","Ocbimv22026357m.g","KQ420033",18494,19713,1219
"19764","Ocbimv22002474m.g","KQ424667",23732,48920,25188
"19765","Ocbimv22013867m.g","KQ418069",28365,39184,10819
"19766","Ocbimv22014432m.g","KQ428915",72717,73015,298
"19767","Ocbimv22030218m.g","KQ420924",365781,378807,13026
"19768","Ocbimv22002311m.g","KQ424627",378384,378587,203
"19769","Ocbimv22028642m.g","KQ415707",316245,316430,185
"19770","Ocbimv22013728m.g","KQ428622",47526,48805,1279
"19771","Ocbimv22018263m.g","KQ430613",32031,35653,3622
"19772","Ocbimv22001870m.g","KQ424457",18977,29945,10968
"19773","Ocbimv22032541m.g","KQ415729",4588,4989,401
"19774","Ocbimv22001641m.g","KQ416950",1524929,1525910,981
"19775","Ocbimv22016717m.g","KQ418389",22237,22450,213
"19776","Ocbimv22007246m.g","KQ426259",173873,174217,344
"19777","Ocbimv22024850m.g","KQ419640",131647,145912,14265
"19778","Ocbimv22039482m.g","KQ423675",342409,343523,1114
"19779","Ocbimv22001094m.g","KQ424178",159890,160087,197
"19780","Ocbimv22017346m.g","KQ418483",324834,351802,26968
"19781","Ocbimv22026788m.g","KQ420117",181860,185474,3614
"19782","Ocbimv22019338m.g","KQ418751",50192,50446,254
"19783","Ocbimv22003540m.g","KQ417090",1597055,1601093,4038
"19784","Ocbimv22003792m.g","KQ417112",891780,910439,18659
"19785","Ocbimv22007046m.g","KQ417371",176526,177599,1073
"19786","Ocbimv22038775m.g","KQ416765",754429,755977,1548
"19787","Ocbimv22026258m.g","KQ420022",180356,202407,22051
"19788","Ocbimv22002551m.g","KQ424685",4752,6766,2014
"19789","Ocbimv22035339m.g","KQ422362",52595,53702,1107
"19790","Ocbimv22007489m.g","KQ415843",163100,164857,1757
"19791","Ocbimv22027100m.g","KQ420181",723364,725770,2406
"19792","Ocbimv22007439m.g","KQ417414",115986,116366,380
"19793","Ocbimv22026917m.g","KQ416205",3737,4255,518
"19794","Ocbimv22033748m.g","KQ421864",183038,187504,4466
"19795","Ocbimv22030389m.g","KQ420970",188120,193796,5676
"19796","Ocbimv22015172m.g","KQ418202",135586,136502,916
"19797","Ocbimv22011173m.g","KQ417756",138252,154239,15987
"19798","Ocbimv22039233m.g","KQ423591",154675,155208,533
"19799","Ocbimv22026384m.g","KQ420035",55899,74017,18118
"19800","Ocbimv22025585m.g","KQ419857",21415,21651,236
"19801","Ocbimv22035106m.g","KQ422281",121566,132025,10459
"19802","Ocbimv22024519m.g","KQ434028",24491,34053,9562
"19803","Ocbimv22023465m.g","KQ419414",430836,431114,278
"19804","Ocbimv22033471m.g","KQ416482",164573,167239,2666
"19805","Ocbimv22036635m.g","KQ416651",1646003,1646377,374
"19806","Ocbimv22004413m.g","KQ415804",242794,267120,24326
"19807","Ocbimv22026037m.g","KQ419961",43743,54367,10624
"19808","Ocbimv22026760m.g","KQ420109",338811,344049,5238
"19809","Ocbimv22009321m.g","KQ415863",109927,112034,2107
"19810","Ocbimv22032456m.g","KQ421549",73610,138392,64782
"19811","Ocbimv22017127m.g","KQ418453",43744,47998,4254
"19812","Ocbimv22034426m.g","KQ416531",142112,143635,1523
"19813","Ocbimv22033972m.g","KQ421932",168875,213500,44625
"19814","Ocbimv22038049m.g","KQ423209",33257,33544,287
"19815","Ocbimv22032266m.g","KQ421507",58536,129735,71199
"19816","Ocbimv22012635m.g","KQ417921",1721681,1722250,569
"19817","Ocbimv22027070m.g","KQ420174",288619,289533,914
"19818","Ocbimv22009624m.g","KQ427057",208806,208985,179
"19819","Ocbimv22037029m.g","KQ422909",359580,369888,10308
"19820","Ocbimv22035593m.g","KQ416594",618,18403,17785
"19821","Ocbimv22007348m.g","KQ415841",317802,328284,10482
"19822","Ocbimv22014010m.g","KQ428720",23002,26887,3885
"19823","Ocbimv22005936m.g","KQ417285",57133,70582,13449
"19824","Ocbimv22026133m.g","KQ419994",70261,92471,22210
"19825","Ocbimv22005066m.g","KQ425510",292781,293296,515
"19826","Ocbimv22024770m.g","KQ419625",162502,186989,24487
"19827","Ocbimv22028371m.g","KQ416256",3757,4540,783
"19828","Ocbimv22007971m.g","KQ417466",1864948,1928844,63896
"19829","Ocbimv22030703m.g","KQ421075",283,22238,21955
"19830","Ocbimv22027623m.g","KQ420314",109363,109590,227
"19831","Ocbimv22030953m.g","KQ421132",37803,40205,2402
"19832","Ocbimv22038389m.g","KQ423305",43481,44098,617
"19833","Ocbimv22003939m.g","KQ425152",23165,24492,1327
"19834","Ocbimv22014393m.g","KQ415929",43236,44409,1173
"19835","Ocbimv22029993m.g","KQ420877",2079,6025,3946
"19836","Ocbimv22002473m.g","KQ424667",3653,22025,18372
"19837","Ocbimv22014589m.g","KQ428995",169809,170042,233
"19838","Ocbimv22000822m.g","KQ424081",296234,313850,17616
"19839","Ocbimv22014537m.g","KQ428981",22773,54452,31679
"19840","Ocbimv22003391m.g","KQ425002",508508,510389,1881
"19841","Ocbimv22004038m.g","KQ425190",75562,78646,3084
"19842","Ocbimv22026870m.g","KQ420132",752638,801276,48638
"19843","Ocbimv22032662m.g","KQ421628",254377,269623,15246
"19844","Ocbimv22014595m.g","KQ418156",39583,39854,271
"19845","Ocbimv22006635m.g","KQ426043",194646,246064,51418
"19846","Ocbimv22029214m.g","KQ416291",1573912,1574352,440
"19847","Ocbimv22019834m.g","KQ418821",68664,69326,662
"19848","Ocbimv22030955m.g","KQ421133",15657,22783,7126
"19849","Ocbimv22011299m.g","KQ417777",166682,169004,2322
"19850","Ocbimv22026113m.g","KQ419989",671700,671969,269
"19851","Ocbimv22038893m.g","KQ416771",363270,365557,2287
"19852","Ocbimv22017461m.g","KQ418498",333137,333547,410
"19853","Ocbimv22007125m.g","KQ417381",71250,79784,8534
"19854","Ocbimv22026501m.g","KQ420059",393754,435886,42132
"19855","Ocbimv22020188m.g","LGKD01657918",869,1099,230
"19856","Ocbimv22002354m.g","KQ424644",77550,101779,24229
"19857","Ocbimv22001636m.g","KQ416950",1224517,1225071,554
"19858","Ocbimv22019494m.g","KQ418776",7051,7344,293
"19859","Ocbimv22006131m.g","KQ417300",414101,414253,152
"19860","Ocbimv22017467m.g","KQ430302",3833,24704,20871
"19861","Ocbimv22025025m.g","KQ416136",289370,295983,6613
"19862","Ocbimv22039750m.g","KQ416821",9036,27485,18449
"19863","Ocbimv22007346m.g","KQ415841",151319,153084,1765
"19864","Ocbimv22018297m.g","KQ418598",361463,362957,1494
"19865","Ocbimv22018870m.g","KQ418693",456859,463852,6993
"19866","Ocbimv22034011m.g","KQ421946",229698,230197,499
"19867","Ocbimv22025768m.g","KQ416166",748952,762471,13519
"19868","Ocbimv22015010m.g","KQ418194",187995,188951,956
"19869","Ocbimv22036889m.g","KQ422891",11136,21123,9987
"19870","Ocbimv22032223m.g","KQ421487",30669,42196,11527
"19871","Ocbimv22029526m.g","KQ420769",79633,117728,38095
"19872","Ocbimv22008335m.g","KQ417497",1181249,1181416,167
"19873","Ocbimv22030291m.g","KQ420940",22784,23669,885
"19874","Ocbimv22029788m.g","KQ420822",31531,36016,4485
"19875","Ocbimv22036237m.g","KQ416626",1134671,1139322,4651
"19876","Ocbimv22023440m.g","KQ419409",672709,672892,183
"19877","Ocbimv22017223m.g","KQ418469",189866,243243,53377
"19878","Ocbimv22006975m.g","LGKD01551624",41,514,473
"19879","Ocbimv22014388m.g","KQ418125",156166,157448,1282
"19880","Ocbimv22007042m.g","KQ417371",84321,148518,64197
"19881","Ocbimv22021812m.g","KQ432338",11800,12319,519
"19882","Ocbimv22017152m.g","LGKD01633276",2115,3251,1136
"19883","Ocbimv22023095m.g","KQ419348",36557,36854,297
"19884","Ocbimv22033048m.g","KQ421721",372369,387292,14923
"19885","Ocbimv22018493m.g","KQ418627",139843,140019,176
"19886","Ocbimv22011092m.g","KQ417747",276682,294456,17774
"19887","Ocbimv22037896m.g","KQ423152",5595,5759,164
"19888","Ocbimv22008313m.g","KQ426613",171685,195702,24017
"19889","Ocbimv22026147m.g","KQ420004",156691,172710,16019
"19890","Ocbimv22004207m.g","KQ415801",63288,84080,20792
"19891","Ocbimv22011266m.g","KQ417771",1226376,1226818,442
"19892","Ocbimv22020127m.g","KQ418859",21534,62165,40631
"19893","Ocbimv22030852m.g","KQ416373",183949,184266,317
"19894","Ocbimv22025136m.g","KQ419705",48559,50388,1829
"19895","Ocbimv22033457m.g","KQ421816",848754,850579,1825
"19896","Ocbimv22030280m.g","KQ416340",719211,719627,416
"19897","Ocbimv22004935m.g","KQ417214",84178,94792,10614
"19898","Ocbimv22012656m.g","KQ417923",615167,623293,8126
"19899","Ocbimv22038965m.g","KQ423494",249922,259183,9261
"19900","Ocbimv22005361m.g","KQ425596",180607,215812,35205
"19901","Ocbimv22029839m.g","KQ420828",1286598,1287278,680
"19902","Ocbimv22023614m.g","KQ419442",23784,24038,254
"19903","Ocbimv22005727m.g","KQ425730",17990,18874,884
"19904","Ocbimv22007924m.g","KQ417459",648927,725540,76613
"19905","Ocbimv22016925m.g","KQ418423",383639,384351,712
"19906","Ocbimv22010303m.g","KQ417666",1064692,1065432,740
"19907","Ocbimv22010132m.g","KQ427272",88218,88541,323
"19908","Ocbimv22008226m.g","KQ415852",421591,421818,227
"19909","Ocbimv22005841m.g","KQ417280",144629,145981,1352
"19910","Ocbimv22012609m.g","KQ417921",174199,178084,3885
"19911","Ocbimv22015412m.g","KQ429325",186997,187903,906
"19912","Ocbimv22002107m.g","KQ416986",278218,305036,26818
"19913","Ocbimv22031652m.g","KQ421305",551254,554157,2903
"19914","Ocbimv22000089m.g","KQ416839",121411,121704,293
"19915","Ocbimv22030380m.g","KQ420969",411490,447284,35794
"19916","Ocbimv22036912m.g","KQ422894",380878,409351,28473
"19917","Ocbimv22038865m.g","KQ416769",585874,586360,486
"19918","Ocbimv22004444m.g","KQ417160",41491,45152,3661
"19919","Ocbimv22003926m.g","KQ417125",200856,201864,1008
"19920","Ocbimv22018348m.g","KQ430669",73663,73911,248
"19921","Ocbimv22014060m.g","KQ415672",380116,380872,756
"19922","Ocbimv22019205m.g","KQ418734",38923,47508,8585
"19923","Ocbimv22029843m.g","KQ420828",1333587,1349815,16228
"19924","Ocbimv22011329m.g","KQ417781",27211,37627,10416
"19925","Ocbimv22030917m.g","KQ421117",1835199,1836599,1400
"19926","Ocbimv22000783m.g","KQ424065",912,23779,22867
"19927","Ocbimv22007800m.g","KQ417452",36278,37221,943
"19928","Ocbimv22009470m.g","KQ417596",489380,532303,42923
"19929","Ocbimv22024802m.g","KQ419631",189987,208055,18068
"19930","Ocbimv22024868m.g","KQ419643",421333,423472,2139
"19931","Ocbimv22000021m.g","KQ423822",15994,168888,152894
"19932","Ocbimv22016173m.g","KQ429723",14457,18582,4125
"19933","Ocbimv22006532m.g","KQ425990",17885,42915,25030
"19934","Ocbimv22016800m.g","KQ418402",16,7809,7793
"19935","Ocbimv22002876m.g","KQ417044",97440,98014,574
"19936","Ocbimv22017470m.g","KQ430310",1245,1733,488
"19937","Ocbimv22014873m.g","KQ415936",3014,19767,16753
"19938","Ocbimv22006283m.g","KQ425850",290365,290593,228
"19939","Ocbimv22013845m.g","KQ418068",41177,43136,1959
"19940","Ocbimv22002500m.g","KQ417011",96924,98182,1258
"19941","Ocbimv22005735m.g","KQ425732",121862,141881,20019
"19942","Ocbimv22029926m.g","KQ420850",8614,24667,16053
"19943","Ocbimv22010901m.g","LGKD01583352",77,280,203
"19944","Ocbimv22012401m.g","KQ428149",1562,9567,8005
"19945","Ocbimv22009112m.g","KQ417563",205179,205367,188
"19946","Ocbimv22028147m.g","KQ416251",1584314,1584523,209
"19947","Ocbimv22039957m.g","KQ423809",41416,48123,6707
"19948","Ocbimv22015323m.g","KQ429266",2236,3759,1523
"19949","Ocbimv22034897m.g","KQ422209",78582,78948,366
"19950","Ocbimv22039381m.g","KQ423637",91326,92114,788
"19951","Ocbimv22002612m.g","KQ417023",260348,284759,24411
"19952","Ocbimv22029807m.g","KQ420828",58530,59639,1109
"19953","Ocbimv22039835m.g","KQ423774",169319,169474,155
"19954","Ocbimv22018145m.g","KQ418577",101813,118759,16946
"19955","Ocbimv22021974m.g","KQ419141",2340,28780,26440
"19956","Ocbimv22034345m.g","KQ422016",298499,326792,28293
"19957","Ocbimv22038957m.g","KQ423493",949639,971148,21509
"19958","Ocbimv22008562m.g","KQ426701",56272,62628,6356
"19959","Ocbimv22007404m.g","KQ417412",18002,29418,11416
"19960","Ocbimv22017182m.g","KQ418462",519986,543350,23364
"19961","Ocbimv22009037m.g","KQ415859",135738,135998,260
"19962","Ocbimv22034703m.g","KQ416547",189810,244867,55057
"19963","Ocbimv22004414m.g","KQ415804",274452,284145,9693
"19964","Ocbimv22023448m.g","KQ419413",41791,42978,1187
"19965","Ocbimv22002284m.g","KQ424621",15826,17297,1471
"19966","Ocbimv22035817m.g","KQ422559",16395,16787,392
"19967","Ocbimv22014520m.g","KQ415932",792025,873491,81466
"19968","Ocbimv22032177m.g","KQ421467",34531,38871,4340
"19969","Ocbimv22032854m.g","KQ416453",19302,22600,3298
"19970","Ocbimv22037979m.g","KQ416717",65347,65520,173
"19971","Ocbimv22014413m.g","KQ418129",426898,427122,224
"19972","Ocbimv22025323m.g","KQ419774",21202,21618,416
"19973","Ocbimv22033832m.g","KQ421893",1442,40326,38884
"19974","Ocbimv22003574m.g","KQ417092",185630,186021,391
"19975","Ocbimv22018439m.g","KQ415992",275338,285197,9859
"19976","Ocbimv22012506m.g","KQ417917",313778,316359,2581
"19977","Ocbimv22031226m.g","KQ421201",218874,273878,55004
"19978","Ocbimv22031489m.g","KQ421261",131421,222886,91465
"19979","Ocbimv22032073m.g","KQ421423",42271,42426,155
"19980","Ocbimv22018766m.g","KQ418671",30903,31544,641
"19981","Ocbimv22014547m.g","KQ428981",177154,185340,8186
"19982","Ocbimv22019924m.g","KQ431376",417899,428296,10397
"19983","Ocbimv22003763m.g","KQ425096",22469,25639,3170
"19984","Ocbimv22020684m.g","KQ418953",46815,47144,329
"19985","Ocbimv22032067m.g","KQ421417",117114,169555,52441
"19986","Ocbimv22030026m.g","KQ420886",32669,36741,4072
"19987","Ocbimv22011483m.g","KQ417795",240636,310737,70101
"19988","Ocbimv22005827m.g","KQ417280",89945,92858,2913
"19989","Ocbimv22003971m.g","KQ425162",19833,20882,1049
"19990","Ocbimv22020623m.g","LGKD01662168",692,11164,10472
"19991","Ocbimv22009863m.g","KQ417620",1695576,1695806,230
"19992","Ocbimv22025958m.g","KQ416177",214410,222287,7877
"19993","Ocbimv22008360m.g","KQ417498",375617,375901,284
"19994","Ocbimv22022783m.g","KQ433010",21478,22154,676
"19995","Ocbimv22003841m.g","KQ425130",920,101250,100330
"19996","Ocbimv22009740m.g","KQ417609",346264,347636,1372
"19997","Ocbimv22028984m.g","KQ420621",157722,187343,29621
"19998","Ocbimv22006529m.g","KQ425986",46318,94180,47862
"19999","Ocbimv22035668m.g","KQ422496",314660,394279,79619
"20000","Ocbimv22010697m.g","KQ427468",14643,23043,8400
"20001","Ocbimv22030804m.g","KQ421089",36176,41307,5131
"20002","Ocbimv22000451m.g","KQ423968",179305,191229,11924
"20003","Ocbimv22004018m.g","KQ425188",206250,227011,20761
"20004","Ocbimv22011382m.g","KQ417791",600265,614792,14527
"20005","Ocbimv22032171m.g","KQ421464",841276,843925,2649
"20006","Ocbimv22033080m.g","KQ421724",350278,350857,579
"20007","Ocbimv22032922m.g","KQ421685",37924,84243,46319
"20008","Ocbimv22027417m.g","KQ420270",122920,134257,11337
"20009","Ocbimv22027644m.g","KQ420329",41272,136691,95419
"20010","Ocbimv22015032m.g","KQ418194",585823,586074,251
"20011","Ocbimv22016876m.g","KQ418416",777,31459,30682
"20012","Ocbimv22023908m.g","KQ433699",42561,95569,53008
"20013","Ocbimv22034938m.g","KQ416562",602123,608161,6038
"20014","Ocbimv22007116m.g","KQ417381",6099,9163,3064
"20015","Ocbimv22008979m.g","KQ426823",17297,17683,386
"20016","Ocbimv22031150m.g","KQ421177",1101,1364,263
"20017","Ocbimv22036469m.g","KQ422771",166556,173833,7277
"20018","Ocbimv22008532m.g","KQ426668",1467,40049,38582
"20019","Ocbimv22012728m.g","KQ417931",118245,118490,245
"20020","Ocbimv22025206m.g","KQ419727",700678,709663,8985
"20021","Ocbimv22020612m.g","KQ418938",604332,604844,512
"20022","Ocbimv22034704m.g","KQ416547",250679,253607,2928
"20023","Ocbimv22026578m.g","KQ416193",592136,599427,7291
"20024","Ocbimv22037279m.g","KQ422989",17208,50981,33773
"20025","Ocbimv22029899m.g","KQ416321",56887,70044,13157
"20026","Ocbimv22039605m.g","KQ423717",20716,20970,254
"20027","Ocbimv22005721m.g","KQ425728",241503,241952,449
"20028","Ocbimv22034331m.g","KQ422016",153092,154220,1128
"20029","Ocbimv22007263m.g","KQ417395",315452,334490,19038
"20030","Ocbimv22016191m.g","KQ429737",260,568,308
"20031","Ocbimv22036896m.g","KQ422894",90126,96366,6240
"20032","Ocbimv22037232m.g","LGKD01458094",125,552,427
"20033","Ocbimv22003399m.g","KQ417086",78770,141652,62882
"20034","Ocbimv22026806m.g","KQ416203",444800,445204,404
"20035","Ocbimv22027749m.g","KQ420357",87551,88624,1073
"20036","Ocbimv22020928m.g","LGKD01663688",2,1078,1076
"20037","Ocbimv22015530m.g","KQ429401",4318,14188,9870
"20038","Ocbimv22022280m.g","KQ419192",387744,388046,302
"20039","Ocbimv22003589m.g","KQ417094",161389,176070,14681
"20040","Ocbimv22006717m.g","KQ426076",131203,131430,227
"20041","Ocbimv22022619m.g","LGKD01681042",16,276,260
"20042","Ocbimv22020407m.g","KQ418908",412827,413790,963
"20043","Ocbimv22021114m.g","KQ419008",297314,297956,642
"20044","Ocbimv22002460m.g","KQ424661",12212,19407,7195
"20045","Ocbimv22023026m.g","KQ416080",477161,478251,1090
"20046","Ocbimv22014783m.g","KQ418176",1473057,1548922,75865
"20047","Ocbimv22016025m.g","KQ429661",173358,174975,1617
"20048","Ocbimv22012335m.g","KQ415907",724311,725344,1033
"20049","Ocbimv22035772m.g","KQ416600",189571,250380,60809
"20050","Ocbimv22033774m.g","KQ421868",63705,63905,200
"20051","Ocbimv22007503m.g","KQ417417",157803,158135,332
"20052","Ocbimv22028948m.g","KQ420605",779193,781340,2147
"20053","Ocbimv22010083m.g","KQ417641",184606,212616,28010
"20054","Ocbimv22037648m.g","KQ416705",306320,320805,14485
"20055","Ocbimv22014401m.g","KQ428905",125646,129527,3881
"20056","Ocbimv22039251m.g","KQ423592",140313,157421,17108
"20057","Ocbimv22017063m.g","KQ418447",99937,100206,269
"20058","Ocbimv22026550m.g","KQ416192",135659,146050,10391
"20059","Ocbimv22008071m.g","KQ426557",127342,152720,25378
"20060","Ocbimv22013684m.g","KQ428597",1570,9665,8095
"20061","Ocbimv22028659m.g","KQ420545",190876,195527,4651
"20062","Ocbimv22038793m.g","KQ415767",760375,760656,281
"20063","Ocbimv22033409m.g","KQ421805",19526,41958,22432
"20064","Ocbimv22002031m.g","KQ424519",293,803,510
"20065","Ocbimv22021742m.g","KQ432301",82862,96630,13768
"20066","Ocbimv22033106m.g","KQ421727",496638,497003,365
"20067","Ocbimv22038707m.g","KQ416761",350911,351627,716
"20068","Ocbimv22000673m.g","KQ424049",88538,88762,224
"20069","Ocbimv22006678m.g","KQ426074",39071,39643,572
"20070","Ocbimv22035643m.g","KQ422485",31156,32181,1025
"20071","Ocbimv22008529m.g","KQ426666",67549,142590,75041
"20072","Ocbimv22022262m.g","KQ416064",1843217,1843576,359
"20073","Ocbimv22026297m.g","KQ420023",346166,363991,17825
"20074","Ocbimv22013100m.g","KQ417981",763450,823586,60136
"20075","Ocbimv22033708m.g","KQ416492",367454,379251,11797
"20076","Ocbimv22034743m.g","KQ422141",23853,25160,1307
"20077","Ocbimv22017752m.g","KQ418537",508772,509425,653
"20078","Ocbimv22020489m.g","KQ418919",495810,497309,1499
"20079","Ocbimv22019112m.g","KQ418718",2403,41009,38606
"20080","Ocbimv22015034m.g","KQ418194",590000,592675,2675
"20081","Ocbimv22027120m.g","KQ420193",410243,410629,386
"20082","Ocbimv22013771m.g","KQ428659",8741,19125,10384
"20083","Ocbimv22009477m.g","KQ417596",834541,835073,532
"20084","Ocbimv22001761m.g","KQ424406",16643,16822,179
"20085","Ocbimv22004044m.g","KQ425190",103259,106987,3728
"20086","Ocbimv22026609m.g","KQ420079",398736,399038,302
"20087","Ocbimv22017221m.g","KQ418469",57229,71449,14220
"20088","Ocbimv22039545m.g","LGKD01483777",939,1094,155
"20089","Ocbimv22019209m.g","KQ418734",64648,64896,248
"20090","Ocbimv22026145m.g","KQ420004",44430,123702,79272
"20091","Ocbimv22003582m.g","KQ425034",146151,146524,373
"20092","Ocbimv22031642m.g","KQ421305",325107,325334,227
"20093","Ocbimv22018308m.g","KQ418600",233590,298652,65062
"20094","Ocbimv22002547m.g","KQ417014",160870,161829,959
"20095","Ocbimv22022242m.g","KQ432655",11699,13221,1522
"20096","Ocbimv22030114m.g","KQ420892",200075,200749,674
"20097","Ocbimv22021335m.g","LGKD01667024",177,504,327
"20098","Ocbimv22034261m.g","KQ422015",224737,245902,21165
"20099","Ocbimv22006164m.g","KQ417300",1626108,1626479,371
"20100","Ocbimv22033962m.g","KQ421924",73471,73755,284
"20101","Ocbimv22024194m.g","KQ433854",6539,9856,3317
"20102","Ocbimv22029836m.g","KQ420828",1192644,1243770,51126
"20103","Ocbimv22016141m.g","KQ418322",288523,299514,10991
"20104","Ocbimv22035821m.g","KQ415753",348331,349152,821
"20105","Ocbimv22038659m.g","KQ423432",83721,107237,23516
"20106","Ocbimv22028603m.g","KQ416263",771845,777717,5872
"20107","Ocbimv22036995m.g","KQ422903",70614,143729,73115
"20108","Ocbimv22018897m.g","KQ430924",68463,68956,493
"20109","Ocbimv22023644m.g","KQ433537",111,9925,9814
"20110","Ocbimv22018299m.g","KQ418598",381758,412650,30892
"20111","Ocbimv22022827m.g","KQ419305",25864,59835,33971
"20112","Ocbimv22012922m.g","KQ428290",192,561,369
"20113","Ocbimv22024178m.g","KQ419545",4722,9757,5035
"20114","Ocbimv22027755m.g","KQ420358",160039,186653,26614
"20115","Ocbimv22002376m.g","KQ415792",624671,624841,170
"20116","Ocbimv22022035m.g","KQ419149",409764,410467,703
"20117","Ocbimv22023985m.g","KQ419513",265626,330405,64779
"20118","Ocbimv22011492m.g","KQ427766",11012,11198,186
"20119","Ocbimv22032833m.g","KQ421664",1257269,1307043,49774
"20120","Ocbimv22027889m.g","KQ420388",498897,499175,278
"20121","Ocbimv22007619m.g","KQ417438",427123,476837,49714
"20122","Ocbimv22034010m.g","KQ421946",178118,229980,51862
"20123","Ocbimv22007557m.g","KQ417425",127237,127789,552
"20124","Ocbimv22029044m.g","KQ416282",10477,16776,6299
"20125","Ocbimv22032168m.g","KQ421464",591606,593835,2229
"20126","Ocbimv22035014m.g","KQ422246",130487,136865,6378
"20127","Ocbimv22007507m.g","KQ417417",196990,205834,8844
"20128","Ocbimv22029217m.g","KQ420681",56483,57151,668
"20129","Ocbimv22030778m.g","KQ421086",86958,87271,313
"20130","Ocbimv22039837m.g","KQ423776",57084,58497,1413
"20131","Ocbimv22006274m.g","KQ425850",77181,77432,251
"20132","Ocbimv22030189m.g","KQ420919",136747,139777,3030
"20133","Ocbimv22019857m.g","KQ418823",7098,7724,626
"20134","Ocbimv22001955m.g","KQ416976",130779,131358,579
"20135","Ocbimv22014982m.g","KQ418190",346114,483965,137851
"20136","Ocbimv22006410m.g","KQ425905",67879,69093,1214
"20137","Ocbimv22023519m.g","KQ433432",55642,71573,15931
"20138","Ocbimv22030295m.g","KQ420941",503858,519563,15705
"20139","Ocbimv22026659m.g","KQ420089",37113,147992,110879
"20140","Ocbimv22010355m.g","KQ427364",56773,87894,31121
"20141","Ocbimv22011540m.g","KQ427775",84717,85843,1126
"20142","Ocbimv22004823m.g","KQ417209",6212,9065,2853
"20143","Ocbimv22000331m.g","KQ423926",48830,49743,913
"20144","Ocbimv22014035m.g","KQ428725",54611,54883,272
"20145","Ocbimv22031565m.g","KQ421280",92336,92671,335
"20146","Ocbimv22001354m.g","KQ416924",813940,825694,11754
"20147","Ocbimv22004165m.g","KQ425220",187816,197671,9855
"20148","Ocbimv22012873m.g","KQ417946",123027,123296,269
"20149","Ocbimv22016761m.g","KQ418393",219216,230703,11487
"20150","Ocbimv22014045m.g","KQ428735",1834,17387,15553
"20151","Ocbimv22024776m.g","KQ419629",133347,134079,732
"20152","Ocbimv22034881m.g","KQ422206",65970,68354,2384
"20153","Ocbimv22039421m.g","KQ423654",57635,94070,36435
"20154","Ocbimv22036059m.g","KQ416616",55635,56911,1276
"20155","Ocbimv22011331m.g","KQ417781",37692,42562,4870
"20156","Ocbimv22004374m.g","KQ415803",609510,611365,1855
"20157","Ocbimv22026776m.g","KQ420113",89453,95190,5737
"20158","Ocbimv22021149m.g","KQ419009",411996,564461,152465
"20159","Ocbimv22026351m.g","KQ420032",38566,38736,170
"20160","Ocbimv22028472m.g","KQ420499",110538,111517,979
"20161","Ocbimv22022833m.g","KQ433045",3917,13977,10060
"20162","Ocbimv22037996m.g","KQ416719",201679,220910,19231
"20163","Ocbimv22027282m.g","KQ420241",298182,298466,284
"20164","Ocbimv22012467m.g","KQ428165",269953,301820,31867
"20165","Ocbimv22020599m.g","KQ418933",225477,225671,194
"20166","Ocbimv22003594m.g","KQ417094",246979,247812,833
"20167","Ocbimv22032086m.g","KQ421430",285300,289701,4401
"20168","Ocbimv22001028m.g","KQ424157",423244,437329,14085
"20169","Ocbimv22034392m.g","KQ422028",79573,80448,875
"20170","Ocbimv22020891m.g","KQ418974",47515,156729,109214
"20171","Ocbimv22036361m.g","KQ416635",115440,130872,15432
"20172","Ocbimv22017029m.g","LGKD01632347",1,429,428
"20173","Ocbimv22038420m.g","KQ423333",87823,88026,203
"20174","Ocbimv22010436m.g","KQ427385",280659,285349,4690
"20175","Ocbimv22003927m.g","KQ417125",202944,203321,377
"20176","Ocbimv22015332m.g","KQ418223",224658,230361,5703
"20177","Ocbimv22007485m.g","KQ415843",124216,142345,18129
"20178","Ocbimv22033348m.g","KQ416475",198031,200367,2336
"20179","Ocbimv22003076m.g","KQ424877",226600,248151,21551
"20180","Ocbimv22015837m.g","KQ418295",292861,301313,8452
"20181","Ocbimv22022509m.g","KQ419238",9264,10121,857
"20182","Ocbimv22036530m.g","KQ422784",313910,314278,368
"20183","Ocbimv22021422m.g","KQ419046",8115,15060,6945
"20184","Ocbimv22037246m.g","KQ422973",45099,45978,879
"20185","Ocbimv22037899m.g","KQ423154",37671,40921,3250
"20186","Ocbimv22000289m.g","KQ423912",38088,72947,34859
"20187","Ocbimv22035038m.g","KQ422254",52874,65426,12552
"20188","Ocbimv22032400m.g","KQ421531",110214,111782,1568
"20189","Ocbimv22036370m.g","KQ422728",82863,83444,581
"20190","Ocbimv22036779m.g","KQ422859",138686,147065,8379
"20191","Ocbimv22017517m.g","KQ418504",3346,31374,28028
"20192","Ocbimv22015726m.g","KQ429522",1,11958,11957
"20193","Ocbimv22000489m.g","KQ416864",441491,499844,58353
"20194","Ocbimv22008198m.g","KQ417484",19343,33435,14092
"20195","Ocbimv22024457m.g","KQ416123",228850,237947,9097
"20196","Ocbimv22036965m.g","KQ416666",1999860,2000162,302
"20197","Ocbimv22012655m.g","KQ417923",609882,611051,1169
"20198","Ocbimv22021303m.g","KQ419026",647871,664691,16820
"20199","Ocbimv22010460m.g","LGKD01579698",319,1125,806
"20200","Ocbimv22021497m.g","KQ419059",208866,319911,111045
"20201","Ocbimv22038085m.g","KQ423213",137061,153206,16145
"20202","Ocbimv22021784m.g","KQ419101",89363,112842,23479
"20203","Ocbimv22022875m.g","KQ419318",174543,178349,3806
"20204","Ocbimv22038876m.g","KQ423484",63403,63900,497
"20205","Ocbimv22003175m.g","KQ417062",173957,176344,2387
"20206","Ocbimv22024544m.g","KQ419593",87960,91619,3659
"20207","Ocbimv22002415m.g","KQ417009",611364,611623,259
"20208","Ocbimv22038612m.g","KQ423415",31082,31520,438
"20209","Ocbimv22014061m.g","KQ415672",478920,522785,43865
"20210","Ocbimv22010651m.g","KQ427464",110798,111596,798
"20211","Ocbimv22020716m.g","KQ418955",100241,101467,1226
"20212","Ocbimv22038226m.g","KQ416731",685067,701447,16380
"20213","Ocbimv22021791m.g","KQ419102",156719,175180,18461
"20214","Ocbimv22039505m.g","KQ423680",140476,147430,6954
"20215","Ocbimv22028424m.g","KQ420483",260763,269705,8942
"20216","Ocbimv22026256m.g","KQ420022",176770,180066,3296
"20217","Ocbimv22000909m.g","KQ424107",43440,81993,38553
"20218","Ocbimv22015928m.g","KQ418303",1019783,1026878,7095
"20219","Ocbimv22032692m.g","KQ416444",793046,793420,374
"20220","Ocbimv22032556m.g","KQ421584",262250,262446,196
"20221","Ocbimv22009341m.g","KQ417584",127645,127953,308
"20222","Ocbimv22020881m.g","KQ418971",611832,639874,28042
"20223","Ocbimv22029983m.g","KQ420872",269,649,380
"20224","Ocbimv22003750m.g","KQ417105",332155,333150,995
"20225","Ocbimv22020357m.g","KQ418900",172197,173101,904
"20226","Ocbimv22003100m.g","KQ415796",309488,350703,41215
"20227","Ocbimv22027063m.g","KQ420173",179329,179802,473
"20228","Ocbimv22007257m.g","KQ426271",95072,105342,10270
"20229","Ocbimv22036340m.g","KQ422717",25484,38188,12704
"20230","Ocbimv22007977m.g","KQ426514",12695,13682,987
"20231","Ocbimv22008849m.g","KQ426790",91639,103055,11416
"20232","Ocbimv22002874m.g","KQ417044",51017,56383,5366
"20233","Ocbimv22038346m.g","KQ416737",1198294,1208079,9785
"20234","Ocbimv22015118m.g","KQ418196",115639,115970,331
"20235","Ocbimv22034093m.g","KQ421974",13063,26869,13806
"20236","Ocbimv22022178m.g","KQ419180",565420,565779,359
"20237","Ocbimv22005512m.g","LGKD01152367",575,817,242
"20238","Ocbimv22008861m.g","KQ426791",322934,338007,15073
"20239","Ocbimv22003548m.g","KQ417090",1705948,1709428,3480
"20240","Ocbimv22003107m.g","KQ424883",88063,88554,491
"20241","Ocbimv22028085m.g","KQ420428",128789,150042,21253
"20242","Ocbimv22014542m.g","KQ428981",110537,152040,41503
"20243","Ocbimv22002443m.g","KQ424659",67730,70891,3161
"20244","Ocbimv22037032m.g","KQ422909",394529,426186,31657
"20245","Ocbimv22021332m.g","KQ419031",641412,642480,1068
"20246","Ocbimv22003804m.g","KQ425115",176975,183323,6348
"20247","Ocbimv22026703m.g","KQ420096",71135,73893,2758
"20248","Ocbimv22029697m.g","KQ420807",13141,13893,752
"20249","Ocbimv22025220m.g","KQ419738",435721,513880,78159
"20250","Ocbimv22014065m.g","KQ428741",20350,20517,167
"20251","Ocbimv22016198m.g","KQ415678",318290,320553,2263
"20252","Ocbimv22012755m.g","KQ415909",388901,389188,287
"20253","Ocbimv22037636m.g","KQ423084",63702,64546,844
"20254","Ocbimv22036218m.g","KQ422681",163522,164738,1216
"20255","Ocbimv22012323m.g","KQ415907",390629,407062,16433
"20256","Ocbimv22012385m.g","KQ417908",153008,164845,11837
"20257","Ocbimv22036214m.g","KQ422680",275855,301163,25308
"20258","Ocbimv22039378m.g","KQ423634",288792,362781,73989
"20259","Ocbimv22010021m.g","KQ427207",90878,94717,3839
"20260","Ocbimv22005984m.g","KQ417288",390552,391136,584
"20261","Ocbimv22027350m.g","KQ416222",149534,153783,4249
"20262","Ocbimv22027356m.g","KQ420264",181451,182704,1253
"20263","Ocbimv22016354m.g","KQ415961",26638,26835,197
"20264","Ocbimv22016509m.g","KQ429904",90494,94710,4216
"20265","Ocbimv22021101m.g","KQ419003",464602,465084,482
"20266","Ocbimv22036949m.g","KQ416666",1332914,1340073,7159
"20267","Ocbimv22031761m.g","KQ421338",809946,814604,4658
"20268","Ocbimv22008009m.g","KQ415849",248152,248357,205
"20269","Ocbimv22011068m.g","KQ415882",7441,8377,936
"20270","Ocbimv22013699m.g","KQ418049",124664,143885,19221
"20271","Ocbimv22011499m.g","KQ417796",402524,408135,5611
"20272","Ocbimv22008989m.g","KQ426829",179867,182213,2346
"20273","Ocbimv22018326m.g","KQ430653",41091,41907,816
"20274","Ocbimv22025821m.g","KQ419909",308792,324650,15858
"20275","Ocbimv22012895m.g","KQ428273",18376,20595,2219
"20276","Ocbimv22033742m.g","KQ421864",105372,115480,10108
"20277","Ocbimv22013491m.g","KQ428533",74916,173945,99029
"20278","Ocbimv22016248m.g","KQ418332",1,1651,1650
"20279","Ocbimv22028885m.g","KQ416274",55289,234013,178724
"20280","Ocbimv22014649m.g","KQ429025",23191,38574,15383
"20281","Ocbimv22014197m.g","KQ418100",52944,60394,7450
"20282","Ocbimv22019009m.g","KQ418710",1802797,1803027,230
"20283","Ocbimv22028666m.g","LGKD01358580",3,416,413
"20284","Ocbimv22005489m.g","KQ425619",146412,161382,14970
"20285","Ocbimv22023796m.g","KQ419477",205306,208439,3133
"20286","Ocbimv22031318m.g","KQ421217",813900,814358,458
"20287","Ocbimv22028083m.g","KQ420428",118115,118995,880
"20288","Ocbimv22013844m.g","KQ418068",37445,40635,3190
"20289","Ocbimv22004201m.g","KQ425223",55256,55794,538
"20290","Ocbimv22035652m.g","KQ422493",188246,204597,16351
"20291","Ocbimv22030431m.g","KQ420978",313017,313367,350
"20292","Ocbimv22013704m.g","KQ418049",193529,205730,12201
"20293","Ocbimv22039300m.g","KQ423609",857888,889531,31643
"20294","Ocbimv22018774m.g","KQ418671",96481,101325,4844
"20295","Ocbimv22024648m.g","KQ419606",62566,160111,97545
"20296","Ocbimv22009323m.g","KQ415863",131112,131354,242
"20297","Ocbimv22033556m.g","KQ421830",104696,121773,17077
"20298","Ocbimv22011203m.g","KQ427679",33897,34169,272
"20299","Ocbimv22005595m.g","KQ425660",102934,104254,1320
"20300","Ocbimv22005017m.g","KQ417224",163837,167880,4043
"20301","Ocbimv22027191m.g","KQ420215",52947,59398,6451
"20302","Ocbimv22002255m.g","KQ424585",140813,157412,16599
"20303","Ocbimv22005566m.g","KQ425654",168589,171441,2852
"20304","Ocbimv22036505m.g","KQ422781",222188,271808,49620
"20305","Ocbimv22014198m.g","KQ418100",160528,178077,17549
"20306","Ocbimv22024120m.g","KQ419535",715254,715481,227
"20307","Ocbimv22023116m.g","KQ419350",838845,841123,2278
"20308","Ocbimv22018634m.g","KQ418647",40666,60727,20061
"20309","Ocbimv22004933m.g","KQ417214",34197,34930,733
"20310","Ocbimv22015599m.g","KQ415946",644900,656056,11156
"20311","Ocbimv22016983m.g","KQ418431",627939,668841,40902
"20312","Ocbimv22001718m.g","KQ416957",1976,3034,1058
"20313","Ocbimv22003091m.g","KQ424880",61314,69834,8520
"20314","Ocbimv22022910m.g","KQ419324",366576,377649,11073
"20315","Ocbimv22006218m.g","KQ425846",10557,29300,18743
"20316","Ocbimv22012040m.g","KQ427981",6974,84021,77047
"20317","Ocbimv22008224m.g","KQ415852",22196,22959,763
"20318","Ocbimv22001502m.g","KQ424337",64431,96699,32268
"20319","Ocbimv22026346m.g","KQ420031",135709,159876,24167
"20320","Ocbimv22001064m.g","KQ424172",56637,73799,17162
"20321","Ocbimv22027205m.g","KQ420217",744289,744528,239
"20322","Ocbimv22014740m.g","KQ429057",163837,164430,593
"20323","Ocbimv22031567m.g","KQ421281",33086,33358,272
"20324","Ocbimv22037304m.g","KQ422997",838242,856528,18286
"20325","Ocbimv22039507m.g","KQ423680",196342,201884,5542
"20326","Ocbimv22026099m.g","KQ419989",319611,388630,69019
"20327","Ocbimv22034486m.g","KQ422055",262440,296433,33993
"20328","Ocbimv22011506m.g","KQ417796",459426,461110,1684
"20329","Ocbimv22011459m.g","KQ427753",122315,143708,21393
"20330","Ocbimv22034202m.g","KQ422008",45844,81515,35671
"20331","Ocbimv22007833m.g","KQ426466",212134,224045,11911
"20332","Ocbimv22037897m.g","KQ423154",14259,17935,3676
"20333","Ocbimv22020037m.g","KQ418844",63156,80764,17608
"20334","Ocbimv22038365m.g","KQ423295",42761,47163,4402
"20335","Ocbimv22018665m.g","KQ430792",27021,27740,719
"20336","Ocbimv22005244m.g","KQ417234",335567,345536,9969
"20337","Ocbimv22009103m.g","KQ417562",276710,295185,18475
"20338","Ocbimv22032481m.g","KQ416432",66039,92668,26629
"20339","Ocbimv22035692m.g","KQ422516",697962,698377,415
"20340","Ocbimv22005098m.g","KQ417228",157578,158051,473
"20341","Ocbimv22038267m.g","KQ416733",239182,240362,1180
"20342","Ocbimv22031289m.g","KQ421217",134487,286824,152337
"20343","Ocbimv22012047m.g","KQ427990",32277,68172,35895
"20344","Ocbimv22029718m.g","KQ420813",577686,587736,10050
"20345","Ocbimv22034158m.g","KQ416515",67381,67764,383
"20346","Ocbimv22023424m.g","KQ419407",13519,70826,57307
"20347","Ocbimv22007558m.g","KQ417425",149637,150027,390
"20348","Ocbimv22019445m.g","KQ418767",382535,382936,401
"20349","Ocbimv22033257m.g","KQ421758",1495991,1498868,2877
"20350","Ocbimv22010816m.g","KQ427527",56252,89223,32971
"20351","Ocbimv22038066m.g","KQ416724",5152,16717,11565
"20352","Ocbimv22021219m.g","KQ419014",94181,94363,182
"20353","Ocbimv22008633m.g","KQ426714",147520,147678,158
"20354","Ocbimv22038748m.g","KQ416765",83477,83872,395
"20355","Ocbimv22022124m.g","KQ419175",364942,365457,515
"20356","Ocbimv22010668m.g","KQ427465",18613,28669,10056
"20357","Ocbimv22033700m.g","KQ416491",514083,533620,19537
"20358","Ocbimv22033138m.g","KQ421733",126247,127118,871
"20359","Ocbimv22012909m.g","KQ415670",83952,113070,29118
"20360","Ocbimv22019540m.g","KQ418783",153088,174535,21447
"20361","Ocbimv22007907m.g","KQ417459",234719,235084,365
"20362","Ocbimv22032211m.g","KQ416425",657780,659422,1642
"20363","Ocbimv22007612m.g","KQ417438",70889,72204,1315
"20364","Ocbimv22013550m.g","KQ418036",14251,23561,9310
"20365","Ocbimv22008721m.g","KQ415858",2352880,2353140,260
"20366","Ocbimv22017301m.g","KQ430251",27267,38083,10816
"20367","Ocbimv22000770m.g","KQ416879",360818,409968,49150
"20368","Ocbimv22010112m.g","KQ427263",119617,148193,28576
"20369","Ocbimv22019850m.g","KQ418821",773237,790007,16770
"20370","Ocbimv22017400m.g","KQ430284",24855,25373,518
"20371","Ocbimv22025421m.g","KQ419796",50272,59811,9539
"20372","Ocbimv22007526m.g","KQ417421",139788,157863,18075
"20373","Ocbimv22014977m.g","KQ418190",8390,9691,1301
"20374","Ocbimv22031496m.g","KQ421261",431261,441860,10599
"20375","Ocbimv22035065m.g","KQ422263",224379,225951,1572
"20376","Ocbimv22014759m.g","KQ418175",773292,813958,40666
"20377","Ocbimv22007639m.g","KQ415845",698806,719570,20764
"20378","Ocbimv22034823m.g","KQ422187",317938,445829,127891
"20379","Ocbimv22023317m.g","KQ416087",1997818,1997982,164
"20380","Ocbimv22032872m.g","KQ416454",127000,186289,59289
"20381","Ocbimv22015481m.g","LGKD01619247",17,511,494
"20382","Ocbimv22035220m.g","KQ422320",128708,129231,523
"20383","Ocbimv22023744m.g","KQ419470",685502,759562,74060
"20384","Ocbimv22021486m.g","KQ419056",208015,220096,12081
"20385","Ocbimv22004926m.g","KQ425470",229981,243760,13779
"20386","Ocbimv22022534m.g","KQ419241",516482,517789,1307
"20387","Ocbimv22003303m.g","KQ417078",19954,61193,41239
"20388","Ocbimv22037208m.g","KQ416683",147411,149585,2174
"20389","Ocbimv22008672m.g","KQ417519",860234,864132,3898
"20390","Ocbimv22003217m.g","KQ417064",44443,46194,1751
"20391","Ocbimv22035089m.g","KQ422274",133486,134377,891
"20392","Ocbimv22028608m.g","KQ416263",797586,798607,1021
"20393","Ocbimv22022368m.g","KQ432701",17294,18661,1367
"20394","Ocbimv22026321m.g","KQ420026",149902,161486,11584
"20395","Ocbimv22029780m.g","KQ420821",215160,235401,20241
"20396","Ocbimv22021253m.g","KQ419020",171851,172231,380
"20397","Ocbimv22033625m.g","KQ421852",14308,14490,182
"20398","Ocbimv22025896m.g","KQ416175",691513,695622,4109
"20399","Ocbimv22010532m.g","KQ417687",1344102,1344746,644
"20400","Ocbimv22004538m.g","KQ415805",2201794,2201943,149
"20401","Ocbimv22021193m.g","KQ416040",340481,364919,24438
"20402","Ocbimv22005937m.g","KQ417285",57756,58116,360
"20403","Ocbimv22016744m.g","KQ429989",93486,113025,19539
"20404","Ocbimv22037457m.g","KQ423037",95706,128858,33152
"20405","Ocbimv22016586m.g","KQ418368",425423,426724,1301
"20406","Ocbimv22025550m.g","KQ416158",106341,114791,8450
"20407","Ocbimv22028204m.g","KQ420444",210441,217607,7166
"20408","Ocbimv22013141m.g","KQ417985",1279682,1281194,1512
"20409","Ocbimv22028173m.g","KQ416252",42387,56119,13732
"20410","Ocbimv22012526m.g","KQ417917",688392,695360,6968
"20411","Ocbimv22017123m.g","KQ418453",951,1993,1042
"20412","Ocbimv22019399m.g","KQ418760",49010,49249,239
"20413","Ocbimv22038062m.g","KQ423210",91755,110729,18974
"20414","Ocbimv22019155m.g","KQ418723",437436,450192,12756
"20415","Ocbimv22036183m.g","KQ422667",147965,158697,10732
"20416","Ocbimv22016512m.g","KQ429904",170220,171401,1181
"20417","Ocbimv22003231m.g","KQ424913",15187,15465,278
"20418","Ocbimv22002119m.g","LGKD01509475",55,459,404
"20419","Ocbimv22005316m.g","KQ425580",56492,69596,13104
"20420","Ocbimv22028900m.g","KQ416274",894794,903167,8373
"20421","Ocbimv22024853m.g","KQ419640",178616,179407,791
"20422","Ocbimv22026945m.g","KQ420146",382438,396128,13690
"20423","Ocbimv22017896m.g","KQ418555",1177685,1179965,2280
"20424","Ocbimv22013015m.g","KQ417972",381895,422294,40399
"20425","Ocbimv22016676m.g","KQ418380",25792,25953,161
"20426","Ocbimv22004358m.g","KQ417152",821718,822003,285
"20427","Ocbimv22025018m.g","KQ416136",137285,153132,15847
"20428","Ocbimv22037923m.g","KQ423169",138749,142466,3717
"20429","Ocbimv22009133m.g","KQ417566",159610,176038,16428
"20430","Ocbimv22008763m.g","KQ426760",369261,394138,24877
"20431","Ocbimv22015628m.g","KQ418269",799680,801835,2155
"20432","Ocbimv22016564m.g","KQ429917",60986,62788,1802
"20433","Ocbimv22014652m.g","KQ429026",237377,246322,8945
"20434","Ocbimv22001279m.g","KQ424250",357086,372259,15173
"20435","Ocbimv22009896m.g","KQ417621",865820,903231,37411
"20436","Ocbimv22035666m.g","KQ422496",92577,93945,1368
"20437","Ocbimv22025057m.g","KQ416136",1038325,1053166,14841
"20438","Ocbimv22006116m.g","KQ417299",1868,33371,31503
"20439","Ocbimv22009892m.g","KQ417621",583242,585473,2231
"20440","Ocbimv22000900m.g","KQ415781",25285,29088,3803
"20441","Ocbimv22002675m.g","KQ424735",177497,178391,894
"20442","Ocbimv22030111m.g","KQ420892",125588,140906,15318
"20443","Ocbimv22027428m.g","KQ420273",131174,134285,3111
"20444","Ocbimv22028162m.g","KQ420439",256740,265829,9089
"20445","Ocbimv22009296m.g","KQ417581",34290,45000,10710
"20446","Ocbimv22029897m.g","KQ420840",511060,514165,3105
"20447","Ocbimv22015861m.g","KQ418297",381908,413961,32053
"20448","Ocbimv22004251m.g","KQ425239",187217,187600,383
"20449","Ocbimv22034143m.g","KQ421987",49478,67932,18454
"20450","Ocbimv22001185m.g","KQ424218",79304,79462,158
"20451","Ocbimv22035438m.g","KQ415750",56090,69182,13092
"20452","Ocbimv22039889m.g","KQ416833",1096559,1097060,501
"20453","Ocbimv22014210m.g","KQ418101",60620,62665,2045
"20454","Ocbimv22007624m.g","KQ417438",654103,676121,22018
"20455","Ocbimv22032651m.g","KQ421627",71065,87243,16178
"20456","Ocbimv22035059m.g","KQ422263",132005,132409,404
"20457","Ocbimv22002219m.g","KQ424575",139004,139189,185
"20458","Ocbimv22016086m.g","KQ429704",62678,63233,555
"20459","Ocbimv22036308m.g","KQ416632",135969,136196,227
"20460","Ocbimv22002379m.g","KQ415792",850160,851348,1188
"20461","Ocbimv22005938m.g","KQ417285",80627,94783,14156
"20462","Ocbimv22029484m.g","KQ416308",911761,914193,2432
"20463","Ocbimv22026176m.g","KQ420009",325383,326750,1367
"20464","Ocbimv22015015m.g","KQ418194",291390,299237,7847
"20465","Ocbimv22034377m.g","KQ422021",437932,449447,11515
"20466","Ocbimv22006630m.g","KQ426041",3446,4617,1171
"20467","Ocbimv22011825m.g","KQ415893",914074,914382,308
"20468","Ocbimv22023542m.g","LGKD01689850",3,152,149
"20469","Ocbimv22009370m.g","KQ426978",47545,48515,970
"20470","Ocbimv22031918m.g","KQ421376",1192936,1193139,203
"20471","Ocbimv22014638m.g","KQ418160",398835,434963,36128
"20472","Ocbimv22014664m.g","KQ418166",41590,45508,3918
"20473","Ocbimv22032867m.g","KQ416454",39947,85193,45246
"20474","Ocbimv22030100m.g","KQ420892",1,5030,5029
"20475","Ocbimv22005334m.g","KQ417245",13918,14256,338
"20476","Ocbimv22025095m.g","KQ416137",472214,474556,2342
"20477","Ocbimv22023698m.g","KQ416093",129838,130098,260
"20478","Ocbimv22015541m.g","KQ418265",551,974,423
"20479","Ocbimv22015361m.g","KQ429295",28732,58440,29708
"20480","Ocbimv22005072m.g","KQ425511",7933,8130,197
"20481","Ocbimv22005204m.g","KQ417232",900559,902598,2039
"20482","Ocbimv22036893m.g","KQ422894",9979,36663,26684
"20483","Ocbimv22037129m.g","KQ422932",36339,42514,6175
"20484","Ocbimv22036283m.g","LGKD01449679",3,332,329
"20485","Ocbimv22025243m.g","KQ419743",379528,408379,28851
"20486","Ocbimv22016058m.g","KQ415952",26467,35292,8825
"20487","Ocbimv22030627m.g","KQ416359",1417939,1429647,11708
"20488","Ocbimv22023549m.g","KQ433461",13819,14049,230
"20489","Ocbimv22020310m.g","KQ418888",158267,158805,538
"20490","Ocbimv22014232m.g","KQ428805",30404,30942,538
"20491","Ocbimv22030206m.g","KQ420924",137640,140440,2800
"20492","Ocbimv22004685m.g","KQ417198",158004,159320,1316
"20493","Ocbimv22027332m.g","KQ420261",163054,171822,8768
"20494","Ocbimv22038640m.g","KQ423430",331910,332176,266
"20495","Ocbimv22003911m.g","KQ417122",59895,61397,1502
"20496","Ocbimv22005551m.g","LGKD01538968",66,221,155
"20497","Ocbimv22034851m.g","KQ422195",6766,52897,46131
"20498","Ocbimv22035147m.g","KQ422290",369957,370396,439
"20499","Ocbimv22017385m.g","KQ430272",309176,309869,693
"20500","Ocbimv22003774m.g","KQ417112",146042,153021,6979
"20501","Ocbimv22011157m.g","KQ417754",78627,82077,3450
"20502","Ocbimv22013372m.g","KQ428468",382936,383379,443
"20503","Ocbimv22018154m.g","KQ418578",178567,178809,242
"20504","Ocbimv22026313m.g","KQ420025",34711,55061,20350
"20505","Ocbimv22010848m.g","KQ417719",370895,379219,8324
"20506","Ocbimv22012266m.g","KQ417896",159449,161993,2544
"20507","Ocbimv22010439m.g","KQ427386",150651,152365,1714
"20508","Ocbimv22025893m.g","KQ416175",613762,620753,6991
"20509","Ocbimv22009736m.g","KQ417609",244120,332724,88604
"20510","Ocbimv22011558m.g","KQ417802",422216,441924,19708
"20511","Ocbimv22032185m.g","KQ421472",58434,59266,832
"20512","Ocbimv22034712m.g","KQ422121",92911,93183,272
"20513","Ocbimv22002083m.g","KQ424537",115802,122005,6203
"20514","Ocbimv22021590m.g","KQ432245",16430,17316,886
"20515","Ocbimv22030745m.g","KQ421083",173267,214796,41529
"20516","Ocbimv22020778m.g","KQ418964",194396,208495,14099
"20517","Ocbimv22004238m.g","KQ417143",170983,194099,23116
"20518","Ocbimv22018595m.g","KQ418644",591221,593745,2524
"20519","Ocbimv22021958m.g","LGKD01673194",1272,2184,912
"20520","Ocbimv22039401m.g","KQ423650",17471,20866,3395
"20521","Ocbimv22007953m.g","LGKD01559370",413,667,254
"20522","Ocbimv22017056m.g","KQ418445",365294,367605,2311
"20523","Ocbimv22002383m.g","KQ417007",218182,228483,10301
"20524","Ocbimv22004226m.g","KQ417143",42246,42743,497
"20525","Ocbimv22023457m.g","KQ419414",349874,350717,843
"20526","Ocbimv22021345m.g","KQ416042",770826,771527,701
"20527","Ocbimv22024473m.g","KQ419584",137724,137924,200
"20528","Ocbimv22033701m.g","KQ416491",540825,556070,15245
"20529","Ocbimv22022109m.g","KQ419168",33710,121769,88059
"20530","Ocbimv22016791m.g","KQ430030",9404,11169,1765
"20531","Ocbimv22012123m.g","KQ415902",32177,57528,25351
"20532","Ocbimv22034658m.g","KQ416544",227715,232756,5041
"20533","Ocbimv22039532m.g","KQ423697",11044,11766,722
"20534","Ocbimv22018611m.g","KQ418644",863842,864081,239
"20535","Ocbimv22008213m.g","KQ417487",578509,644509,66000
"20536","Ocbimv22024133m.g","KQ419538",143994,144167,173
"20537","Ocbimv22020592m.g","KQ418928",334993,337021,2028
"20538","Ocbimv22007314m.g","KQ426287",293112,295528,2416
"20539","Ocbimv22037645m.g","KQ416705",188106,302762,114656
"20540","Ocbimv22017486m.g","KQ430314",113949,114599,650
"20541","Ocbimv22015258m.g","KQ418216",444426,525000,80574
"20542","Ocbimv22012874m.g","KQ428260",2534,12811,10277
"20543","Ocbimv22039365m.g","KQ423631",258462,279322,20860
"20544","Ocbimv22016470m.g","KQ415966",155186,155344,158
"20545","Ocbimv22021072m.g","KQ418998",35210,89356,54146
"20546","Ocbimv22021723m.g","KQ416053",13475,13930,455
"20547","Ocbimv22027953m.g","KQ420409",347251,358163,10912
"20548","Ocbimv22034260m.g","KQ422015",201696,219219,17523
"20549","Ocbimv22019386m.g","KQ431108",101050,114818,13768
"20550","Ocbimv22009359m.g","KQ426964",40021,40468,447
"20551","Ocbimv22030308m.g","KQ420942",333112,333459,347
"20552","Ocbimv22027653m.g","KQ420330",578520,578759,239
"20553","Ocbimv22023716m.g","KQ433592",2936,11598,8662
"20554","Ocbimv22027287m.g","KQ420243",32868,33823,955
"20555","Ocbimv22003299m.g","KQ417077",2307,2900,593
"20556","Ocbimv22010281m.g","KQ427344",114139,116848,2709
"20557","Ocbimv22033890m.g","KQ421899",96099,100666,4567
"20558","Ocbimv22038150m.g","KQ423220",23818,24207,389
"20559","Ocbimv22006849m.g","KQ417358",324935,336855,11920
"20560","Ocbimv22011451m.g","KQ427752",10956,11180,224
"20561","Ocbimv22002901m.g","KQ424815",53,9624,9571
"20562","Ocbimv22007372m.g","KQ426313",320367,320581,214
"20563","Ocbimv22028709m.g","KQ420562",168101,191676,23575
"20564","Ocbimv22006406m.g","KQ425904",83403,84092,689
"20565","Ocbimv22008060m.g","KQ426556",119517,119855,338
"20566","Ocbimv22016529m.g","KQ418364",593104,593589,485
"20567","Ocbimv22008673m.g","KQ417519",1141548,1161852,20304
"20568","Ocbimv22003998m.g","KQ417129",611503,611826,323
"20569","Ocbimv22025431m.g","KQ419797",406359,406634,275
"20570","Ocbimv22021402m.g","KQ432116",116345,119278,2933
"20571","Ocbimv22034203m.g","KQ422008",113041,115261,2220
"20572","Ocbimv22000928m.g","KQ424119",13318,14403,1085
"20573","Ocbimv22015507m.g","KQ418263",1244643,1244951,308
"20574","Ocbimv22017431m.g","KQ418495",431054,468939,37885
"20575","Ocbimv22026127m.g","KQ419991",156137,240129,83992
"20576","Ocbimv22029782m.g","KQ420821",264031,272683,8652
"20577","Ocbimv22011572m.g","KQ427785",143715,143978,263
"20578","Ocbimv22001180m.g","KQ424217",71208,71819,611
"20579","Ocbimv22028375m.g","KQ420480",98141,98569,428
"20580","Ocbimv22015856m.g","KQ418297",90343,90986,643
"20581","Ocbimv22024758m.g","KQ419623",141686,143915,2229
"20582","Ocbimv22017414m.g","KQ418493",80390,81472,1082
"20583","Ocbimv22002738m.g","KQ424767",22627,24444,1817
"20584","Ocbimv22029158m.g","KQ420671",29593,29775,182
"20585","Ocbimv22038326m.g","KQ423283",38177,38846,669
"20586","Ocbimv22000830m.g","KQ424085",176647,177084,437
"20587","Ocbimv22029923m.g","KQ420849",89556,98592,9036
"20588","Ocbimv22002337m.g","KQ415791",3447,6641,3194
"20589","Ocbimv22039587m.g","KQ423712",225716,231748,6032
"20590","Ocbimv22015423m.g","KQ429328",12910,13377,467
"20591","Ocbimv22015024m.g","KQ418194",389963,410976,21013
"20592","Ocbimv22004709m.g","KQ417199",65835,114158,48323
"20593","Ocbimv22023746m.g","KQ419473",11686,93550,81864
"20594","Ocbimv22009499m.g","KQ415865",465371,468176,2805
"20595","Ocbimv22020258m.g","KQ418878",21988,24578,2590
"20596","Ocbimv22019065m.g","KQ416006",30315,30533,218
"20597","Ocbimv22001922m.g","KQ424478",12860,27436,14576
"20598","Ocbimv22006432m.g","KQ417319",1531,7708,6177
"20599","Ocbimv22024696m.g","KQ419616",12061,13056,995
"20600","Ocbimv22010011m.g","KQ427205",87287,90383,3096
"20601","Ocbimv22037772m.g","LGKD01463888",8442,10382,1940
"20602","Ocbimv22007460m.g","KQ426348",2411,4088,1677
"20603","Ocbimv22013430m.g","KQ418022",163797,164351,554
"20604","Ocbimv22000276m.g","KQ423910",479310,506877,27567
"20605","Ocbimv22011871m.g","KQ427941",163778,196205,32427
"20606","Ocbimv22021992m.g","KQ419142",46125,48220,2095
"20607","Ocbimv22022749m.g","KQ416074",937435,984134,46699
"20608","Ocbimv22004835m.g","KQ417209",149874,150664,790
"20609","Ocbimv22036176m.g","KQ422664",50973,60541,9568
"20610","Ocbimv22017504m.g","KQ430326",37847,39202,1355
"20611","Ocbimv22029878m.g","KQ420828",2161433,2162240,807
"20612","Ocbimv22012750m.g","KQ428218",15568,16035,467
"20613","Ocbimv22016820m.g","KQ430048",14579,15013,434
"20614","Ocbimv22007230m.g","LGKD01162536",347,751,404
"20615","Ocbimv22006523m.g","KQ425982",11193,11837,644
"20616","Ocbimv22009865m.g","KQ417620",1833071,1877777,44706
"20617","Ocbimv22000695m.g","KQ424055",709211,750498,41287
"20618","Ocbimv22023545m.g","KQ416091",155062,155406,344
"20619","Ocbimv22005810m.g","KQ415823",1314436,1357883,43447
"20620","Ocbimv22027543m.g","KQ420299",1488784,1497963,9179
"20621","Ocbimv22030777m.g","KQ421086",73718,77455,3737
"20622","Ocbimv22030932m.g","KQ421121",223014,234715,11701
"20623","Ocbimv22037234m.g","KQ422973",21081,23259,2178
"20624","Ocbimv22002419m.g","KQ417009",1021230,1061575,40345
"20625","Ocbimv22017678m.g","KQ418527",255539,255940,401
"20626","Ocbimv22014513m.g","KQ415932",437830,438297,467
"20627","Ocbimv22031874m.g","KQ421370",9590,13922,4332
"20628","Ocbimv22016998m.g","KQ418431",974300,990733,16433
"20629","Ocbimv22005918m.g","KQ417284",335570,337232,1662
"20630","Ocbimv22028886m.g","KQ416274",269740,271713,1973
"20631","Ocbimv22030889m.g","KQ421117",147064,167468,20404
"20632","Ocbimv22016785m.g","KQ430029",19701,20583,882
"20633","Ocbimv22036866m.g","KQ422880",14092,14560,468
"20634","Ocbimv22033464m.g","KQ421819",233078,233407,329
"20635","Ocbimv22023994m.g","KQ419514",1145618,1146673,1055
"20636","Ocbimv22030980m.g","KQ421139",51003,53880,2877
"20637","Ocbimv22023629m.g","KQ419448",1979,2407,428
"20638","Ocbimv22034416m.g","KQ422034",66794,77949,11155
"20639","Ocbimv22031146m.g","KQ421175",431807,434071,2264
"20640","Ocbimv22026157m.g","KQ420006",222393,224627,2234
"20641","Ocbimv22007431m.g","KQ417413",8240,8484,244
"20642","Ocbimv22034520m.g","KQ422068",82171,83162,991
"20643","Ocbimv22014694m.g","KQ418168",542702,591113,48411
"20644","Ocbimv22001270m.g","KQ424245",35929,51137,15208
"20645","Ocbimv22009267m.g","KQ417578",1351085,1352956,1871
"20646","Ocbimv22020105m.g","KQ418855",166948,168485,1537
"20647","Ocbimv22028448m.g","KQ420490",81842,83257,1415
"20648","Ocbimv22004963m.g","KQ425487",238462,299866,61404
"20649","Ocbimv22028785m.g","KQ420583",135195,196289,61094
"20650","Ocbimv22035787m.g","KQ422538",28399,47051,18652
"20651","Ocbimv22027951m.g","KQ420409",322384,327096,4712
"20652","Ocbimv22000863m.g","KQ424096",113985,129586,15601
"20653","Ocbimv22021672m.g","KQ416049",452315,468517,16202
"20654","Ocbimv22011781m.g","KQ417831",477465,477710,245
"20655","Ocbimv22027086m.g","KQ420176",74242,154801,80559
"20656","Ocbimv22018353m.g","KQ418610",70625,80278,9653
"20657","Ocbimv22020373m.g","KQ418900",551626,555984,4358
"20658","Ocbimv22011508m.g","KQ417796",478560,484796,6236
"20659","Ocbimv22031891m.g","KQ421373",246199,246925,726
"20660","Ocbimv22039463m.g","KQ423672",229676,231984,2308
"20661","Ocbimv22021194m.g","KQ416040",368234,423883,55649
"20662","Ocbimv22007044m.g","KQ417371",107672,108031,359
"20663","Ocbimv22003603m.g","KQ425041",311278,350774,39496
"20664","Ocbimv22031218m.g","KQ421200",355794,370859,15065
"20665","Ocbimv22031460m.g","KQ416399",147997,166438,18441
"20666","Ocbimv22030931m.g","KQ421121",192585,223010,30425
"20667","Ocbimv22019927m.g","KQ418836",194141,229575,35434
"20668","Ocbimv22018797m.g","KQ418682",99781,115220,15439
"20669","Ocbimv22017275m.g","KQ418475",158765,160518,1753
"20670","Ocbimv22013150m.g","KQ417989",563188,583436,20248
"20671","Ocbimv22025685m.g","KQ419886",452549,540858,88309
"20672","Ocbimv22006544m.g","KQ426001",1778,4783,3005
"20673","Ocbimv22004625m.g","KQ425392",80737,80934,197
"20674","Ocbimv22021054m.g","KQ431971",21364,25672,4308
"20675","Ocbimv22022837m.g","LGKD01683085",178,288,110
"20676","Ocbimv22004544m.g","KQ417180",70792,71094,302
"20677","Ocbimv22009690m.g","KQ417604",52587,52900,313
"20678","Ocbimv22003854m.g","KQ425131",16053,71166,55113
"20679","Ocbimv22009068m.g","KQ426856",9768,12089,2321
"20680","Ocbimv22002763m.g","KQ424777",673,29987,29314
"20681","Ocbimv22018840m.g","KQ416003",287488,374304,86816
"20682","Ocbimv22034490m.g","KQ422062",73883,76312,2429
"20683","Ocbimv22018151m.g","KQ418577",249841,250059,218
"20684","Ocbimv22013960m.g","KQ418073",313908,360929,47021
"20685","Ocbimv22015120m.g","KQ418196",153570,158404,4834
"20686","Ocbimv22005518m.g","KQ417259",95077,98911,3834
"20687","Ocbimv22025519m.g","KQ419831",189490,260404,70914
"20688","Ocbimv22018402m.g","KQ430684",246418,256798,10380
"20689","Ocbimv22039903m.g","KQ416834",240814,241140,326
"20690","Ocbimv22006206m.g","KQ417304",126148,130189,4041
"20691","Ocbimv22025055m.g","KQ416136",1027626,1036719,9093
"20692","Ocbimv22024060m.g","KQ433775",2965,134058,131093
"20693","Ocbimv22018241m.g","LGKD01641573",280,594,314
"20694","Ocbimv22013512m.g","KQ418031",957192,957707,515
"20695","Ocbimv22038285m.g","KQ423260",269677,271275,1598
"20696","Ocbimv22037903m.g","KQ423156",1218,1667,449
"20697","Ocbimv22030379m.g","KQ420969",323871,407479,83608
"20698","Ocbimv22025898m.g","KQ416175",865733,866371,638
"20699","Ocbimv22036375m.g","KQ422732",6815,7168,353
"20700","Ocbimv22034029m.g","KQ421951",6323,10106,3783
"20701","Ocbimv22004644m.g","KQ417192",41544,79207,37663
"20702","Ocbimv22017167m.g","KQ418459",206555,208850,2295
"20703","Ocbimv22034061m.g","KQ416508",741765,742751,986
"20704","Ocbimv22034549m.g","KQ416536",866982,894743,27761
"20705","Ocbimv22002919m.g","KQ424838",9165,42195,33030
"20706","Ocbimv22023660m.g","KQ419456",517034,676532,159498
"20707","Ocbimv22034683m.g","KQ416547",44599,51580,6981
"20708","Ocbimv22038304m.g","KQ423274",183615,185463,1848
"20709","Ocbimv22018642m.g","KQ418649",270319,371817,101498
"20710","Ocbimv22007259m.g","KQ417395",133699,153699,20000
"20711","Ocbimv22011751m.g","KQ415890",30273,73408,43135
"20712","Ocbimv22033103m.g","KQ421727",134867,244807,109940
"20713","Ocbimv22031549m.g","KQ421273",475054,475852,798
"20714","Ocbimv22025630m.g","KQ419863",100484,101610,1126
"20715","Ocbimv22020896m.g","KQ418974",203695,215228,11533
"20716","Ocbimv22012414m.g","KQ417911",101795,102634,839
"20717","Ocbimv22015150m.g","KQ418200",484232,500137,15905
"20718","Ocbimv22019419m.g","KQ418762",35348,40815,5467
"20719","Ocbimv22013555m.g","KQ428572",10739,17165,6426
"20720","Ocbimv22031063m.g","KQ416383",34563,58474,23911
"20721","Ocbimv22013367m.g","KQ418016",50476,51693,1217
"20722","Ocbimv22009982m.g","KQ417629",421412,424095,2683
"20723","Ocbimv22011328m.g","KQ417781",12922,26311,13389
"20724","Ocbimv22001661m.g","KQ416951",422982,424796,1814
"20725","Ocbimv22005327m.g","KQ417240",522816,616337,93521
"20726","Ocbimv22020323m.g","KQ418892",296295,296941,646
"20727","Ocbimv22020129m.g","KQ418859",106869,120479,13610
"20728","Ocbimv22029694m.g","KQ420806",16370,17642,1272
"20729","Ocbimv22032924m.g","KQ421685",145554,159296,13742
"20730","Ocbimv22014291m.g","KQ418115",43619,45370,1751
"20731","Ocbimv22008427m.g","KQ417501",184376,184904,528
"20732","Ocbimv22023248m.g","KQ419380",102098,102283,185
"20733","Ocbimv22010748m.g","LGKD01582048",160,489,329
"20734","Ocbimv22039771m.g","KQ423745",10060,10440,380
"20735","Ocbimv22039839m.g","KQ416831",14620,19823,5203
"20736","Ocbimv22004113m.g","KQ417137",189251,342826,153575
"20737","Ocbimv22004017m.g","KQ425188",160329,202412,42083
"20738","Ocbimv22007750m.g","KQ415847",686645,687420,775
"20739","Ocbimv22008770m.g","KQ417533",47698,47901,203
"20740","Ocbimv22022697m.g","LGKD01681586",104,412,308
"20741","Ocbimv22034954m.g","KQ422223",688589,688894,305
"20742","Ocbimv22004865m.g","KQ425454",343394,344765,1371
"20743","Ocbimv22003464m.g","KQ425015",376638,387195,10557
"20744","Ocbimv22001990m.g","KQ416979",940595,984989,44394
"20745","Ocbimv22031947m.g","KQ421389",17195,27603,10408
"20746","Ocbimv22023633m.g","KQ419448",100258,138027,37769
"20747","Ocbimv22025739m.g","KQ415694",61082,106235,45153
"20748","Ocbimv22005464m.g","KQ425611",269932,273430,3498
"20749","Ocbimv22036519m.g","KQ422783",108667,115218,6551
"20750","Ocbimv22002670m.g","KQ424732",16018,17010,992
"20751","Ocbimv22002116m.g","KQ424547",18562,130025,111463
"20752","Ocbimv22005110m.g","KQ415813",171124,181100,9976
"20753","Ocbimv22022193m.g","KQ419184",12933,28094,15161
"20754","Ocbimv22024924m.g","KQ419657",1376836,1377020,184
"20755","Ocbimv22022139m.g","KQ419175",569650,590953,21303
"20756","Ocbimv22013637m.g","KQ428581",24073,48669,24596
"20757","Ocbimv22014775m.g","KQ418176",1026499,1039693,13194
"20758","Ocbimv22039260m.g","KQ423598",92369,167143,74774
"20759","Ocbimv22016008m.g","KQ418310",9499,50771,41272
"20760","Ocbimv22003523m.g","KQ425021",302873,312688,9815
"20761","Ocbimv22005307m.g","KQ425573",90011,100046,10035
"20762","Ocbimv22013297m.g","KQ418007",685268,685645,377
"20763","Ocbimv22029738m.g","KQ420814",222049,222854,805
"20764","Ocbimv22029860m.g","KQ420828",1826584,1827092,508
"20765","Ocbimv22028010m.g","KQ416243",1202629,1202898,269
"20766","Ocbimv22026563m.g","KQ416193",197215,207961,10746
"20767","Ocbimv22031225m.g","KQ421201",155060,156814,1754
"20768","Ocbimv22031263m.g","KQ421208",288777,295571,6794
"20769","Ocbimv22032785m.g","KQ421658",438157,438851,694
"20770","Ocbimv22022652m.g","KQ419277",163108,198563,35455
"20771","Ocbimv22022908m.g","KQ419324",282735,283571,836
"20772","Ocbimv22007420m.g","KQ426334",118478,139468,20990
"20773","Ocbimv22034798m.g","KQ422177",33563,135461,101898
"20774","Ocbimv22038058m.g","KQ423210",59697,71740,12043
"20775","Ocbimv22012334m.g","KQ415907",622693,719622,96929
"20776","Ocbimv22002043m.g","KQ424530",6164,130836,124672
"20777","Ocbimv22004857m.g","KQ415809",361935,375247,13312
"20778","Ocbimv22013679m.g","KQ418045",102910,106399,3489
"20779","Ocbimv22001881m.g","KQ424459",260907,264008,3101
"20780","Ocbimv22010828m.g","KQ417716",5330,42995,37665
"20781","Ocbimv22024960m.g","KQ419666",312575,331900,19325
"20782","Ocbimv22005021m.g","KQ417224",203270,228367,25097
"20783","Ocbimv22013915m.g","KQ418071",473357,473527,170
"20784","Ocbimv22024048m.g","KQ433769",224316,233763,9447
"20785","Ocbimv22023897m.g","LGKD01693833",67,789,722
"20786","Ocbimv22030223m.g","KQ420924",399544,399799,255
"20787","Ocbimv22029564m.g","KQ420776",687041,709040,21999
"20788","Ocbimv22020856m.g","KQ418970",2415601,2417217,1616
"20789","Ocbimv22028149m.g","KQ416251",1659746,1660054,308
"20790","Ocbimv22007075m.g","KQ417377",112325,197903,85578
"20791","Ocbimv22021242m.g","KQ419018",607825,608373,548
"20792","Ocbimv22031051m.g","KQ421147",568543,568986,443
"20793","Ocbimv22014446m.g","KQ428932",5683,5871,188
"20794","Ocbimv22016327m.g","KQ418338",652097,658304,6207
"20795","Ocbimv22007679m.g","KQ415846",26581,27360,779
"20796","Ocbimv22030985m.g","KQ416380",98062,99020,958
"20797","Ocbimv22012613m.g","KQ417921",276065,280159,4094
"20798","Ocbimv22031997m.g","KQ421409",494532,494858,326
"20799","Ocbimv22000205m.g","KQ423898",65564,65906,342
"20800","Ocbimv22032076m.g","KQ416417",180215,180619,404
"20801","Ocbimv22003557m.g","KQ417090",1795341,1803422,8081
"20802","Ocbimv22023419m.g","LGKD01688353",182,421,239
"20803","Ocbimv22018176m.g","KQ430594",110193,121639,11446
"20804","Ocbimv22036010m.g","KQ422632",234379,234741,362
"20805","Ocbimv22011064m.g","KQ427615",15973,28290,12317
"20806","Ocbimv22014424m.g","KQ418133",189887,190333,446
"20807","Ocbimv22010583m.g","KQ417693",261369,263204,1835
"20808","Ocbimv22033406m.g","KQ421804",107573,108322,749
"20809","Ocbimv22001505m.g","KQ424337",101049,111160,10111
"20810","Ocbimv22021464m.g","KQ416046",1082644,1082928,284
"20811","Ocbimv22027397m.g","KQ416223",260614,261082,468
"20812","Ocbimv22008498m.g","KQ417506",304476,342474,37998
"20813","Ocbimv22033264m.g","KQ421758",1740145,1769482,29337
"20814","Ocbimv22034098m.g","KQ421974",58665,70335,11670
"20815","Ocbimv22019853m.g","KQ418822",20533,21318,785
"20816","Ocbimv22032380m.g","KQ416430",279077,279490,413
"20817","Ocbimv22036881m.g","KQ422889",208165,209088,923
"20818","Ocbimv22015555m.g","KQ429416",225651,226193,542
"20819","Ocbimv22019185m.g","LGKD01649052",190,582,392
"20820","Ocbimv22002762m.g","KQ424775",105246,105674,428
"20821","Ocbimv22038632m.g","KQ423424",171468,182398,10930
"20822","Ocbimv22032100m.g","KQ421445",86631,86885,254
"20823","Ocbimv22001546m.g","KQ424353",186661,187619,958
"20824","Ocbimv22023300m.g","KQ416087",509056,593314,84258
"20825","Ocbimv22033346m.g","KQ416475",160209,169112,8903
"20826","Ocbimv22004796m.g","KQ417208",50188,51042,854
"20827","Ocbimv22003106m.g","KQ424883",40680,41582,902
"20828","Ocbimv22016259m.g","KQ418333",320670,323101,2431
"20829","Ocbimv22025607m.g","KQ419858",233920,247502,13582
"20830","Ocbimv22024030m.g","KQ419524",6794,114982,108188
"20831","Ocbimv22010777m.g","KQ427515",37477,43015,5538
"20832","Ocbimv22012756m.g","KQ415909",653778,653981,203
"20833","Ocbimv22018330m.g","KQ418607",41555,42788,1233
"20834","Ocbimv22030455m.g","KQ416350",348046,406830,58784
"20835","Ocbimv22013724m.g","KQ418053",314234,314398,164
"20836","Ocbimv22033642m.g","KQ421854",327612,328235,623
"20837","Ocbimv22015333m.g","KQ418223",234944,250939,15995
"20838","Ocbimv22039141m.g","KQ423549",831,4889,4058
"20839","Ocbimv22039848m.g","KQ423780",75455,100676,25221
"20840","Ocbimv22022163m.g","KQ419180",263316,264885,1569
"20841","Ocbimv22036299m.g","KQ416631",151741,151926,185
"20842","Ocbimv22030450m.g","KQ416350",121459,121635,176
"20843","Ocbimv22016131m.g","KQ418320",741854,742737,883
"20844","Ocbimv22022725m.g","KQ416074",232522,301875,69353
"20845","Ocbimv22013099m.g","KQ417981",748444,748692,248
"20846","Ocbimv22002944m.g","KQ424851",370902,372284,1382
"20847","Ocbimv22038405m.g","KQ416739",42185,51657,9472
"20848","Ocbimv22020879m.g","KQ418971",534651,610851,76200
"20849","Ocbimv22009013m.g","KQ426841",26807,93958,67151
"20850","Ocbimv22010195m.g","KQ417655",48987,49952,965
"20851","Ocbimv22007440m.g","KQ417414",163760,171876,8116
"20852","Ocbimv22032635m.g","KQ421621",190477,190731,254
"20853","Ocbimv22007065m.g","KQ417374",115501,204912,89411
"20854","Ocbimv22018464m.g","KQ418619",105185,105496,311
"20855","Ocbimv22010747m.g","KQ427491",125900,140413,14513
"20856","Ocbimv22015067m.g","KQ418194",1264693,1266427,1734
"20857","Ocbimv22001042m.g","KQ424160",27558,28370,812
"20858","Ocbimv22006153m.g","KQ417300",935282,936947,1665
"20859","Ocbimv22006101m.g","KQ425820",72340,74978,2638
"20860","Ocbimv22017113m.g","KQ418451",53485,53652,167
"20861","Ocbimv22005686m.g","KQ425711",61568,63619,2051
"20862","Ocbimv22023859m.g","KQ416102",198375,198563,188
"20863","Ocbimv22026378m.g","KQ416188",357346,365054,7708
"20864","Ocbimv22020874m.g","KQ418971",434446,499548,65102
"20865","Ocbimv22001827m.g","KQ424439",29026,31128,2102
"20866","Ocbimv22012283m.g","KQ428101",89642,90578,936
"20867","Ocbimv22013510m.g","KQ418031",890726,949407,58681
"20868","Ocbimv22020184m.g","KQ418870",61149,61460,311
"20869","Ocbimv22029349m.g","KQ420715",23539,23721,182
"20870","Ocbimv22025432m.g","KQ419797",436472,437171,699
"20871","Ocbimv22017629m.g","KQ418516",218964,219113,149
"20872","Ocbimv22028576m.g","KQ420524",299693,321900,22207
"20873","Ocbimv22026269m.g","KQ420022",508792,509841,1049
"20874","Ocbimv22020324m.g","KQ418892",341424,354027,12603
"20875","Ocbimv22039682m.g","KQ416813",1735181,1737591,2410
"20876","Ocbimv22030563m.g","KQ421022",224188,224486,298
"20877","Ocbimv22035606m.g","KQ422461",8516,117132,108616
"20878","Ocbimv22001166m.g","KQ416913",203446,213386,9940
"20879","Ocbimv22001471m.g","KQ424310",57235,57444,209
"20880","Ocbimv22012162m.g","KQ417878",373938,374192,254
"20881","Ocbimv22014120m.g","KQ418092",100067,100321,254
"20882","Ocbimv22022409m.g","KQ416068",17644,26859,9215
"20883","Ocbimv22039959m.g","KQ423809",56660,66933,10273
"20884","Ocbimv22037038m.g","KQ422909",569820,584040,14220
"20885","Ocbimv22015818m.g","KQ418295",144100,144483,383
"20886","Ocbimv22010133m.g","KQ427272",120583,123689,3106
"20887","Ocbimv22014865m.g","KQ418184",204493,205738,1245
"20888","Ocbimv22011479m.g","KQ417795",87412,89403,1991
"20889","Ocbimv22030366m.g","KQ420965",33440,85197,51757
"20890","Ocbimv22000914m.g","KQ424114",28818,35677,6859
"20891","Ocbimv22004280m.g","KQ425255",304123,308823,4700
"20892","Ocbimv22038231m.g","KQ423235",46019,52920,6901
"20893","Ocbimv22037441m.g","KQ423024",202379,202852,473
"20894","Ocbimv22022159m.g","KQ419179",4913,50828,45915
"20895","Ocbimv22013132m.g","KQ417985",395142,462953,67811
"20896","Ocbimv22003320m.g","KQ417080",41179,41418,239
"20897","Ocbimv22014575m.g","KQ428994",50173,61173,11000
"20898","Ocbimv22009669m.g","KQ427061",10452,24317,13865
"20899","Ocbimv22034777m.g","KQ422169",200117,200533,416
"20900","Ocbimv22033419m.g","KQ421809",800,5525,4725
"20901","Ocbimv22017798m.g","KQ418547",530782,531471,689
"20902","Ocbimv22022808m.g","KQ419300",703025,703947,922
"20903","Ocbimv22038851m.g","KQ415768",168110,181783,13673
"20904","Ocbimv22015099m.g","KQ418194",2576848,2631881,55033
"20905","Ocbimv22027478m.g","KQ416225",167251,183826,16575
"20906","Ocbimv22016079m.g","KQ429694",26657,38759,12102
"20907","Ocbimv22024155m.g","KQ419541",306416,371343,64927
"20908","Ocbimv22032217m.g","KQ421482",215479,215640,161
"20909","Ocbimv22039144m.g","KQ416781",307508,309903,2395
"20910","Ocbimv22035021m.g","KQ416568",103000,121382,18382
"20911","Ocbimv22028781m.g","KQ420580",71934,111510,39576
"20912","Ocbimv22026187m.g","KQ420015",142594,143169,575
"20913","Ocbimv22001120m.g","KQ424186",143998,144909,911
"20914","Ocbimv22030265m.g","KQ416339",173518,174116,598
"20915","Ocbimv22020030m.g","KQ418843",236017,242800,6783
"20916","Ocbimv22020451m.g","KQ418914",8594,47854,39260
"20917","Ocbimv22008803m.g","KQ426774",153782,157860,4078
"20918","Ocbimv22031763m.g","KQ416404",521973,524296,2323
"20919","Ocbimv22017296m.g","KQ415976",52920,53486,566
"20920","Ocbimv22006961m.g","KQ426166",21101,21559,458
"20921","Ocbimv22000157m.g","KQ423874",34095,34291,196
"20922","Ocbimv22030772m.g","KQ421085",230445,230915,470
"20923","Ocbimv22006465m.g","KQ417324",316783,331665,14882
"20924","Ocbimv22017007m.g","KQ430115",5057,5560,503
"20925","Ocbimv22008382m.g","KQ417499",108190,108492,302
"20926","Ocbimv22033637m.g","KQ421854",199808,200711,903
"20927","Ocbimv22019363m.g","KQ416009",116675,117035,360
"20928","Ocbimv22039580m.g","KQ423712",118893,122381,3488
"20929","Ocbimv22028282m.g","KQ420458",38306,39966,1660
"20930","Ocbimv22006416m.g","KQ425905",216737,231094,14357
"20931","Ocbimv22038780m.g","KQ416765",940739,941793,1054
"20932","Ocbimv22010456m.g","KQ417678",190363,212064,21701
"20933","Ocbimv22017842m.g","KQ418552",23516,23695,179
"20934","Ocbimv22001631m.g","KQ416950",571149,593347,22198
"20935","Ocbimv22009275m.g","KQ426944",191492,208535,17043
"20936","Ocbimv22016269m.g","KQ429784",132264,133337,1073
"20937","Ocbimv22012821m.g","KQ417943",5389,36645,31256
"20938","Ocbimv22018067m.g","KQ418562",158564,159577,1013
"20939","Ocbimv22008587m.g","KQ417510",375740,376940,1200
"20940","Ocbimv22033129m.g","KQ421731",423709,448732,25023
"20941","Ocbimv22001324m.g","KQ415784",139111,143145,4034
"20942","Ocbimv22020692m.g","KQ418954",438111,438416,305
"20943","Ocbimv22001405m.g","KQ424300",94972,95451,479
"20944","Ocbimv22022806m.g","KQ419300",642467,657377,14910
"20945","Ocbimv22030876m.g","KQ416373",1087284,1097896,10612
"20946","Ocbimv22004674m.g","KQ417196",39896,42118,2222
"20947","Ocbimv22038939m.g","KQ416772",678778,697665,18887
"20948","Ocbimv22029702m.g","KQ420810",136703,138647,1944
"20949","Ocbimv22012482m.g","KQ417917",9908,14574,4666
"20950","Ocbimv22032916m.g","KQ421684",92174,94720,2546
"20951","Ocbimv22003114m.g","KQ417059",65389,71372,5983
"20952","Ocbimv22018994m.g","KQ418708",678033,678221,188
"20953","Ocbimv22036159m.g","KQ422660",67375,67926,551
"20954","Ocbimv22023073m.g","KQ419343",65538,65765,227
"20955","Ocbimv22033572m.g","KQ421836",361589,362446,857
"20956","Ocbimv22001110m.g","KQ424182",242692,275207,32515
"20957","Ocbimv22029413m.g","KQ416305",95975,96172,197
"20958","Ocbimv22029534m.g","KQ420776",35032,56184,21152
"20959","Ocbimv22030421m.g","KQ420978",100487,111146,10659
"20960","Ocbimv22018702m.g","LGKD01645175",22,468,446
"20961","Ocbimv22027680m.g","KQ420337",45734,45967,233
"20962","Ocbimv22028138m.g","KQ416251",1225198,1250804,25606
"20963","Ocbimv22009560m.g","KQ427018",4318,4887,569
"20964","Ocbimv22001089m.g","KQ424177",73570,74489,919
"20965","Ocbimv22038447m.g","KQ423341",88409,90580,2171
"20966","Ocbimv22026132m.g","KQ419994",15540,79245,63705
"20967","Ocbimv22021695m.g","LGKD01670270",118,396,278
"20968","Ocbimv22026027m.g","KQ419958",64559,65689,1130
"20969","Ocbimv22031881m.g","KQ421370",214109,214572,463
"20970","Ocbimv22037861m.g","KQ423141",57597,75483,17886
"20971","Ocbimv22010178m.g","KQ417653",399878,401609,1731
"20972","Ocbimv22007993m.g","KQ417469",82421,82894,473
"20973","Ocbimv22026451m.g","KQ420052",207781,211876,4095
"20974","Ocbimv22031374m.g","KQ416393",373984,374202,218
"20975","Ocbimv22015988m.g","KQ418306",107371,107586,215
"20976","Ocbimv22039252m.g","KQ423592",206405,206674,269
"20977","Ocbimv22016115m.g","KQ418320",236963,237637,674
"20978","Ocbimv22029432m.g","KQ416306",590425,590589,164
"20979","Ocbimv22006536m.g","KQ425992",191702,192019,317
"20980","Ocbimv22012589m.g","KQ417917",1869164,1871213,2049
"20981","Ocbimv22005556m.g","KQ417261",92149,92526,377
"20982","Ocbimv22036216m.g","KQ422680",462543,462854,311
"20983","Ocbimv22008002m.g","KQ415849",29177,29411,234
"20984","Ocbimv22004469m.g","KQ425325",4181,4345,164
"20985","Ocbimv22003596m.g","LGKD01522699",32,223,191
"20986","Ocbimv22028780m.g","KQ420580",44304,68894,24590
"20987","Ocbimv22031476m.g","KQ416399",399251,400918,1667
"20988","Ocbimv22010440m.g","KQ427386",155473,174801,19328
"20989","Ocbimv22032560m.g","KQ421589",288224,289777,1553
"20990","Ocbimv22000317m.g","KQ415776",575114,575380,266
"20991","Ocbimv22030509m.g","KQ421009",440914,442423,1509
"20992","Ocbimv22020944m.g","KQ418982",238124,239116,992
"20993","Ocbimv22024826m.g","KQ416129",52205,52498,293
"20994","Ocbimv22021923m.g","KQ419133",25415,26979,1564
"20995","Ocbimv22004620m.g","KQ415807",7285,7725,440
"20996","Ocbimv22028239m.g","KQ416254",220264,220611,347
"20997","Ocbimv22019407m.g","KQ418760",488522,489411,889
"20998","Ocbimv22004972m.g","KQ425492",14355,14619,264
"20999","Ocbimv22020657m.g","KQ418946",105352,105966,614
"21000","Ocbimv22019392m.g","KQ416010",163174,208729,45555
"21001","Ocbimv22007636m.g","KQ415845",447993,448253,260
"21002","Ocbimv22017276m.g","KQ418475",202866,204052,1186
"21003","Ocbimv22003515m.g","KQ425021",205004,205379,375
"21004","Ocbimv22022077m.g","KQ419158",282441,283175,734
"21005","Ocbimv22031353m.g","KQ421221",17055,17276,221
"21006","Ocbimv22030175m.g","KQ420915",834332,839491,5159
"21007","Ocbimv22024569m.g","KQ434061",27369,30238,2869
"21008","Ocbimv22021076m.g","KQ418998",1029494,1033138,3644
"21009","Ocbimv22039134m.g","KQ416780",62316,62726,410
"21010","Ocbimv22017433m.g","KQ418495",479910,499735,19825
"21011","Ocbimv22034121m.g","KQ421984",1565,2297,732
"21012","Ocbimv22029998m.g","KQ420877",126577,142117,15540
"21013","Ocbimv22003090m.g","KQ424880",55022,59914,4892
"21014","Ocbimv22027010m.g","KQ420162",308174,332023,23849
"21015","Ocbimv22024684m.g","KQ419615",301966,302788,822
"21016","Ocbimv22018825m.g","KQ430889",53645,89978,36333
"21017","Ocbimv22009693m.g","KQ417604",297008,298121,1113
"21018","Ocbimv22026008m.g","KQ416180",295060,305576,10516
"21019","Ocbimv22033410m.g","KQ421805",49700,71042,21342
"21020","Ocbimv22016754m.g","LGKD01630205",1,408,407
"21021","Ocbimv22035576m.g","KQ422439",70835,72296,1461
"21022","Ocbimv22003920m.g","KQ417125",76735,127238,50503
"21023","Ocbimv22030372m.g","KQ420966",272890,273246,356
"21024","Ocbimv22001769m.g","KQ416962",85309,89400,4091
"21025","Ocbimv22019792m.g","KQ431314",92883,98002,5119
"21026","Ocbimv22029209m.g","KQ416291",782755,782910,155
"21027","Ocbimv22026893m.g","KQ420137",167166,167761,595
"21028","Ocbimv22008941m.g","KQ426816",87880,133624,45744
"21029","Ocbimv22019929m.g","KQ418836",261011,292382,31371
"21030","Ocbimv22015774m.g","KQ429553",9251,18319,9068
"21031","Ocbimv22018235m.g","KQ415990",2282189,2282386,197
"21032","Ocbimv22002261m.g","KQ424589",170673,171277,604
"21033","Ocbimv22026405m.g","KQ420039",759769,760119,350
"21034","Ocbimv22008548m.g","KQ426686",10725,25971,15246
"21035","Ocbimv22036107m.g","KQ416617",400506,409397,8891
"21036","Ocbimv22021199m.g","KQ416040",515218,535645,20427
"21037","Ocbimv22011657m.g","KQ427833",602902,603120,218
"21038","Ocbimv22021502m.g","KQ419061",34275,34824,549
"21039","Ocbimv22003562m.g","KQ417090",1824447,1834493,10046
"21040","Ocbimv22015244m.g","KQ418214",198376,198756,380
"21041","Ocbimv22009102m.g","KQ417562",246513,246905,392
"21042","Ocbimv22037629m.g","KQ415761",816181,817472,1291
"21043","Ocbimv22027098m.g","KQ420181",684489,690391,5902
"21044","Ocbimv22021162m.g","LGKD01665837",100,309,209
"21045","Ocbimv22004437m.g","KQ425306",63720,84475,20755
"21046","Ocbimv22037154m.g","KQ416677",687389,744013,56624
"21047","Ocbimv22034212m.g","KQ422009",207678,207905,227
"21048","Ocbimv22037480m.g","KQ423045",3257,12495,9238
"21049","Ocbimv22007344m.g","KQ415841",32151,32468,317
"21050","Ocbimv22037668m.g","KQ416705",2420337,2420837,500
"21051","Ocbimv22035399m.g","KQ422367",156941,157406,465
"21052","Ocbimv22029925m.g","KQ420849",252180,252491,311
"21053","Ocbimv22016282m.g","KQ429791",5615,21907,16292
"21054","Ocbimv22008642m.g","KQ426717",1,10741,10740
"21055","Ocbimv22009875m.g","KQ417621",252578,285603,33025
"21056","Ocbimv22032702m.g","KQ421638",51126,52821,1695
"21057","Ocbimv22028236m.g","KQ416254",40280,40621,341
"21058","Ocbimv22036979m.g","KQ422897",249153,256629,7476
"21059","Ocbimv22007032m.g","KQ417370",615351,618654,3303
"21060","Ocbimv22013530m.g","KQ428551",1,508,507
"21061","Ocbimv22009495m.g","KQ415865",431687,445515,13828
"21062","Ocbimv22035651m.g","KQ422493",132360,135783,3423
"21063","Ocbimv22030943m.g","KQ416376",419776,445706,25930
"21064","Ocbimv22003737m.g","KQ425078",9572,11072,1500
"21065","Ocbimv22019973m.g","KQ418839",586396,598282,11886
"21066","Ocbimv22035543m.g","KQ422426",186593,210822,24229
"21067","Ocbimv22006656m.g","KQ417340",25382,25726,344
"21068","Ocbimv22023516m.g","KQ433432",550,4396,3846
"21069","Ocbimv22032578m.g","KQ421601",205988,206161,173
"21070","Ocbimv22037260m.g","KQ422986",69373,142754,73381
"21071","Ocbimv22001149m.g","KQ416913",23370,36492,13122
"21072","Ocbimv22018488m.g","KQ418626",42512,42846,334
"21073","Ocbimv22024142m.g","KQ419539",79575,138765,59190
"21074","Ocbimv22038452m.g","KQ423343",17278,17599,321
"21075","Ocbimv22024373m.g","KQ419574",1111674,1112311,637
"21076","Ocbimv22030735m.g","KQ421081",2987,109863,106876
"21077","Ocbimv22035174m.g","KQ422295",25877,43826,17949
"21078","Ocbimv22014008m.g","KQ418075",965668,965826,158
"21079","Ocbimv22000193m.g","KQ423891",33795,34986,1191
"21080","Ocbimv22019537m.g","KQ418783",82523,95943,13420
"21081","Ocbimv22035325m.g","KQ422352",9580,10805,1225
"21082","Ocbimv22035403m.g","KQ422367",222839,223138,299
"21083","Ocbimv22009679m.g","LGKD01572577",413,912,499
"21084","Ocbimv22025895m.g","KQ416175",619757,641821,22064
"21085","Ocbimv22018494m.g","KQ418627",357026,357323,297
"21086","Ocbimv22012504m.g","KQ417917",302094,307061,4967
"21087","Ocbimv22023171m.g","KQ419366",399388,399848,460
"21088","Ocbimv22013920m.g","KQ418071",602839,603015,176
"21089","Ocbimv22021564m.g","KQ419078",288336,294356,6020
"21090","Ocbimv22021419m.g","KQ432140",59978,89003,29025
"21091","Ocbimv22027313m.g","KQ420255",146778,147159,381
"21092","Ocbimv22008400m.g","KQ426629",169493,170366,873
"21093","Ocbimv22024095m.g","KQ419533",489647,501019,11372
"21094","Ocbimv22029288m.g","KQ420698",18387,27794,9407
"21095","Ocbimv22005252m.g","KQ425554",86041,125827,39786
"21096","Ocbimv22004565m.g","KQ425361",360650,392185,31535
"21097","Ocbimv22039736m.g","KQ423737",75254,77272,2018
"21098","Ocbimv22015814m.g","KQ418295",121825,123372,1547
"21099","Ocbimv22028973m.g","KQ416278",248662,250648,1986
"21100","Ocbimv22003935m.g","KQ425151",98412,100778,2366
"21101","Ocbimv22009039m.g","KQ415859",521513,546422,24909
"21102","Ocbimv22028352m.g","KQ420477",205126,223942,18816
"21103","Ocbimv22025355m.g","KQ419781",9320,46124,36804
"21104","Ocbimv22002951m.g","KQ424852",46945,75803,28858
"21105","Ocbimv22003626m.g","KQ417095",209143,213600,4457
"21106","Ocbimv22000943m.g","KQ424129",374000,374251,251
"21107","Ocbimv22012241m.g","KQ417892",618004,625998,7994
"21108","Ocbimv22005426m.g","KQ425603",3230,9048,5818
"21109","Ocbimv22001540m.g","KQ424353",4943,5977,1034
"21110","Ocbimv22039213m.g","KQ423576",413897,441514,27617
"21111","Ocbimv22012064m.g","KQ417858",271906,304669,32763
"21112","Ocbimv22017035m.g","KQ430132",3053,3944,891
"21113","Ocbimv22019495m.g","KQ418776",8805,98210,89405
"21114","Ocbimv22006068m.g","KQ425805",196106,196315,209
"21115","Ocbimv22007131m.g","KQ417381",118456,119499,1043
"21116","Ocbimv22016350m.g","KQ415679",340487,343200,2713
"21117","Ocbimv22005885m.g","KQ417281",647690,654056,6366
"21118","Ocbimv22025763m.g","KQ416166",589361,598913,9552
"21119","Ocbimv22021821m.g","KQ415687",300747,300953,206
"21120","Ocbimv22030521m.g","KQ421009",1551665,1554673,3008
"21121","Ocbimv22038524m.g","KQ423384",296568,301220,4652
"21122","Ocbimv22011073m.g","KQ427619",57491,66640,9149
"21123","Ocbimv22006238m.g","KQ417305",105327,105865,538
"21124","Ocbimv22013619m.g","KQ418039",655364,661304,5940
"21125","Ocbimv22014470m.g","KQ418139",249225,249407,182
"21126","Ocbimv22012156m.g","KQ417877",1052289,1066206,13917
"21127","Ocbimv22033022m.g","KQ416464",507885,509207,1322
"21128","Ocbimv22028712m.g","KQ416268",5459,23078,17619
"21129","Ocbimv22014038m.g","KQ428727",3053,5151,2098
"21130","Ocbimv22033711m.g","KQ421860",350231,350536,305
"21131","Ocbimv22001650m.g","KQ416951",15456,30971,15515
"21132","Ocbimv22008277m.g","KQ417493",138941,139141,200
"21133","Ocbimv22006254m.g","KQ417305",495022,502331,7309
"21134","Ocbimv22036114m.g","KQ416618",8567,20106,11539
"21135","Ocbimv22038928m.g","KQ423490",162331,174511,12180
"21136","Ocbimv22036384m.g","KQ422736",438375,439368,993
"21137","Ocbimv22001183m.g","KQ424218",10976,13124,2148
"21138","Ocbimv22000702m.g","KQ416877",285381,304452,19071
"21139","Ocbimv22017198m.g","KQ418465",6954,24727,17773
"21140","Ocbimv22038271m.g","KQ416733",349770,350169,399
"21141","Ocbimv22014196m.g","KQ418100",48259,51006,2747
"21142","Ocbimv22011220m.g","KQ417763",310952,323059,12107
"21143","Ocbimv22039441m.g","KQ416799",426549,427260,711
"21144","Ocbimv22037518m.g","KQ423056",429902,430576,674
"21145","Ocbimv22038418m.g","KQ423329",104419,104652,233
"21146","Ocbimv22036497m.g","KQ422777",209151,229715,20564
"21147","Ocbimv22008185m.g","KQ417482",80364,80893,529
"21148","Ocbimv22038674m.g","KQ423436",25287,25886,599
"21149","Ocbimv22023253m.g","KQ419380",410042,410215,173
"21150","Ocbimv22000347m.g","LGKD01490746",547,1335,788
"21151","Ocbimv22035609m.g","KQ422469",264,802,538
"21152","Ocbimv22031184m.g","KQ415722",80931,84121,3190
"21153","Ocbimv22017749m.g","KQ418537",422544,440305,17761
"21154","Ocbimv22028489m.g","KQ420505",238432,239115,683
"21155","Ocbimv22007961m.g","KQ426505",157726,159375,1649
"21156","Ocbimv22017684m.g","KQ430417",57721,58658,937
"21157","Ocbimv22010677m.g","KQ417701",308541,344175,35634
"21158","Ocbimv22035100m.g","KQ416572",41706,42104,398
"21159","Ocbimv22015577m.g","KQ418267",702279,702488,209
"21160","Ocbimv22001154m.g","KQ416913",120398,126943,6545
"21161","Ocbimv22009944m.g","LGKD01574299",1,261,260
"21162","Ocbimv22016774m.g","KQ430010",711,983,272
"21163","Ocbimv22016239m.g","KQ429763",205854,222882,17028
"21164","Ocbimv22031514m.g","KQ421263",780057,780317,260
"21165","Ocbimv22020777m.g","KQ418964",188882,191568,2686
"21166","Ocbimv22038111m.g","KQ423217",37693,48825,11132
"21167","Ocbimv22008298m.g","KQ426612",10319,26687,16368
"21168","Ocbimv22006075m.g","KQ425807",188510,189255,745
"21169","Ocbimv22020849m.g","KQ418970",2349648,2365944,16296
"21170","Ocbimv22019809m.g","KQ416017",27455,27637,182
"21171","Ocbimv22039030m.g","KQ423515",326753,331417,4664
"21172","Ocbimv22006179m.g","KQ425835",2,55778,55776
"21173","Ocbimv22039624m.g","KQ416810",914367,914779,412
"21174","Ocbimv22014805m.g","KQ418180",170329,171159,830
"21175","Ocbimv22017711m.g","KQ415981",978859,979278,419
"21176","Ocbimv22015473m.g","LGKD01619048",3,191,188
"21177","Ocbimv22012871m.g","KQ417946",107268,107561,293
"21178","Ocbimv22006732m.g","LGKD01159270",41,292,251
"21179","Ocbimv22001886m.g","KQ424459",1248586,1261300,12714
"21180","Ocbimv22020925m.g","KQ418974",2310866,2317387,6521
"21181","Ocbimv22039093m.g","KQ423546",329089,377853,48764
"21182","Ocbimv22023141m.g","KQ416081",245419,246186,767
"21183","Ocbimv22010420m.g","LGKD01579159",816,1067,251
"21184","Ocbimv22029640m.g","KQ420791",7040,7316,276
"21185","Ocbimv22001481m.g","KQ424317",20412,21459,1047
"21186","Ocbimv22023788m.g","KQ419476",17004,135966,118962
"21187","Ocbimv22018339m.g","KQ418609",245500,246044,544
"21188","Ocbimv22016797m.g","KQ418400",152213,152675,462
"21189","Ocbimv22003760m.g","KQ425095",30512,81988,51476
"21190","Ocbimv22006984m.g","KQ417370",26206,51547,25341
"21191","Ocbimv22020543m.g","KQ418922",1389744,1390946,1202
"21192","Ocbimv22034738m.g","KQ422138",374377,385426,11049
"21193","Ocbimv22002735m.g","KQ417030",1267413,1269199,1786
"21194","Ocbimv22016835m.g","KQ430054",7451,7867,416
"21195","Ocbimv22008864m.g","KQ426791",347233,353132,5899
"21196","Ocbimv22005968m.g","KQ425764",196495,206084,9589
"21197","Ocbimv22029146m.g","KQ416288",67597,79548,11951
"21198","Ocbimv22039859m.g","KQ423780",931613,932699,1086
"21199","Ocbimv22016656m.g","KQ418375",598330,622526,24196
"21200","Ocbimv22037151m.g","KQ416677",612954,615830,2876
"21201","Ocbimv22030857m.g","KQ416373",528318,550941,22623
"21202","Ocbimv22012725m.g","KQ417931",239,56914,56675
"21203","Ocbimv22025907m.g","KQ419921",116326,116631,305
"21204","Ocbimv22003244m.g","KQ417068",277918,278190,272
"21205","Ocbimv22000591m.g","KQ424015",149833,184385,34552
"21206","Ocbimv22020497m.g","KQ418919",620708,622023,1315
"21207","Ocbimv22035678m.g","KQ422509",13381,15608,2227
"21208","Ocbimv22035322m.g","KQ422351",660158,673397,13239
"21209","Ocbimv22006520m.g","KQ425980",64624,65490,866
"21210","Ocbimv22022678m.g","KQ419280",544316,603957,59641
"21211","Ocbimv22012486m.g","KQ417917",99649,100180,531
"21212","Ocbimv22028673m.g","KQ420549",362927,400483,37556
"21213","Ocbimv22033880m.g","KQ416497",30776,33886,3110
"21214","Ocbimv22016305m.g","KQ418338",163089,176756,13667
"21215","Ocbimv22022110m.g","KQ419168",161410,162306,896
"21216","Ocbimv22013431m.g","KQ418022",229825,269936,40111
"21217","Ocbimv22020954m.g","KQ416036",51610,63396,11786
"21218","Ocbimv22008260m.g","KQ417492",265010,265279,269
"21219","Ocbimv22025373m.g","KQ416152",506200,509595,3395
"21220","Ocbimv22014083m.g","KQ415924",80540,229227,148687
"21221","Ocbimv22021801m.g","LGKD01670994",3,341,338
"21222","Ocbimv22004517m.g","KQ417175",93508,93915,407
"21223","Ocbimv22032324m.g","KQ421523",348232,349152,920
"21224","Ocbimv22005822m.g","KQ417280",63717,67211,3494
"21225","Ocbimv22003117m.g","KQ417059",94427,121691,27264
"21226","Ocbimv22001148m.g","KQ416913",11692,18915,7223
"21227","Ocbimv22024305m.g","KQ419564",131718,169764,38046
"21228","Ocbimv22029965m.g","KQ420863",28921,29145,224
"21229","Ocbimv22011554m.g","KQ417802",124327,125127,800
"21230","Ocbimv22013730m.g","KQ418054",52992,53360,368
"21231","Ocbimv22022388m.g","KQ432745",16552,18272,1720
"21232","Ocbimv22013557m.g","KQ428572",21953,22855,902
"21233","Ocbimv22004079m.g","KQ417133",626581,647841,21260
"21234","Ocbimv22021924m.g","KQ419133",29352,117738,88386
"21235","Ocbimv22038198m.g","KQ416731",183409,183591,182
"21236","Ocbimv22024705m.g","KQ419618",268,3891,3623
"21237","Ocbimv22009167m.g","KQ426910",25214,51535,26321
"21238","Ocbimv22025234m.g","KQ419743",59652,62077,2425
"21239","Ocbimv22038518m.g","KQ423384",122661,186533,63872
"21240","Ocbimv22003889m.g","KQ417119",77997,79596,1599
"21241","Ocbimv22035363m.g","KQ416583",78045,120214,42169
"21242","Ocbimv22026820m.g","KQ420120",201335,211344,10009
"21243","Ocbimv22005608m.g","KQ425676",419439,436365,16926
"21244","Ocbimv22024458m.g","KQ416123",253649,311083,57434
"21245","Ocbimv22039692m.g","KQ423731",24283,25846,1563
"21246","Ocbimv22014238m.g","KQ418105",31831,96398,64567
"21247","Ocbimv22013467m.g","LGKD01601952",1231,1554,323
"21248","Ocbimv22018594m.g","KQ418644",586268,586970,702
"21249","Ocbimv22024843m.g","KQ419640",81682,98028,16346
"21250","Ocbimv22032354m.g","KQ421523",1392395,1392799,404
"21251","Ocbimv22022992m.g","KQ419335",2597,83482,80885
"21252","Ocbimv22034294m.g","KQ422015",1011128,1026591,15463
"21253","Ocbimv22017088m.g","KQ430163",2513,155498,152985
"21254","Ocbimv22021775m.g","KQ419098",934083,962954,28871
"21255","Ocbimv22006708m.g","KQ426075",487500,494045,6545
"21256","Ocbimv22006192m.g","KQ417301",130430,131267,837
"21257","Ocbimv22007050m.g","KQ417371",211999,212340,341
"21258","Ocbimv22037509m.g","KQ416699",49795,50664,869
"21259","Ocbimv22015419m.g","KQ418241",461941,462228,287
"21260","Ocbimv22004627m.g","KQ417186",34694,36436,1742
"21261","Ocbimv22014100m.g","KQ428760",27165,28916,1751
"21262","Ocbimv22018140m.g","KQ415987",273128,340732,67604
"21263","Ocbimv22008660m.g","KQ426725",24356,27932,3576
"21264","Ocbimv22023011m.g","KQ419338",207506,256216,48710
"21265","Ocbimv22024828m.g","KQ416129",375686,375895,209
"21266","Ocbimv22023345m.g","KQ419395",115767,116758,991
"21267","Ocbimv22025262m.g","KQ419751",38710,107736,69026
"21268","Ocbimv22037210m.g","KQ416683",175078,197088,22010
"21269","Ocbimv22029512m.g","KQ416311",467856,523956,56100
"21270","Ocbimv22017214m.g","KQ418467",69313,69513,200
"21271","Ocbimv22034829m.g","KQ422188",7384,7671,287
"21272","Ocbimv22018950m.g","KQ418702",244641,257989,13348
"21273","Ocbimv22013981m.g","KQ428717",32568,36264,3696
"21274","Ocbimv22011606m.g","LGKD01588161",315,410,95
"21275","Ocbimv22026626m.g","KQ420081",117571,117798,227
"21276","Ocbimv22033200m.g","KQ416471",52726,71918,19192
"21277","Ocbimv22032043m.g","KQ421413",28029,42889,14860
"21278","Ocbimv22001879m.g","KQ424459",187191,231784,44593
"21279","Ocbimv22025311m.g","KQ419766",254794,255711,917
"21280","Ocbimv22010800m.g","KQ417715",161049,161774,725
"21281","Ocbimv22016577m.g","KQ418368",295332,300579,5247
"21282","Ocbimv22005913m.g","KQ417284",282078,282801,723
"21283","Ocbimv22002930m.g","KQ417050",211132,211878,746
"21284","Ocbimv22012780m.g","KQ428238",27916,56761,28845
"21285","Ocbimv22012322m.g","KQ415907",383203,385746,2543
"21286","Ocbimv22007776m.g","KQ426456",167328,171706,4378
"21287","Ocbimv22035055m.g","KQ422263",73283,74317,1034
"21288","Ocbimv22002921m.g","KQ424838",48272,49252,980
"21289","Ocbimv22039942m.g","KQ423805",11462,11674,212
"21290","Ocbimv22006651m.g","KQ417339",55837,105275,49438
"21291","Ocbimv22022376m.g","LGKD01677370",62,364,302
"21292","Ocbimv22014064m.g","KQ415672",546820,547167,347
"21293","Ocbimv22030146m.g","KQ420909",66466,124174,57708
"21294","Ocbimv22020178m.g","KQ418869",232493,232990,497
"21295","Ocbimv22012673m.g","KQ417924",580522,584564,4042
"21296","Ocbimv22009471m.g","KQ417596",563764,609530,45766
"21297","Ocbimv22035319m.g","KQ422351",602639,640671,38032
"21298","Ocbimv22035971m.g","KQ422621",99492,99875,383
"21299","Ocbimv22000326m.g","KQ423925",3701,3916,215
"21300","Ocbimv22036450m.g","KQ422765",487055,488482,1427
"21301","Ocbimv22021553m.g","KQ432237",5,415,410
"21302","Ocbimv22017121m.g","KQ418451",343223,350269,7046
"21303","Ocbimv22008774m.g","KQ426768",86020,86343,323
"21304","Ocbimv22000008m.g","KQ423819",241582,362816,121234
"21305","Ocbimv22037867m.g","KQ423141",86271,120172,33901
"21306","Ocbimv22014648m.g","KQ429021",13745,13951,206
"21307","Ocbimv22024374m.g","KQ419574",1113875,1118228,4353
"21308","Ocbimv22015875m.g","LGKD01622720",26,454,428
"21309","Ocbimv22020812m.g","KQ418970",281629,281823,194
"21310","Ocbimv22020119m.g","KQ431468",20653,50178,29525
"21311","Ocbimv22008197m.g","KQ417484",6603,19893,13290
"21312","Ocbimv22019840m.g","KQ418821",545146,545606,460
"21313","Ocbimv22003488m.g","KQ425015",1059887,1064300,4413
"21314","Ocbimv22008859m.g","KQ426791",313744,319865,6121
"21315","Ocbimv22032885m.g","KQ421675",23865,24517,652
"21316","Ocbimv22009720m.g","KQ427096",311070,311414,344
"21317","Ocbimv22038960m.g","KQ423493",997739,1008337,10598
"21318","Ocbimv22003648m.g","KQ425062",8448,35368,26920
"21319","Ocbimv22034073m.g","KQ416508",1024759,1031735,6976
"21320","Ocbimv22008624m.g","KQ417510",1049805,1050240,435
"21321","Ocbimv22027296m.g","KQ420246",203,28290,28087
"21322","Ocbimv22007481m.g","KQ415843",75738,98633,22895
"21323","Ocbimv22012956m.g","KQ428311",27047,27395,348
"21324","Ocbimv22010245m.g","KQ427331",10351,39154,28803
"21325","Ocbimv22005431m.g","KQ425605",3179,26735,23556
"21326","Ocbimv22001061m.g","KQ424169",58219,58772,553
"21327","Ocbimv22038635m.g","KQ423428",29870,30022,152
"21328","Ocbimv22026175m.g","KQ420009",309818,310757,939
"21329","Ocbimv22019825m.g","KQ431332",295268,297200,1932
"21330","Ocbimv22006279m.g","KQ425850",137039,231594,94555
"21331","Ocbimv22007778m.g","KQ426456",172197,196289,24092
"21332","Ocbimv22029382m.g","KQ416301",301118,301662,544
"21333","Ocbimv22007493m.g","KQ415843",208215,219895,11680
"21334","Ocbimv22025650m.g","KQ419876",50102,50448,346
"21335","Ocbimv22033282m.g","KQ421760",8680,81247,72567
"21336","Ocbimv22036926m.g","KQ416666",80705,81043,338
"21337","Ocbimv22018860m.g","KQ418693",251296,321629,70333
"21338","Ocbimv22024036m.g","KQ416109",1050133,1051315,1182
"21339","Ocbimv22012013m.g","KQ427967",31652,31921,269
"21340","Ocbimv22037368m.g","KQ423019",25193,26852,1659
"21341","Ocbimv22036883m.g","KQ422889",545451,555179,9728
"21342","Ocbimv22038983m.g","KQ423499",90640,94362,3722
"21343","Ocbimv22028616m.g","KQ416264",480616,562103,81487
"21344","Ocbimv22000377m.g","KQ423941",456751,457238,487
"21345","Ocbimv22027759m.g","KQ420358",282815,296335,13520
"21346","Ocbimv22016541m.g","KQ418366",2929,43374,40445
"21347","Ocbimv22031291m.g","KQ421217",319444,366066,46622
"21348","Ocbimv22005281m.g","KQ417238",717864,718181,317
"21349","Ocbimv22036758m.g","KQ416656",9666,12787,3121
"21350","Ocbimv22005520m.g","KQ425644",19612,20139,527
"21351","Ocbimv22007545m.g","KQ426371",247024,254114,7090
"21352","Ocbimv22008742m.g","KQ417528",481738,487778,6040
"21353","Ocbimv22024831m.g","KQ419638",15132,28562,13430
"21354","Ocbimv22028133m.g","KQ416251",979348,979764,416
"21355","Ocbimv22007084m.g","KQ417377",511540,516168,4628
"21356","Ocbimv22039172m.g","KQ423560",17385,18222,837
"21357","Ocbimv22021589m.g","KQ432245",13369,14082,713
"21358","Ocbimv22035739m.g","KQ422521",407736,409223,1487
"21359","Ocbimv22015469m.g","LGKD01228012",1,219,218
"21360","Ocbimv22030190m.g","KQ420920",100,21728,21628
"21361","Ocbimv22002424m.g","KQ417009",1276183,1306961,30778
"21362","Ocbimv22001122m.g","KQ424186",249312,251516,2204
"21363","Ocbimv22015611m.g","KQ418269",7238,17218,9980
"21364","Ocbimv22037778m.g","KQ423132",33188,99036,65848
"21365","Ocbimv22013694m.g","KQ428612",188410,191293,2883
"21366","Ocbimv22017827m.g","KQ430486",40604,44970,4366
"21367","Ocbimv22001255m.g","KQ424243",154748,160933,6185
"21368","Ocbimv22032782m.g","KQ421658",222494,222709,215
"21369","Ocbimv22002975m.g","KQ417051",2123657,2124745,1088
"21370","Ocbimv22005085m.g","KQ425517",98263,127905,29642
"21371","Ocbimv22020465m.g","LGKD01660952",15,635,620
"21372","Ocbimv22021315m.g","KQ419028",140598,229910,89312
"21373","Ocbimv22018342m.g","KQ418609",488849,560522,71673
"21374","Ocbimv22000551m.g","KQ423995",218268,227571,9303
"21375","Ocbimv22009283m.g","KQ426944",844929,875555,30626
"21376","Ocbimv22004186m.g","KQ425220",354054,354779,725
"21377","Ocbimv22003578m.g","KQ417092",214564,215929,1365
"21378","Ocbimv22037536m.g","KQ423058",153668,286417,132749
"21379","Ocbimv22003636m.g","LGKD01523046",143,478,335
"21380","Ocbimv22002790m.g","KQ417037",31281,32081,800
"21381","Ocbimv22032917m.g","KQ421684",113233,113775,542
"21382","Ocbimv22019402m.g","KQ418760",340682,348159,7477
"21383","Ocbimv22029826m.g","KQ420828",938189,939958,1769
"21384","Ocbimv22003945m.g","KQ425156",13926,14189,263
"21385","Ocbimv22036622m.g","KQ416651",563150,563374,224
"21386","Ocbimv22018273m.g","KQ418590",113837,115653,1816
"21387","Ocbimv22008204m.g","KQ426580",3302,35483,32181
"21388","Ocbimv22002764m.g","KQ424777",9865,11382,1517
"21389","Ocbimv22026108m.g","KQ419989",496897,500897,4000
"21390","Ocbimv22024498m.g","KQ419590",82166,88101,5935
"21391","Ocbimv22025022m.g","KQ416136",233914,242710,8796
"21392","Ocbimv22034245m.g","KQ422015",55483,62028,6545
"21393","Ocbimv22014438m.g","KQ428921",1364,14974,13610
"21394","Ocbimv22012650m.g","KQ417923",334920,335174,254
"21395","Ocbimv22023369m.g","KQ419395",279018,283487,4469
"21396","Ocbimv22011539m.g","KQ427775",76016,81179,5163
"21397","Ocbimv22018156m.g","KQ418580",155066,155299,233
"21398","Ocbimv22003220m.g","KQ417064",151490,152196,706
"21399","Ocbimv22027217m.g","KQ416214",59592,60200,608
"21400","Ocbimv22016212m.g","KQ418328",163572,164060,488
"21401","Ocbimv22032150m.g","KQ421460",232777,240804,8027
"21402","Ocbimv22004208m.g","KQ415801",100608,143884,43276
"21403","Ocbimv22005232m.g","KQ417233",1281,3266,1985
"21404","Ocbimv22004103m.g","KQ425202",122710,125435,2725
"21405","Ocbimv22006955m.g","KQ417367",24239,75073,50834
"21406","Ocbimv22007709m.g","KQ426434",2311,3249,938
"21407","Ocbimv22012831m.g","KQ417945",10657,49091,38434
"21408","Ocbimv22015143m.g","KQ418200",173318,173567,249
"21409","Ocbimv22026380m.g","KQ416188",378404,389765,11361
"21410","Ocbimv22007837m.g","KQ417455",12413,13387,974
"21411","Ocbimv22005871m.g","KQ417280",347765,353304,5539
"21412","Ocbimv22006761m.g","KQ417347",1106376,1163411,57035
"21413","Ocbimv22001348m.g","KQ416924",404899,405474,575
"21414","Ocbimv22037960m.g","KQ423185",283362,293418,10056
"21415","Ocbimv22003150m.g","KQ424898",65835,66299,464
"21416","Ocbimv22016819m.g","KQ418408",42586,46694,4108
"21417","Ocbimv22016296m.g","KQ429800",2716,3860,1144
"21418","Ocbimv22031841m.g","KQ421356",804688,830382,25694
"21419","Ocbimv22024251m.g","KQ433889",2704,2919,215
"21420","Ocbimv22001323m.g","KQ415784",87920,88096,176
"21421","Ocbimv22012278m.g","KQ417898",143449,161398,17949
"21422","Ocbimv22034393m.g","KQ422028",83897,104657,20760
"21423","Ocbimv22017570m.g","KQ418506",491673,492304,631
"21424","Ocbimv22020731m.g","KQ418957",155487,155801,314
"21425","Ocbimv22032797m.g","KQ421658",617584,631009,13425
"21426","Ocbimv22001226m.g","KQ416917",107702,107971,269
"21427","Ocbimv22025324m.g","KQ419774",26003,26200,197
"21428","Ocbimv22015138m.g","KQ418197",1,2313,2312
"21429","Ocbimv22035142m.g","KQ422290",30442,53156,22714
"21430","Ocbimv22021736m.g","KQ419092",342694,343278,584
"21431","Ocbimv22001511m.g","KQ424337",346832,363641,16809
"21432","Ocbimv22021711m.g","KQ432289",454,684,230
"21433","Ocbimv22027878m.g","KQ420387",72135,73028,893
"21434","Ocbimv22014074m.g","KQ418087",619288,619437,149
"21435","Ocbimv22036491m.g","KQ422777",83915,102815,18900
"21436","Ocbimv22012818m.g","KQ428242",182,523,341
"21437","Ocbimv22025044m.g","KQ416136",732643,736844,4201
"21438","Ocbimv22016672m.g","KQ418378",110991,111218,227
"21439","Ocbimv22030609m.g","KQ416359",959120,959954,834
"21440","Ocbimv22039773m.g","KQ423746",100015,105897,5882
"21441","Ocbimv22012430m.g","KQ417911",353145,354096,951
"21442","Ocbimv22021912m.g","KQ419129",3901,12367,8466
"21443","Ocbimv22017774m.g","KQ418544",174760,177840,3080
"21444","Ocbimv22024297m.g","KQ419563",54838,55143,305
"21445","Ocbimv22020706m.g","KQ416032",259491,327782,68291
"21446","Ocbimv22020092m.g","KQ431447",2955,4097,1142
"21447","Ocbimv22005271m.g","KQ415814",446612,448514,1902
"21448","Ocbimv22000445m.g","KQ423968",48445,53961,5516
"21449","Ocbimv22003728m.g","KQ425076",272356,306597,34241
"21450","Ocbimv22013339m.g","LGKD01600665",324,611,287
"21451","Ocbimv22036145m.g","KQ422658",207513,208597,1084
"21452","Ocbimv22012239m.g","KQ417892",537130,540868,3738
"21453","Ocbimv22037472m.g","KQ423042",17430,58720,41290
"21454","Ocbimv22022406m.g","KQ419215",463115,464762,1647
"21455","Ocbimv22010069m.g","KQ427248",13874,15064,1190
"21456","Ocbimv22033871m.g","KQ421896",369345,370418,1073
"21457","Ocbimv22019019m.g","KQ418711",401169,402260,1091
"21458","Ocbimv22005626m.g","KQ425692",5234,8501,3267
"21459","Ocbimv22005041m.g","KQ415812",21992,22303,311
"21460","Ocbimv22024533m.g","KQ419593",23968,27505,3537
"21461","Ocbimv22036988m.g","KQ422901",13967,44461,30494
"21462","Ocbimv22003261m.g","KQ417073",120805,121203,398
"21463","Ocbimv22001231m.g","KQ416917",643093,643520,427
"21464","Ocbimv22000176m.g","KQ423883",1513,1725,212
"21465","Ocbimv22038177m.g","KQ423226",66645,115799,49154
"21466","Ocbimv22039946m.g","KQ423808",134315,144528,10213
"21467","Ocbimv22025017m.g","KQ416136",130100,131478,1378
"21468","Ocbimv22009452m.g","KQ417593",142757,143630,873
"21469","Ocbimv22010275m.g","KQ427344",80775,93343,12568
"21470","Ocbimv22010149m.g","KQ427278",81361,81867,506
"21471","Ocbimv22010257m.g","KQ415873",287114,340085,52971
"21472","Ocbimv22022468m.g","LGKD01678280",11,1078,1067
"21473","Ocbimv22025902m.g","KQ419920",45726,140429,94703
"21474","Ocbimv22038453m.g","KQ423344",20140,20734,594
"21475","Ocbimv22003678m.g","KQ425064",152362,152526,164
"21476","Ocbimv22027925m.g","KQ420404",495077,495380,303
"21477","Ocbimv22001624m.g","KQ416950",342032,342241,209
"21478","Ocbimv22007980m.g","KQ426515",2609,23990,21381
"21479","Ocbimv22013682m.g","KQ418045",184324,224115,39791
"21480","Ocbimv22020742m.g","KQ418958",80816,91389,10573
"21481","Ocbimv22011428m.g","KQ427746",77917,78369,452
"21482","Ocbimv22036320m.g","KQ415755",16782,26123,9341
"21483","Ocbimv22009860m.g","KQ417620",1446505,1448251,1746
"21484","Ocbimv22011535m.g","KQ427773",22270,32502,10232
"21485","Ocbimv22001557m.g","KQ424356",34872,35255,383
"21486","Ocbimv22001901m.g","KQ424463",163887,178380,14493
"21487","Ocbimv22007742m.g","KQ415847",261106,261633,527
"21488","Ocbimv22039384m.g","KQ423638",83569,89917,6348
"21489","Ocbimv22034492m.g","KQ422062",181487,188162,6675
"21490","Ocbimv22037305m.g","KQ422997",839583,841150,1567
"21491","Ocbimv22005501m.g","KQ425633",37273,37686,413
"21492","Ocbimv22000395m.g","KQ416856",95302,167061,71759
"21493","Ocbimv22029204m.g","KQ420677",32519,50404,17885
"21494","Ocbimv22015719m.g","KQ429511",15496,16079,583
"21495","Ocbimv22002466m.g","KQ424662",121474,126235,4761
"21496","Ocbimv22014360m.g","KQ428883",11665,28479,16814
"21497","Ocbimv22002770m.g","KQ424777",95411,95983,572
"21498","Ocbimv22018556m.g","KQ418636",30740,35797,5057
"21499","Ocbimv22036147m.g","KQ422658",252224,253338,1114
"21500","Ocbimv22017292m.g","KQ430242",21550,23925,2375
"21501","Ocbimv22034715m.g","KQ422121",306825,306983,158
"21502","Ocbimv22005848m.g","KQ417280",186124,190007,3883
"21503","Ocbimv22022927m.g","KQ419326",650033,652247,2214
"21504","Ocbimv22013287m.g","KQ418007",409986,416144,6158
"21505","Ocbimv22016281m.g","KQ429791",2656,3636,980
"21506","Ocbimv22025483m.g","KQ419817",168305,182953,14648
"21507","Ocbimv22022574m.g","KQ432875",30788,65865,35077
"21508","Ocbimv22006607m.g","KQ426027",223722,225408,1686
"21509","Ocbimv22009851m.g","KQ417620",851241,855166,3925
"21510","Ocbimv22018487m.g","KQ418626",11153,28296,17143
"21511","Ocbimv22000379m.g","KQ423941",468102,468976,874
"21512","Ocbimv22012979m.g","KQ428320",373,705,332
"21513","Ocbimv22010266m.g","KQ427339",37899,43991,6092
"21514","Ocbimv22034222m.g","KQ422014",29046,58939,29893
"21515","Ocbimv22012477m.g","KQ417914",86429,142249,55820
"21516","Ocbimv22017412m.g","KQ418493",62908,63693,785
"21517","Ocbimv22001979m.g","KQ415787",907630,908905,1275
"21518","Ocbimv22017722m.g","KQ430437",89297,94128,4831
"21519","Ocbimv22023616m.g","KQ433514",6,710,704
"21520","Ocbimv22009327m.g","KQ426949",28030,30659,2629
"21521","Ocbimv22002372m.g","KQ415792",164440,165158,718
"21522","Ocbimv22021501m.g","KQ419061",10270,14173,3903
"21523","Ocbimv22031135m.g","KQ421173",74007,75224,1217
"21524","Ocbimv22034779m.g","KQ422170",38252,39876,1624
"21525","Ocbimv22019334m.g","KQ418750",648129,673843,25714
"21526","Ocbimv22022994m.g","KQ433179",3355,4612,1257
"21527","Ocbimv22024087m.g","KQ419533",383324,405088,21764
"21528","Ocbimv22038348m.g","KQ416737",1283299,1284243,944
"21529","Ocbimv22032260m.g","KQ421506",29165,33366,4201
"21530","Ocbimv22003243m.g","KQ417067",424121,424552,431
"21531","Ocbimv22003956m.g","KQ425160",128534,161008,32474
"21532","Ocbimv22012931m.g","KQ417957",90985,91919,934
"21533","Ocbimv22035404m.g","KQ422367",278858,279130,272
"21534","Ocbimv22006938m.g","KQ417364",782033,782374,341
"21535","Ocbimv22005621m.g","KQ425681",190055,211188,21133
"21536","Ocbimv22036975m.g","KQ416666",2533675,2554062,20387
"21537","Ocbimv22029206m.g","KQ420677",88089,90302,2213
"21538","Ocbimv22001468m.g","KQ416935",25606,25963,357
"21539","Ocbimv22024315m.g","KQ419565",24175,24583,408
"21540","Ocbimv22014255m.g","KQ418108",1463,15488,14025
"21541","Ocbimv22018446m.g","KQ415992",456404,467643,11239
"21542","Ocbimv22019657m.g","KQ431222",622,13778,13156
"21543","Ocbimv22026585m.g","KQ420075",321077,323050,1973
"21544","Ocbimv22006650m.g","KQ417339",39580,39879,299
"21545","Ocbimv22015922m.g","KQ418303",794098,794685,587
"21546","Ocbimv22039235m.g","KQ423591",160554,160806,252
"21547","Ocbimv22008114m.g","KQ426567",252491,290346,37855
"21548","Ocbimv22029112m.g","KQ420656",338512,338925,413
"21549","Ocbimv22007077m.g","KQ417377",322920,324849,1929
"21550","Ocbimv22005549m.g","KQ425650",80228,105058,24830
"21551","Ocbimv22016015m.g","KQ418310",221370,231053,9683
"21552","Ocbimv22015663m.g","KQ418273",588398,588619,221
"21553","Ocbimv22028454m.g","KQ420491",73190,77777,4587
"21554","Ocbimv22032604m.g","KQ421605",102769,103791,1022
"21555","Ocbimv22038654m.g","KQ416758",257310,268361,11051
"21556","Ocbimv22038473m.g","KQ423358",73978,74166,188
"21557","Ocbimv22038398m.g","KQ423316",130345,155850,25505
"21558","Ocbimv22013636m.g","KQ428581",18506,22102,3596
"21559","Ocbimv22008652m.g","KQ417518",416037,416752,715
"21560","Ocbimv22007527m.g","KQ417421",186814,236243,49429
"21561","Ocbimv22003046m.g","KQ424867",5551,17166,11615
"21562","Ocbimv22019347m.g","KQ418754",12063,12609,546
"21563","Ocbimv22021530m.g","KQ419071",104043,105731,1688
"21564","Ocbimv22034209m.g","KQ416523",561562,561894,332
"21565","Ocbimv22013478m.g","KQ428526",1273,7517,6244
"21566","Ocbimv22015849m.g","KQ418296",84076,84729,653
"21567","Ocbimv22000747m.g","KQ416878",103473,104042,569
"21568","Ocbimv22029414m.g","KQ416305",145022,146601,1579
"21569","Ocbimv22017719m.g","KQ430433",112273,112485,212
"21570","Ocbimv22002854m.g","KQ424805",35430,44811,9381
"21571","Ocbimv22007446m.g","KQ415842",98033,98254,221
"21572","Ocbimv22006268m.g","LGKD01543659",26,529,503
"21573","Ocbimv22031362m.g","KQ421221",703642,703857,215
"21574","Ocbimv22015891m.g","KQ418299",450984,511595,60611
"21575","Ocbimv22009378m.g","KQ417588",413379,414659,1280
"21576","Ocbimv22007555m.g","KQ417425",34938,44531,9593
"21577","Ocbimv22026404m.g","KQ420039",756869,757979,1110
"21578","Ocbimv22006351m.g","KQ417315",27622,28318,696
"21579","Ocbimv22009945m.g","KQ427168",10663,16508,5845
"21580","Ocbimv22024742m.g","KQ419622",67215,71103,3888
"21581","Ocbimv22031230m.g","KQ421203",93668,94474,806
"21582","Ocbimv22030905m.g","KQ421117",1362660,1364909,2249
"21583","Ocbimv22015538m.g","KQ429407",22315,45396,23081
"21584","Ocbimv22024416m.g","KQ419577",338096,343595,5499
"21585","Ocbimv22013212m.g","KQ418002",277139,280023,2884
"21586","Ocbimv22037274m.g","KQ422987",212437,213651,1214
"21587","Ocbimv22000138m.g","KQ423868",98171,100206,2035
"21588","Ocbimv22027000m.g","KQ420161",12523,34106,21583
"21589","Ocbimv22029705m.g","KQ416318",32179,32529,350
"21590","Ocbimv22023907m.g","KQ433699",33833,42542,8709
"21591","Ocbimv22003585m.g","KQ417094",5180,5398,218
"21592","Ocbimv22038407m.g","KQ416739",74363,106168,31805
"21593","Ocbimv22017576m.g","KQ418507",56647,59865,3218
"21594","Ocbimv22016504m.g","KQ429904",13879,54113,40234
"21595","Ocbimv22012226m.g","KQ415905",891573,891812,239
"21596","Ocbimv22010827m.g","KQ427529",123161,123502,341
"21597","Ocbimv22030623m.g","KQ416359",1263088,1288455,25367
"21598","Ocbimv22029749m.g","KQ415712",585752,588643,2891
"21599","Ocbimv22029451m.g","KQ420752",109990,150698,40708
"21600","Ocbimv22009357m.g","KQ417585",1217203,1232411,15208
"21601","Ocbimv22039263m.g","KQ423598",218123,227345,9222
"21602","Ocbimv22023303m.g","KQ416087",612967,630636,17669
"21603","Ocbimv22024823m.g","KQ419634",2185,2661,476
"21604","Ocbimv22038378m.g","KQ416738",228834,272162,43328
"21605","Ocbimv22000403m.g","KQ423954",330410,330625,215
"21606","Ocbimv22013488m.g","KQ415916",314676,315297,621
"21607","Ocbimv22015195m.g","LGKD01225491",8,160,152
"21608","Ocbimv22008144m.g","KQ417481",512686,514276,1590
"21609","Ocbimv22022889m.g","KQ433098",19789,28266,8477
"21610","Ocbimv22026109m.g","KQ419989",535467,548626,13159
"21611","Ocbimv22004421m.g","KQ415804",349364,366224,16860
"21612","Ocbimv22010020m.g","KQ427207",75512,89964,14452
"21613","Ocbimv22024225m.g","KQ419550",317925,318306,381
"21614","Ocbimv22028847m.g","KQ420593",67391,95067,27676
"21615","Ocbimv22002360m.g","KQ424646",5761,6429,668
"21616","Ocbimv22026931m.g","KQ416205",609609,614244,4635
"21617","Ocbimv22023832m.g","KQ416099",150623,171878,21255
"21618","Ocbimv22033481m.g","KQ421821",38107,79007,40900
"21619","Ocbimv22023772m.g","KQ416096",1189694,1268096,78402
"21620","Ocbimv22000305m.g","KQ423917",92077,93146,1069
"21621","Ocbimv22039744m.g","KQ423737",122071,124455,2384
"21622","Ocbimv22019974m.g","KQ418839",623960,636584,12624
"21623","Ocbimv22000123m.g","KQ416841",527869,563709,35840
"21624","Ocbimv22019987m.g","KQ418840",1195427,1220742,25315
"21625","Ocbimv22000264m.g","KQ423910",68580,69318,738
"21626","Ocbimv22010538m.g","KQ427428",128824,148619,19795
"21627","Ocbimv22034538m.g","KQ416536",263918,273246,9328
"21628","Ocbimv22031548m.g","KQ421273",460365,486409,26044
"21629","Ocbimv22014657m.g","KQ418165",78653,87191,8538
"21630","Ocbimv22039761m.g","KQ423738",183764,184162,398
"21631","Ocbimv22031443m.g","KQ421244",145763,146041,278
"21632","Ocbimv22000815m.g","KQ424080",76231,80146,3915
"21633","Ocbimv22024652m.g","KQ419607",136266,154409,18143
"21634","Ocbimv22008783m.g","KQ426774",53574,62577,9003
"21635","Ocbimv22019810m.g","KQ416017",67181,67552,371
"21636","Ocbimv22025380m.g","KQ419786",323906,324067,161
"21637","Ocbimv22020605m.g","KQ418936",562736,563041,305
"21638","Ocbimv22000107m.g","KQ423864",129400,130708,1308
"21639","Ocbimv22034389m.g","KQ422027",15942,29763,13821
"21640","Ocbimv22002615m.g","KQ417023",440192,440912,720
"21641","Ocbimv22001147m.g","KQ416912",219916,220104,188
"21642","Ocbimv22010708m.g","KQ417704",136789,147509,10720
"21643","Ocbimv22009794m.g","KQ427137",57094,57261,167
"21644","Ocbimv22010240m.g","KQ427326",46918,63101,16183
"21645","Ocbimv22020117m.g","KQ418856",569034,591996,22962
"21646","Ocbimv22024415m.g","KQ419577",323534,333802,10268
"21647","Ocbimv22032590m.g","KQ421603",39687,78143,38456
"21648","Ocbimv22012060m.g","KQ417858",176674,177306,632
"21649","Ocbimv22032429m.g","KQ421533",735886,752104,16218
"21650","Ocbimv22022000m.g","KQ432502",47598,48881,1283
"21651","Ocbimv22010188m.g","KQ417653",757444,758238,794
"21652","Ocbimv22019877m.g","KQ431356",1689,2282,593
"21653","Ocbimv22003896m.g","KQ425137",232138,232623,485
"21654","Ocbimv22032997m.g","KQ421712",254040,254414,374
"21655","Ocbimv22018291m.g","KQ418596",56052,56210,158
"21656","Ocbimv22027152m.g","KQ420204",108409,108663,254
"21657","Ocbimv22012141m.g","KQ417877",64771,65957,1186
"21658","Ocbimv22003817m.g","KQ417114",192819,194600,1781
"21659","Ocbimv22011552m.g","KQ417802",65219,65809,590
"21660","Ocbimv22008254m.g","KQ426605",7599,7920,321
"21661","Ocbimv22030402m.g","KQ420971",74543,79377,4834
"21662","Ocbimv22012044m.g","KQ427988",36696,39720,3024
"21663","Ocbimv22022999m.g","KQ419337",134988,151918,16930
"21664","Ocbimv22023834m.g","KQ416099",571079,571258,179
"21665","Ocbimv22020717m.g","KQ418955",112150,130555,18405
"21666","Ocbimv22007584m.g","KQ417432",101532,101771,239
"21667","Ocbimv22013962m.g","KQ418073",403808,408966,5158
"21668","Ocbimv22001288m.g","KQ416918",1011316,1012636,1320
"21669","Ocbimv22001933m.g","KQ416974",721178,721544,366
"21670","Ocbimv22013440m.g","KQ428507",142248,180782,38534
"21671","Ocbimv22019072m.g","KQ418715",20473,36842,16369
"21672","Ocbimv22031933m.g","KQ421381",11397,13158,1761
"21673","Ocbimv22030982m.g","KQ421140",17479,18522,1043
"21674","Ocbimv22036254m.g","KQ422691",295009,295332,323
"21675","Ocbimv22028491m.g","KQ420510",26753,37406,10653
"21676","Ocbimv22031358m.g","KQ421221",355348,355524,176
"21677","Ocbimv22019545m.g","KQ418783",442742,450362,7620
"21678","Ocbimv22011486m.g","KQ417795",321488,337352,15864
"21679","Ocbimv22013630m.g","KQ418040",173818,174000,182
"21680","Ocbimv22012187m.g","KQ428063",116062,119953,3891
"21681","Ocbimv22012345m.g","KQ415907",1058655,1059352,697
"21682","Ocbimv22020100m.g","KQ418855",11102,46659,35557
"21683","Ocbimv22004253m.g","KQ425242",15129,37698,22569
"21684","Ocbimv22026933m.g","KQ416205",622187,626542,4355
"21685","Ocbimv22026772m.g","KQ420113",19925,25955,6030
"21686","Ocbimv22036637m.g","KQ422815",1291,10545,9254
"21687","Ocbimv22006752m.g","KQ417347",300970,301767,797
"21688","Ocbimv22036352m.g","KQ422717",275697,275960,263
"21689","Ocbimv22016890m.g","KQ430074",19133,20372,1239
"21690","Ocbimv22017298m.g","KQ418479",144738,203876,59138
"21691","Ocbimv22002498m.g","KQ424672",82898,97916,15018
"21692","Ocbimv22019587m.g","KQ418789",182120,182374,254
"21693","Ocbimv22029532m.g","KQ420774",356881,367305,10424
"21694","Ocbimv22014366m.g","KQ428883",232138,233511,1373
"21695","Ocbimv22002047m.g","KQ424530",157902,164177,6275
"21696","Ocbimv22029802m.g","KQ420827",14280,14842,562
"21697","Ocbimv22011589m.g","KQ417807",136005,140465,4460
"21698","Ocbimv22000712m.g","KQ416877",475992,476879,887
"21699","Ocbimv22034997m.g","KQ416567",89118,90853,1735
"21700","Ocbimv22037773m.g","KQ423131",106948,107358,410
"21701","Ocbimv22023072m.g","KQ419342",193694,194371,677
"21702","Ocbimv22031924m.g","KQ416413",642992,645063,2071
"21703","Ocbimv22019964m.g","KQ418839",273697,332725,59028
"21704","Ocbimv22016893m.g","KQ418420",59360,62043,2683
"21705","Ocbimv22006020m.g","KQ425779",468728,469708,980
"21706","Ocbimv22011200m.g","KQ427675",63703,64359,656
"21707","Ocbimv22031375m.g","KQ416393",383814,384158,344
"21708","Ocbimv22033915m.g","KQ421906",518014,529672,11658
"21709","Ocbimv22037073m.g","KQ422919",5733,5960,227
"21710","Ocbimv22038997m.g","KQ423506",113128,123665,10537
"21711","Ocbimv22005785m.g","KQ415823",380052,418798,38746
"21712","Ocbimv22026280m.g","KQ420022",628941,629258,317
"21713","Ocbimv22027577m.g","KQ420308",65236,67588,2352
"21714","Ocbimv22034431m.g","KQ422036",355122,355295,173
"21715","Ocbimv22014202m.g","KQ428799",43099,44102,1003
"21716","Ocbimv22005199m.g","KQ417232",139684,140235,551
"21717","Ocbimv22005233m.g","KQ417233",18791,25876,7085
"21718","Ocbimv22031743m.g","KQ421337",10830,11279,449
"21719","Ocbimv22021363m.g","KQ419034",7956,8301,345
"21720","Ocbimv22025930m.g","KQ419930",439684,440010,326
"21721","Ocbimv22018931m.g","KQ418698",125523,147641,22118
"21722","Ocbimv22020799m.g","KQ431861",27113,27403,290
"21723","Ocbimv22014204m.g","KQ428800",2922,4955,2033
"21724","Ocbimv22016722m.g","KQ429980",72244,72480,236
"21725","Ocbimv22004739m.g","KQ425434",1933,86043,84110
"21726","Ocbimv22033250m.g","KQ421758",1398454,1399651,1197
"21727","Ocbimv22032583m.g","KQ421602",74593,76605,2012
"21728","Ocbimv22005070m.g","KQ425510",361195,365866,4671
"21729","Ocbimv22026790m.g","KQ420117",666370,667125,755
"21730","Ocbimv22039117m.g","KQ416779",776768,776954,186
"21731","Ocbimv22012095m.g","KQ417873",56921,57229,308
"21732","Ocbimv22000813m.g","KQ416886",418752,419030,278
"21733","Ocbimv22019178m.g","KQ418729",31442,42506,11064
"21734","Ocbimv22020841m.g","KQ418970",2303505,2308374,4869
"21735","Ocbimv22033136m.g","KQ421733",43474,47905,4431
"21736","Ocbimv22023355m.g","KQ419395",159025,161097,2072
"21737","Ocbimv22037542m.g","KQ423058",751617,752606,989
"21738","Ocbimv22024196m.g","LGKD01696696",52,468,416
"21739","Ocbimv22033879m.g","KQ416497",27271,29365,2094
"21740","Ocbimv22033126m.g","KQ421731",397404,405713,8309
"21741","Ocbimv22011493m.g","KQ427766",21865,23775,1910
"21742","Ocbimv22002765m.g","KQ424777",36722,42872,6150
"21743","Ocbimv22008473m.g","KQ415854",685551,686214,663
"21744","Ocbimv22001049m.g","KQ424160",205756,219611,13855
"21745","Ocbimv22034895m.g","KQ422209",10380,11132,752
"21746","Ocbimv22032665m.g","KQ421629",12,4628,4616
"21747","Ocbimv22039131m.g","KQ416780",15730,15915,185
"21748","Ocbimv22032802m.g","KQ421658",679925,706764,26839
"21749","Ocbimv22016450m.g","KQ415965",1055130,1055486,356
"21750","Ocbimv22033231m.g","KQ421758",539748,541471,1723
"21751","Ocbimv22038481m.g","KQ416745",477311,477490,179
"21752","Ocbimv22005004m.g","KQ415811",1103945,1116634,12689
"21753","Ocbimv22026889m.g","KQ420137",70847,109034,38187
"21754","Ocbimv22032853m.g","KQ416453",12535,13059,524
"21755","Ocbimv22033777m.g","KQ421871",154890,155339,449
"21756","Ocbimv22032580m.g","KQ416440",74964,75632,668
"21757","Ocbimv22003318m.g","KQ417080",24233,62275,38042
"21758","Ocbimv22020475m.g","KQ418919",90322,90504,182
"21759","Ocbimv22036165m.g","KQ422662",89728,108385,18657
"21760","Ocbimv22020495m.g","KQ418919",555645,558901,3256
"21761","Ocbimv22020616m.g","KQ418940",449218,449803,585
"21762","Ocbimv22028312m.g","KQ420471",79984,106137,26153
"21763","Ocbimv22002590m.g","KQ424712",76665,78281,1616
"21764","Ocbimv22023651m.g","KQ419452",164384,164599,215
"21765","Ocbimv22014220m.g","KQ418103",144328,144687,359
"21766","Ocbimv22031775m.g","KQ421343",7263,14374,7111
"21767","Ocbimv22008326m.g","KQ417497",548682,638860,90178
"21768","Ocbimv22019463m.g","KQ418770",252474,252740,266
"21769","Ocbimv22038984m.g","KQ423499",102132,155186,53054
"21770","Ocbimv22033558m.g","KQ421832",26079,27217,1138
"21771","Ocbimv22021760m.g","KQ419095",75908,116906,40998
"21772","Ocbimv22017732m.g","KQ415982",774439,813727,39288
"21773","Ocbimv22032276m.g","KQ421510",5866,37690,31824
"21774","Ocbimv22025379m.g","KQ419786",196784,197374,590
"21775","Ocbimv22030824m.g","KQ421098",5437,40833,35396
"21776","Ocbimv22017747m.g","KQ418537",347033,347570,537
"21777","Ocbimv22005545m.g","KQ425649",568130,578745,10615
"21778","Ocbimv22016562m.g","KQ418367",698683,699493,810
"21779","Ocbimv22030730m.g","KQ421080",20420,21567,1147
"21780","Ocbimv22015048m.g","KQ418194",671629,781904,110275
"21781","Ocbimv22034973m.g","KQ422233",221978,222181,203
"21782","Ocbimv22039691m.g","KQ423731",19661,19882,221
"21783","Ocbimv22032416m.g","KQ421533",95967,116954,20987
"21784","Ocbimv22026964m.g","KQ420154",173055,173880,825
"21785","Ocbimv22035759m.g","KQ422527",245080,245705,625
"21786","Ocbimv22029583m.g","KQ420778",416267,416458,191
"21787","Ocbimv22034766m.g","KQ422163",123729,124149,420
"21788","Ocbimv22013527m.g","KQ428545",92410,95068,2658
"21789","Ocbimv22022855m.g","KQ433074",65507,143674,78167
"21790","Ocbimv22016433m.g","LGKD01627577",252,769,517
"21791","Ocbimv22031337m.g","KQ421218",417966,449301,31335
"21792","Ocbimv22016452m.g","KQ415965",1323318,1324189,871
"21793","Ocbimv22025824m.g","KQ419909",329791,334981,5190
"21794","Ocbimv22036093m.g","KQ416616",2346123,2363296,17173
"21795","Ocbimv22004610m.g","KQ417183",197159,198318,1159
"21796","Ocbimv22033357m.g","KQ421798",33910,41003,7093
"21797","Ocbimv22039950m.g","KQ423808",206559,211803,5244
"21798","Ocbimv22036466m.g","KQ422771",148855,154610,5755
"21799","Ocbimv22003257m.g","KQ424923",15807,16574,767
"21800","Ocbimv22011541m.g","KQ427775",87270,130458,43188
"21801","Ocbimv22002815m.g","KQ424788",31595,43866,12271
"21802","Ocbimv22027473m.g","KQ416225",97340,116509,19169
"21803","Ocbimv22034457m.g","KQ422047",20458,40933,20475
"21804","Ocbimv22033601m.g","KQ416487",247313,247906,593
"21805","Ocbimv22017424m.g","KQ418495",157511,159169,1658
"21806","Ocbimv22000098m.g","KQ423857",150547,151149,602
"21807","Ocbimv22030409m.g","KQ420971",117109,136656,19547
"21808","Ocbimv22008852m.g","KQ426790",107871,108449,578
"21809","Ocbimv22013648m.g","KQ418042",401057,497796,96739
"21810","Ocbimv22027510m.g","KQ420294",373887,374165,278
"21811","Ocbimv22006819m.g","KQ426123",19633,53862,34229
"21812","Ocbimv22037138m.g","KQ422938",108225,108905,680
"21813","Ocbimv22023975m.g","KQ419513",84171,86621,2450
"21814","Ocbimv22014707m.g","KQ418168",610053,646738,36685
"21815","Ocbimv22036486m.g","KQ422776",1853,2402,549
"21816","Ocbimv22034100m.g","KQ421974",87512,93804,6292
"21817","Ocbimv22027324m.g","KQ420260",501679,502479,800
"21818","Ocbimv22016762m.g","KQ418393",414953,467345,52392
"21819","Ocbimv22036087m.g","KQ416616",1881293,1887546,6253
"21820","Ocbimv22011081m.g","KQ427635",38984,39202,218
"21821","Ocbimv22003017m.g","KQ417055",155183,155332,149
"21822","Ocbimv22027757m.g","KQ420358",188644,189162,518
"21823","Ocbimv22006691m.g","KQ426075",235995,292690,56695
"21824","Ocbimv22033397m.g","KQ416479",876133,878943,2810
"21825","Ocbimv22025690m.g","KQ416164",189768,190025,257
"21826","Ocbimv22002402m.g","KQ424657",319518,320182,664
"21827","Ocbimv22005572m.g","KQ425655",115169,154563,39394
"21828","Ocbimv22021014m.g","LGKD01664688",297,935,638
"21829","Ocbimv22006462m.g","KQ417324",33240,112847,79607
"21830","Ocbimv22015536m.g","KQ429401",63049,63519,470
"21831","Ocbimv22016852m.g","KQ418413",86988,87665,677
"21832","Ocbimv22021064m.g","KQ431974",129354,129745,391
"21833","Ocbimv22000392m.g","KQ423946",1028,2394,1366
"21834","Ocbimv22036704m.g","KQ416654",119726,197661,77935
"21835","Ocbimv22012591m.g","KQ417917",1897641,1898739,1098
"21836","Ocbimv22029725m.g","KQ420813",662127,682371,20244
"21837","Ocbimv22036364m.g","KQ416635",638543,639072,529
"21838","Ocbimv22004256m.g","KQ425245",78566,79125,559
"21839","Ocbimv22035170m.g","KQ422293",18471,21685,3214
"21840","Ocbimv22035527m.g","KQ422420",125529,126461,932
"21841","Ocbimv22036356m.g","KQ422722",5342,22361,17019
"21842","Ocbimv22003810m.g","KQ417113",330880,331329,449
"21843","Ocbimv22021144m.g","KQ419009",255725,305417,49692
"21844","Ocbimv22031088m.g","KQ421158",101616,113280,11664
"21845","Ocbimv22006193m.g","KQ417301",133381,133703,322
"21846","Ocbimv22017482m.g","KQ430313",154369,162051,7682
"21847","Ocbimv22029663m.g","KQ420798",782941,783714,773
"21848","Ocbimv22028877m.g","KQ420596",21202,23794,2592
"21849","Ocbimv22019054m.g","KQ418712",109093,114767,5674
"21850","Ocbimv22003904m.g","KQ425143",247888,280520,32632
"21851","Ocbimv22004440m.g","KQ425306",108658,111560,2902
"21852","Ocbimv22035136m.g","KQ416575",296248,296922,674
"21853","Ocbimv22032498m.g","KQ421564",110134,112376,2242
"21854","Ocbimv22026046m.g","KQ419973",289289,298224,8935
"21855","Ocbimv22031102m.g","KQ416385",197547,197825,278
"21856","Ocbimv22013549m.g","LGKD01602621",1,216,215
"21857","Ocbimv22008225m.g","KQ415852",160362,160565,203
"21858","Ocbimv22005723m.g","KQ425728",245509,250930,5421
"21859","Ocbimv22018849m.g","KQ416003",1592449,1593685,1236
"21860","Ocbimv22028019m.g","KQ420421",122903,178938,56035
"21861","Ocbimv22022138m.g","KQ419175",553863,569475,15612
"21862","Ocbimv22025603m.g","KQ419858",197693,228855,31162
"21863","Ocbimv22027076m.g","KQ420175",162865,182570,19705
"21864","Ocbimv22000545m.g","KQ423995",104043,120166,16123
"21865","Ocbimv22012757m.g","KQ415909",775890,776928,1038
"21866","Ocbimv22037266m.g","KQ422986",334020,365686,31666
"21867","Ocbimv22017265m.g","KQ430232",101807,102196,389
"21868","Ocbimv22006500m.g","KQ425961",11311,11487,176
"21869","Ocbimv22025808m.g","KQ419907",116154,116918,764
"21870","Ocbimv22013975m.g","KQ428716",18871,20046,1175
"21871","Ocbimv22009725m.g","KQ427101",34848,35084,236
"21872","Ocbimv22018369m.g","KQ418610",193829,194092,263
"21873","Ocbimv22020763m.g","KQ418961",79271,79474,203
"21874","Ocbimv22029980m.g","KQ420868",83643,114161,30518
"21875","Ocbimv22006108m.g","KQ417297",232601,239468,6867
"21876","Ocbimv22030653m.g","KQ421049",107735,124793,17058
"21877","Ocbimv22029848m.g","KQ420828",1437236,1469559,32323
"21878","Ocbimv22012329m.g","KQ415907",513784,515670,1886
"21879","Ocbimv22000672m.g","KQ424049",65963,66121,158
"21880","Ocbimv22021468m.g","KQ416046",1884820,1885182,362
"21881","Ocbimv22018731m.g","KQ418664",3225,3623,398
"21882","Ocbimv22011437m.g","KQ427746",345372,385371,39999
"21883","Ocbimv22035967m.g","KQ422621",11252,19018,7766
"21884","Ocbimv22004563m.g","KQ425361",341621,354030,12409
"21885","Ocbimv22032408m.g","KQ421532",202621,203415,794
"21886","Ocbimv22026130m.g","KQ419991",243160,245005,1845
"21887","Ocbimv22013791m.g","KQ428672",25334,26881,1547
"21888","Ocbimv22033548m.g","KQ416485",74808,81631,6823
"21889","Ocbimv22029096m.g","KQ420647",96131,96514,383
"21890","Ocbimv22020356m.g","KQ418900",128435,137847,9412
"21891","Ocbimv22014081m.g","KQ415924",40190,40594,404
"21892","Ocbimv22033828m.g","KQ421891",218693,230100,11407
"21893","Ocbimv22025471m.g","KQ419810",93408,108842,15434
"21894","Ocbimv22009703m.g","KQ427095",52575,65053,12478
"21895","Ocbimv22032080m.g","KQ421429",62029,62437,408
"21896","Ocbimv22000901m.g","KQ415781",32159,32820,661
"21897","Ocbimv22039181m.g","KQ416784",315939,317958,2019
"21898","Ocbimv22002522m.g","KQ417012",353364,353678,314
"21899","Ocbimv22035522m.g","KQ422418",18575,21210,2635
"21900","Ocbimv22005353m.g","KQ425592",42158,43384,1226
"21901","Ocbimv22028728m.g","KQ416270",798853,800251,1398
"21902","Ocbimv22019486m.g","LGKD01651160",176,418,242
"21903","Ocbimv22033018m.g","KQ421718",516148,560841,44693
"21904","Ocbimv22025617m.g","KQ419861",485871,490398,4527
"21905","Ocbimv22001792m.g","KQ424420",186460,188827,2367
"21906","Ocbimv22007737m.g","KQ426447",7492,31706,24214
"21907","Ocbimv22002542m.g","KQ424680",92376,93455,1079
"21908","Ocbimv22019557m.g","KQ418783",617479,617679,200
"21909","Ocbimv22036417m.g","KQ416641",400850,421147,20297
"21910","Ocbimv22030652m.g","KQ421049",77285,92485,15200
"21911","Ocbimv22017770m.g","KQ430468",75655,76966,1311
"21912","Ocbimv22006574m.g","KQ426022",79966,80325,359
"21913","Ocbimv22000761m.g","KQ424061",240970,241185,215
"21914","Ocbimv22030368m.g","KQ420965",184927,185394,467
"21915","Ocbimv22023458m.g","KQ419414",351352,353453,2101
"21916","Ocbimv22004472m.g","LGKD01530506",34,336,302
"21917","Ocbimv22033732m.g","KQ416495",366247,398782,32535
"21918","Ocbimv22005084m.g","KQ425517",96680,98199,1519
"21919","Ocbimv22034846m.g","KQ422192",157748,159296,1548
"21920","Ocbimv22004987m.g","KQ417220",47044,49817,2773
"21921","Ocbimv22033754m.g","KQ421864",234622,241627,7005
"21922","Ocbimv22001969m.g","LGKD01507929",279,1042,763
"21923","Ocbimv22005718m.g","KQ425728",206327,208243,1916
"21924","Ocbimv22021329m.g","KQ419031",219964,220128,164
"21925","Ocbimv22022354m.g","KQ419204",38219,38701,482
"21926","Ocbimv22012986m.g","KQ417967",101297,101575,278
"21927","Ocbimv22005897m.g","KQ415825",122566,180515,57949
"21928","Ocbimv22012336m.g","KQ415907",734941,735376,435
"21929","Ocbimv22013749m.g","KQ428650",109,3240,3131
"21930","Ocbimv22006881m.g","KQ417359",12893,13301,408
"21931","Ocbimv22027362m.g","KQ420265",294967,296086,1119
"21932","Ocbimv22031439m.g","KQ421244",78376,84477,6101
"21933","Ocbimv22019845m.g","KQ418821",641438,655132,13694
"21934","Ocbimv22014036m.g","KQ428725",54915,55088,173
"21935","Ocbimv22020903m.g","KQ418974",280027,281034,1007
"21936","Ocbimv22013216m.g","KQ418002",308655,315846,7191
"21937","Ocbimv22033379m.g","KQ416479",407620,468212,60592
"21938","Ocbimv22038918m.g","KQ423490",23465,51377,27912
"21939","Ocbimv22039603m.g","KQ423716",47010,69612,22602
"21940","Ocbimv22011132m.g","KQ427653",40799,43028,2229
"21941","Ocbimv22008444m.g","KQ415854",23257,43478,20221
"21942","Ocbimv22027037m.g","KQ420166",753179,765053,11874
"21943","Ocbimv22025999m.g","KQ419951",162676,163679,1003
"21944","Ocbimv22025122m.g","KQ416138",93181,93624,443
"21945","Ocbimv22014184m.g","KQ418098",220429,221577,1148
"21946","Ocbimv22004557m.g","KQ425361",199786,215396,15610
"21947","Ocbimv22034768m.g","KQ422164",14,3822,3808
"21948","Ocbimv22019439m.g","KQ418767",329933,332942,3009
"21949","Ocbimv22021948m.g","KQ419137",175563,175721,158
"21950","Ocbimv22025466m.g","KQ419808",590815,591443,628
"21951","Ocbimv22002010m.g","KQ424513",112808,119618,6810
"21952","Ocbimv22011643m.g","KQ427830",88470,88697,227
"21953","Ocbimv22006725m.g","KQ415834",321503,321931,428
"21954","Ocbimv22018528m.g","KQ418633",280679,296655,15976
"21955","Ocbimv22032469m.g","KQ421549",274848,275179,331
"21956","Ocbimv22018925m.g","KQ430925",103112,140222,37110
"21957","Ocbimv22025749m.g","KQ419903",50771,50929,158
"21958","Ocbimv22005444m.g","KQ417252",1391406,1400555,9149
"21959","Ocbimv22026849m.g","KQ420130",262728,268281,5553
"21960","Ocbimv22001964m.g","KQ424504",18239,20289,2050
"21961","Ocbimv22031383m.g","KQ421226",35748,36659,911
"21962","Ocbimv22004496m.g","KQ417173",617651,617992,341
"21963","Ocbimv22022988m.g","KQ419334",215336,215761,425
"21964","Ocbimv22037212m.g","KQ416683",356193,357083,890
"21965","Ocbimv22011350m.g","KQ427732",26405,27668,1263
"21966","Ocbimv22037919m.g","KQ423167",100095,142012,41917
"21967","Ocbimv22009140m.g","KQ415861",201471,201814,343
"21968","Ocbimv22015399m.g","KQ418240",551,12444,11893
"21969","Ocbimv22027436m.g","KQ420276",13615,58211,44596
"21970","Ocbimv22024166m.g","KQ419543",325518,344035,18517
"21971","Ocbimv22008475m.g","KQ415854",702577,706572,3995
"21972","Ocbimv22039823m.g","KQ416827",50272,50421,149
"21973","Ocbimv22014165m.g","KQ418096",472229,472462,233
"21974","Ocbimv22027318m.g","KQ420258",359118,361163,2045
"21975","Ocbimv22008533m.g","KQ426670",2575,3591,1016
"21976","Ocbimv22006247m.g","KQ417305",418537,425249,6712
"21977","Ocbimv22013965m.g","KQ418073",433638,437284,3646
"21978","Ocbimv22010949m.g","KQ417726",263994,264224,230
"21979","Ocbimv22024975m.g","KQ419670",267068,267586,518
"21980","Ocbimv22033332m.g","KQ421780",200124,211327,11203
"21981","Ocbimv22010871m.g","LGKD01583265",6,356,350
"21982","Ocbimv22037395m.g","KQ416694",1219162,1254754,35592
"21983","Ocbimv22016001m.g","KQ429650",46448,62721,16273
"21984","Ocbimv22019892m.g","KQ418832",589439,589804,365
"21985","Ocbimv22031667m.g","KQ421308",43917,57496,13579
"21986","Ocbimv22026040m.g","KQ419966",15616,15986,370
"21987","Ocbimv22029719m.g","KQ420813",594468,608199,13731
"21988","Ocbimv22007425m.g","KQ426340",23896,31293,7397
"21989","Ocbimv22007170m.g","KQ417386",1463061,1497792,34731
"21990","Ocbimv22010578m.g","KQ427436",24766,25125,359
"21991","Ocbimv22032488m.g","KQ421555",21432,38181,16749
"21992","Ocbimv22000447m.g","KQ423968",141070,143243,2173
"21993","Ocbimv22025765m.g","KQ416166",604321,605795,1474
"21994","Ocbimv22006866m.g","KQ426126",11559,37336,25777
"21995","Ocbimv22027327m.g","KQ420260",590004,590228,224
"21996","Ocbimv22013988m.g","KQ428718",17321,31718,14397
"21997","Ocbimv22017328m.g","KQ418483",127419,127823,404
"21998","Ocbimv22035096m.g","KQ422277",284,3219,2935
"21999","Ocbimv22033441m.g","KQ421816",221449,285247,63798
"22000","Ocbimv22028315m.g","KQ420471",132365,141292,8927
"22001","Ocbimv22016910m.g","KQ418422",531435,531767,332
"22002","Ocbimv22038241m.g","KQ423245",338211,358540,20329
"22003","Ocbimv22038942m.g","KQ423493",144062,144460,398
"22004","Ocbimv22037945m.g","KQ423179",6513,7907,1394
"22005","Ocbimv22014472m.g","KQ418139",293131,293540,409
"22006","Ocbimv22025707m.g","KQ419887",702260,715657,13397
"22007","Ocbimv22018469m.g","KQ430702",1225,8097,6872
"22008","Ocbimv22038585m.g","KQ423412",100707,103484,2777
"22009","Ocbimv22006766m.g","KQ417347",1233103,1233360,257
"22010","Ocbimv22002760m.g","KQ424775",59489,91554,32065
"22011","Ocbimv22026215m.g","KQ420017",442426,442720,294
"22012","Ocbimv22028038m.g","KQ416244",139134,159089,19955
"22013","Ocbimv22038147m.g","KQ423217",690632,697378,6746
"22014","Ocbimv22032309m.g","KQ421523",53879,77593,23714
"22015","Ocbimv22005437m.g","KQ417252",202310,203912,1602
"22016","Ocbimv22036860m.g","KQ416662",637454,638436,982
"22017","Ocbimv22036256m.g","KQ416628",95,2500,2405
"22018","Ocbimv22026795m.g","KQ420117",1075047,1075298,251
"22019","Ocbimv22004234m.g","KQ417143",92267,93077,810
"22020","Ocbimv22027218m.g","KQ416214",91830,123036,31206
"22021","Ocbimv22031448m.g","KQ421251",14903,23456,8553
"22022","Ocbimv22006393m.g","KQ417318",213099,247023,33924
"22023","Ocbimv22023741m.g","KQ419470",568539,577169,8630
"22024","Ocbimv22003010m.g","KQ417054",188054,212673,24619
"22025","Ocbimv22033547m.g","KQ416485",1493,64571,63078
"22026","Ocbimv22027460m.g","KQ416225",24594,28493,3899
"22027","Ocbimv22016635m.g","KQ429932",346,9656,9310
"22028","Ocbimv22026869m.g","KQ420132",724872,725084,212
"22029","Ocbimv22004000m.g","KQ425175",7739,8116,377
"22030","Ocbimv22028373m.g","KQ416256",6373,47727,41354
"22031","Ocbimv22039820m.g","KQ423766",572561,572873,312
"22032","Ocbimv22036097m.g","KQ416616",2533878,2534836,958
"22033","Ocbimv22029941m.g","KQ416325",99596,99820,224
"22034","Ocbimv22008484m.g","KQ426647",166535,166723,188
"22035","Ocbimv22033060m.g","KQ421721",653907,682949,29042
"22036","Ocbimv22030674m.g","KQ421058",289714,292568,2854
"22037","Ocbimv22015296m.g","KQ429255",188189,188515,326
"22038","Ocbimv22029556m.g","KQ420776",435735,438125,2390
"22039","Ocbimv22010317m.g","KQ427354",9481,10248,767
"22040","Ocbimv22029954m.g","KQ420859",224177,225028,851
"22041","Ocbimv22023477m.g","KQ433417",268552,288654,20102
"22042","Ocbimv22028057m.g","KQ420424",115051,116068,1017
"22043","Ocbimv22018997m.g","LGKD01647515",17,148,131
"22044","Ocbimv22016352m.g","KQ415679",475109,476838,1729
"22045","Ocbimv22007984m.g","KQ426517",72768,73022,254
"22046","Ocbimv22036189m.g","KQ422669",41390,41620,230
"22047","Ocbimv22027483m.g","KQ416225",421085,454869,33784
"22048","Ocbimv22030025m.g","KQ420886",30310,31791,1481
"22049","Ocbimv22029957m.g","KQ420859",290860,291246,386
"22050","Ocbimv22006136m.g","KQ417300",627301,631030,3729
"22051","Ocbimv22038037m.g","KQ415762",646272,649211,2939
"22052","Ocbimv22030725m.g","KQ421079",162818,163177,359
"22053","Ocbimv22023675m.g","KQ419458",206016,224671,18655
"22054","Ocbimv22010713m.g","KQ427475",22445,23677,1232
"22055","Ocbimv22007177m.g","KQ426223",76584,103888,27304
"22056","Ocbimv22038738m.g","KQ416764",254024,258179,4155
"22057","Ocbimv22028497m.g","KQ416259",35683,61677,25994
"22058","Ocbimv22007933m.g","KQ426499",3055,54564,51509
"22059","Ocbimv22022964m.g","KQ416079",312094,312375,281
"22060","Ocbimv22023289m.g","KQ419392",72664,74835,2171
"22061","Ocbimv22003387m.g","KQ425000",73792,74741,949
"22062","Ocbimv22027542m.g","KQ420299",1380180,1484709,104529
"22063","Ocbimv22009928m.g","KQ417623",248478,305228,56750
"22064","Ocbimv22018821m.g","KQ430889",34994,36051,1057
"22065","Ocbimv22008269m.g","KQ417492",522797,547621,24824
"22066","Ocbimv22000775m.g","KQ416879",488351,544376,56025
"22067","Ocbimv22018623m.g","LGKD01644460",321,1118,797
"22068","Ocbimv22013138m.g","KQ417985",796038,796292,254
"22069","Ocbimv22019656m.g","KQ431220",181260,181496,236
"22070","Ocbimv22027799m.g","KQ416233",535857,542544,6687
"22071","Ocbimv22033806m.g","KQ421878",165407,198465,33058
"22072","Ocbimv22017681m.g","KQ430417",19648,22148,2500
"22073","Ocbimv22027019m.g","KQ420163",31887,33305,1418
"22074","Ocbimv22008333m.g","KQ417497",1053668,1098558,44890
"22075","Ocbimv22031877m.g","KQ421370",58158,61248,3090
"22076","Ocbimv22010389m.g","KQ415876",1902531,1903193,662
"22077","Ocbimv22016592m.g","KQ418368",791372,794130,2758
"22078","Ocbimv22037366m.g","KQ423019",14673,15970,1297
"22079","Ocbimv22000232m.g","KQ423903",94273,135018,40745
"22080","Ocbimv22021863m.g","KQ419113",101031,143783,42752
"22081","Ocbimv22005293m.g","KQ425571",161631,161813,182
"22082","Ocbimv22004648m.g","KQ425406",11079,11408,329
"22083","Ocbimv22024332m.g","KQ419574",155131,182576,27445
"22084","Ocbimv22007433m.g","KQ417413",32362,37074,4712
"22085","Ocbimv22018935m.g","KQ418699",216956,217378,422
"22086","Ocbimv22003408m.g","KQ417086",503831,569006,65175
"22087","Ocbimv22004869m.g","KQ417211",15816,22958,7142
"22088","Ocbimv22015204m.g","KQ429202",1745,1894,149
"22089","Ocbimv22018272m.g","KQ418590",105989,106583,594
"22090","Ocbimv22000787m.g","KQ424066",54654,104378,49724
"22091","Ocbimv22022311m.g","KQ432661",136,588,452
"22092","Ocbimv22029000m.g","KQ416279",247686,296103,48417
"22093","Ocbimv22024372m.g","KQ419574",1091117,1098100,6983
"22094","Ocbimv22016340m.g","KQ429822",39591,41033,1442
"22095","Ocbimv22003423m.g","KQ417087",402563,407074,4511
"22096","Ocbimv22035893m.g","KQ422595",221965,246219,24254
"22097","Ocbimv22011237m.g","KQ417766",85279,87232,1953
"22098","Ocbimv22020099m.g","KQ416019",457746,457970,224
"22099","Ocbimv22037550m.g","KQ423059",87163,87525,362
"22100","Ocbimv22034225m.g","KQ422014",112434,119114,6680
"22101","Ocbimv22028618m.g","KQ416264",733584,736480,2896
"22102","Ocbimv22025959m.g","KQ416177",223589,223922,333
"22103","Ocbimv22013718m.g","KQ428621",85818,86219,401
"22104","Ocbimv22005450m.g","KQ417252",1906213,1906817,604
"22105","Ocbimv22007049m.g","KQ417371",197279,200820,3541
"22106","Ocbimv22004035m.g","KQ425190",54851,55937,1086
"22107","Ocbimv22022863m.g","KQ416078",10859,11098,239
"22108","Ocbimv22010063m.g","KQ417640",49422,49982,560
"22109","Ocbimv22007223m.g","KQ426253",67452,67622,170
"22110","Ocbimv22039208m.g","KQ423576",232985,287218,54233
"22111","Ocbimv22000382m.g","KQ423941",513818,514556,738
"22112","Ocbimv22022673m.g","KQ432947",1562,3254,1692
"22113","Ocbimv22018317m.g","KQ430646",41223,78620,37397
"22114","Ocbimv22025537m.g","KQ419832",23643,24674,1031
"22115","Ocbimv22017773m.g","KQ418544",118766,119050,284
"22116","Ocbimv22019670m.g","KQ431226",54969,56838,1869
"22117","Ocbimv22028212m.g","KQ420444",340451,340969,518
"22118","Ocbimv22025087m.g","KQ416137",443959,446049,2090
"22119","Ocbimv22028437m.g","KQ420488",87549,93840,6291
"22120","Ocbimv22031937m.g","KQ421385",105436,105762,326
"22121","Ocbimv22006312m.g","KQ425873",149375,150895,1520
"22122","Ocbimv22012444m.g","KQ417911",1092214,1093068,854
"22123","Ocbimv22035056m.g","KQ422263",79174,86072,6898
"22124","Ocbimv22021737m.g","KQ432297",3776,8638,4862
"22125","Ocbimv22020964m.g","KQ418983",59741,68367,8626
"22126","Ocbimv22032095m.g","KQ421442",175815,304438,128623
"22127","Ocbimv22035980m.g","KQ422621",214914,233453,18539
"22128","Ocbimv22009320m.g","KQ415863",83204,105719,22515
"22129","Ocbimv22010506m.g","KQ417682",3802,33393,29591
"22130","Ocbimv22011860m.g","KQ427934",24605,28723,4118
"22131","Ocbimv22023544m.g","KQ416091",74916,75317,401
"22132","Ocbimv22039900m.g","KQ416834",190532,190941,409
"22133","Ocbimv22021529m.g","KQ419071",80976,81488,512
"22134","Ocbimv22032137m.g","KQ421460",93793,96594,2801
"22135","Ocbimv22014932m.g","KQ429139",62075,76345,14270
"22136","Ocbimv22008546m.g","KQ426679",1635,1940,305
"22137","Ocbimv22034160m.g","LGKD01424476",3,591,588
"22138","Ocbimv22003788m.g","KQ417112",722271,746591,24320
"22139","Ocbimv22025120m.g","KQ419696",72077,72286,209
"22140","Ocbimv22023938m.g","KQ419503",6914,7757,843
"22141","Ocbimv22014519m.g","KQ415932",776983,792366,15383
"22142","Ocbimv22026955m.g","KQ420149",78139,82689,4550
"22143","Ocbimv22011406m.g","KQ417791",1136313,1136783,470
"22144","Ocbimv22014331m.g","KQ418119",27900,29307,1407
"22145","Ocbimv22030933m.g","KQ421121",236749,266831,30082
"22146","Ocbimv22002371m.g","KQ415792",78717,79280,563
"22147","Ocbimv22034830m.g","KQ422188",130320,130972,652
"22148","Ocbimv22030243m.g","KQ416338",329250,343305,14055
"22149","Ocbimv22037262m.g","KQ422986",144000,179548,35548
"22150","Ocbimv22026019m.g","KQ419957",262649,264575,1926
"22151","Ocbimv22016408m.g","KQ429848",1888,31785,29897
"22152","Ocbimv22001585m.g","KQ416946",7634,58457,50823
"22153","Ocbimv22029439m.g","KQ416306",1408993,1409250,257
"22154","Ocbimv22037595m.g","KQ423077",500267,522241,21974
"22155","Ocbimv22026681m.g","KQ416196",999701,1006035,6334
"22156","Ocbimv22036524m.g","KQ422783",135042,136245,1203
"22157","Ocbimv22039265m.g","KQ423598",227585,239229,11644
"22158","Ocbimv22004474m.g","KQ417167",93353,98000,4647
"22159","Ocbimv22022010m.g","KQ432511",30981,34522,3541
"22160","Ocbimv22039535m.g","KQ423698",5497,38553,33056
"22161","Ocbimv22038330m.g","KQ423285",15103,41115,26012
"22162","Ocbimv22020690m.g","KQ418954",399267,433672,34405
"22163","Ocbimv22037105m.g","KQ422923",141366,141667,301
"22164","Ocbimv22001477m.g","KQ424315",95945,96853,908
"22165","Ocbimv22000763m.g","KQ416879",179518,188213,8695
"22166","Ocbimv22002098m.g","KQ424540",6832,11168,4336
"22167","Ocbimv22035985m.g","KQ422621",260923,279585,18662
"22168","Ocbimv22037383m.g","KQ416694",1039769,1041601,1832
"22169","Ocbimv22039196m.g","KQ423574",45969,64043,18074
"22170","Ocbimv22030845m.g","LGKD01073709",78,341,263
"22171","Ocbimv22011238m.g","KQ417766",194179,194352,173
"22172","Ocbimv22007765m.g","KQ415847",997840,998780,940
"22173","Ocbimv22038171m.g","KQ423223",235657,235866,209
"22174","Ocbimv22013239m.g","KQ418003",138029,157078,19049
"22175","Ocbimv22028671m.g","KQ420549",154222,156199,1977
"22176","Ocbimv22020835m.g","KQ418970",1824225,1839278,15053
"22177","Ocbimv22036408m.g","KQ416641",134976,136763,1787
"22178","Ocbimv22011138m.g","KQ427654",4234,4635,401
"22179","Ocbimv22002534m.g","KQ424678",160799,167685,6886
"22180","Ocbimv22016190m.g","KQ429735",6119,9482,3363
"22181","Ocbimv22016817m.g","KQ430041",4154,5526,1372
"22182","Ocbimv22017348m.g","KQ418483",372034,412428,40394
"22183","Ocbimv22032889m.g","KQ421676",134099,136623,2524
"22184","Ocbimv22035580m.g","KQ422445",27343,27696,353
"22185","Ocbimv22002599m.g","KQ424714",130593,132127,1534
"22186","Ocbimv22018747m.g","KQ416000",31,76468,76437
"22187","Ocbimv22015902m.g","KQ429626",93321,93602,281
"22188","Ocbimv22020308m.g","KQ418887",73008,73844,836
"22189","Ocbimv22022451m.g","KQ432747",191,736,545
"22190","Ocbimv22014809m.g","KQ429094",172187,174357,2170
"22191","Ocbimv22016286m.g","KQ429791",20309,21625,1316
"22192","Ocbimv22022569m.g","KQ419260",823654,823884,230
"22193","Ocbimv22008544m.g","KQ426678",27613,53692,26079
"22194","Ocbimv22039214m.g","KQ423579",1411,13041,11630
"22195","Ocbimv22034879m.g","KQ422205",33,973,940
"22196","Ocbimv22036597m.g","KQ422799",18160,18670,510
"22197","Ocbimv22000079m.g","KQ416838",37402,37709,307
"22198","Ocbimv22018106m.g","KQ430572",349127,360902,11775
"22199","Ocbimv22014114m.g","KQ428763",66624,69221,2597
"22200","Ocbimv22031715m.g","KQ421325",129403,148880,19477
"22201","Ocbimv22035308m.g","KQ422351",406245,408034,1789
"22202","Ocbimv22004329m.g","KQ417149",262918,274305,11387
"22203","Ocbimv22024609m.g","KQ419601",1472981,1526735,53754
"22204","Ocbimv22013369m.g","KQ428463",27058,27390,332
"22205","Ocbimv22014016m.g","KQ418078",14869,15477,608
"22206","Ocbimv22029793m.g","KQ415713",10948,11202,254
"22207","Ocbimv22015751m.g","KQ418289",206252,222686,16434
"22208","Ocbimv22034621m.g","KQ422091",103414,112472,9058
"22209","Ocbimv22018419m.g","KQ430684",801586,801783,197
"22210","Ocbimv22018511m.g","KQ415994",15373,16636,1263
"22211","Ocbimv22009007m.g","KQ417549",395723,396662,939
"22212","Ocbimv22015578m.g","KQ418267",718033,718392,359
"22213","Ocbimv22029038m.g","KQ420631",10164,10328,164
"22214","Ocbimv22008690m.g","KQ426734",1548,2241,693
"22215","Ocbimv22007051m.g","KQ417371",213691,264230,50539
"22216","Ocbimv22013529m.g","KQ415917",172239,173576,1337
"22217","Ocbimv22010599m.g","KQ417698",13411,14427,1016
"22218","Ocbimv22006281m.g","KQ425850",212968,220616,7648
"22219","Ocbimv22036962m.g","KQ416666",1828941,1866595,37654
"22220","Ocbimv22020820m.g","KQ418970",669160,719050,49890
"22221","Ocbimv22019837m.g","KQ418821",503428,524999,21571
"22222","Ocbimv22038931m.g","KQ423490",258424,261412,2988
"22223","Ocbimv22037915m.g","KQ423165",19635,59037,39402
"22224","Ocbimv22034874m.g","KQ416561",60553,80186,19633
"22225","Ocbimv22028414m.g","KQ420483",123568,143245,19677
"22226","Ocbimv22016312m.g","KQ418338",268322,268546,224
"22227","Ocbimv22023837m.g","KQ419485",31649,31972,323
"22228","Ocbimv22030006m.g","KQ420882",48564,52794,4230
"22229","Ocbimv22033934m.g","KQ416499",230619,231728,1109
"22230","Ocbimv22026816m.g","KQ420119",152385,153345,960
"22231","Ocbimv22025587m.g","KQ419857",110583,111041,458
"22232","Ocbimv22022924m.g","KQ419326",560267,598972,38705
"22233","Ocbimv22019818m.g","KQ431332",93317,167123,73806
"22234","Ocbimv22004853m.g","KQ415809",265719,273971,8252
"22235","Ocbimv22015980m.g","KQ415949",1103757,1107501,3744
"22236","Ocbimv22029989m.g","KQ416327",1548,2055,507
"22237","Ocbimv22028960m.g","KQ420616",123369,123749,380
"22238","Ocbimv22001036m.g","KQ424157",668715,714037,45322
"22239","Ocbimv22021794m.g","KQ419103",354315,354912,597
"22240","Ocbimv22020775m.g","KQ418964",129800,155559,25759
"22241","Ocbimv22011163m.g","KQ427657",19115,34445,15330
"22242","Ocbimv22032383m.g","KQ416430",499602,499817,215
"22243","Ocbimv22039236m.g","KQ423591",167474,202533,35059
"22244","Ocbimv22021165m.g","KQ415686",234380,242138,7758
"22245","Ocbimv22036342m.g","KQ422717",108114,112395,4281
"22246","Ocbimv22038795m.g","KQ415767",1069085,1069252,167
"22247","Ocbimv22009553m.g","KQ415865",1746913,1748446,1533
"22248","Ocbimv22039290m.g","KQ423605",138226,186834,48608
"22249","Ocbimv22036718m.g","KQ416654",522448,534180,11732
"22250","Ocbimv22030217m.g","KQ420924",348301,362863,14562
"22251","Ocbimv22025800m.g","KQ419906",123308,154349,31041
"22252","Ocbimv22023467m.g","KQ419414",436848,437372,524
"22253","Ocbimv22015353m.g","KQ429290",15302,55135,39833
"22254","Ocbimv22037769m.g","LGKD01463888",221,2256,2035
"22255","Ocbimv22019935m.g","KQ418838",4180,5003,823
"22256","Ocbimv22038436m.g","KQ423338",233899,238191,4292
"22257","Ocbimv22021181m.g","LGKD01665979",1852,2355,503
"22258","Ocbimv22034801m.g","KQ416556",264,44223,43959
"22259","Ocbimv22011784m.g","KQ417832",131516,181124,49608
"22260","Ocbimv22004528m.g","KQ415805",1384462,1398564,14102
"22261","Ocbimv22024165m.g","KQ419543",298983,319217,20234
"22262","Ocbimv22015566m.g","KQ418267",459786,488182,28396
"22263","Ocbimv22014722m.g","KQ418170",106098,123577,17479
"22264","Ocbimv22021833m.g","KQ415687",887346,888333,987
"22265","Ocbimv22032726m.g","KQ421646",37242,38897,1655
"22266","Ocbimv22015202m.g","LGKD01615362",27,332,305
"22267","Ocbimv22028688m.g","KQ420555",111225,111984,759
"22268","Ocbimv22005763m.g","KQ417276",581651,642418,60767
"22269","Ocbimv22009867m.g","KQ417620",1937265,1937666,401
"22270","Ocbimv22008414m.g","KQ426634",182481,229117,46636
"22271","Ocbimv22014409m.g","KQ418129",84280,84780,500
"22272","Ocbimv22000186m.g","KQ423889",41391,66286,24895
"22273","Ocbimv22018341m.g","KQ418609",349027,350324,1297
"22274","Ocbimv22037160m.g","KQ416678",408226,505975,97749
"22275","Ocbimv22002646m.g","KQ417023",1384165,1402841,18676
"22276","Ocbimv22002578m.g","KQ424701",177327,200848,23521
"22277","Ocbimv22037402m.g","KQ416694",1698410,1698825,415
"22278","Ocbimv22006701m.g","KQ426075",373657,384855,11198
"22279","Ocbimv22016442m.g","KQ418355",197178,197749,571
"22280","Ocbimv22002355m.g","KQ424644",118202,119671,1469
"22281","Ocbimv22025662m.g","KQ419878",219865,221442,1577
"22282","Ocbimv22025649m.g","KQ419876",46120,54452,8332
"22283","Ocbimv22014798m.g","LGKD01223274",6,131,125
"22284","Ocbimv22035197m.g","KQ422300",133386,137720,4334
"22285","Ocbimv22017389m.g","KQ430272",424303,425426,1123
"22286","Ocbimv22016905m.g","KQ430077",52491,54287,1796
"22287","Ocbimv22024503m.g","KQ419590",343623,344093,470
"22288","Ocbimv22032886m.g","KQ421675",358030,358551,521
"22289","Ocbimv22000337m.g","KQ416854",417991,454763,36772
"22290","Ocbimv22014980m.g","KQ418190",109891,111099,1208
"22291","Ocbimv22031259m.g","KQ421206",609172,627868,18696
"22292","Ocbimv22004069m.g","KQ425192",93325,93687,362
"22293","Ocbimv22014092m.g","KQ418088",86145,86318,173
"22294","Ocbimv22007013m.g","KQ417370",400898,429036,28138
"22295","Ocbimv22038152m.g","KQ423220",428461,429414,953
"22296","Ocbimv22007076m.g","KQ417377",203039,211184,8145
"22297","Ocbimv22009154m.g","KQ426900",109020,109771,751
"22298","Ocbimv22021764m.g","KQ432312",1201,2143,942
"22299","Ocbimv22013405m.g","KQ428493",4798,162785,157987
"22300","Ocbimv22008295m.g","KQ417495",124993,126906,1913
"22301","Ocbimv22024580m.g","KQ419601",543216,544264,1048
"22302","Ocbimv22009861m.g","KQ417620",1592582,1592806,224
"22303","Ocbimv22014467m.g","LGKD01610047",340,1443,1103
"22304","Ocbimv22034035m.g","KQ416508",281164,281907,743
"22305","Ocbimv22024499m.g","KQ419590",107243,116260,9017
"22306","Ocbimv22007712m.g","KQ417446",48057,68900,20843
"22307","Ocbimv22034533m.g","KQ416536",120013,120968,955
"22308","Ocbimv22029188m.g","KQ420673",369378,400166,30788
"22309","Ocbimv22026445m.g","KQ420052",137369,152958,15589
"22310","Ocbimv22001614m.g","KQ416949",296323,296637,314
"22311","Ocbimv22033473m.g","KQ416482",215720,216163,443
"22312","Ocbimv22024735m.g","KQ419622",12053,13608,1555
"22313","Ocbimv22021252m.g","KQ419020",105553,138593,33040
"22314","Ocbimv22025445m.g","LGKD01318253",325,657,332
"22315","Ocbimv22004082m.g","KQ417133",670932,671792,860
"22316","Ocbimv22031378m.g","KQ416393",657918,658505,587
"22317","Ocbimv22016028m.g","KQ429665",16837,23284,6447
"22318","Ocbimv22032507m.g","KQ416435",65213,65368,155
"22319","Ocbimv22015137m.g","KQ418196",1208334,1213312,4978
"22320","Ocbimv22039747m.g","KQ416818",400024,401290,1266
"22321","Ocbimv22004087m.g","KQ417134",22449,32346,9897
"22322","Ocbimv22036108m.g","KQ416617",410150,412977,2827
"22323","Ocbimv22029359m.g","KQ420720",39162,44916,5754
"22324","Ocbimv22038388m.g","KQ423305",9042,24149,15107
"22325","Ocbimv22027230m.g","KQ420223",5668,47195,41527
"22326","Ocbimv22025945m.g","KQ419931",174661,174990,329
"22327","Ocbimv22007380m.g","LGKD01554886",1,424,423
"22328","Ocbimv22010096m.g","KQ417641",490197,492863,2666
"22329","Ocbimv22018778m.g","KQ418673",105892,106332,440
"22330","Ocbimv22017901m.g","KQ418556",117,680,563
"22331","Ocbimv22038588m.g","KQ423412",322651,323151,500
"22332","Ocbimv22019349m.g","KQ418754",38880,39785,905
"22333","Ocbimv22030520m.g","KQ421009",1496322,1496549,227
"22334","Ocbimv22009394m.g","KQ426988",42718,65614,22896
"22335","Ocbimv22023298m.g","KQ416087",401532,401844,312
"22336","Ocbimv22008488m.g","LGKD01563010",21,407,386
"22337","Ocbimv22032108m.g","KQ421451",127972,134664,6692
"22338","Ocbimv22027365m.g","KQ420265",515930,545984,30054
"22339","Ocbimv22026667m.g","KQ416196",372210,431864,59654
"22340","Ocbimv22014710m.g","KQ429037",19244,40398,21154
"22341","Ocbimv22028878m.g","KQ420596",34986,76694,41708
"22342","Ocbimv22012743m.g","KQ417934",977522,997342,19820
"22343","Ocbimv22010963m.g","KQ427571",51729,59808,8079
"22344","Ocbimv22001033m.g","KQ424157",605818,641268,35450
"22345","Ocbimv22035400m.g","KQ422367",176460,176704,244
"22346","Ocbimv22036005m.g","KQ422631",19798,19953,155
"22347","Ocbimv22036785m.g","KQ416657",116952,134782,17830
"22348","Ocbimv22000554m.g","KQ423995",335007,353209,18202
"22349","Ocbimv22033436m.g","KQ421810",237370,245710,8340
"22350","Ocbimv22007476m.g","KQ415843",2689,3922,1233
"22351","Ocbimv22034605m.g","KQ422087",94876,97628,2752
"22352","Ocbimv22011387m.g","KQ417791",738678,747858,9180
"22353","Ocbimv22017646m.g","KQ418523",5344,41744,36400
"22354","Ocbimv22017407m.g","KQ418493",19819,20805,986
"22355","Ocbimv22031133m.g","KQ421173",51008,72000,20992
"22356","Ocbimv22033206m.g","KQ421752",168065,168475,410
"22357","Ocbimv22012724m.g","KQ417930",61932,62360,428
"22358","Ocbimv22034926m.g","KQ415742",1041844,1081607,39763
"22359","Ocbimv22029334m.g","KQ420711",561992,565575,3583
"22360","Ocbimv22015145m.g","KQ418200",324526,384110,59584
"22361","Ocbimv22018394m.g","KQ430684",50249,66208,15959
"22362","Ocbimv22039632m.g","KQ416810",1045330,1049129,3799
"22363","Ocbimv22001497m.g","KQ416938",217698,224885,7187
"22364","Ocbimv22018985m.g","KQ418706",126604,127979,1375
"22365","Ocbimv22018127m.g","KQ430573",4165,4626,461
"22366","Ocbimv22028025m.g","KQ420423",72490,72672,182
"22367","Ocbimv22034067m.g","KQ416508",872717,882490,9773
"22368","Ocbimv22024213m.g","KQ419550",100930,102181,1251
"22369","Ocbimv22036751m.g","KQ422849",171522,173148,1626
"22370","Ocbimv22003665m.g","KQ417100",220715,228901,8186
"22371","Ocbimv22009029m.g","KQ426847",35677,49506,13829
"22372","Ocbimv22013299m.g","KQ428434",9005,9184,179
"22373","Ocbimv22005578m.g","KQ425655",271648,276739,5091
"22374","Ocbimv22022374m.g","KQ419208",365860,366444,584
"22375","Ocbimv22032800m.g","KQ421658",661595,663599,2004
"22376","Ocbimv22032779m.g","KQ421658",32048,40777,8729
"22377","Ocbimv22016550m.g","KQ418367",295601,371739,76138
"22378","Ocbimv22032314m.g","KQ421523",177267,181873,4606
"22379","Ocbimv22006473m.g","KQ417326",407590,419886,12296
"22380","Ocbimv22021288m.g","KQ419026",160,816,656
"22381","Ocbimv22033359m.g","KQ421798",55901,92045,36144
"22382","Ocbimv22009235m.g","KQ426937",14692,65844,51152
"22383","Ocbimv22006926m.g","KQ426153",12596,12983,387
"22384","Ocbimv22005301m.g","KQ417239",21770,45682,23912
"22385","Ocbimv22020412m.g","KQ418908",535651,538701,3050
"22386","Ocbimv22029798m.g","KQ420826",366,20442,20076
"22387","Ocbimv22034404m.g","KQ422029",76092,83570,7478
"22388","Ocbimv22013433m.g","KQ418023",217317,217583,266
"22389","Ocbimv22000577m.g","KQ424000",109267,109521,254
"22390","Ocbimv22019245m.g","KQ431067",21539,21970,431
"22391","Ocbimv22008032m.g","KQ426535",210775,211182,407
"22392","Ocbimv22030820m.g","KQ416371",615309,615557,248
"22393","Ocbimv22014645m.g","KQ418162",722,5341,4619
"22394","Ocbimv22038343m.g","KQ416737",631679,632467,788
"22395","Ocbimv22032613m.g","KQ421607",232655,250523,17868
"22396","Ocbimv22010628m.g","KQ415669",1760929,1761953,1024
"22397","Ocbimv22038423m.g","KQ423334",144234,144473,239
"22398","Ocbimv22031059m.g","KQ421150",28413,80949,52536
"22399","Ocbimv22012293m.g","KQ417901",54417,88773,34356
"22400","Ocbimv22036533m.g","KQ422786",49286,49540,254
"22401","Ocbimv22013249m.g","KQ418004",337160,337638,478
"22402","Ocbimv22035788m.g","KQ422538",47160,47551,391
"22403","Ocbimv22037417m.g","KQ416694",2694082,2705073,10991
"22404","Ocbimv22007952m.g","LGKD01559352",144,767,623
"22405","Ocbimv22001903m.g","KQ424463",194182,194424,242
"22406","Ocbimv22000638m.g","KQ424026",37704,41581,3877
"22407","Ocbimv22022089m.g","KQ432556",15441,114219,98778
"22408","Ocbimv22038603m.g","KQ416754",64162,95950,31788
"22409","Ocbimv22010138m.g","KQ427275",315232,315675,443
"22410","Ocbimv22039358m.g","KQ423631",161671,169414,7743
"22411","Ocbimv22026003m.g","KQ419952",288605,288865,260
"22412","Ocbimv22031930m.g","KQ421377",13932,15898,1966
"22413","Ocbimv22035446m.g","KQ422385",94748,95322,574
"22414","Ocbimv22033574m.g","KQ421836",383114,383798,684
"22415","Ocbimv22007328m.g","KQ426292",28234,46449,18215
"22416","Ocbimv22026410m.g","KQ420047",88572,88757,185
"22417","Ocbimv22022071m.g","KQ432553",23854,76708,52854
"22418","Ocbimv22009402m.g","KQ417591",313791,315467,1676
"22419","Ocbimv22030329m.g","KQ420950",427783,427980,197
"22420","Ocbimv22005043m.g","KQ415812",319493,320074,581
"22421","Ocbimv22007167m.g","KQ417386",1402102,1403079,977
"22422","Ocbimv22016385m.g","KQ415962",1752769,1798324,45555
"22423","Ocbimv22036386m.g","KQ422737",12936,36188,23252
"22424","Ocbimv22007092m.g","KQ417377",861446,863828,2382
"22425","Ocbimv22020411m.g","KQ418908",520517,533779,13262
"22426","Ocbimv22003499m.g","KQ417089",176500,177266,766
"22427","Ocbimv22032099m.g","KQ421445",69334,70383,1049
"22428","Ocbimv22039396m.g","KQ416793",10782,58399,47617
"22429","Ocbimv22020889m.g","KQ431871",55818,88577,32759
"22430","Ocbimv22026857m.g","KQ420130",1011749,1012239,490
"22431","Ocbimv22010569m.g","KQ417691",482920,492242,9322
"22432","Ocbimv22026163m.g","KQ416186",58832,60312,1480
"22433","Ocbimv22037092m.g","KQ422920",249709,255226,5517
"22434","Ocbimv22027900m.g","KQ416239",283088,283905,817
"22435","Ocbimv22030595m.g","KQ421034",369941,371819,1878
"22436","Ocbimv22004392m.g","KQ425290",29813,46250,16437
"22437","Ocbimv22020158m.g","KQ418863",450371,495449,45078
"22438","Ocbimv22002778m.g","KQ424779",324645,324896,251
"22439","Ocbimv22018534m.g","KQ415995",48857,49093,236
"22440","Ocbimv22019806m.g","KQ418817",10038,10355,317
"22441","Ocbimv22009924m.g","KQ417623",65256,68266,3010
"22442","Ocbimv22014443m.g","LGKD01609487",152,352,200
"22443","Ocbimv22004367m.g","KQ415803",221381,222049,668
"22444","Ocbimv22003765m.g","KQ417110",11895,58357,46462
"22445","Ocbimv22038195m.g","KQ423231",387269,390781,3512
"22446","Ocbimv22010171m.g","KQ427300",9975,28896,18921
"22447","Ocbimv22011597m.g","KQ427793",11397,11904,507
"22448","Ocbimv22020919m.g","KQ418974",1815705,1816046,341
"22449","Ocbimv22030459m.g","KQ420992",8476,59824,51348
"22450","Ocbimv22007533m.g","KQ426366",86034,86540,506
"22451","Ocbimv22035781m.g","KQ422532",2678,33567,30889
"22452","Ocbimv22031322m.g","KQ421218",115153,115578,425
"22453","Ocbimv22036526m.g","KQ422783",139250,140375,1125
"22454","Ocbimv22008828m.g","KQ426780",16399,72713,56314
"22455","Ocbimv22020533m.g","KQ418922",814723,821403,6680
"22456","Ocbimv22016067m.g","KQ418315",506,17956,17450
"22457","Ocbimv22015007m.g","KQ418194",124071,128793,4722
"22458","Ocbimv22027950m.g","KQ420409",194457,254532,60075
"22459","Ocbimv22022004m.g","LGKD01673960",65,535,470
"22460","Ocbimv22030327m.g","KQ420950",361401,361595,194
"22461","Ocbimv22023910m.g","KQ433699",96924,119960,23036
"22462","Ocbimv22034876m.g","KQ422203",5601,8028,2427
"22463","Ocbimv22039917m.g","KQ423795",67448,139343,71895
"22464","Ocbimv22034205m.g","KQ416523",410153,410540,387
"22465","Ocbimv22028114m.g","KQ416250",88236,88949,713
"22466","Ocbimv22001713m.g","KQ424391",45600,139818,94218
"22467","Ocbimv22022870m.g","KQ433085",11879,12361,482
"22468","Ocbimv22028515m.g","KQ420516",814205,814378,173
"22469","Ocbimv22005872m.g","KQ417280",354523,358671,4148
"22470","Ocbimv22027340m.g","KQ420261",1180185,1180732,547
"22471","Ocbimv22006857m.g","KQ417358",752843,759956,7113
"22472","Ocbimv22006962m.g","KQ426167",32411,34624,2213
"22473","Ocbimv22015388m.g","KQ429315",62407,62625,218
"22474","Ocbimv22026252m.g","KQ420022",33489,33761,272
"22475","Ocbimv22023571m.g","KQ419433",83488,153145,69657
"22476","Ocbimv22031969m.g","LGKD01398453",87,1244,1157
"22477","Ocbimv22025202m.g","KQ419727",603069,603239,170
"22478","Ocbimv22031902m.g","KQ421375",88614,90190,1576
"22479","Ocbimv22003486m.g","KQ425015",932371,933969,1598
"22480","Ocbimv22038668m.g","KQ423432",475869,545270,69401
"22481","Ocbimv22027089m.g","KQ420177",149146,149589,443
"22482","Ocbimv22019426m.g","KQ418762",91927,92181,254
"22483","Ocbimv22008889m.g","KQ426792",13864,26347,12483
"22484","Ocbimv22028301m.g","KQ420464",382996,383334,338
"22485","Ocbimv22018118m.g","KQ430572",442027,446530,4503
"22486","Ocbimv22027603m.g","KQ420313",629801,671437,41636
"22487","Ocbimv22016952m.g","KQ430103",34023,36929,2906
"22488","Ocbimv22028939m.g","KQ420605",149715,151544,1829
"22489","Ocbimv22008618m.g","KQ417510",896041,904345,8304
"22490","Ocbimv22023267m.g","LGKD01687404",1,636,635
"22491","Ocbimv22008664m.g","KQ417519",33,24485,24452
"22492","Ocbimv22018427m.g","KQ418618",57870,58946,1076
"22493","Ocbimv22036984m.g","KQ416667",8327,16236,7909
"22494","Ocbimv22009978m.g","KQ417629",363575,363751,176
"22495","Ocbimv22012775m.g","KQ417939",315733,367594,51861
"22496","Ocbimv22009031m.g","KQ426847",63263,63802,539
"22497","Ocbimv22013870m.g","KQ418069",101981,105964,3983
"22498","Ocbimv22006898m.g","KQ426136",1345,11561,10216
"22499","Ocbimv22027241m.g","KQ416216",141523,142077,554
"22500","Ocbimv22012189m.g","KQ428065",21775,41379,19604
"22501","Ocbimv22032465m.g","KQ421549",205690,206305,615
"22502","Ocbimv22015493m.g","KQ418263",152798,154018,1220
"22503","Ocbimv22031684m.g","KQ421308",551005,579699,28694
"22504","Ocbimv22017712m.g","KQ415981",1073312,1073539,227
"22505","Ocbimv22032857m.g","KQ416453",146492,147115,623
"22506","Ocbimv22030352m.g","KQ416345",965680,966216,536
"22507","Ocbimv22026512m.g","KQ420060",139064,139486,422
"22508","Ocbimv22028863m.g","KQ420595",28339,28554,215
"22509","Ocbimv22011605m.g","LGKD01588152",2,865,863
"22510","Ocbimv22023205m.g","LGKD01686397",7,417,410
"22511","Ocbimv22035064m.g","KQ422263",207895,220079,12184
"22512","Ocbimv22020506m.g","KQ418919",682219,693011,10792
"22513","Ocbimv22028540m.g","KQ416260",144479,150132,5653
"22514","Ocbimv22022780m.g","KQ433008",344103,353441,9338
"22515","Ocbimv22008364m.g","KQ417498",616640,623941,7301
"22516","Ocbimv22009661m.g","KQ427059",680258,707735,27477
"22517","Ocbimv22020656m.g","KQ418945",1009299,1010743,1444
"22518","Ocbimv22017372m.g","KQ418486",207730,537548,329818
"22519","Ocbimv22033834m.g","KQ421893",40366,58562,18196
"22520","Ocbimv22013236m.g","KQ418003",118040,120992,2952
"22521","Ocbimv22006661m.g","KQ426065",16117,24531,8414
"22522","Ocbimv22024128m.g","KQ419537",881295,883341,2046
"22523","Ocbimv22015738m.g","KQ429530",161661,177577,15916
"22524","Ocbimv22008775m.g","KQ426768",93063,93924,861
"22525","Ocbimv22020251m.g","KQ431557",10909,11250,341
"22526","Ocbimv22026500m.g","KQ420059",323898,330948,7050
"22527","Ocbimv22016143m.g","KQ418322",335052,335806,754
"22528","Ocbimv22015904m.g","KQ418303",19696,45965,26269
"22529","Ocbimv22008821m.g","KQ426774",292239,297125,4886
"22530","Ocbimv22015995m.g","KQ418308",11631,18568,6937
"22531","Ocbimv22012758m.g","KQ415909",781866,784196,2330
"22532","Ocbimv22035597m.g","KQ416594",83247,102753,19506
"22533","Ocbimv22025347m.g","KQ419780",28899,47306,18407
"22534","Ocbimv22030673m.g","KQ421058",77598,77864,266
"22535","Ocbimv22033885m.g","KQ421897",25686,94638,68952
"22536","Ocbimv22029133m.g","KQ420662",126787,129061,2274
"22537","Ocbimv22027979m.g","KQ420415",12648,107200,94552
"22538","Ocbimv22009580m.g","KQ427029",385554,385856,302
"22539","Ocbimv22036473m.g","KQ416642",101096,101649,553
"22540","Ocbimv22023103m.g","KQ433220",1,1171,1170
"22541","Ocbimv22002758m.g","KQ417033",21975,22439,464
"22542","Ocbimv22009434m.g","KQ426995",17724,31217,13493
"22543","Ocbimv22021485m.g","KQ419056",197190,201180,3990
"22544","Ocbimv22026292m.g","KQ420023",289755,300328,10573
"22545","Ocbimv22010146m.g","KQ417648",499674,502535,2861
"22546","Ocbimv22008304m.g","KQ417496",254430,255535,1105
"22547","Ocbimv22018507m.g","KQ430732",6214,11352,5138
"22548","Ocbimv22008674m.g","KQ417519",1281805,1282059,254
"22549","Ocbimv22010789m.g","KQ427521",313589,314775,1186
"22550","Ocbimv22000485m.g","KQ416864",395127,432584,37457
"22551","Ocbimv22015626m.g","KQ418269",611630,611987,357
"22552","Ocbimv22024436m.g","KQ419577",667070,693751,26681
"22553","Ocbimv22018682m.g","KQ415684",1823465,1826224,2759
"22554","Ocbimv22027792m.g","KQ416233",409402,427135,17733
"22555","Ocbimv22007458m.g","KQ426347",209168,209822,654
"22556","Ocbimv22012795m.g","KQ415910",96118,96351,233
"22557","Ocbimv22016421m.g","KQ429859",221035,246983,25948
"22558","Ocbimv22031331m.g","KQ421218",301226,352589,51363
"22559","Ocbimv22020319m.g","KQ431609",59834,70795,10961
"22560","Ocbimv22038756m.g","KQ416765",91750,92941,1191
"22561","Ocbimv22014195m.g","KQ418100",23353,23723,370
"22562","Ocbimv22026924m.g","KQ416205",494713,500758,6045
"22563","Ocbimv22002557m.g","KQ424691",4518,5076,558
"22564","Ocbimv22034769m.g","KQ422166",9603,132472,122869
"22565","Ocbimv22013979m.g","LGKD01605479",15,434,419
"22566","Ocbimv22019976m.g","KQ418839",645545,645880,335
"22567","Ocbimv22002062m.g","KQ424530",724589,725049,460
"22568","Ocbimv22010160m.g","KQ427290",165039,175848,10809
"22569","Ocbimv22009090m.g","KQ426874",4089,5176,1087
"22570","Ocbimv22029347m.g","KQ420714",154031,158014,3983
"22571","Ocbimv22026552m.g","KQ416192",175283,209980,34697
"22572","Ocbimv22022560m.g","KQ419259",33415,33633,218
"22573","Ocbimv22012035m.g","KQ427980",72678,108430,35752
"22574","Ocbimv22028522m.g","KQ420517",66999,67313,314
"22575","Ocbimv22031555m.g","KQ421273",781818,813381,31563
"22576","Ocbimv22028124m.g","KQ416251",121390,138674,17284
"22577","Ocbimv22029731m.g","KQ420814",12799,15336,2537
"22578","Ocbimv22005425m.g","LGKD01537459",146,589,443
"22579","Ocbimv22019780m.g","KQ418813",1,276,275
"22580","Ocbimv22027727m.g","KQ420350",47995,49239,1244
"22581","Ocbimv22008310m.g","KQ426613",69524,69922,398
"22582","Ocbimv22034185m.g","KQ416518",588506,655565,67059
"22583","Ocbimv22032706m.g","KQ421638",322780,390883,68103
"22584","Ocbimv22023012m.g","KQ419338",208600,209373,773
"22585","Ocbimv22003732m.g","KQ425076",341608,345773,4165
"22586","Ocbimv22009747m.g","KQ427109",2,457,455
"22587","Ocbimv22023505m.g","KQ433427",144807,145683,876
"22588","Ocbimv22038679m.g","KQ423438",73124,74159,1035
"22589","Ocbimv22030846m.g","KQ421114",105,632,527
"22590","Ocbimv22031175m.g","KQ421192",218549,246881,28332
"22591","Ocbimv22032097m.g","LGKD01399892",479,787,308
"22592","Ocbimv22030692m.g","KQ421067",90128,90854,726
"22593","Ocbimv22023185m.g","KQ419368",244608,245068,460
"22594","Ocbimv22038546m.g","KQ423395",84579,88108,3529
"22595","Ocbimv22026085m.g","KQ419989",129972,138965,8993
"22596","Ocbimv22030962m.g","KQ421138",200245,200421,176
"22597","Ocbimv22007195m.g","KQ417391",42235,74045,31810
"22598","Ocbimv22025976m.g","KQ419940",47480,48181,701
"22599","Ocbimv22019671m.g","KQ418794",9182,12414,3232
"22600","Ocbimv22003159m.g","KQ417062",41939,43519,1580
"22601","Ocbimv22001604m.g","KQ424367",256284,272248,15964
"22602","Ocbimv22007336m.g","KQ426300",17717,46782,29065
"22603","Ocbimv22017907m.g","KQ418559",74514,76751,2237
"22604","Ocbimv22011801m.g","KQ427910",58638,58898,260
"22605","Ocbimv22019567m.g","KQ418784",56953,87946,30993
"22606","Ocbimv22014007m.g","KQ418075",919996,922021,2025
"22607","Ocbimv22018502m.g","LGKD01643628",437,1804,1367
"22608","Ocbimv22036880m.g","KQ422889",44027,44653,626
"22609","Ocbimv22035540m.g","KQ422426",8256,54696,46440
"22610","Ocbimv22019569m.g","KQ418784",104262,159789,55527
"22611","Ocbimv22023702m.g","KQ416093",297487,297693,206
"22612","Ocbimv22039325m.g","KQ416788",158713,161015,2302
"22613","Ocbimv22035994m.g","KQ422629",315418,521443,206025
"22614","Ocbimv22002027m.g","KQ424513",231646,231822,176
"22615","Ocbimv22018340m.g","KQ418609",247807,294937,47130
"22616","Ocbimv22032186m.g","KQ416424",28147,30651,2504
"22617","Ocbimv22017397m.g","LGKD01635244",1,270,269
"22618","Ocbimv22015222m.g","KQ429216",90596,90991,395
"22619","Ocbimv22000646m.g","KQ416872",500404,514243,13839
"22620","Ocbimv22021460m.g","KQ416046",303741,304247,506
"22621","Ocbimv22014313m.g","KQ418116",94905,95681,776
"22622","Ocbimv22011332m.g","KQ427712",16270,16590,320
"22623","Ocbimv22000574m.g","KQ423998",237917,238735,818
"22624","Ocbimv22034376m.g","KQ422021",255761,274264,18503
"22625","Ocbimv22027177m.g","KQ416213",71459,141018,69559
"22626","Ocbimv22023869m.g","KQ433683",4764,6744,1980
"22627","Ocbimv22035546m.g","KQ415751",49806,50048,242
"22628","Ocbimv22038842m.g","KQ416768",398844,429414,30570
"22629","Ocbimv22038571m.g","KQ423405",254406,267657,13251
"22630","Ocbimv22008902m.g","KQ417538",140860,160599,19739
"22631","Ocbimv22007338m.g","KQ426300",132675,170690,38015
"22632","Ocbimv22032096m.g","KQ421442",339755,350361,10606
"22633","Ocbimv22034636m.g","KQ422095",276784,280402,3618
"22634","Ocbimv22009683m.g","KQ427081",4974,39710,34736
"22635","Ocbimv22009346m.g","KQ417585",12243,16102,3859
"22636","Ocbimv22027531m.g","KQ420299",667617,668459,842
"22637","Ocbimv22022951m.g","KQ433154",23507,23743,236
"22638","Ocbimv22031980m.g","KQ416415",148082,150673,2591
"22639","Ocbimv22005973m.g","KQ425767",197958,238907,40949
"22640","Ocbimv22010274m.g","KQ427344",50191,71181,20990
"22641","Ocbimv22017114m.g","KQ418451",102487,116302,13815
"22642","Ocbimv22020428m.g","KQ416027",62766,140737,77971
"22643","Ocbimv22005720m.g","KQ425728",237772,239251,1479
"22644","Ocbimv22032883m.g","KQ421674",9606,18944,9338
"22645","Ocbimv22011341m.g","KQ427716",57,3576,3519
"22646","Ocbimv22012567m.g","KQ417917",1386762,1390861,4099
"22647","Ocbimv22003529m.g","KQ425022",25736,30057,4321
"22648","Ocbimv22007083m.g","KQ417377",455277,490925,35648
"22649","Ocbimv22020241m.g","KQ431554",23439,23924,485
"22650","Ocbimv22001913m.g","KQ424470",44789,101683,56894
"22651","Ocbimv22007616m.g","KQ417438",167876,169047,1171
"22652","Ocbimv22039468m.g","KQ423675",53889,94801,40912
"22653","Ocbimv22003336m.g","KQ424979",5329,6705,1376
"22654","Ocbimv22014483m.g","KQ418140",162158,162544,386
"22655","Ocbimv22035340m.g","KQ422362",67944,68159,215
"22656","Ocbimv22016959m.g","LGKD01632099",3,943,940
"22657","Ocbimv22003838m.g","KQ425128",452100,497238,45138
"22658","Ocbimv22020093m.g","KQ418852",50067,50225,158
"22659","Ocbimv22008019m.g","KQ417470",225829,226029,200
"22660","Ocbimv22036908m.g","KQ422894",343406,353369,9963
"22661","Ocbimv22028683m.g","KQ420554",128865,130258,1393
"22662","Ocbimv22015406m.g","KQ418240",128329,153878,25549
"22663","Ocbimv22031144m.g","KQ421175",184504,184812,308
"22664","Ocbimv22018287m.g","KQ430628",30007,34645,4638
"22665","Ocbimv22004477m.g","KQ425333",9351,52303,42952
"22666","Ocbimv22030194m.g","KQ420921",65926,67523,1597
"22667","Ocbimv22010364m.g","KQ427367",93633,93935,302
"22668","Ocbimv22005753m.g","KQ415822",76301,90122,13821
"22669","Ocbimv22007345m.g","KQ415841",52032,52418,386
"22670","Ocbimv22030304m.g","KQ420942",238392,253516,15124
"22671","Ocbimv22004361m.g","KQ425275",8272,8901,629
"22672","Ocbimv22023970m.g","KQ419512",58836,100260,41424
"22673","Ocbimv22009817m.g","KQ417620",165081,186672,21591
"22674","Ocbimv22038033m.g","KQ415762",293436,295910,2474
"22675","Ocbimv22017498m.g","KQ430324",835,1047,212
"22676","Ocbimv22026764m.g","KQ420110",433372,433659,287
"22677","Ocbimv22035298m.g","KQ422351",162669,203036,40367
"22678","Ocbimv22027264m.g","KQ420240",115484,140066,24582
"22679","Ocbimv22019361m.g","KQ416009",59839,138077,78238
"22680","Ocbimv22038374m.g","KQ416738",28261,29025,764
"22681","Ocbimv22020220m.g","KQ431541",68657,77340,8683
"22682","Ocbimv22002389m.g","KQ424656",4865,5717,852
"22683","Ocbimv22014281m.g","KQ415926",52054,90950,38896
"22684","Ocbimv22013811m.g","KQ428677",120401,132040,11639
"22685","Ocbimv22029871m.g","KQ420828",1981769,1984585,2816
"22686","Ocbimv22015269m.g","KQ418216",1092006,1092828,822
"22687","Ocbimv22033604m.g","KQ416487",510556,557234,46678
"22688","Ocbimv22027974m.g","KQ420414",351990,363640,11650
"22689","Ocbimv22021200m.g","KQ432038",86497,134246,47749
"22690","Ocbimv22035376m.g","KQ422366",14338,39730,25392
"22691","Ocbimv22001762m.g","KQ416962",2993,7390,4397
"22692","Ocbimv22036360m.g","KQ422722",148563,148997,434
"22693","Ocbimv22018079m.g","KQ430560",12246,12581,335
"22694","Ocbimv22006049m.g","KQ417292",171282,171440,158
"22695","Ocbimv22032365m.g","KQ421524",41226,55281,14055
"22696","Ocbimv22017364m.g","KQ418485",91503,92448,945
"22697","Ocbimv22031445m.g","KQ421244",179719,179976,257
"22698","Ocbimv22023645m.g","KQ433537",22026,46339,24313
"22699","Ocbimv22029516m.g","KQ416311",588016,611735,23719
"22700","Ocbimv22015764m.g","KQ418290",207687,210265,2578
"22701","Ocbimv22001685m.g","KQ424386",46291,56615,10324
"22702","Ocbimv22037957m.g","KQ423185",239439,253935,14496
"22703","Ocbimv22017661m.g","KQ418525",182745,195197,12452
"22704","Ocbimv22030428m.g","KQ420978",284987,304060,19073
"22705","Ocbimv22037989m.g","KQ416717",333572,334249,677
"22706","Ocbimv22016169m.g","KQ429720",160456,160620,164
"22707","Ocbimv22006579m.g","KQ426026",123623,123957,334
"22708","Ocbimv22017373m.g","KQ418486",549306,557689,8383
"22709","Ocbimv22022317m.g","KQ432680",61048,61509,461
"22710","Ocbimv22026969m.g","KQ416207",41036,51244,10208
"22711","Ocbimv22025036m.g","KQ416136",514015,518702,4687
"22712","Ocbimv22003713m.g","KQ417103",404840,405118,278
"22713","Ocbimv22022872m.g","LGKD01683669",2030,2734,704
"22714","Ocbimv22026739m.g","KQ416198",345785,370916,25131
"22715","Ocbimv22006282m.g","KQ425850",250684,271884,21200
"22716","Ocbimv22034325m.g","KQ422016",68795,70837,2042
"22717","Ocbimv22011699m.g","LGKD01589619",14,331,317
"22718","Ocbimv22028325m.g","KQ420475",254178,263527,9349
"22719","Ocbimv22016661m.g","KQ418376",30146,39698,9552
"22720","Ocbimv22020166m.g","KQ418864",99174,99332,158
"22721","Ocbimv22007325m.g","KQ426291",75433,75778,345
"22722","Ocbimv22023891m.g","KQ419493",82976,83937,961
"22723","Ocbimv22022590m.g","KQ419268",31507,82133,50626
"22724","Ocbimv22027778m.g","KQ420370",126060,127580,1520
"22725","Ocbimv22027633m.g","KQ415703",141007,143331,2324
"22726","Ocbimv22009909m.g","KQ417622",850907,851317,410
"22727","Ocbimv22024820m.g","KQ419631",842006,849390,7384
"22728","Ocbimv22004897m.g","KQ417213",175621,214606,38985
"22729","Ocbimv22020240m.g","KQ431554",21606,22948,1342
"22730","Ocbimv22025678m.g","KQ419886",189290,202751,13461
"22731","Ocbimv22007500m.g","KQ417417",25422,63130,37708
"22732","Ocbimv22034041m.g","KQ416508",435837,436486,649
"22733","Ocbimv22017651m.g","KQ418523",370363,370823,460
"22734","Ocbimv22015590m.g","KQ415946",211706,213522,1816
"22735","Ocbimv22035987m.g","KQ422623",23762,24147,385
"22736","Ocbimv22036927m.g","KQ416666",290981,329462,38481
"22737","Ocbimv22037421m.g","KQ416694",2734190,2754334,20144
"22738","Ocbimv22005624m.g","KQ425685",184555,185037,482
"22739","Ocbimv22038796m.g","KQ415767",1101935,1102120,185
"22740","Ocbimv22023888m.g","KQ419491",322133,364046,41913
"22741","Ocbimv22033649m.g","KQ421858",6529,9984,3455
"22742","Ocbimv22026379m.g","KQ416188",367581,374136,6555
"22743","Ocbimv22023310m.g","KQ416087",1149263,1152028,2765
"22744","Ocbimv22012769m.g","KQ428229",93369,138957,45588
"22745","Ocbimv22028170m.g","KQ420439",351395,392997,41602
"22746","Ocbimv22022003m.g","KQ416058",45343,99961,54618
"22747","Ocbimv22007635m.g","KQ415845",270545,281811,11266
"22748","Ocbimv22017177m.g","KQ418460",82085,82714,629
"22749","Ocbimv22021860m.g","LGKD01671679",10,400,390
"22750","Ocbimv22001560m.g","KQ424356",223160,223507,347
"22751","Ocbimv22019520m.g","KQ418781",66988,69975,2987
"22752","Ocbimv22030141m.g","KQ420909",1,3926,3925
"22753","Ocbimv22035010m.g","KQ422245",203672,251500,47828
"22754","Ocbimv22010388m.g","KQ415876",1532842,1534716,1874
"22755","Ocbimv22012117m.g","KQ417875",24359,24970,611
"22756","Ocbimv22010897m.g","KQ427563",89205,107240,18035
"22757","Ocbimv22025215m.g","KQ419737",14794,15472,678
"22758","Ocbimv22018696m.g","LGKD01645042",248,376,128
"22759","Ocbimv22030422m.g","KQ420978",134504,135073,569
"22760","Ocbimv22029250m.g","KQ420694",56529,67034,10505
"22761","Ocbimv22014001m.g","KQ418075",630705,647333,16628
"22762","Ocbimv22010382m.g","KQ415876",947298,985381,38083
"22763","Ocbimv22010473m.g","KQ417681",177641,177844,203
"22764","Ocbimv22012445m.g","KQ417911",1093085,1098545,5460
"22765","Ocbimv22031365m.g","KQ421224",45124,45360,236
"22766","Ocbimv22010025m.g","KQ415869",118063,181067,63004
"22767","Ocbimv22013380m.g","KQ418018",785386,787266,1880
"22768","Ocbimv22010869m.g","KQ427557",64209,92326,28117
"22769","Ocbimv22031865m.g","KQ421363",49112,80036,30924
"22770","Ocbimv22016502m.g","KQ418363",134366,152053,17687
"22771","Ocbimv22000757m.g","KQ424061",93503,104246,10743
"22772","Ocbimv22033689m.g","KQ416491",214338,227520,13182
"22773","Ocbimv22035614m.g","KQ422473",142301,156381,14080
"22774","Ocbimv22038484m.g","KQ423362",44809,45720,911
"22775","Ocbimv22035288m.g","KQ422349",208993,221338,12345
"22776","Ocbimv22033667m.g","KQ421858",261340,266805,5465
"22777","Ocbimv22012882m.g","KQ428261",155790,156307,517
"22778","Ocbimv22000321m.g","KQ415776",961063,961291,228
"22779","Ocbimv22006361m.g","KQ425894",54035,72622,18587
"22780","Ocbimv22024713m.g","KQ419621",290860,293233,2373
"22781","Ocbimv22036841m.g","KQ422874",30072,30723,651
"22782","Ocbimv22027168m.g","KQ416211",257060,258119,1059
"22783","Ocbimv22009812m.g","KQ417620",74517,76806,2289
"22784","Ocbimv22019712m.g","KQ418804",694385,695476,1091
"22785","Ocbimv22031815m.g","KQ415726",472323,473245,922
"22786","Ocbimv22032497m.g","KQ421564",13860,23920,10060
"22787","Ocbimv22029886m.g","KQ420830",348984,365654,16670
"22788","Ocbimv22008746m.g","KQ426758",209315,321713,112398
"22789","Ocbimv22012377m.g","KQ428145",3251,3730,479
"22790","Ocbimv22001098m.g","KQ424180",43885,44079,194
"22791","Ocbimv22024576m.g","KQ419601",128928,202143,73215
"22792","Ocbimv22034832m.g","KQ422189",1210,8235,7025
"22793","Ocbimv22008093m.g","KQ426567",55200,67099,11899
"22794","Ocbimv22027044m.g","KQ416209",181603,182096,493
"22795","Ocbimv22015662m.g","KQ418273",544222,566025,21803
"22796","Ocbimv22012305m.g","KQ417902",94382,94603,221
"22797","Ocbimv22006564m.g","KQ417336",547914,548318,404
"22798","Ocbimv22021716m.g","KQ419091",184624,185634,1010
"22799","Ocbimv22036588m.g","KQ422794",314898,317219,2321
"22800","Ocbimv22022864m.g","KQ416078",12253,15115,2862
"22801","Ocbimv22003224m.g","KQ424910",5567,23954,18387
"22802","Ocbimv22003335m.g","LGKD01520954",81,734,653
"22803","Ocbimv22028444m.g","KQ420489",12873,13222,349
"22804","Ocbimv22001220m.g","KQ424229",353677,438544,84867
"22805","Ocbimv22019821m.g","KQ431332",194184,277977,83793
"22806","Ocbimv22007685m.g","KQ415846",178503,189716,11213
"22807","Ocbimv22023961m.g","KQ419507",314716,327051,12335
"22808","Ocbimv22035789m.g","KQ422541",27811,28110,299
"22809","Ocbimv22003577m.g","KQ417092",210904,219353,8449
"22810","Ocbimv22005761m.g","KQ417276",414126,414329,203
"22811","Ocbimv22038767m.g","KQ416765",330422,336454,6032
"22812","Ocbimv22025971m.g","KQ419938",39147,46516,7369
"22813","Ocbimv22021044m.g","KQ418997",137530,138063,533
"22814","Ocbimv22014391m.g","LGKD01608985",444,903,459
"22815","Ocbimv22015655m.g","LGKD01620244",419,583,164
"22816","Ocbimv22035768m.g","KQ416600",106701,107069,368
"22817","Ocbimv22021003m.g","KQ431922",100784,101329,545
"22818","Ocbimv22038303m.g","KQ423274",182052,182730,678
"22819","Ocbimv22024224m.g","KQ419550",302209,317734,15525
"22820","Ocbimv22019288m.g","KQ418741",262498,283482,20984
"22821","Ocbimv22036831m.g","KQ416661",295256,295615,359
"22822","Ocbimv22026368m.g","KQ416188",106244,112522,6278
"22823","Ocbimv22028421m.g","KQ420483",235980,244872,8892
"22824","Ocbimv22015992m.g","KQ418307",130178,131705,1527
"22825","Ocbimv22005132m.g","KQ415813",1293457,1308675,15218
"22826","Ocbimv22032803m.g","KQ421658",719047,720195,1148
"22827","Ocbimv22013129m.g","KQ417985",359554,364453,4899
"22828","Ocbimv22002313m.g","KQ424629",3099,6630,3531
"22829","Ocbimv22013999m.g","KQ418075",584111,584305,194
"22830","Ocbimv22019720m.g","LGKD01653194",293,577,284
"22831","Ocbimv22013226m.g","KQ418002",436393,438137,1744
"22832","Ocbimv22017537m.g","KQ430345",53093,54303,1210
"22833","Ocbimv22039701m.g","KQ423732",70800,71669,869
"22834","Ocbimv22026414m.g","KQ420047",221872,222129,257
"22835","Ocbimv22007746m.g","KQ415847",560706,578125,17419
"22836","Ocbimv22028589m.g","KQ416263",22695,24621,1926
"22837","Ocbimv22021333m.g","KQ419032",13107,77648,64541
"22838","Ocbimv22012722m.g","LGKD01596340",29,256,227
"22839","Ocbimv22036494m.g","KQ422777",147907,174109,26202
"22840","Ocbimv22022496m.g","KQ419232",418631,482947,64316
"22841","Ocbimv22035254m.g","KQ415748",123467,124303,836
"22842","Ocbimv22035412m.g","KQ422367",484091,484581,490
"22843","Ocbimv22014719m.g","KQ418170",42001,44056,2055
"22844","Ocbimv22025464m.g","KQ419808",56715,77746,21031
"22845","Ocbimv22004264m.g","KQ425248",325812,326552,740
"22846","Ocbimv22016465m.g","KQ418359",394833,395528,695
"22847","Ocbimv22020922m.g","KQ418974",2035778,2036074,296
"22848","Ocbimv22033546m.g","KQ421827",131368,132847,1479
"22849","Ocbimv22022443m.g","KQ419216",191976,229025,37049
"22850","Ocbimv22002718m.g","KQ424760",43943,77981,34038
"22851","Ocbimv22001378m.g","KQ416929",742760,778820,36060
"22852","Ocbimv22034608m.g","KQ416539",138363,138704,341
"22853","Ocbimv22037973m.g","KQ415663",36899,59486,22587
"22854","Ocbimv22001060m.g","KQ424168",586011,587955,1944
"22855","Ocbimv22032105m.g","KQ421451",15692,66798,51106
"22856","Ocbimv22025307m.g","KQ419766",56547,133287,76740
"22857","Ocbimv22003350m.g","KQ424990",119408,119749,341
"22858","Ocbimv22035331m.g","KQ422356",858,48370,47512
"22859","Ocbimv22026766m.g","KQ420112",145710,146096,386
"22860","Ocbimv22037378m.g","KQ416694",707922,709605,1683
"22861","Ocbimv22024212m.g","KQ419550",84461,89464,5003
"22862","Ocbimv22006880m.g","KQ426130",445670,445966,296
"22863","Ocbimv22035882m.g","KQ422595",98160,109970,11810
"22864","Ocbimv22014137m.g","LGKD01606722",3,224,221
"22865","Ocbimv22006970m.g","KQ417369",2148,2324,176
"22866","Ocbimv22039049m.g","KQ423525",6307,38056,31749
"22867","Ocbimv22012588m.g","KQ417917",1854428,1854616,188
"22868","Ocbimv22030495m.g","KQ416353",28667,80686,52019
"22869","Ocbimv22036187m.g","KQ422667",288429,336714,48285
"22870","Ocbimv22023332m.g","KQ419395",12707,13705,998
"22871","Ocbimv22038815m.g","KQ423471",71747,76506,4759
"22872","Ocbimv22002306m.g","KQ424627",186498,213102,26604
"22873","Ocbimv22019880m.g","KQ418829",128197,128505,308
"22874","Ocbimv22014264m.g","KQ418110",295230,295412,182
"22875","Ocbimv22000426m.g","KQ423959",50826,51856,1030
"22876","Ocbimv22015634m.g","KQ418269",1102853,1112159,9306
"22877","Ocbimv22019047m.g","KQ418711",1209563,1210786,1223
"22878","Ocbimv22022032m.g","KQ419149",350481,379258,28777
"22879","Ocbimv22024000m.g","KQ433738",109091,117202,8111
"22880","Ocbimv22005280m.g","KQ417238",600432,601021,589
"22881","Ocbimv22001567m.g","KQ415665",57150,62446,5296
"22882","Ocbimv22008014m.g","KQ415849",306326,312213,5887
"22883","Ocbimv22036804m.g","KQ416657",848709,856889,8180
"22884","Ocbimv22017156m.g","KQ418457",25483,44774,19291
"22885","Ocbimv22022329m.g","KQ419199",175338,217557,42219
"22886","Ocbimv22000149m.g","KQ423870",59603,60053,450
"22887","Ocbimv22018605m.g","KQ418644",835860,1008217,172357
"22888","Ocbimv22014942m.g","KQ429139",416357,434632,18275
"22889","Ocbimv22024674m.g","KQ419611",175873,176241,368
"22890","Ocbimv22009003m.g","KQ417549",345995,346384,389
"22891","Ocbimv22000465m.g","KQ416861",689285,689539,254
"22892","Ocbimv22028921m.g","KQ416274",2041285,2058377,17092
"22893","Ocbimv22010889m.g","KQ417722",465366,465524,158
"22894","Ocbimv22028003m.g","KQ420415",656322,677548,21226
"22895","Ocbimv22005817m.g","KQ417280",33174,37888,4714
"22896","Ocbimv22010346m.g","KQ427361",29957,50851,20894
"22897","Ocbimv22018160m.g","KQ418580",698515,699546,1031
"22898","Ocbimv22014481m.g","KQ428960",72907,75824,2917
"22899","Ocbimv22033038m.g","KQ416466",222924,224774,1850
"22900","Ocbimv22023017m.g","KQ416080",55399,56458,1059
"22901","Ocbimv22004408m.g","KQ415804",139112,141331,2219
"22902","Ocbimv22010545m.g","KQ427431",35832,38379,2547
"22903","Ocbimv22008263m.g","KQ417492",303973,360866,56893
"22904","Ocbimv22002605m.g","KQ417021",1648212,1648553,341
"22905","Ocbimv22012904m.g","KQ428275",16135,91966,75831
"22906","Ocbimv22003881m.g","KQ425134",128846,129427,581
"22907","Ocbimv22012476m.g","KQ417914",49796,82730,32934
"22908","Ocbimv22020852m.g","KQ418970",2366794,2381879,15085
"22909","Ocbimv22017645m.g","KQ418523",3122,5142,2020
"22910","Ocbimv22014673m.g","KQ418168",78293,80098,1805
"22911","Ocbimv22013570m.g","KQ418038",160103,164449,4346
"22912","Ocbimv22012410m.g","KQ417911",21512,22179,667
"22913","Ocbimv22012007m.g","KQ415896",236377,236538,161
"22914","Ocbimv22035029m.g","KQ415745",369084,369251,167
"22915","Ocbimv22011280m.g","KQ427697",14815,74632,59817
"22916","Ocbimv22034896m.g","KQ422209",45383,78256,32873
"22917","Ocbimv22025680m.g","KQ419886",204150,218790,14640
"22918","Ocbimv22027325m.g","KQ420260",530110,530594,484
"22919","Ocbimv22033358m.g","KQ421798",37749,38144,395
"22920","Ocbimv22014468m.g","KQ428951",1858,2082,224
"22921","Ocbimv22018559m.g","KQ418637",11944,50700,38756
"22922","Ocbimv22012255m.g","KQ428087",88901,89785,884
"22923","Ocbimv22035465m.g","KQ422391",242071,243100,1029
"22924","Ocbimv22025139m.g","KQ419706",101466,101786,320
"22925","Ocbimv22020480m.g","KQ418919",101308,162875,61567
"22926","Ocbimv22037374m.g","KQ416694",187347,187784,437
"22927","Ocbimv22012678m.g","KQ428200",230175,247343,17168
"22928","Ocbimv22014829m.g","KQ429096",535919,537769,1850
"22929","Ocbimv22004252m.g","KQ425239",362091,362612,521
"22930","Ocbimv22027144m.g","KQ420203",89766,159491,69725
"22931","Ocbimv22035912m.g","KQ422600",39337,44630,5293
"22932","Ocbimv22002611m.g","KQ417023",249360,250324,964
"22933","Ocbimv22034936m.g","KQ416562",465356,466008,652
"22934","Ocbimv22020704m.g","KQ416032",193133,194654,1521
"22935","Ocbimv22010592m.g","KQ417694",28654,29324,670
"22936","Ocbimv22020655m.g","KQ418945",999652,1000257,605
"22937","Ocbimv22031573m.g","KQ421281",802498,803149,651
"22938","Ocbimv22008789m.g","KQ426774",88620,93547,4927
"22939","Ocbimv22039405m.g","KQ423651",830211,844047,13836
"22940","Ocbimv22023155m.g","KQ419361",10968,67519,56551
"22941","Ocbimv22030334m.g","KQ420951",16053,17540,1487
"22942","Ocbimv22024918m.g","KQ419657",383978,384217,239
"22943","Ocbimv22027956m.g","KQ420409",422462,449129,26667
"22944","Ocbimv22022957m.g","KQ416079",26768,28190,1422
"22945","Ocbimv22019541m.g","KQ418783",242952,244137,1185
"22946","Ocbimv22021682m.g","KQ416051",415114,415560,446
"22947","Ocbimv22006974m.g","KQ417369",83411,92648,9237
"22948","Ocbimv22030200m.g","KQ420924",65185,68252,3067
"22949","Ocbimv22015945m.g","KQ418303",1496059,1509846,13787
"22950","Ocbimv22019934m.g","LGKD01655407",1,168,167
"22951","Ocbimv22019100m.g","KQ430964",71163,197816,126653
"22952","Ocbimv22023286m.g","KQ419392",45056,55847,10791
"22953","Ocbimv22024045m.g","KQ433769",94720,102586,7866
"22954","Ocbimv22033152m.g","KQ421737",197919,207055,9136
"22955","Ocbimv22017332m.g","KQ418483",164756,175363,10607
"22956","Ocbimv22001136m.g","KQ424203",143315,143895,580
"22957","Ocbimv22013156m.g","KQ428391",6525,6848,323
"22958","Ocbimv22015116m.g","KQ418196",3765,23937,20172
"22959","Ocbimv22011397m.g","KQ417791",1050486,1052112,1626
"22960","Ocbimv22009799m.g","KQ417617",41820,55640,13820
"22961","Ocbimv22011881m.g","KQ417844",1062074,1062292,218
"22962","Ocbimv22035309m.g","KQ422351",409655,410554,899
"22963","Ocbimv22000408m.g","KQ423957",115385,118081,2696
"22964","Ocbimv22028006m.g","KQ416243",16431,16935,504
"22965","Ocbimv22010431m.g","KQ427385",1982,7727,5745
"22966","Ocbimv22021418m.g","KQ432140",2286,44914,42628
"22967","Ocbimv22001273m.g","KQ424245",75779,100617,24838
"22968","Ocbimv22020033m.g","KQ418844",535,11753,11218
"22969","Ocbimv22010991m.g","KQ417731",281589,282852,1263
"22970","Ocbimv22010013m.g","KQ427205",130983,146825,15842
"22971","Ocbimv22023022m.g","KQ416080",371001,372308,1307
"22972","Ocbimv22011598m.g","KQ417808",2085,3644,1559
"22973","Ocbimv22027682m.g","KQ420338",29015,61925,32910
"22974","Ocbimv22007241m.g","KQ426259",85222,91529,6307
"22975","Ocbimv22011834m.g","KQ415893",1318196,1354493,36297
"22976","Ocbimv22016197m.g","KQ415678",274813,277118,2305
"22977","Ocbimv22038833m.g","KQ416768",128357,148036,19679
"22978","Ocbimv22035459m.g","KQ422391",15,22274,22259
"22979","Ocbimv22006299m.g","KQ425863",98708,99310,602
"22980","Ocbimv22019150m.g","KQ431021",55,1201,1146
"22981","Ocbimv22011746m.g","KQ427887",165553,188181,22628
"22982","Ocbimv22003027m.g","KQ417055",1131653,1137127,5474
"22983","Ocbimv22036418m.g","KQ416641",488838,489869,1031
"22984","Ocbimv22008869m.g","KQ426791",386424,388115,1691
"22985","Ocbimv22029768m.g","KQ420820",508625,525937,17312
"22986","Ocbimv22022571m.g","KQ419262",113293,113668,375
"22987","Ocbimv22025477m.g","KQ419816",37822,49434,11612
"22988","Ocbimv22008899m.g","KQ417538",78212,78998,786
"22989","Ocbimv22030952m.g","KQ421131",105260,105430,170
"22990","Ocbimv22012089m.g","KQ417872",52696,53059,363
"22991","Ocbimv22019327m.g","KQ431096",39479,40144,665
"22992","Ocbimv22012715m.g","KQ417929",171164,192870,21706
"22993","Ocbimv22008027m.g","KQ417471",33672,34100,428
"22994","Ocbimv22008700m.g","KQ426738",134825,137422,2597
"22995","Ocbimv22026756m.g","KQ420109",214603,215145,542
"22996","Ocbimv22031382m.g","KQ421225",12134,12464,330
"22997","Ocbimv22023615m.g","KQ419443",111734,112048,314
"22998","Ocbimv22004456m.g","KQ425315",19214,19498,284
"22999","Ocbimv22030805m.g","KQ421090",15718,105333,89615
"23000","Ocbimv22005385m.g","KQ417249",596328,699860,103532
"23001","Ocbimv22013282m.g","KQ418007",89392,89547,155
"23002","Ocbimv22010124m.g","KQ417645",342114,364604,22490
"23003","Ocbimv22023502m.g","KQ433427",76018,107911,31893
"23004","Ocbimv22007122m.g","KQ417381",48261,56110,7849
"23005","Ocbimv22000202m.g","KQ423898",43199,43426,227
"23006","Ocbimv22028516m.g","KQ420516",865222,867840,2618
"23007","Ocbimv22014141m.g","KQ418094",38563,82634,44071
"23008","Ocbimv22035719m.g","KQ422521",213729,216991,3262
"23009","Ocbimv22038705m.g","KQ416761",326526,331903,5377
"23010","Ocbimv22025875m.g","KQ419919",39386,39879,493
"23011","Ocbimv22030447m.g","KQ416350",116152,149431,33279
"23012","Ocbimv22028481m.g","KQ420502",186700,205784,19084
"23013","Ocbimv22016712m.g","KQ418388",2576,19330,16754
"23014","Ocbimv22018792m.g","KQ430876",4767,5015,248
"23015","Ocbimv22036971m.g","KQ416666",2419556,2439590,20034
"23016","Ocbimv22032245m.g","KQ421494",6075,6296,221
"23017","Ocbimv22037656m.g","KQ416705",1201223,1246991,45768
"23018","Ocbimv22011829m.g","KQ415893",1069000,1069707,707
"23019","Ocbimv22000047m.g","KQ423834",124560,130300,5740
"23020","Ocbimv22030584m.g","KQ416357",945089,982026,36937
"23021","Ocbimv22025912m.g","KQ419926",637,29329,28692
"23022","Ocbimv22038449m.g","KQ423342",159045,159434,389
"23023","Ocbimv22003256m.g","KQ424919",70867,71247,380
"23024","Ocbimv22005651m.g","KQ425702",103364,126402,23038
"23025","Ocbimv22022761m.g","KQ432990",108130,117213,9083
"23026","Ocbimv22002493m.g","KQ424671",346123,346697,574
"23027","Ocbimv22035578m.g","KQ422443",83905,84204,299
"23028","Ocbimv22016288m.g","KQ429791",23321,27543,4222
"23029","Ocbimv22013201m.g","KQ415914",327927,328697,770
"23030","Ocbimv22002960m.g","KQ417051",804325,804654,329
"23031","Ocbimv22028646m.g","KQ420545",43743,64169,20426
"23032","Ocbimv22016654m.g","KQ418375",545252,564801,19549
"23033","Ocbimv22035981m.g","KQ422621",235320,248250,12930
"23034","Ocbimv22004541m.g","KQ425354",36246,37755,1509
"23035","Ocbimv22005560m.g","KQ425654",84938,107635,22697
"23036","Ocbimv22039829m.g","KQ423773",31973,32176,203
"23037","Ocbimv22015418m.g","KQ418241",411338,412673,1335
"23038","Ocbimv22029249m.g","KQ420694",53587,56132,2545
"23039","Ocbimv22026953m.g","KQ420148",383890,384666,776
"23040","Ocbimv22012378m.g","LGKD01201175",2,289,287
"23041","Ocbimv22003852m.g","KQ415798",108686,108976,290
"23042","Ocbimv22009890m.g","KQ417621",573689,575386,1697
"23043","Ocbimv22020751m.g","KQ431824",116223,215428,99205
"23044","Ocbimv22037771m.g","LGKD01463888",4184,5864,1680
"23045","Ocbimv22017327m.g","KQ418483",116097,116557,460
"23046","Ocbimv22020744m.g","KQ431819",64849,65121,272
"23047","Ocbimv22004321m.g","KQ425263",88346,88753,407
"23048","Ocbimv22010906m.g","KQ427566",37,106168,106131
"23049","Ocbimv22029489m.g","KQ420760",40687,73979,33292
"23050","Ocbimv22006477m.g","KQ417326",1020189,1021826,1637
"23051","Ocbimv22012431m.g","KQ417911",387049,387219,170
"23052","Ocbimv22019163m.g","KQ418725",1031,4247,3216
"23053","Ocbimv22014355m.g","KQ418120",635999,658733,22734
"23054","Ocbimv22016035m.g","KQ418312",159108,161274,2166
"23055","Ocbimv22029148m.g","KQ416288",150864,152852,1988
"23056","Ocbimv22033853m.g","KQ421896",106653,113165,6512
"23057","Ocbimv22014770m.g","KQ418176",707386,714843,7457
"23058","Ocbimv22025429m.g","KQ419797",341167,353076,11909
"23059","Ocbimv22038250m.g","KQ423250",156024,156275,251
"23060","Ocbimv22029274m.g","KQ420696",365720,368343,2623
"23061","Ocbimv22011021m.g","KQ427595",65523,65741,218
"23062","Ocbimv22038219m.g","KQ416731",648858,659160,10302
"23063","Ocbimv22033544m.g","KQ421827",17971,27208,9237
"23064","Ocbimv22024439m.g","KQ419577",741714,742124,410
"23065","Ocbimv22016192m.g","KQ418324",414936,416232,1296
"23066","Ocbimv22004816m.g","KQ417208",304048,305679,1631
"23067","Ocbimv22002057m.g","KQ424530",238309,239429,1120
"23068","Ocbimv22000760m.g","KQ424061",136804,157634,20830
"23069","Ocbimv22028402m.g","KQ416257",1010074,1102981,92907
"23070","Ocbimv22000209m.g","KQ423900",33691,37730,4039
"23071","Ocbimv22016552m.g","KQ418367",401555,430120,28565
"23072","Ocbimv22012365m.g","KQ428130",243310,250584,7274
"23073","Ocbimv22020453m.g","KQ416029",49413,49757,344
"23074","Ocbimv22020277m.g","KQ416024",118296,119603,1307
"23075","Ocbimv22026273m.g","KQ420022",528113,529623,1510
"23076","Ocbimv22011975m.g","KQ417850",134,64942,64808
"23077","Ocbimv22006141m.g","KQ417300",658228,739238,81010
"23078","Ocbimv22002266m.g","KQ424600",11195,11515,320
"23079","Ocbimv22034790m.g","KQ416553",7951,8779,828
"23080","Ocbimv22009742m.g","KQ417609",368439,369040,601
"23081","Ocbimv22027813m.g","KQ420375",28751,60328,31577
"23082","Ocbimv22002607m.g","KQ417023",60638,113577,52939
"23083","Ocbimv22025482m.g","KQ419817",154955,155281,326
"23084","Ocbimv22016790m.g","KQ430030",1178,2378,1200
"23085","Ocbimv22009515m.g","KQ415865",730519,739024,8505
"23086","Ocbimv22006560m.g","KQ417336",82063,82332,269
"23087","Ocbimv22005769m.g","KQ417278",1731,2135,404
"23088","Ocbimv22012167m.g","KQ428057",25524,25739,215
"23089","Ocbimv22022565m.g","KQ419260",123295,123570,275
"23090","Ocbimv22028077m.g","KQ420427",69341,69712,371
"23091","Ocbimv22021124m.g","KQ416039",1239457,1273684,34227
"23092","Ocbimv22006485m.g","KQ425942",5105,6946,1841
"23093","Ocbimv22037902m.g","KQ423155",88296,88550,254
"23094","Ocbimv22022959m.g","KQ416079",223173,232984,9811
"23095","Ocbimv22028370m.g","KQ420477",505347,522211,16864
"23096","Ocbimv22022356m.g","KQ419204",324655,327322,2667
"23097","Ocbimv22018795m.g","KQ418681",172485,172652,167
"23098","Ocbimv22027406m.g","KQ416223",891308,892546,1238
"23099","Ocbimv22035498m.g","KQ422411",132629,138352,5723
"23100","Ocbimv22035303m.g","KQ422351",291803,299453,7650
"23101","Ocbimv22015923m.g","KQ418303",893420,901344,7924
"23102","Ocbimv22026302m.g","KQ420023",394665,442852,48187
"23103","Ocbimv22000834m.g","KQ424087",129506,129753,247
"23104","Ocbimv22006269m.g","KQ417306",97008,97307,299
"23105","Ocbimv22009028m.g","KQ426847",19566,26814,7248
"23106","Ocbimv22024671m.g","KQ419607",863285,863626,341
"23107","Ocbimv22014901m.g","KQ418187",220043,226707,6664
"23108","Ocbimv22039600m.g","KQ416808",225285,225527,242
"23109","Ocbimv22018310m.g","KQ418600",583962,627291,43329
"23110","Ocbimv22032449m.g","KQ416431",217753,218920,1167
"23111","Ocbimv22039965m.g","KQ423813",181621,191304,9683
"23112","Ocbimv22028901m.g","KQ416274",929703,972483,42780
"23113","Ocbimv22016988m.g","KQ418431",844944,860748,15804
"23114","Ocbimv22017709m.g","KQ415981",744092,744262,170
"23115","Ocbimv22029819m.g","KQ420828",867700,868208,508
"23116","Ocbimv22028478m.g","KQ420501",30885,58592,27707
"23117","Ocbimv22037356m.g","KQ423013",33670,34760,1090
"23118","Ocbimv22019005m.g","KQ418710",715580,715729,149
"23119","Ocbimv22008095m.g","KQ426567",70047,81326,11279
"23120","Ocbimv22019144m.g","LGKD01648601",2,184,182
"23121","Ocbimv22028324m.g","KQ420475",161591,174611,13020
"23122","Ocbimv22021034m.g","KQ431955",60632,73544,12912
"23123","Ocbimv22028054m.g","KQ420424",52023,89647,37624
"23124","Ocbimv22029376m.g","KQ420734",2990,3335,345
"23125","Ocbimv22037090m.g","KQ422919",1604715,1614124,9409
"23126","Ocbimv22036392m.g","KQ422743",551203,551794,591
"23127","Ocbimv22036453m.g","KQ422770",6740,8431,1691
"23128","Ocbimv22016546m.g","KQ418367",254104,259181,5077
"23129","Ocbimv22010048m.g","KQ427227",157529,157855,326
"23130","Ocbimv22020699m.g","KQ416032",122870,124055,1185
"23131","Ocbimv22026727m.g","KQ416198",73614,74909,1295
"23132","Ocbimv22016948m.g","KQ430102",219490,269049,49559
"23133","Ocbimv22005054m.g","KQ417227",88428,89102,674
"23134","Ocbimv22028483m.g","KQ420502",228500,233894,5394
"23135","Ocbimv22037563m.g","KQ416701",228972,229832,860
"23136","Ocbimv22015309m.g","KQ418217",117728,123532,5804
"23137","Ocbimv22012532m.g","KQ417917",759503,760568,1065
"23138","Ocbimv22034109m.g","KQ421978",248937,263092,14155
"23139","Ocbimv22003009m.g","KQ417054",122523,122762,239
"23140","Ocbimv22030633m.g","KQ421038",20207,24155,3948
"23141","Ocbimv22013494m.g","KQ418031",116981,117472,491
"23142","Ocbimv22020685m.g","KQ418954",10141,21572,11431
"23143","Ocbimv22006013m.g","KQ425779",369812,370370,558
"23144","Ocbimv22031757m.g","KQ421338",621537,622922,1385
"23145","Ocbimv22012892m.g","KQ417949",58688,63352,4664
"23146","Ocbimv22025322m.g","KQ419774",50,31208,31158
"23147","Ocbimv22038895m.g","KQ416771",369695,389782,20087
"23148","Ocbimv22010536m.g","KQ427428",85162,132402,47240
"23149","Ocbimv22014609m.g","KQ429007",49993,51287,1294
"23150","Ocbimv22016645m.g","KQ429941",1842,19989,18147
"23151","Ocbimv22027006m.g","KQ420162",225714,283466,57752
"23152","Ocbimv22010681m.g","KQ417701",422671,444381,21710
"23153","Ocbimv22021031m.g","KQ431953",26755,27050,295
"23154","Ocbimv22010127m.g","KQ427268",11757,14872,3115
"23155","Ocbimv22037631m.g","KQ415761",906874,907344,470
"23156","Ocbimv22013024m.g","KQ417975",924523,926276,1753
"23157","Ocbimv22032944m.g","KQ421688",131013,141085,10072
"23158","Ocbimv22000552m.g","KQ423995",255493,313256,57763
"23159","Ocbimv22016432m.g","LGKD01627554",8,492,484
"23160","Ocbimv22033780m.g","KQ421871",210460,210845,385
"23161","Ocbimv22034742m.g","KQ422141",13092,20091,6999
"23162","Ocbimv22032078m.g","KQ421429",10554,69094,58540
"23163","Ocbimv22019665m.g","LGKD01652392",1,292,291
"23164","Ocbimv22000184m.g","KQ423887",293732,329903,36171
"23165","Ocbimv22037377m.g","KQ416694",621421,626090,4669
"23166","Ocbimv22034984m.g","KQ422234",5099,8583,3484
"23167","Ocbimv22035645m.g","KQ422489",132277,152255,19978
"23168","Ocbimv22011849m.g","KQ427922",24564,25510,946
"23169","Ocbimv22032824m.g","KQ421661",252474,252725,251
"23170","Ocbimv22019523m.g","KQ416015",10701,27185,16484
"23171","Ocbimv22027461m.g","KQ416225",31261,33868,2607
"23172","Ocbimv22037541m.g","KQ423058",687555,687993,438
"23173","Ocbimv22007064m.g","KQ417374",76788,94476,17688
"23174","Ocbimv22028474m.g","KQ420499",287324,287560,236
"23175","Ocbimv22034111m.g","KQ421978",268870,269148,278
"23176","Ocbimv22004355m.g","KQ417152",252329,252496,167
"23177","Ocbimv22012829m.g","KQ428255",94839,95496,657
"23178","Ocbimv22019141m.g","KQ418721",9619,26295,16676
"23179","Ocbimv22012908m.g","KQ415670",4661,72556,67895
"23180","Ocbimv22015567m.g","KQ418267",544408,574104,29696
"23181","Ocbimv22019986m.g","KQ418840",1122935,1124682,1747
"23182","Ocbimv22013696m.g","KQ418049",26420,44675,18255
"23183","Ocbimv22013774m.g","KQ428661",62936,85362,22426
"23184","Ocbimv22022244m.g","KQ432655",30839,39223,8384
"23185","Ocbimv22011027m.g","KQ427597",78452,199621,121169
"23186","Ocbimv22019885m.g","KQ418832",242808,243047,239
"23187","Ocbimv22031167m.g","KQ421187",44063,87033,42970
"23188","Ocbimv22018474m.g","KQ430702",111078,111403,325
"23189","Ocbimv22038406m.g","KQ416739",56943,61527,4584
"23190","Ocbimv22015830m.g","KQ418295",236369,247766,11397
"23191","Ocbimv22006301m.g","KQ425868",8747,40735,31988
"23192","Ocbimv22003783m.g","KQ417112",512682,589403,76721
"23193","Ocbimv22023273m.g","KQ419390",127716,128144,428
"23194","Ocbimv22029784m.g","KQ420821",395546,396023,477
"23195","Ocbimv22027504m.g","KQ420294",66006,69190,3184
"23196","Ocbimv22022661m.g","KQ419279",4440,5222,782
"23197","Ocbimv22036014m.g","KQ422632",421526,431294,9768
"23198","Ocbimv22013062m.g","KQ417977",397639,401701,4062
"23199","Ocbimv22029287m.g","KQ420698",1250,3958,2708
"23200","Ocbimv22025457m.g","KQ419807",211476,212565,1089
"23201","Ocbimv22011204m.g","KQ427679",42284,42667,383
"23202","Ocbimv22025185m.g","KQ419725",10542,29016,18474
"23203","Ocbimv22004351m.g","KQ417152",37581,44161,6580
"23204","Ocbimv22030012m.g","KQ416330",73309,111214,37905
"23205","Ocbimv22037850m.g","KQ423139",590629,607419,16790
"23206","Ocbimv22024386m.g","KQ415693",276127,280880,4753
"23207","Ocbimv22031863m.g","KQ421363",1481,3654,2173
"23208","Ocbimv22020523m.g","KQ418922",17220,59255,42035
"23209","Ocbimv22027255m.g","KQ420233",14278,15788,1510
"23210","Ocbimv22028702m.g","KQ416267",52126,57661,5535
"23211","Ocbimv22027600m.g","KQ420313",389519,433846,44327
"23212","Ocbimv22039828m.g","KQ423773",7815,62261,54446
"23213","Ocbimv22024912m.g","KQ416131",883785,931550,47765
"23214","Ocbimv22036082m.g","KQ416616",1238665,1262356,23691
"23215","Ocbimv22035074m.g","KQ416570",59877,60260,383
"23216","Ocbimv22023076m.g","KQ419344",1173,5580,4407
"23217","Ocbimv22032201m.g","KQ421479",109302,109683,381
"23218","Ocbimv22021420m.g","KQ432140",92627,93076,449
"23219","Ocbimv22021370m.g","KQ432094",409,9283,8874
"23220","Ocbimv22036013m.g","KQ422632",386668,419058,32390
"23221","Ocbimv22023815m.g","KQ419480",292634,293636,1002
"23222","Ocbimv22014930m.g","KQ429134",68,277,209
"23223","Ocbimv22036755m.g","KQ422849",196500,196670,170
"23224","Ocbimv22012957m.g","KQ428311",44075,63705,19630
"23225","Ocbimv22019062m.g","KQ418714",165414,165677,263
"23226","Ocbimv22010958m.g","KQ427569",6587,6874,287
"23227","Ocbimv22021317m.g","KQ419029",459,43564,43105
"23228","Ocbimv22001330m.g","KQ424268",15114,20897,5783
"23229","Ocbimv22013439m.g","KQ428507",116387,129746,13359
"23230","Ocbimv22027652m.g","KQ420330",330486,334504,4018
"23231","Ocbimv22030536m.g","KQ421017",94812,95695,883
"23232","Ocbimv22025460m.g","KQ419807",234012,237104,3092
"23233","Ocbimv22034218m.g","KQ422009",486333,486752,419
"23234","Ocbimv22006595m.g","KQ426027",52062,64793,12731
"23235","Ocbimv22033258m.g","KQ421758",1512873,1533711,20838
"23236","Ocbimv22002481m.g","KQ424671",8802,27681,18879
"23237","Ocbimv22004063m.g","KQ425191",186086,254758,68672
"23238","Ocbimv22020514m.g","KQ418921",708741,708932,191
"23239","Ocbimv22029597m.g","KQ420779",447956,452498,4542
"23240","Ocbimv22000124m.g","KQ416841",620985,621770,785
"23241","Ocbimv22028045m.g","KQ416244",199279,201934,2655
"23242","Ocbimv22006275m.g","KQ425850",87682,88243,561
"23243","Ocbimv22014643m.g","KQ418160",760602,760754,152
"23244","Ocbimv22032103m.g","KQ421447",101169,102058,889
"23245","Ocbimv22008593m.g","KQ417510",473127,473517,390
"23246","Ocbimv22027967m.g","KQ416242",290229,290858,629
"23247","Ocbimv22028532m.g","KQ420517",408710,409081,371
"23248","Ocbimv22004083m.g","KQ417133",673173,678931,5758
"23249","Ocbimv22038131m.g","KQ423217",353688,409369,55681
"23250","Ocbimv22001929m.g","KQ416974",232029,232874,845
"23251","Ocbimv22026847m.g","KQ420130",150006,150161,155
"23252","Ocbimv22020757m.g","KQ431843",5262,6292,1030
"23253","Ocbimv22022373m.g","KQ419208",355711,356371,660
"23254","Ocbimv22003906m.g","KQ425144",110151,117531,7380
"23255","Ocbimv22036554m.g","KQ422791",125137,125367,230
"23256","Ocbimv22001725m.g","KQ416957",33473,35647,2174
"23257","Ocbimv22003903m.g","KQ425143",239226,245016,5790
"23258","Ocbimv22018754m.g","KQ416000",160188,256727,96539
"23259","Ocbimv22034085m.g","KQ421968",18274,30586,12312
"23260","Ocbimv22023485m.g","KQ419416",115809,119923,4114
"23261","Ocbimv22038385m.g","KQ416738",987490,988407,917
"23262","Ocbimv22038181m.g","KQ423229",628338,628676,338
"23263","Ocbimv22038464m.g","KQ423354",118194,118403,209
"23264","Ocbimv22039005m.g","KQ416777",178763,180037,1274
"23265","Ocbimv22008891m.g","KQ426792",41052,123009,81957
"23266","Ocbimv22033824m.g","KQ421891",144773,146846,2073
"23267","Ocbimv22025688m.g","KQ419886",721604,721955,351
"23268","Ocbimv22038265m.g","KQ423255",22853,25088,2235
"23269","Ocbimv22024434m.g","KQ419577",596765,597750,985
"23270","Ocbimv22022441m.g","KQ419216",176766,177096,330
"23271","Ocbimv22034667m.g","KQ416546",24971,25492,521
"23272","Ocbimv22031626m.g","KQ421305",31126,33233,2107
"23273","Ocbimv22003480m.g","KQ425015",809885,827105,17220
"23274","Ocbimv22004929m.g","KQ425475",11374,12688,1314
"23275","Ocbimv22025094m.g","KQ416137",464957,467882,2925
"23276","Ocbimv22028164m.g","KQ420439",270484,287211,16727
"23277","Ocbimv22012709m.g","KQ417929",36111,58752,22641
"23278","Ocbimv22023595m.g","LGKD01298905",34,1579,1545
"23279","Ocbimv22001687m.g","KQ424386",70055,75607,5552
"23280","Ocbimv22035253m.g","KQ415748",69824,70240,416
"23281","Ocbimv22011355m.g","KQ417791",104167,104499,332
"23282","Ocbimv22030916m.g","KQ421117",1809442,1832640,23198
"23283","Ocbimv22014392m.g","KQ415929",36138,46590,10452
"23284","Ocbimv22015479m.g","KQ429383",15770,50047,34277
"23285","Ocbimv22017750m.g","KQ418537",443159,505787,62628
"23286","Ocbimv22022841m.g","KQ416076",137336,138160,824
"23287","Ocbimv22019676m.g","KQ418796",234921,254763,19842
"23288","Ocbimv22038450m.g","KQ423342",182013,182258,245
"23289","Ocbimv22004666m.g","KQ425412",180874,192507,11633
"23290","Ocbimv22029896m.g","KQ420840",449532,463338,13806
"23291","Ocbimv22014183m.g","KQ418098",201513,286622,85109
"23292","Ocbimv22025747m.g","KQ415694",1076448,1076906,458
"23293","Ocbimv22032206m.g","KQ416425",22479,31322,8843
"23294","Ocbimv22010283m.g","KQ427344",123746,132554,8808
"23295","Ocbimv22025269m.g","KQ419754",111212,111492,280
"23296","Ocbimv22035247m.g","KQ422341",82299,83086,787
"23297","Ocbimv22032224m.g","KQ421487",37143,37409,266
"23298","Ocbimv22010313m.g","KQ427350",186431,187291,860
"23299","Ocbimv22023535m.g","LGKD01689679",355,1005,650
"23300","Ocbimv22026134m.g","KQ419994",105754,172944,67190
"23301","Ocbimv22010378m.g","KQ415876",533802,534239,437
"23302","Ocbimv22004542m.g","KQ425354",38470,39300,830
"23303","Ocbimv22002818m.g","KQ424788",91410,93599,2189
"23304","Ocbimv22030767m.g","KQ421085",137389,138519,1130
"23305","Ocbimv22001779m.g","KQ424414",17541,21263,3722
"23306","Ocbimv22010600m.g","KQ417698",29598,48207,18609
"23307","Ocbimv22014597m.g","KQ418156",277009,284887,7878
"23308","Ocbimv22023439m.g","KQ419409",627889,694324,66435
"23309","Ocbimv22013697m.g","KQ418049",41507,41698,191
"23310","Ocbimv22019658m.g","KQ431222",25259,66514,41255
"23311","Ocbimv22013691m.g","KQ428612",92870,93082,212
"23312","Ocbimv22002418m.g","KQ417009",918741,977557,58816
"23313","Ocbimv22004655m.g","KQ417194",26838,27520,682
"23314","Ocbimv22027125m.g","KQ420194",349350,352640,3290
"23315","Ocbimv22008066m.g","KQ426557",33481,57126,23645
"23316","Ocbimv22034239m.g","KQ422015",3235,19640,16405
"23317","Ocbimv22039129m.g","KQ416779",950395,950945,550
"23318","Ocbimv22029730m.g","KQ420813",961925,962553,628
"23319","Ocbimv22015188m.g","KQ418204",25178,35802,10624
"23320","Ocbimv22003827m.g","KQ425124",345717,360904,15187
"23321","Ocbimv22012181m.g","KQ417881",203572,224515,20943
"23322","Ocbimv22013934m.g","KQ418073",1230,2721,1491
"23323","Ocbimv22035402m.g","KQ422367",198584,207054,8470
"23324","Ocbimv22039367m.g","KQ423632",151082,151381,299
"23325","Ocbimv22020804m.g","LGKD01663507",644,805,161
"23326","Ocbimv22033633m.g","KQ421853",452129,452704,575
"23327","Ocbimv22014237m.g","KQ428812",9932,10291,359
"23328","Ocbimv22010854m.g","KQ417719",427062,436475,9413
"23329","Ocbimv22033175m.g","KQ416469",249388,281044,31656
"23330","Ocbimv22012082m.g","KQ428014",14184,16222,2038
"23331","Ocbimv22027178m.g","KQ416213",171407,173118,1711
"23332","Ocbimv22029450m.g","KQ416307",410441,412465,2024
"23333","Ocbimv22021576m.g","KQ416048",80972,81646,674
"23334","Ocbimv22032808m.g","LGKD01408907",3706,6102,2396
"23335","Ocbimv22029996m.g","KQ420877",77195,85045,7850
"23336","Ocbimv22027686m.g","KQ420340",67255,68034,779
"23337","Ocbimv22014892m.g","KQ429131",205922,244748,38826
"23338","Ocbimv22002158m.g","KQ416990",464098,464541,443
"23339","Ocbimv22026900m.g","KQ420138",937797,1113767,175970
"23340","Ocbimv22019554m.g","KQ418783",565186,605106,39920
"23341","Ocbimv22004177m.g","KQ425220",275396,280446,5050
"23342","Ocbimv22038809m.g","KQ423471",13552,16403,2851
"23343","Ocbimv22028380m.g","KQ416257",342377,342767,390
"23344","Ocbimv22002858m.g","KQ424805",200913,203165,2252
"23345","Ocbimv22011165m.g","KQ427657",37835,40110,2275
"23346","Ocbimv22034381m.g","KQ422024",10355,34095,23740
"23347","Ocbimv22021369m.g","KQ432093",57522,83391,25869
"23348","Ocbimv22001189m.g","KQ424219",355259,403505,48246
"23349","Ocbimv22039640m.g","KQ416810",1281955,1313491,31536
"23350","Ocbimv22027027m.g","KQ420166",227590,240616,13026
"23351","Ocbimv22021650m.g","KQ419084",82697,83059,362
"23352","Ocbimv22018551m.g","KQ430742",54873,55452,579
"23353","Ocbimv22001597m.g","KQ424367",65748,74395,8647
"23354","Ocbimv22026415m.g","KQ420047",231996,232220,224
"23355","Ocbimv22022775m.g","KQ419295",44625,44864,239
"23356","Ocbimv22021180m.g","KQ432024",105802,106119,317
"23357","Ocbimv22022054m.g","KQ432535",4145,4543,398
"23358","Ocbimv22029808m.g","KQ420828",60404,67543,7139
"23359","Ocbimv22008446m.g","KQ415854",66175,80234,14059
"23360","Ocbimv22013864m.g","KQ428699",5158,52543,47385
"23361","Ocbimv22013521m.g","KQ428540",65689,66944,1255
"23362","Ocbimv22031985m.g","KQ421396",21325,77230,55905
"23363","Ocbimv22015472m.g","KQ418257",93788,104917,11129
"23364","Ocbimv22002706m.g","KQ424752",158328,158561,233
"23365","Ocbimv22017369m.g","KQ418486",71376,174875,103499
"23366","Ocbimv22009795m.g","KQ427137",60070,114528,54458
"23367","Ocbimv22030576m.g","KQ416357",415756,421111,5355
"23368","Ocbimv22029682m.g","KQ420800",23173,25470,2297
"23369","Ocbimv22024026m.g","KQ419523",22958,31175,8217
"23370","Ocbimv22015762m.g","KQ418290",178736,303387,124651
"23371","Ocbimv22007060m.g","KQ417373",212800,213548,748
"23372","Ocbimv22017268m.g","KQ430232",163619,166035,2416
"23373","Ocbimv22021388m.g","KQ432116",13551,20523,6972
"23374","Ocbimv22013311m.g","KQ418009",669404,670482,1078
"23375","Ocbimv22003142m.g","KQ417061",917939,918238,299
"23376","Ocbimv22018693m.g","KQ418653",382290,384017,1727
"23377","Ocbimv22007867m.g","KQ417455",410542,417131,6589
"23378","Ocbimv22004227m.g","KQ417143",57977,58316,339
"23379","Ocbimv22028743m.g","KQ420571",133664,134050,386
"23380","Ocbimv22022034m.g","KQ419149",395079,421016,25937
"23381","Ocbimv22018657m.g","KQ418651",6928,15997,9069
"23382","Ocbimv22039052m.g","KQ423525",297103,305856,8753
"23383","Ocbimv22015132m.g","KQ418196",562816,565348,2532
"23384","Ocbimv22035742m.g","KQ422521",431314,431625,311
"23385","Ocbimv22013331m.g","KQ418012",359764,360570,806
"23386","Ocbimv22037566m.g","KQ423069",634,54919,54285
"23387","Ocbimv22037247m.g","KQ422975",82681,82845,164
"23388","Ocbimv22029270m.g","KQ420696",320519,358832,38313
"23389","Ocbimv22028508m.g","KQ420516",38447,38758,311
"23390","Ocbimv22039239m.g","KQ423591",270912,271467,555
"23391","Ocbimv22007805m.g","KQ426459",32129,32638,509
"23392","Ocbimv22039054m.g","KQ423531",20322,43645,23323
"23393","Ocbimv22031934m.g","KQ421381",41766,42035,269
"23394","Ocbimv22039913m.g","KQ423795",1806,17099,15293
"23395","Ocbimv22024323m.g","KQ419568",113569,115330,1761
"23396","Ocbimv22026699m.g","KQ420095",47604,89331,41727
"23397","Ocbimv22033613m.g","KQ421847",94432,94707,275
"23398","Ocbimv22011548m.g","KQ417800",14160,15488,1328
"23399","Ocbimv22003245m.g","KQ417068",372975,373295,320
"23400","Ocbimv22038598m.g","KQ423414",136256,137669,1413
"23401","Ocbimv22029888m.g","KQ420832",31792,32031,239
"23402","Ocbimv22006586m.g","KQ426026",383974,398001,14027
"23403","Ocbimv22022062m.g","KQ419155",380298,381028,730
"23404","Ocbimv22007023m.g","KQ417370",549111,557609,8498
"23405","Ocbimv22029145m.g","KQ416288",225,13595,13370
"23406","Ocbimv22008362m.g","KQ417498",451705,452935,1230
"23407","Ocbimv22035258m.g","KQ415748",441148,441528,380
"23408","Ocbimv22016040m.g","KQ418312",344857,376207,31350
"23409","Ocbimv22015800m.g","KQ429582",60441,60814,373
"23410","Ocbimv22021994m.g","KQ419142",58004,58369,365
"23411","Ocbimv22027857m.g","KQ416234",24117,27393,3276
"23412","Ocbimv22010673m.g","KQ417701",267831,290567,22736
"23413","Ocbimv22027575m.g","KQ420308",48540,49001,461
"23414","Ocbimv22024079m.g","KQ419533",227204,307396,80192
"23415","Ocbimv22037082m.g","KQ422919",944610,949540,4930
"23416","Ocbimv22025386m.g","KQ416153",80903,86288,5385
"23417","Ocbimv22014272m.g","KQ418112",62029,98447,36418
"23418","Ocbimv22001696m.g","KQ416955",528607,539107,10500
"23419","Ocbimv22020861m.g","KQ418971",53069,69966,16897
"23420","Ocbimv22028777m.g","KQ420580",2836,27054,24218
"23421","Ocbimv22009255m.g","KQ417578",680961,765476,84515
"23422","Ocbimv22020662m.g","KQ418947",230851,231108,257
"23423","Ocbimv22039108m.g","KQ416779",464841,480631,15790
"23424","Ocbimv22038814m.g","KQ423471",67876,71656,3780
"23425","Ocbimv22014155m.g","KQ428781",32912,33181,269
"23426","Ocbimv22019652m.g","KQ431217",110606,125059,14453
"23427","Ocbimv22006212m.g","KQ417304",164177,182847,18670
"23428","Ocbimv22030505m.g","KQ421007",27268,27699,431
"23429","Ocbimv22036888m.g","KQ416665",54821,55555,734
"23430","Ocbimv22029429m.g","KQ420749",77981,79413,1432
"23431","Ocbimv22000354m.g","KQ423937",104344,105165,821
"23432","Ocbimv22020821m.g","KQ418970",782033,793324,11291
"23433","Ocbimv22009095m.g","KQ417561",75951,76601,650
"23434","Ocbimv22030815m.g","KQ421092",247376,260066,12690
"23435","Ocbimv22003123m.g","KQ424889",353451,370309,16858
"23436","Ocbimv22016423m.g","KQ418351",25838,54148,28310
"23437","Ocbimv22036936m.g","KQ416666",941770,945565,3795
"23438","Ocbimv22014888m.g","KQ429131",153242,155663,2421
"23439","Ocbimv22017490m.g","KQ418502",4430,22291,17861
"23440","Ocbimv22015984m.g","KQ418304",308649,308882,233
"23441","Ocbimv22034711m.g","LGKD01088154",6,161,155
"23442","Ocbimv22004598m.g","KQ417182",599396,638747,39351
"23443","Ocbimv22027028m.g","KQ420166",250203,260015,9812
"23444","Ocbimv22016989m.g","KQ418431",860976,870278,9302
"23445","Ocbimv22021706m.g","KQ419087",232960,234178,1218
"23446","Ocbimv22012409m.g","KQ428159",32402,36828,4426
"23447","Ocbimv22013902m.g","KQ428707",217316,277355,60039
"23448","Ocbimv22009779m.g","KQ417613",1094278,1094631,353
"23449","Ocbimv22030377m.g","KQ420969",263357,264032,675
"23450","Ocbimv22022041m.g","LGKD01674248",8,451,443
"23451","Ocbimv22012318m.g","KQ415907",251164,251370,206
"23452","Ocbimv22038789m.g","KQ415767",25033,35646,10613
"23453","Ocbimv22021362m.g","KQ419034",7086,7895,809
"23454","Ocbimv22022860m.g","LGKD01683451",223,1120,897
"23455","Ocbimv22030187m.g","KQ420917",276354,297332,20978
"23456","Ocbimv22031968m.g","LGKD01398448",2,244,242
"23457","Ocbimv22030149m.g","KQ420910",267719,267997,278
"23458","Ocbimv22002895m.g","KQ424814",535945,539457,3512
"23459","Ocbimv22019041m.g","KQ418711",1086677,1146005,59328
"23460","Ocbimv22019923m.g","KQ431376",382139,383386,1247
"23461","Ocbimv22005359m.g","KQ425596",132308,135505,3197
"23462","Ocbimv22008373m.g","KQ417498",914429,914750,321
"23463","Ocbimv22001165m.g","KQ416913",199968,201817,1849
"23464","Ocbimv22000477m.g","KQ423978",997,3640,2643
"23465","Ocbimv22011782m.g","KQ417832",4918,10431,5513
"23466","Ocbimv22013041m.g","KQ428349",382212,412814,30602
"23467","Ocbimv22006168m.g","KQ417300",2205218,2205409,191
"23468","Ocbimv22007107m.g","KQ417379",55843,57377,1534
"23469","Ocbimv22007341m.g","LGKD01554521",1,159,158
"23470","Ocbimv22035179m.g","KQ422295",146921,147756,835
"23471","Ocbimv22009888m.g","KQ417621",537949,549981,12032
"23472","Ocbimv22001168m.g","KQ424211",3870,5210,1340
"23473","Ocbimv22020196m.g","KQ418873",257179,278863,21684
"23474","Ocbimv22010750m.g","KQ427498",41697,51997,10300
"23475","Ocbimv22007517m.g","KQ426359",34118,34429,311
"23476","Ocbimv22039161m.g","KQ423555",458664,479239,20575
"23477","Ocbimv22001989m.g","KQ416979",907656,909540,1884
"23478","Ocbimv22004370m.g","KQ415803",480023,480773,750
"23479","Ocbimv22002917m.g","KQ417048",211251,211724,473
"23480","Ocbimv22020299m.g","KQ418886",314683,315200,517
"23481","Ocbimv22002022m.g","KQ424513",158747,159304,557
"23482","Ocbimv22024783m.g","KQ419631",25674,64852,39178
"23483","Ocbimv22016489m.g","LGKD01627987",110,352,242
"23484","Ocbimv22035552m.g","KQ422436",63971,65194,1223
"23485","Ocbimv22015225m.g","KQ429221",99309,131644,32335
"23486","Ocbimv22011565m.g","KQ417804",139849,144767,4918
"23487","Ocbimv22006556m.g","KQ415832",200090,200377,287
"23488","Ocbimv22027935m.g","KQ420404",806263,808578,2315
"23489","Ocbimv22015519m.g","KQ415945",801660,805862,4202
"23490","Ocbimv22037687m.g","KQ423101",33456,39232,5776
"23491","Ocbimv22038442m.g","KQ423338",391431,391843,412
"23492","Ocbimv22038824m.g","KQ423478",202926,206617,3691
"23493","Ocbimv22021090m.g","KQ431983",26571,27661,1090
"23494","Ocbimv22001760m.g","KQ424404",209195,209446,251
"23495","Ocbimv22030768m.g","KQ421085",146952,147233,281
"23496","Ocbimv22036072m.g","KQ416616",941266,941828,562
"23497","Ocbimv22006089m.g","KQ417294",401835,481162,79327
"23498","Ocbimv22024687m.g","KQ419615",445211,451418,6207
"23499","Ocbimv22025624m.g","KQ419861",816619,816804,185
"23500","Ocbimv22009559m.g","LGKD01571121",576,1190,614
"23501","Ocbimv22022293m.g","KQ419192",784208,808051,23843
"23502","Ocbimv22017510m.g","KQ430326",88127,89410,1283
"23503","Ocbimv22034771m.g","KQ422166",247445,288745,41300
"23504","Ocbimv22031750m.g","KQ421338",32691,49450,16759
"23505","Ocbimv22020271m.g","KQ418881",998288,998665,377
"23506","Ocbimv22029997m.g","KQ420877",95318,96154,836
"23507","Ocbimv22005407m.g","KQ417249",2359971,2361573,1602
"23508","Ocbimv22009119m.g","KQ426892",16587,18053,1466
"23509","Ocbimv22015174m.g","KQ429178",770,6080,5310
"23510","Ocbimv22015686m.g","KQ429470",288851,365555,76704
"23511","Ocbimv22004434m.g","KQ425304",57390,76468,19078
"23512","Ocbimv22021058m.g","KQ431974",68882,78206,9324
"23513","Ocbimv22005324m.g","KQ417240",458627,479921,21294
"23514","Ocbimv22027355m.g","KQ420264",158958,160869,1911
"23515","Ocbimv22023220m.g","KQ419376",427531,427689,158
"23516","Ocbimv22019978m.g","KQ418839",756102,825363,69261
"23517","Ocbimv22002812m.g","KQ417037",673570,675848,2278
"23518","Ocbimv22027734m.g","KQ420350",227044,257034,29990
"23519","Ocbimv22031472m.g","KQ416399",353975,357226,3251
"23520","Ocbimv22013558m.g","KQ418038",4865,6757,1892
"23521","Ocbimv22031659m.g","KQ421305",629177,636850,7673
"23522","Ocbimv22009793m.g","KQ427135",5196,6644,1448
"23523","Ocbimv22014385m.g","KQ418125",54629,56724,2095
"23524","Ocbimv22027109m.g","KQ420185",212357,212680,323
"23525","Ocbimv22013729m.g","LGKD01603697",16,342,326
"23526","Ocbimv22007703m.g","KQ426423",79261,87246,7985
"23527","Ocbimv22020293m.g","KQ431584",169007,169626,619
"23528","Ocbimv22009288m.g","KQ417579",243760,244591,831
"23529","Ocbimv22038874m.g","KQ423482",17320,89736,72416
"23530","Ocbimv22010334m.g","KQ417671",58901,59126,225
"23531","Ocbimv22012376m.g","KQ428145",2091,3226,1135
"23532","Ocbimv22019125m.g","KQ430988",59894,69155,9261
"23533","Ocbimv22014186m.g","KQ418098",509089,535985,26896
"23534","Ocbimv22025492m.g","KQ419820",33646,41708,8062
"23535","Ocbimv22007741m.g","KQ426449",20,1473,1453
"23536","Ocbimv22014213m.g","KQ418101",206024,206428,404
"23537","Ocbimv22029379m.g","KQ420735",13430,13872,442
"23538","Ocbimv22005399m.g","KQ417249",1963758,1964261,503
"23539","Ocbimv22020591m.g","KQ418928",189919,190494,575
"23540","Ocbimv22023704m.g","KQ416093",303784,304191,407
"23541","Ocbimv22006707m.g","KQ426075",452850,453060,210
"23542","Ocbimv22013993m.g","KQ428718",76025,76607,582
"23543","Ocbimv22006121m.g","KQ417300",111015,121328,10313
"23544","Ocbimv22035077m.g","KQ422268",43464,90616,47152
"23545","Ocbimv22029576m.g","KQ420777",179269,215515,36246
"23546","Ocbimv22034033m.g","KQ416508",139026,139268,242
"23547","Ocbimv22010448m.g","KQ427392",240939,241490,551
"23548","Ocbimv22002035m.g","KQ424524",332962,335236,2274
"23549","Ocbimv22000343m.g","KQ416854",632281,632442,161
"23550","Ocbimv22027320m.g","KQ420258",365980,366818,838
"23551","Ocbimv22007662m.g","KQ426413",252,512,260
"23552","Ocbimv22039930m.g","KQ416835",26953,27366,413
"23553","Ocbimv22033659m.g","KQ421858",236735,242045,5310
"23554","Ocbimv22005589m.g","KQ425656",176940,178230,1290
"23555","Ocbimv22015180m.g","KQ418203",28669,29022,353
"23556","Ocbimv22019945m.g","KQ418838",420541,421648,1107
"23557","Ocbimv22016081m.g","KQ429694",83196,107093,23897
"23558","Ocbimv22015759m.g","KQ418290",73477,73647,170
"23559","Ocbimv22031400m.g","KQ421230",33412,36469,3057
"23560","Ocbimv22000791m.g","KQ424068",11737,64078,52341
"23561","Ocbimv22000870m.g","KQ424096",556311,588307,31996
"23562","Ocbimv22030488m.g","KQ416352",84562,84777,215
"23563","Ocbimv22038570m.g","KQ423405",144453,146588,2135
"23564","Ocbimv22003905m.g","KQ425144",24342,24782,440
"23565","Ocbimv22027802m.g","KQ416233",575216,577840,2624
"23566","Ocbimv22021455m.g","KQ419052",285065,286882,1817
"23567","Ocbimv22013967m.g","KQ428715",3090,66199,63109
"23568","Ocbimv22006658m.g","KQ426062",46875,47048,173
"23569","Ocbimv22006771m.g","KQ426101",100011,100388,377
"23570","Ocbimv22017450m.g","KQ418498",8697,49005,40308
"23571","Ocbimv22011466m.g","KQ417793",34719,36299,1580
"23572","Ocbimv22020708m.g","KQ416032",283436,283925,489
"23573","Ocbimv22017837m.g","KQ415984",80274,98536,18262
"23574","Ocbimv22027127m.g","KQ420195",9739,28059,18320
"23575","Ocbimv22027396m.g","KQ416223",260393,260606,213
"23576","Ocbimv22016092m.g","KQ415954",396115,396429,314
"23577","Ocbimv22030093m.g","KQ420887",52337,52627,290
"23578","Ocbimv22001856m.g","KQ416971",277798,294045,16247
"23579","Ocbimv22000607m.g","KQ424018",12624,27627,15003
"23580","Ocbimv22026152m.g","KQ420004",241633,252409,10776
"23581","Ocbimv22034579m.g","KQ422077",324767,356740,31973
"23582","Ocbimv22028769m.g","KQ420579",534060,535397,1337
"23583","Ocbimv22025223m.g","KQ416145",288756,289249,493
"23584","Ocbimv22037286m.g","KQ422990",27317,27607,290
"23585","Ocbimv22010161m.g","KQ427290",185188,193535,8347
"23586","Ocbimv22021691m.g","KQ416051",1148384,1148941,557
"23587","Ocbimv22038247m.g","KQ423248",372359,372823,464
"23588","Ocbimv22032938m.g","KQ421686",191875,193942,2067
"23589","Ocbimv22017339m.g","KQ418483",186970,189652,2682
"23590","Ocbimv22003184m.g","KQ424903",62963,63619,656
"23591","Ocbimv22012160m.g","KQ417878",269995,270462,467
"23592","Ocbimv22005505m.g","KQ425633",88956,89234,278
"23593","Ocbimv22005452m.g","KQ417253",3717,7099,3382
"23594","Ocbimv22030640m.g","KQ421039",472974,484031,11057
"23595","Ocbimv22006890m.g","KQ426135",145879,148119,2240
"23596","Ocbimv22002310m.g","KQ424627",338703,338875,172
"23597","Ocbimv22012792m.g","KQ428240",125396,127589,2193
"23598","Ocbimv22008804m.g","KQ426774",161928,168187,6259
"23599","Ocbimv22031327m.g","KQ421218",276838,277944,1106
"23600","Ocbimv22033513m.g","KQ421823",145276,180378,35102
"23601","Ocbimv22010782m.g","KQ427521",116133,180223,64090
"23602","Ocbimv22010746m.g","KQ427491",113772,117290,3518
"23603","Ocbimv22030419m.g","KQ420978",11580,12427,847
"23604","Ocbimv22004508m.g","KQ417173",2716534,2718212,1678
"23605","Ocbimv22020122m.g","KQ431469",211,9044,8833
"23606","Ocbimv22019485m.g","KQ431147",28942,33998,5056
"23607","Ocbimv22002594m.g","KQ424714",2,893,891
"23608","Ocbimv22031447m.g","KQ421244",223119,223442,323
"23609","Ocbimv22011275m.g","KQ417772",132829,133032,203
"23610","Ocbimv22020083m.g","KQ431444",5781,6950,1169
"23611","Ocbimv22016752m.g","KQ429998",36464,36616,152
"23612","Ocbimv22019297m.g","KQ431083",3761,4174,413
"23613","Ocbimv22006208m.g","KQ417304",146153,153993,7840
"23614","Ocbimv22013335m.g","KQ418012",603497,605143,1646
"23615","Ocbimv22027244m.g","KQ420227",108705,108989,284
"23616","Ocbimv22006935m.g","LGKD01551306",10,1362,1352
"23617","Ocbimv22003461m.g","KQ425015",321689,332835,11146
"23618","Ocbimv22026243m.g","KQ420020",206118,206586,468
"23619","Ocbimv22023390m.g","KQ433355",13520,13975,455
"23620","Ocbimv22019098m.g","KQ416007",47254,49409,2155
"23621","Ocbimv22034948m.g","KQ422223",396769,397013,244
"23622","Ocbimv22000074m.g","KQ423846",512156,513181,1025
"23623","Ocbimv22010453m.g","KQ417678",51970,65725,13755
"23624","Ocbimv22037568m.g","KQ423069",78830,79776,946
"23625","Ocbimv22029418m.g","KQ416305",395035,411226,16191
"23626","Ocbimv22026761m.g","KQ420109",367667,391970,24303
"23627","Ocbimv22032736m.g","KQ416449",393529,394576,1047
"23628","Ocbimv22032122m.g","KQ421454",19815,20333,518
"23629","Ocbimv22035504m.g","KQ422411",449457,457125,7668
"23630","Ocbimv22000335m.g","KQ416854",134522,135676,1154
"23631","Ocbimv22011399m.g","KQ417791",1072673,1073497,824
"23632","Ocbimv22007645m.g","KQ417439",124197,200769,76572
"23633","Ocbimv22033071m.g","KQ421721",935968,936722,754
"23634","Ocbimv22032229m.g","KQ421487",76373,76722,349
"23635","Ocbimv22001137m.g","KQ424204",33547,33987,440
"23636","Ocbimv22034654m.g","KQ416544",205122,212374,7252
"23637","Ocbimv22030648m.g","KQ416361",8200,8773,573
"23638","Ocbimv22035011m.g","LGKD01435633",5,169,164
"23639","Ocbimv22014569m.g","KQ428991",14773,16115,1342
"23640","Ocbimv22014103m.g","KQ428760",193831,208705,14874
"23641","Ocbimv22014046m.g","KQ428735",33153,105491,72338
"23642","Ocbimv22015190m.g","KQ418204",44519,46219,1700
"23643","Ocbimv22032669m.g","KQ421630",170514,197951,27437
"23644","Ocbimv22019961m.g","KQ418839",179923,199434,19511
"23645","Ocbimv22019666m.g","KQ431224",28431,39470,11039
"23646","Ocbimv22010929m.g","KQ417725",272509,274970,2461
"23647","Ocbimv22017811m.g","KQ418549",580714,581777,1063
"23648","Ocbimv22018193m.g","KQ415990",543507,544931,1424
"23649","Ocbimv22012618m.g","KQ417921",687400,688065,665
"23650","Ocbimv22011071m.g","KQ427619",36934,42704,5770
"23651","Ocbimv22025084m.g","KQ416137",424971,427658,2687
"23652","Ocbimv22017289m.g","KQ418476",458543,462369,3826
"23653","Ocbimv22018486m.g","LGKD01643500",1498,2607,1109
"23654","Ocbimv22039556m.g","KQ416802",472696,482605,9909
"23655","Ocbimv22017054m.g","KQ418445",165950,197995,32045
"23656","Ocbimv22026036m.g","KQ419961",4,2549,2545
"23657","Ocbimv22007251m.g","KQ426262",47668,48585,917
"23658","Ocbimv22008397m.g","KQ426629",131760,133228,1468
"23659","Ocbimv22033500m.g","KQ421821",389546,390778,1232
"23660","Ocbimv22038729m.g","KQ416764",66501,96437,29936
"23661","Ocbimv22015543m.g","KQ429413",790,3893,3103
"23662","Ocbimv22018500m.g","KQ418631",61076,93000,31924
"23663","Ocbimv22034929m.g","KQ422216",62803,110632,47829
"23664","Ocbimv22038822m.g","KQ423474",68635,71156,2521
"23665","Ocbimv22030707m.g","KQ421075",71598,72483,885
"23666","Ocbimv22016238m.g","KQ429763",115218,121601,6383
"23667","Ocbimv22028500m.g","KQ416259",245579,249393,3814
"23668","Ocbimv22007629m.g","KQ415845",47938,53982,6044
"23669","Ocbimv22034988m.g","KQ422234",36875,41463,4588
"23670","Ocbimv22007394m.g","KQ426321",101378,111955,10577
"23671","Ocbimv22015524m.g","KQ415945",850566,855547,4981
"23672","Ocbimv22013090m.g","KQ417980",142758,296079,153321
"23673","Ocbimv22036681m.g","KQ415756",142842,145235,2393
"23674","Ocbimv22032417m.g","KQ421533",123459,123746,287
"23675","Ocbimv22013377m.g","KQ418018",687505,711565,24060
"23676","Ocbimv22029424m.g","KQ420747",540503,540658,155
"23677","Ocbimv22028827m.g","KQ420590",50347,50631,284
"23678","Ocbimv22031562m.g","KQ421277",7698,10768,3070
"23679","Ocbimv22023183m.g","KQ419368",223946,229117,5171
"23680","Ocbimv22028514m.g","KQ420516",633746,634354,608
"23681","Ocbimv22037959m.g","KQ423185",279270,279854,584
"23682","Ocbimv22014776m.g","KQ418176",1039149,1052545,13396
"23683","Ocbimv22013117m.g","LGKD01599346",365,529,164
"23684","Ocbimv22006344m.g","KQ415830",16780,21554,4774
"23685","Ocbimv22017539m.g","KQ430345",93687,98911,5224
"23686","Ocbimv22029293m.g","KQ420698",58817,87225,28408
"23687","Ocbimv22023272m.g","KQ419390",71089,71433,344
"23688","Ocbimv22018243m.g","KQ418587",6907,7323,416
"23689","Ocbimv22026162m.g","KQ420007",3927,4107,180
"23690","Ocbimv22039885m.g","KQ416833",283889,284901,1012
"23691","Ocbimv22025756m.g","KQ416166",299594,300037,443
"23692","Ocbimv22015714m.g","LGKD01621048",47,787,740
"23693","Ocbimv22035469m.g","KQ422393",7282,11354,4072
"23694","Ocbimv22027112m.g","KQ420188",24537,27297,2760
"23695","Ocbimv22020659m.g","KQ418947",62896,66132,3236
"23696","Ocbimv22017154m.g","KQ430174",49987,59799,9812
"23697","Ocbimv22025578m.g","KQ419849",191728,214406,22678
"23698","Ocbimv22030690m.g","KQ421067",43517,48040,4523
"23699","Ocbimv22014090m.g","LGKD01606339",141,737,596
"23700","Ocbimv22039666m.g","KQ423724",32824,33375,551
"23701","Ocbimv22013823m.g","KQ418063",502498,508656,6158
"23702","Ocbimv22019191m.g","KQ431046",1751,15192,13441
"23703","Ocbimv22019916m.g","KQ431376",43279,88241,44962
"23704","Ocbimv22037142m.g","KQ416676",6167,207279,201112
"23705","Ocbimv22035773m.g","KQ416600",267802,274723,6921
"23706","Ocbimv22008671m.g","KQ417519",856975,857995,1020
"23707","Ocbimv22014110m.g","KQ428763",1027,42326,41299
"23708","Ocbimv22005929m.g","KQ417284",546147,546996,849
"23709","Ocbimv22000356m.g","KQ423938",57074,57448,374
"23710","Ocbimv22012839m.g","KQ417945",415697,416063,366
"23711","Ocbimv22029585m.g","KQ420779",105762,135049,29287
"23712","Ocbimv22026063m.g","KQ419975",418615,420684,2069
"23713","Ocbimv22009269m.g","KQ426944",100315,109491,9176
"23714","Ocbimv22035050m.g","KQ422261",47390,57444,10054
"23715","Ocbimv22034138m.g","KQ421984",287470,292803,5333
"23716","Ocbimv22008662m.g","KQ426725",30690,33219,2529
"23717","Ocbimv22032865m.g","KQ421669",78061,87067,9006
"23718","Ocbimv22022061m.g","KQ419155",263008,263829,821
"23719","Ocbimv22034580m.g","KQ422077",367353,368100,747
"23720","Ocbimv22018102m.g","KQ430572",133517,152189,18672
"23721","Ocbimv22001464m.g","KQ416934",339578,339913,335
"23722","Ocbimv22022930m.g","KQ419326",676864,680292,3428
"23723","Ocbimv22018337m.g","KQ430665",112847,162055,49208
"23724","Ocbimv22019869m.g","KQ431344",32500,32673,173
"23725","Ocbimv22009085m.g","LGKD01567659",17,376,359
"23726","Ocbimv22020223m.g","KQ431541",82786,86530,3744
"23727","Ocbimv22033335m.g","KQ421784",86235,87019,784
"23728","Ocbimv22010097m.g","KQ417641",495659,496252,593
"23729","Ocbimv22032044m.g","KQ421413",43650,64244,20594
"23730","Ocbimv22021828m.g","KQ415687",622852,625491,2639
"23731","Ocbimv22037630m.g","KQ415761",852077,854168,2091
"23732","Ocbimv22024535m.g","KQ419593",46029,48029,2000
"23733","Ocbimv22019427m.g","KQ418762",93547,93777,230
"23734","Ocbimv22018675m.g","KQ415684",337333,353200,15867
"23735","Ocbimv22037088m.g","KQ422919",1539425,1560980,21555
"23736","Ocbimv22015985m.g","LGKD01623338",9,131,122
"23737","Ocbimv22022158m.g","KQ419177",31572,32315,743
"23738","Ocbimv22011634m.g","KQ427825",39471,62378,22907
"23739","Ocbimv22013736m.g","KQ428629",3012,6568,3556
"23740","Ocbimv22022793m.g","KQ416075",19073,27574,8501
"23741","Ocbimv22029673m.g","KQ420799",326964,338854,11890
"23742","Ocbimv22005804m.g","KQ415823",1154433,1156567,2134
"23743","Ocbimv22027422m.g","KQ420271",182834,188809,5975
"23744","Ocbimv22007427m.g","KQ426340",58817,82913,24096
"23745","Ocbimv22017505m.g","KQ430326",40608,47588,6980
"23746","Ocbimv22001869m.g","KQ424456",4337,6663,2326
"23747","Ocbimv22037325m.g","KQ423001",412874,433086,20212
"23748","Ocbimv22010383m.g","KQ415876",967487,968576,1089
"23749","Ocbimv22012380m.g","KQ417908",24544,54821,30277
"23750","Ocbimv22022141m.g","KQ419175",603282,608680,5398
"23751","Ocbimv22000201m.g","KQ423898",7540,43854,36314
"23752","Ocbimv22011594m.g","KQ417807",197388,206647,9259
"23753","Ocbimv22032279m.g","KQ421510",76206,80319,4113
"23754","Ocbimv22008470m.g","KQ415854",549395,568714,19319
"23755","Ocbimv22014554m.g","KQ418152",485840,488589,2749
"23756","Ocbimv22032282m.g","KQ421512",11377,31415,20038
"23757","Ocbimv22021616m.g","KQ432252",257660,259673,2013
"23758","Ocbimv22025427m.g","KQ419797",144700,177968,33268
"23759","Ocbimv22039226m.g","KQ423590",58612,120814,62202
"23760","Ocbimv22036479m.g","KQ416642",573197,590808,17611
"23761","Ocbimv22015833m.g","KQ418295",266593,268629,2036
"23762","Ocbimv22038821m.g","KQ423474",26626,28050,1424
"23763","Ocbimv22035030m.g","KQ415745",422679,423257,578
"23764","Ocbimv22035301m.g","KQ422351",277836,283220,5384
"23765","Ocbimv22010054m.g","KQ417636",59381,63343,3962
"23766","Ocbimv22024317m.g","KQ419566",3276,23705,20429
"23767","Ocbimv22001364m.g","KQ416925",129362,155565,26203
"23768","Ocbimv22006256m.g","KQ417305",505632,515845,10213
"23769","Ocbimv22014600m.g","KQ428999",10037,10873,836
"23770","Ocbimv22029572m.g","KQ420777",118831,120630,1799
"23771","Ocbimv22007052m.g","KQ417371",513797,540739,26942
"23772","Ocbimv22019559m.g","KQ418783",819454,837541,18087
"23773","Ocbimv22019102m.g","KQ430964",212300,212562,262
"23774","Ocbimv22008314m.g","KQ426613",237877,273573,35696
"23775","Ocbimv22011813m.g","KQ415893",507978,515400,7422
"23776","Ocbimv22024698m.g","KQ419616",84785,137927,53142
"23777","Ocbimv22006942m.g","KQ426160",54716,56054,1338
"23778","Ocbimv22005870m.g","KQ417280",343972,344121,149
"23779","Ocbimv22005912m.g","KQ417284",259325,261713,2388
"23780","Ocbimv22036500m.g","KQ422777",298427,348200,49773
"23781","Ocbimv22032032m.g","KQ421411",402853,420186,17333
"23782","Ocbimv22008258m.g","KQ417492",195899,221008,25109
"23783","Ocbimv22037920m.g","KQ423169",45960,46163,203
"23784","Ocbimv22003063m.g","KQ424873",19364,20785,1421
"23785","Ocbimv22012330m.g","KQ415907",521351,535205,13854
"23786","Ocbimv22002438m.g","KQ424659",7811,11543,3732
"23787","Ocbimv22019423m.g","KQ418762",56822,60473,3651
"23788","Ocbimv22032441m.g","KQ421542",43962,44993,1031
"23789","Ocbimv22000782m.g","KQ416881",214557,216080,1523
"23790","Ocbimv22026657m.g","KQ420086",10908,51543,40635
"23791","Ocbimv22023307m.g","KQ416087",884772,885080,308
"23792","Ocbimv22018710m.g","KQ418658",88206,108822,20616
"23793","Ocbimv22034546m.g","KQ416536",365101,370361,5260
"23794","Ocbimv22001132m.g","KQ424197",21214,21960,746
"23795","Ocbimv22015463m.g","KQ429365",28539,53504,24965
"23796","Ocbimv22013246m.g","KQ418003",471202,475899,4697
"23797","Ocbimv22033658m.g","KQ421858",229723,235352,5629
"23798","Ocbimv22021915m.g","KQ419129",124504,126024,1520
"23799","Ocbimv22014188m.g","KQ418098",665952,670072,4120
"23800","Ocbimv22032392m.g","KQ421531",48219,49374,1155
"23801","Ocbimv22029295m.g","KQ420698",101991,102239,248
"23802","Ocbimv22025172m.g","KQ416141",634211,634369,158
"23803","Ocbimv22022639m.g","KQ419277",546,13251,12705
"23804","Ocbimv22023211m.g","KQ419372",149207,149842,635
"23805","Ocbimv22029653m.g","KQ416315",18569,18781,212
"23806","Ocbimv22031242m.g","KQ421206",215948,217348,1400
"23807","Ocbimv22032595m.g","KQ416441",128667,129080,413
"23808","Ocbimv22033191m.g","KQ421749",8856,9768,912
"23809","Ocbimv22011412m.g","KQ417791",1334480,1336297,1817
"23810","Ocbimv22001865m.g","KQ416971",457832,487623,29791
"23811","Ocbimv22022824m.g","KQ419302",131086,131859,773
"23812","Ocbimv22020431m.g","KQ416027",239876,242539,2663
"23813","Ocbimv22001630m.g","KQ416950",553920,569907,15987
"23814","Ocbimv22015377m.g","KQ418233",49191,97747,48556
"23815","Ocbimv22005071m.g","KQ425510",368708,377372,8664
"23816","Ocbimv22015287m.g","KQ429244",109018,109773,755
"23817","Ocbimv22026748m.g","KQ420105",297170,340806,43636
"23818","Ocbimv22003679m.g","KQ425065",11950,12111,161
"23819","Ocbimv22035663m.g","KQ422494",264237,264608,371
"23820","Ocbimv22037732m.g","KQ423122",60275,61341,1066
"23821","Ocbimv22035401m.g","KQ422367",182659,184245,1586
"23822","Ocbimv22026418m.g","KQ420047",272110,301120,29010
"23823","Ocbimv22000513m.g","KQ423985",5505,6404,899
"23824","Ocbimv22016868m.g","KQ418414",62790,64981,2191
"23825","Ocbimv22021569m.g","KQ419079",3018,3377,359
"23826","Ocbimv22019405m.g","KQ418760",477273,477719,446
"23827","Ocbimv22001315m.g","KQ416920",565131,565373,242
"23828","Ocbimv22035996m.g","KQ422629",521469,523836,2367
"23829","Ocbimv22023430m.g","KQ419409",64740,65114,374
"23830","Ocbimv22025838m.g","KQ416171",510368,512415,2047
"23831","Ocbimv22013481m.g","KQ418027",39850,90636,50786
"23832","Ocbimv22012091m.g","KQ428032",15241,17691,2450
"23833","Ocbimv22002101m.g","KQ416986",147951,205821,57870
"23834","Ocbimv22003044m.g","KQ417055",1787076,1804941,17865
"23835","Ocbimv22031854m.g","KQ421358",106105,106434,329
"23836","Ocbimv22030452m.g","KQ416350",252790,253203,413
"23837","Ocbimv22000744m.g","KQ416877",1332078,1332381,303
"23838","Ocbimv22012067m.g","KQ428000",372,1979,1607
"23839","Ocbimv22009041m.g","KQ415859",549129,549942,813
"23840","Ocbimv22002475m.g","KQ424667",56613,95495,38882
"23841","Ocbimv22002608m.g","KQ417023",152140,160600,8460
"23842","Ocbimv22034187m.g","KQ421998",15522,16181,659
"23843","Ocbimv22001855m.g","KQ416971",266787,269101,2314
"23844","Ocbimv22032729m.g","KQ421646",58638,60383,1745
"23845","Ocbimv22021554m.g","LGKD01669524",15,1001,986
"23846","Ocbimv22030795m.g","KQ416370",239188,248281,9093
"23847","Ocbimv22010068m.g","KQ427248",4371,7643,3272
"23848","Ocbimv22014153m.g","KQ418095",558676,577836,19160
"23849","Ocbimv22005784m.g","KQ415823",330109,368445,38336
"23850","Ocbimv22017632m.g","KQ430399",4481,6939,2458
"23851","Ocbimv22013063m.g","KQ417977",403994,406832,2838
"23852","Ocbimv22015973m.g","KQ415949",264341,265808,1467
"23853","Ocbimv22025228m.g","KQ419741",191605,191892,287
"23854","Ocbimv22016620m.g","KQ418370",393867,394187,320
"23855","Ocbimv22037123m.g","KQ422926",4475,6099,1624
"23856","Ocbimv22019832m.g","KQ431332",523035,561301,38266
"23857","Ocbimv22023658m.g","KQ419456",424332,445975,21643
"23858","Ocbimv22008942m.g","KQ426816",126638,128118,1480
"23859","Ocbimv22029070m.g","KQ420640",277838,303992,26154
"23860","Ocbimv22005812m.g","KQ415823",1387728,1407284,19556
"23861","Ocbimv22012682m.g","KQ417925",37431,38136,705
"23862","Ocbimv22011913m.g","KQ427949",174372,234355,59983
"23863","Ocbimv22007411m.g","KQ426334",8597,39676,31079
"23864","Ocbimv22012236m.g","KQ417892",220073,221580,1507
"23865","Ocbimv22016982m.g","KQ418431",566622,614357,47735
"23866","Ocbimv22033670m.g","KQ421858",276061,280337,4276
"23867","Ocbimv22020473m.g","KQ418919",67773,68845,1072
"23868","Ocbimv22011028m.g","KQ427597",104005,104564,559
"23869","Ocbimv22022252m.g","KQ432656",256138,260613,4475
"23870","Ocbimv22007283m.g","KQ417398",336487,339679,3192
"23871","Ocbimv22027060m.g","KQ420170",166782,185939,19157
"23872","Ocbimv22026653m.g","KQ420085",580515,597432,16917
"23873","Ocbimv22039753m.g","KQ416821",160395,161403,1008
"23874","Ocbimv22036328m.g","KQ422713",10354,12364,2010
"23875","Ocbimv22006567m.g","KQ417336",759031,759243,212
"23876","Ocbimv22025138m.g","KQ419706",100866,101158,292
"23877","Ocbimv22030834m.g","LGKD01385300",3,239,236
"23878","Ocbimv22023699m.g","KQ416093",217786,217989,203
"23879","Ocbimv22016649m.g","KQ418375",42550,82879,40329
"23880","Ocbimv22014631m.g","KQ418159",222007,222189,182
"23881","Ocbimv22010635m.g","KQ427463",100190,113978,13788
"23882","Ocbimv22002201m.g","KQ416995",188982,202051,13069
"23883","Ocbimv22028557m.g","KQ416260",1719289,1719552,263
"23884","Ocbimv22031474m.g","KQ416399",365838,366679,841
"23885","Ocbimv22035954m.g","KQ416612",1627477,1629613,2136
"23886","Ocbimv22020748m.g","KQ431824",31643,53300,21657
"23887","Ocbimv22004593m.g","KQ417182",271101,307149,36048
"23888","Ocbimv22038125m.g","KQ423217",177843,178400,557
"23889","Ocbimv22012178m.g","KQ417881",55226,97762,42536
"23890","Ocbimv22008823m.g","KQ426775",55766,56766,1000
"23891","Ocbimv22028639m.g","KQ415707",114642,115124,482
"23892","Ocbimv22013089m.g","KQ417980",101272,142686,41414
"23893","Ocbimv22012122m.g","KQ415902",25755,27951,2196
"23894","Ocbimv22006183m.g","KQ417301",14213,14398,185
"23895","Ocbimv22013427m.g","KQ428503",151948,169002,17054
"23896","Ocbimv22027624m.g","KQ420314",115405,121102,5697
"23897","Ocbimv22023344m.g","KQ419395",108748,112798,4050
"23898","Ocbimv22036703m.g","KQ416654",88861,111612,22751
"23899","Ocbimv22008338m.g","KQ417497",1266491,1267817,1326
"23900","Ocbimv22017902m.g","KQ418556",69453,69818,365
"23901","Ocbimv22028934m.g","KQ416275",218226,218516,290
"23902","Ocbimv22025948m.g","KQ416176",4481,4726,245
"23903","Ocbimv22014448m.g","KQ415930",100300,136682,36382
"23904","Ocbimv22011761m.g","KQ417830",169472,169687,215
"23905","Ocbimv22033905m.g","KQ421906",187083,211198,24115
"23906","Ocbimv22012680m.g","KQ417925",15469,25614,10145
"23907","Ocbimv22037080m.g","KQ422919",912864,917792,4928
"23908","Ocbimv22026360m.g","KQ420033",94859,99229,4370
"23909","Ocbimv22000597m.g","KQ424015",320890,323606,2716
"23910","Ocbimv22030669m.g","KQ421056",209606,210338,732
"23911","Ocbimv22002900m.g","KQ424814",617422,620475,3053
"23912","Ocbimv22023823m.g","KQ419484",93949,94333,384
"23913","Ocbimv22016899m.g","KQ418420",409036,410105,1069
"23914","Ocbimv22003252m.g","KQ424914",51923,56032,4109
"23915","Ocbimv22009573m.g","KQ427028",427773,442017,14244
"23916","Ocbimv22035877m.g","KQ416608",716896,718570,1674
"23917","Ocbimv22018078m.g","KQ418570",21086,21487,401
"23918","Ocbimv22032511m.g","KQ421567",50892,51044,152
"23919","Ocbimv22021019m.g","KQ418994",28728,44737,16009
"23920","Ocbimv22034968m.g","KQ422232",1,796,795
"23921","Ocbimv22005405m.g","KQ417249",2278904,2318212,39308
"23922","Ocbimv22016742m.g","KQ429989",28271,86090,57819
"23923","Ocbimv22016895m.g","KQ418420",83754,93175,9421
"23924","Ocbimv22005782m.g","KQ415823",315102,315667,565
"23925","Ocbimv22035267m.g","KQ422349",329,10068,9739
"23926","Ocbimv22022025m.g","KQ419149",46068,46305,237
"23927","Ocbimv22038906m.g","KQ416771",1184735,1185559,824
"23928","Ocbimv22010084m.g","KQ417641",232430,232711,281
"23929","Ocbimv22006967m.g","KQ417368",267138,319911,52773
"23930","Ocbimv22012788m.g","KQ428240",94293,123873,29580
"23931","Ocbimv22028954m.g","KQ416277",83429,101410,17981
"23932","Ocbimv22031793m.g","KQ416408",91914,103061,11147
"23933","Ocbimv22030225m.g","KQ420925",1797,2795,998
"23934","Ocbimv22023500m.g","KQ433425",1039,11758,10719
"23935","Ocbimv22001628m.g","KQ416950",537240,538122,882
"23936","Ocbimv22037967m.g","KQ416716",433979,461750,27771
"23937","Ocbimv22018785m.g","KQ430870",4319,9829,5510
"23938","Ocbimv22002440m.g","KQ424659",14174,60767,46593
"23939","Ocbimv22021325m.g","KQ419030",24701,32911,8210
"23940","Ocbimv22003204m.g","KQ417063",525834,609106,83272
"23941","Ocbimv22011786m.g","KQ417832",670756,671209,453
"23942","Ocbimv22036688m.g","KQ422839",2873,41703,38830
"23943","Ocbimv22000111m.g","KQ423864",295521,299251,3730
"23944","Ocbimv22023507m.g","KQ419420",68240,68655,415
"23945","Ocbimv22039612m.g","KQ423717",138103,138435,332
"23946","Ocbimv22009448m.g","KQ426998",13721,17078,3357
"23947","Ocbimv22011804m.g","KQ415893",170515,174971,4456
"23948","Ocbimv22004653m.g","KQ417194",6111,6850,739
"23949","Ocbimv22002883m.g","KQ424814",77325,113141,35816
"23950","Ocbimv22003422m.g","KQ417087",233941,236151,2210
"23951","Ocbimv22006585m.g","KQ426026",236774,277782,41008
"23952","Ocbimv22005605m.g","KQ425671",44968,59581,14613
"23953","Ocbimv22039905m.g","KQ416834",342369,344327,1958
"23954","Ocbimv22037622m.g","KQ415761",424881,426753,1872
"23955","Ocbimv22010387m.g","KQ415876",1417516,1417725,209
"23956","Ocbimv22035636m.g","KQ422481",243154,245195,2041
"23957","Ocbimv22025777m.g","KQ415695",3128,4250,1122
"23958","Ocbimv22021595m.g","KQ432245",40133,40608,475
"23959","Ocbimv22021804m.g","KQ419106",26459,33034,6575
"23960","Ocbimv22027354m.g","KQ420264",28013,83214,55201
"23961","Ocbimv22017863m.g","KQ418552",400938,412836,11898
"23962","Ocbimv22007781m.g","KQ426456",212410,225843,13433
"23963","Ocbimv22000449m.g","KQ423968",163481,169831,6350
"23964","Ocbimv22029573m.g","KQ420777",132241,133867,1626
"23965","Ocbimv22006050m.g","KQ417292",222040,223341,1301
"23966","Ocbimv22031500m.g","KQ421263",171779,205942,34163
"23967","Ocbimv22001346m.g","KQ416923",190192,192040,1848
"23968","Ocbimv22020002m.g","KQ418840",1941807,1944960,3153
"23969","Ocbimv22016280m.g","KQ418336",35890,62265,26375
"23970","Ocbimv22016926m.g","KQ430088",686,10469,9783
"23971","Ocbimv22017190m.g","KQ430193",1679,16674,14995
"23972","Ocbimv22028906m.g","KQ416274",1246568,1258921,12353
"23973","Ocbimv22027955m.g","KQ420409",384063,385762,1699
"23974","Ocbimv22008874m.g","KQ426791",437481,443584,6103
"23975","Ocbimv22034500m.g","KQ422062",313928,326548,12620
"23976","Ocbimv22026318m.g","KQ420026",2750,17050,14300
"23977","Ocbimv22008233m.g","KQ426596",202449,202745,296
"23978","Ocbimv22010476m.g","KQ417681",468894,469858,964
"23979","Ocbimv22034507m.g","KQ422063",45427,46334,907
"23980","Ocbimv22006927m.g","KQ426154",292,103869,103577
"23981","Ocbimv22014550m.g","KQ428985",12370,13267,897
"23982","Ocbimv22024389m.g","KQ415693",332792,333679,887
"23983","Ocbimv22002193m.g","KQ424573",258,677,419
"23984","Ocbimv22029141m.g","KQ420662",908447,919647,11200
"23985","Ocbimv22009246m.g","KQ417578",265157,357714,92557
"23986","Ocbimv22027276m.g","KQ420241",97936,99548,1612
"23987","Ocbimv22023382m.g","KQ419395",356141,367680,11539
"23988","Ocbimv22012238m.g","KQ417892",477135,491490,14355
"23989","Ocbimv22027023m.g","KQ420165",46999,53026,6027
"23990","Ocbimv22018041m.g","LGKD01640052",1,195,194
"23991","Ocbimv22017836m.g","KQ415984",79523,80175,652
"23992","Ocbimv22008526m.g","KQ426659",59897,60316,419
"23993","Ocbimv22007379m.g","KQ426313",518873,538075,19202
"23994","Ocbimv22033361m.g","KQ421798",130894,131303,409
"23995","Ocbimv22006216m.g","KQ417304",208532,234167,25635
"23996","Ocbimv22008366m.g","KQ417498",671753,672049,296
"23997","Ocbimv22035559m.g","KQ422436",122587,149020,26433
"23998","Ocbimv22032963m.g","KQ421700",294,18112,17818
"23999","Ocbimv22030676m.g","KQ421058",296898,323435,26537
"24000","Ocbimv22026479m.g","KQ420055",287412,376993,89581
"24001","Ocbimv22012938m.g","KQ428301",58613,59095,482
"24002","Ocbimv22018711m.g","KQ418659",13403,14841,1438
"24003","Ocbimv22014619m.g","KQ415934",213839,225906,12067
"24004","Ocbimv22009569m.g","KQ427028",375141,393312,18171
"24005","Ocbimv22003972m.g","KQ425162",32893,38663,5770
"24006","Ocbimv22027335m.g","KQ420261",410280,432701,22421
"24007","Ocbimv22022248m.g","KQ432656",214053,253806,39753
"24008","Ocbimv22032666m.g","KQ421629",11983,24339,12356
"24009","Ocbimv22009988m.g","KQ427199",56881,58342,1461
"24010","Ocbimv22014850m.g","KQ415935",258922,259243,321
"24011","Ocbimv22021843m.g","KQ415687",1115058,1127771,12713
"24012","Ocbimv22032274m.g","LGKD01402288",1,1000,999
"24013","Ocbimv22005749m.g","KQ425733",141622,157239,15617
"24014","Ocbimv22007511m.g","KQ426358",11848,16801,4953
"24015","Ocbimv22037223m.g","KQ416684",360052,360333,281
"24016","Ocbimv22002146m.g","KQ424560",7351,12273,4922
"24017","Ocbimv22004777m.g","KQ417205",140011,140715,704
"24018","Ocbimv22024461m.g","LGKD01307431",363,707,344
"24019","Ocbimv22033939m.g","KQ416499",286622,312069,25447
"24020","Ocbimv22032194m.g","KQ421476",208159,228979,20820
"24021","Ocbimv22038041m.g","KQ423207",66573,68048,1475
"24022","Ocbimv22016184m.g","KQ418323",780133,782597,2464
"24023","Ocbimv22014246m.g","KQ428820",18456,19073,617
"24024","Ocbimv22013739m.g","KQ428638",4324,18591,14267
"24025","Ocbimv22007377m.g","KQ426313",455233,469219,13986
"24026","Ocbimv22033405m.g","KQ421804",94864,96491,1627
"24027","Ocbimv22020968m.g","KQ418985",219,875,656
"24028","Ocbimv22031352m.g","KQ421220",106921,118825,11904
"24029","Ocbimv22020929m.g","KQ431883",1171,98481,97310
"24030","Ocbimv22032142m.g","KQ421460",163381,172428,9047
"24031","Ocbimv22026402m.g","KQ420039",541586,541912,326
"24032","Ocbimv22003134m.g","KQ424892",7308,7805,497
"24033","Ocbimv22006007m.g","KQ425779",265429,283921,18492
"24034","Ocbimv22036874m.g","KQ422887",113593,166624,53031
"24035","Ocbimv22004505m.g","KQ417173",2229929,2230108,179
"24036","Ocbimv22005245m.g","KQ417234",379328,379516,188
"24037","Ocbimv22030946m.g","KQ421127",53082,53914,832
"24038","Ocbimv22009262m.g","KQ417578",905280,907731,2451
"24039","Ocbimv22026491m.g","KQ416189",269204,272264,3060
"24040","Ocbimv22031797m.g","KQ421349",99967,100362,395
"24041","Ocbimv22013373m.g","KQ428470",1271,7712,6441
"24042","Ocbimv22001469m.g","KQ416935",71118,73893,2775
"24043","Ocbimv22033586m.g","KQ421839",121417,121698,281
"24044","Ocbimv22010091m.g","KQ417641",362646,362990,344
"24045","Ocbimv22032451m.g","KQ421547",23638,29558,5920
"24046","Ocbimv22016735m.g","KQ429984",98386,114839,16453
"24047","Ocbimv22031379m.g","KQ416393",680381,681198,817
"24048","Ocbimv22029346m.g","KQ420714",116924,154030,37106
"24049","Ocbimv22000807m.g","KQ416885",604998,663118,58120
"24050","Ocbimv22011697m.g","KQ427864",14,24015,24001
"24051","Ocbimv22008605m.g","KQ417510",660990,661736,746
"24052","Ocbimv22005183m.g","KQ425538",19861,276301,256440
"24053","Ocbimv22003116m.g","KQ417059",85766,86824,1058
"24054","Ocbimv22019703m.g","KQ418804",14501,14839,338
"24055","Ocbimv22021103m.g","KQ432009",64166,64321,155
"24056","Ocbimv22033354m.g","KQ416476",106088,106537,449
"24057","Ocbimv22008953m.g","KQ417543",12478,19815,7337
"24058","Ocbimv22011966m.g","KQ415895",294704,383482,88778
"24059","Ocbimv22025009m.g","LGKD01312906",131,672,541
"24060","Ocbimv22003556m.g","KQ417090",1790910,1797582,6672
"24061","Ocbimv22017696m.g","KQ430417",254989,275008,20019
"24062","Ocbimv22031733m.g","KQ421332",756372,762481,6109
"24063","Ocbimv22039904m.g","KQ416834",298712,337707,38995
"24064","Ocbimv22027940m.g","KQ420404",1260579,1261256,677
"24065","Ocbimv22036309m.g","KQ416632",169795,170019,224
"24066","Ocbimv22035826m.g","KQ416602",495420,496883,1463
"24067","Ocbimv22014273m.g","KQ418112",96566,96796,230
"24068","Ocbimv22011614m.g","KQ427808",73990,74325,335
"24069","Ocbimv22034082m.g","KQ421961",47207,48220,1013
"24070","Ocbimv22004556m.g","KQ425361",190940,197515,6575
"24071","Ocbimv22020254m.g","KQ431560",33077,34944,1867
"24072","Ocbimv22026787m.g","KQ420117",154559,171802,17243
"24073","Ocbimv22006913m.g","KQ426140",102598,103760,1162
"24074","Ocbimv22005700m.g","KQ417274",241938,242677,739
"24075","Ocbimv22022357m.g","KQ419204",327486,327923,437
"24076","Ocbimv22036891m.g","KQ422891",35201,35759,558
"24077","Ocbimv22018202m.g","KQ415990",1373301,1391419,18118
"24078","Ocbimv22020866m.g","KQ418971",186720,187720,1000
"24079","Ocbimv22002081m.g","KQ424537",75884,76265,381
"24080","Ocbimv22024294m.g","KQ416121",1406997,1414154,7157
"24081","Ocbimv22025987m.g","KQ415696",207354,212709,5355
"24082","Ocbimv22021759m.g","KQ419095",6391,75033,68642
"24083","Ocbimv22008939m.g","KQ417542",1871,8867,6996
"24084","Ocbimv22006904m.g","KQ417361",291508,291983,475
"24085","Ocbimv22032642m.g","KQ421625",177179,177546,367
"24086","Ocbimv22032801m.g","KQ421658",669744,671199,1455
"24087","Ocbimv22011187m.g","KQ427669",82752,83195,443
"24088","Ocbimv22026225m.g","KQ420017",601174,611030,9856
"24089","Ocbimv22015224m.g","KQ429221",69021,69329,308
"24090","Ocbimv22039464m.g","KQ423675",150,1553,1403
"24091","Ocbimv22036424m.g","KQ422761",88255,101075,12820
"24092","Ocbimv22003131m.g","KQ424891",106381,106570,189
"24093","Ocbimv22033337m.g","KQ421784",224904,226576,1672
"24094","Ocbimv22036864m.g","KQ416662",945201,946666,1465
"24095","Ocbimv22031710m.g","KQ421325",68220,69018,798
"24096","Ocbimv22005165m.g","KQ425537",146802,150940,4138
"24097","Ocbimv22028109m.g","KQ416249",582666,583324,658
"24098","Ocbimv22037221m.g","KQ422970",103559,103915,356
"24099","Ocbimv22000097m.g","KQ423852",40176,44093,3917
"24100","Ocbimv22014425m.g","KQ418133",251139,251393,254
"24101","Ocbimv22014182m.g","KQ418098",173469,199253,25784
"24102","Ocbimv22037344m.g","KQ423006",152391,152788,397
"24103","Ocbimv22027989m.g","KQ420415",197718,198548,830
"24104","Ocbimv22036414m.g","KQ416641",366059,367501,1442
"24105","Ocbimv22011835m.g","KQ415893",1354553,1357995,3442
"24106","Ocbimv22003563m.g","KQ417090",1840669,1857658,16989
"24107","Ocbimv22005371m.g","KQ417249",205049,205360,311
"24108","Ocbimv22022210m.g","KQ416062",28675,29058,383
"24109","Ocbimv22019482m.g","KQ418772",29909,51340,21431
"24110","Ocbimv22039216m.g","KQ423582",6904,7254,350
"24111","Ocbimv22008569m.g","KQ417510",38182,38420,238
"24112","Ocbimv22004509m.g","KQ417173",2718339,2719135,796
"24113","Ocbimv22038032m.g","KQ415762",139625,140002,377
"24114","Ocbimv22016355m.g","KQ415961",79110,80006,896
"24115","Ocbimv22018894m.g","KQ430924",10773,32884,22111
"24116","Ocbimv22006070m.g","KQ425805",577208,577729,521
"24117","Ocbimv22039510m.g","KQ423680",230986,231483,497
"24118","Ocbimv22006265m.g","KQ417305",596125,597642,1517
"24119","Ocbimv22008741m.g","KQ417528",389601,391905,2304
"24120","Ocbimv22037507m.g","KQ416699",15344,38459,23115
"24121","Ocbimv22029818m.g","KQ420828",807513,808416,903
"24122","Ocbimv22015344m.g","KQ415942",83603,124627,41024
"24123","Ocbimv22001381m.g","KQ416929",895328,896874,1546
"24124","Ocbimv22002356m.g","KQ424645",59729,60094,365
"24125","Ocbimv22038827m.g","KQ423478",443504,444172,668
"24126","Ocbimv22037422m.g","KQ416694",2759211,2768159,8948
"24127","Ocbimv22010908m.g","KQ417724",107999,108265,266
"24128","Ocbimv22027057m.g","KQ420170",112683,112991,308
"24129","Ocbimv22009466m.g","KQ417596",19257,21101,1844
"24130","Ocbimv22024258m.g","KQ433896",2603,2998,395
"24131","Ocbimv22020168m.g","KQ418865",60003,61110,1107
"24132","Ocbimv22019939m.g","KQ418838",94316,113412,19096
"24133","Ocbimv22039774m.g","KQ423746",181328,182316,988
"24134","Ocbimv22021440m.g","KQ419049",113585,115908,2323
"24135","Ocbimv22001927m.g","KQ416974",221496,222351,855
"24136","Ocbimv22039972m.g","KQ415773",196818,243023,46205
"24137","Ocbimv22010450m.g","KQ427393",86,49792,49706
"24138","Ocbimv22015410m.g","KQ429325",114837,115043,206
"24139","Ocbimv22024922m.g","KQ419657",816655,817571,916
"24140","Ocbimv22018868m.g","KQ418693",412991,414733,1742
"24141","Ocbimv22028130m.g","KQ416251",492018,492317,299
"24142","Ocbimv22036048m.g","KQ422637",3883,19936,16053
"24143","Ocbimv22027083m.g","KQ420176",22720,35819,13099
"24144","Ocbimv22000861m.g","KQ424096",56944,81690,24746
"24145","Ocbimv22009153m.g","KQ426900",44041,44669,628
"24146","Ocbimv22030750m.g","KQ421083",471289,485962,14673
"24147","Ocbimv22032054m.g","KQ421415",38262,44362,6100
"24148","Ocbimv22013883m.g","KQ428701",51735,61812,10077
"24149","Ocbimv22036213m.g","KQ422680",263963,275766,11803
"24150","Ocbimv22027266m.g","KQ420240",257994,270266,12272
"24151","Ocbimv22011255m.g","KQ417771",366088,366747,659
"24152","Ocbimv22015513m.g","KQ415945",610191,673212,63021
"24153","Ocbimv22039469m.g","KQ423675",103636,111300,7664
"24154","Ocbimv22036572m.g","KQ422794",41862,55706,13844
"24155","Ocbimv22019156m.g","KQ418723",480096,480296,200
"24156","Ocbimv22037239m.g","KQ422973",30975,32806,1831
"24157","Ocbimv22037375m.g","KQ416694",339277,341203,1926
"24158","Ocbimv22014052m.g","KQ428735",265809,280467,14658
"24159","Ocbimv22017120m.g","KQ418451",278522,278803,281
"24160","Ocbimv22032753m.g","KQ421655",42151,53726,11575
"24161","Ocbimv22010454m.g","KQ417678",74786,113420,38634
"24162","Ocbimv22026663m.g","KQ416196",179127,247094,67967
"24163","Ocbimv22002956m.g","KQ424852",190896,198289,7393
"24164","Ocbimv22034604m.g","KQ422087",16264,61088,44824
"24165","Ocbimv22029187m.g","KQ420673",348637,350592,1955
"24166","Ocbimv22039292m.g","KQ423606",66559,66738,179
"24167","Ocbimv22006600m.g","KQ426027",139204,140001,797
"24168","Ocbimv22026629m.g","KQ420083",2714,3145,431
"24169","Ocbimv22002190m.g","LGKD01129111",277,504,227
"24170","Ocbimv22015885m.g","KQ415948",12073,58416,46343
"24171","Ocbimv22035608m.g","KQ422467",3101,4274,1173
"24172","Ocbimv22038959m.g","KQ423493",985753,988455,2702
"24173","Ocbimv22011344m.g","KQ427731",397,2091,1694
"24174","Ocbimv22030608m.g","KQ416359",902603,903666,1063
"24175","Ocbimv22030348m.g","KQ416344",55530,70911,15381
"24176","Ocbimv22033657m.g","KQ421858",196456,196749,293
"24177","Ocbimv22028457m.g","KQ416258",20159,20443,284
"24178","Ocbimv22024920m.g","KQ419657",649173,650357,1184
"24179","Ocbimv22025641m.g","KQ419869",3866,4174,308
"24180","Ocbimv22002600m.g","KQ424716",22,393,371
"24181","Ocbimv22018589m.g","KQ418644",228471,237263,8792
"24182","Ocbimv22021305m.g","KQ419026",834734,841576,6842
"24183","Ocbimv22010566m.g","KQ417691",423487,431376,7889
"24184","Ocbimv22031213m.g","KQ421200",282515,288877,6362
"24185","Ocbimv22013935m.g","KQ418073",5153,10039,4886
"24186","Ocbimv22010150m.g","KQ427278",140614,140940,326
"24187","Ocbimv22006863m.g","KQ417358",795651,796737,1086
"24188","Ocbimv22008590m.g","KQ417510",441262,447812,6550
"24189","Ocbimv22015283m.g","KQ415941",152292,152738,446
"24190","Ocbimv22007736m.g","KQ426447",7,2860,2853
"24191","Ocbimv22003643m.g","KQ417098",49386,50644,1258
"24192","Ocbimv22026674m.g","KQ416196",652598,654358,1760
"24193","Ocbimv22018532m.g","KQ430737",2114,4357,2243
"24194","Ocbimv22020229m.g","LGKD01658023",16,123,107
"24195","Ocbimv22035658m.g","KQ422493",352667,361442,8775
"24196","Ocbimv22027742m.g","KQ416232",234781,249472,14691
"24197","Ocbimv22004214m.g","KQ425228",130477,130752,275
"24198","Ocbimv22033395m.g","KQ416479",839875,875505,35630
"24199","Ocbimv22002134m.g","KQ415788",593671,595385,1714
"24200","Ocbimv22007869m.g","KQ417455",424943,437601,12658
"24201","Ocbimv22017018m.g","KQ430123",160215,162517,2302
"24202","Ocbimv22032995m.g","KQ421712",2495,2656,161
"24203","Ocbimv22015319m.g","KQ418220",40922,44968,4046
"24204","Ocbimv22010939m.g","KQ417725",477597,484196,6599
"24205","Ocbimv22005272m.g","KQ417238",212,703,491
"24206","Ocbimv22004365m.g","KQ425281",78633,121896,43263
"24207","Ocbimv22033442m.g","KQ421816",295910,297877,1967
"24208","Ocbimv22001924m.g","KQ416974",89215,201161,111946
"24209","Ocbimv22008121m.g","KQ426568",117858,164978,47120
"24210","Ocbimv22039533m.g","KQ423697",58481,58660,179
"24211","Ocbimv22018184m.g","KQ415989",89708,129463,39755
"24212","Ocbimv22018723m.g","KQ418660",112000,117480,5480
"24213","Ocbimv22001823m.g","KQ416966",692344,696271,3927
"24214","Ocbimv22022770m.g","KQ419292",158078,158374,296
"24215","Ocbimv22027240m.g","KQ416215",713941,730755,16814
"24216","Ocbimv22038887m.g","KQ416771",145809,149616,3807
"24217","Ocbimv22029459m.g","KQ420756",19468,71566,52098
"24218","Ocbimv22039198m.g","KQ423574",86606,106811,20205
"24219","Ocbimv22020069m.g","KQ418849",168715,169696,981
"24220","Ocbimv22007088m.g","KQ417377",652271,708747,56476
"24221","Ocbimv22021838m.g","KQ415687",1061853,1076058,14205
"24222","Ocbimv22031805m.g","KQ415726",114441,130484,16043
"24223","Ocbimv22026675m.g","KQ416196",693281,813614,120333
"24224","Ocbimv22018216m.g","KQ415990",1845502,1925331,79829
"24225","Ocbimv22028253m.g","KQ415659",391301,392193,892
"24226","Ocbimv22015819m.g","KQ418295",146238,148013,1775
"24227","Ocbimv22024917m.g","KQ419657",101274,101546,272
"24228","Ocbimv22012666m.g","KQ417924",497977,528033,30056
"24229","Ocbimv22009721m.g","KQ427097",12543,13382,839
"24230","Ocbimv22029574m.g","KQ420777",148445,160167,11722
"24231","Ocbimv22019189m.g","KQ431041",125535,126398,863
"24232","Ocbimv22023654m.g","KQ419455",49115,62432,13317
"24233","Ocbimv22013108m.g","KQ417982",262877,270576,7699
"24234","Ocbimv22021868m.g","KQ419114",93292,151818,58526
"24235","Ocbimv22000328m.g","KQ423926",17900,28803,10903
"24236","Ocbimv22033461m.g","KQ421819",57148,73303,16155
"24237","Ocbimv22022070m.g","KQ432553",18272,19179,907
"24238","Ocbimv22001438m.g","KQ416933",226246,263825,37579
"24239","Ocbimv22031463m.g","KQ416399",243523,261210,17687
"24240","Ocbimv22004410m.g","KQ415804",222510,232805,10295
"24241","Ocbimv22010779m.g","LGKD01582491",8,142,134
"24242","Ocbimv22018061m.g","KQ418561",185637,208370,22733
"24243","Ocbimv22005590m.g","KQ425656",192709,271319,78610
"24244","Ocbimv22035071m.g","KQ422264",6149,6586,437
"24245","Ocbimv22003818m.g","KQ417114",276951,279388,2437
"24246","Ocbimv22005309m.g","KQ425576",256056,256208,152
"24247","Ocbimv22036148m.g","KQ422659",85428,85685,257
"24248","Ocbimv22013651m.g","KQ428583",77526,90310,12784
"24249","Ocbimv22013812m.g","KQ428677",135238,142333,7095
"24250","Ocbimv22038868m.g","KQ416769",752963,753340,377
"24251","Ocbimv22007321m.g","KQ417403",340916,342773,1857
"24252","Ocbimv22014106m.g","KQ418089",1201,5520,4319
"24253","Ocbimv22015405m.g","KQ418240",111197,119941,8744
"24254","Ocbimv22034719m.g","LGKD01430818",2,447,445
"24255","Ocbimv22000177m.g","KQ423884",30226,30509,283
"24256","Ocbimv22010603m.g","KQ417698",91652,115275,23623
"24257","Ocbimv22004596m.g","KQ417182",535845,536609,764
"24258","Ocbimv22005028m.g","KQ417224",302779,304572,1793
"24259","Ocbimv22007247m.g","KQ426259",183208,185595,2387
"24260","Ocbimv22006541m.g","KQ425992",340422,340823,401
"24261","Ocbimv22009963m.g","KQ427186",284,111350,111066
"24262","Ocbimv22034493m.g","KQ422062",193367,246475,53108
"24263","Ocbimv22028009m.g","KQ416243",1132368,1132529,161
"24264","Ocbimv22029642m.g","KQ420795",39582,40458,876
"24265","Ocbimv22009325m.g","KQ415863",283624,283848,224
"24266","Ocbimv22029460m.g","KQ420757",59973,60419,446
"24267","Ocbimv22010092m.g","KQ417641",367022,367807,785
"24268","Ocbimv22004551m.g","KQ425356",49513,50253,740
"24269","Ocbimv22025727m.g","KQ419891",55865,58357,2492
"24270","Ocbimv22012565m.g","KQ417917",1362550,1363482,932
"24271","Ocbimv22019887m.g","KQ418832",289842,334517,44675
"24272","Ocbimv22030605m.g","KQ416359",277898,278300,402
"24273","Ocbimv22000918m.g","KQ424114",66239,86654,20415
"24274","Ocbimv22004159m.g","KQ425220",103770,108341,4571
"24275","Ocbimv22010734m.g","KQ417706",501963,502326,363
"24276","Ocbimv22001818m.g","KQ416965",24733,36750,12017
"24277","Ocbimv22022614m.g","LGKD01680900",1,195,194
"24278","Ocbimv22006441m.g","KQ417319",128886,162071,33185
"24279","Ocbimv22026951m.g","KQ420147",2308,54284,51976
"24280","Ocbimv22037726m.g","KQ423122",28938,29654,716
"24281","Ocbimv22015369m.g","KQ418232",266372,266548,176
"24282","Ocbimv22034532m.g","KQ416536",22204,66478,44274
"24283","Ocbimv22006807m.g","KQ417352",18423,18632,209
"24284","Ocbimv22014498m.g","KQ418142",189257,200876,11619
"24285","Ocbimv22018449m.g","KQ415992",576841,577914,1073
"24286","Ocbimv22028184m.g","KQ420442",8781,40640,31859
"24287","Ocbimv22024241m.g","KQ433876",122794,122961,167
"24288","Ocbimv22016206m.g","KQ415958",235213,236949,1736
"24289","Ocbimv22006038m.g","KQ425792",25666,25890,224
"24290","Ocbimv22001730m.g","KQ424397",104,283,179
"24291","Ocbimv22031665m.g","KQ421308",6736,28267,21531
"24292","Ocbimv22034700m.g","KQ416547",134984,141127,6143
"24293","Ocbimv22006924m.g","KQ417363",59578,59816,238
"24294","Ocbimv22038399m.g","KQ423319",27,2334,2307
"24295","Ocbimv22038217m.g","KQ416731",642513,645965,3452
"24296","Ocbimv22023357m.g","KQ419395",192630,196200,3570
"24297","Ocbimv22015725m.g","KQ418281",208953,209210,257
"24298","Ocbimv22029491m.g","KQ420761",580621,580812,191
"24299","Ocbimv22007513m.g","KQ426358",38410,38601,191
"24300","Ocbimv22017445m.g","KQ418496",519219,519485,266
"24301","Ocbimv22020085m.g","KQ431445",604,4873,4269
"24302","Ocbimv22019995m.g","KQ418840",1687199,1722059,34860
"24303","Ocbimv22004313m.g","KQ417147",1515727,1516440,713
"24304","Ocbimv22036856m.g","KQ416662",85195,85780,585
"24305","Ocbimv22030679m.g","KQ421059",205492,206010,518
"24306","Ocbimv22019904m.g","KQ418833",435312,435955,643
"24307","Ocbimv22008342m.g","KQ417497",1778389,1814731,36342
"24308","Ocbimv22012137m.g","KQ415902",351109,366228,15119
"24309","Ocbimv22011452m.g","KQ427753",16882,17322,440
"24310","Ocbimv22018333m.g","KQ430665",53150,57249,4099
"24311","Ocbimv22038901m.g","KQ416771",853176,853376,200
"24312","Ocbimv22030751m.g","KQ421083",486012,509140,23128
"24313","Ocbimv22035413m.g","KQ422369",8537,9866,1329
"24314","Ocbimv22015179m.g","LGKD01225403",8,379,371
"24315","Ocbimv22019259m.g","KQ418739",158415,198364,39949
"24316","Ocbimv22019160m.g","KQ431024",12106,12644,538
"24317","Ocbimv22035735m.g","KQ422521",356267,356893,626
"24318","Ocbimv22000697m.g","KQ416877",10410,10944,534
"24319","Ocbimv22007718m.g","KQ417446",193970,208161,14191
"24320","Ocbimv22019004m.g","KQ418710",714569,714820,251
"24321","Ocbimv22005604m.g","KQ425671",38162,39853,1691
"24322","Ocbimv22027739m.g","KQ416232",42873,54157,11284
"24323","Ocbimv22019094m.g","KQ430963",163143,170956,7813
"24324","Ocbimv22010410m.g","KQ417676",916346,918144,1798
"24325","Ocbimv22007767m.g","KQ415847",1009448,1024343,14895
"24326","Ocbimv22010130m.g","KQ427271",20108,22762,2654
"24327","Ocbimv22005363m.g","KQ425596",333301,367229,33928
"24328","Ocbimv22017261m.g","KQ430232",12891,44022,31131
"24329","Ocbimv22000710m.g","KQ416877",421204,471278,50074
"24330","Ocbimv22020013m.g","KQ431395",22773,27330,4557
"24331","Ocbimv22022116m.g","LGKD01675608",52,306,254
"24332","Ocbimv22039850m.g","KQ423780",339961,341721,1760
"24333","Ocbimv22039246m.g","KQ423592",14315,15403,1088
"24334","Ocbimv22011726m.g","KQ417827",17736,32838,15102
"24335","Ocbimv22021382m.g","LGKD01667410",2,280,278
"24336","Ocbimv22024910m.g","KQ416131",822694,831361,8667
"24337","Ocbimv22027724m.g","KQ420347",382958,383523,565
"24338","Ocbimv22001978m.g","KQ415787",604907,605176,269
"24339","Ocbimv22009759m.g","KQ417611",170583,171918,1335
"24340","Ocbimv22036043m.g","KQ422636",110786,123244,12458
"24341","Ocbimv22036757m.g","KQ416656",6295,7233,938
"24342","Ocbimv22008259m.g","KQ417492",229461,255012,25551
"24343","Ocbimv22022148m.g","KQ419176",234951,240402,5451
"24344","Ocbimv22011494m.g","KQ427766",30043,31241,1198
"24345","Ocbimv22029377m.g","KQ420735",1599,1766,167
"24346","Ocbimv22007342m.g","KQ415841",19527,20903,1376
"24347","Ocbimv22009818m.g","KQ417620",192186,247479,55293
"24348","Ocbimv22003598m.g","KQ425041",86674,86943,269
"24349","Ocbimv22017782m.g","KQ430473",78481,110944,32463
"24350","Ocbimv22008331m.g","KQ417497",863085,904681,41596
"24351","Ocbimv22023227m.g","KQ419376",668670,670041,1371
"24352","Ocbimv22025109m.g","KQ419694",134419,138079,3660
"24353","Ocbimv22004700m.g","KQ417198",387573,388481,908
"24354","Ocbimv22023672m.g","KQ419458",100185,100379,194
"24355","Ocbimv22011381m.g","KQ417791",572167,572526,359
"24356","Ocbimv22002982m.g","KQ424855",59012,59206,194
"24357","Ocbimv22017264m.g","KQ430232",100470,101673,1203
"24358","Ocbimv22034323m.g","KQ422016",51466,53202,1736
"24359","Ocbimv22028215m.g","KQ420444",440431,440695,264
"24360","Ocbimv22020134m.g","KQ418859",196929,239574,42645
"24361","Ocbimv22025255m.g","KQ419748",509843,510467,624
"24362","Ocbimv22015246m.g","KQ418215",37602,46177,8575
"24363","Ocbimv22008246m.g","KQ426602",84998,138544,53546
"24364","Ocbimv22003089m.g","KQ424877",511754,611998,100244
"24365","Ocbimv22033341m.g","KQ421785",193826,194462,636
"24366","Ocbimv22004269m.g","KQ425253",37663,37860,197
"24367","Ocbimv22029493m.g","KQ416310",84631,137849,53218
"24368","Ocbimv22002786m.g","KQ424780",1975,2226,251
"24369","Ocbimv22012637m.g","KQ428192",64573,77182,12609
"24370","Ocbimv22004637m.g","KQ417191",6711,10547,3836
"24371","Ocbimv22002799m.g","KQ417037",211872,214671,2799
"24372","Ocbimv22025179m.g","KQ419721",574174,574449,275
"24373","Ocbimv22022977m.g","KQ419333",49333,53489,4156
"24374","Ocbimv22000206m.g","KQ423898",68075,83543,15468
"24375","Ocbimv22034482m.g","KQ422055",117530,117821,291
"24376","Ocbimv22026784m.g","KQ420117",126426,127452,1026
"24377","Ocbimv22028926m.g","KQ416274",2066087,2074922,8835
"24378","Ocbimv22012967m.g","KQ417963",140328,141388,1060
"24379","Ocbimv22022051m.g","KQ419154",418383,418586,203
"24380","Ocbimv22039433m.g","KQ423659",168662,171627,2965
"24381","Ocbimv22015671m.g","KQ429463",49697,49970,273
"24382","Ocbimv22015109m.g","KQ418195",17151,17396,245
"24383","Ocbimv22030525m.g","KQ421009",1982843,1983097,254
"24384","Ocbimv22007552m.g","KQ417423",160787,161095,308
"24385","Ocbimv22036959m.g","KQ416666",1806812,1824820,18008
"24386","Ocbimv22008449m.g","KQ415854",114263,173869,59606
"24387","Ocbimv22035286m.g","KQ422349",178718,192709,13991
"24388","Ocbimv22020346m.g","KQ418899",7513,7791,278
"24389","Ocbimv22031525m.g","KQ421265",217444,220630,3186
"24390","Ocbimv22018343m.g","KQ418609",769995,771113,1118
"24391","Ocbimv22037435m.g","KQ423023",88722,91401,2679
"24392","Ocbimv22017067m.g","KQ430152",61963,115467,53504
"24393","Ocbimv22003246m.g","KQ417068",550714,550908,194
"24394","Ocbimv22036845m.g","KQ422875",29633,55445,25812
"24395","Ocbimv22007307m.g","KQ426287",260583,272251,11668
"24396","Ocbimv22007155m.g","KQ426216",22091,24907,2816
"24397","Ocbimv22038497m.g","KQ423378",56129,70408,14279
"24398","Ocbimv22020174m.g","KQ431508",1777,11142,9365
"24399","Ocbimv22018875m.g","KQ418693",601675,613503,11828
"24400","Ocbimv22039514m.g","KQ423680",262701,264954,2253
"24401","Ocbimv22025367m.g","KQ419781",219397,231541,12144
"24402","Ocbimv22012782m.g","KQ428240",24781,24984,203
"24403","Ocbimv22004497m.g","KQ417173",796530,796934,404
"24404","Ocbimv22005254m.g","KQ417236",29193,37731,8538
"24405","Ocbimv22009993m.g","KQ427201",60995,61867,872
"24406","Ocbimv22038914m.g","KQ423490",2,9477,9475
"24407","Ocbimv22039582m.g","KQ423712",138516,139920,1404
"24408","Ocbimv22013044m.g","KQ415671",53744,164364,110620
"24409","Ocbimv22023068m.g","KQ433194",163572,166396,2824
"24410","Ocbimv22022637m.g","KQ432934",14782,15670,888
"24411","Ocbimv22020871m.g","KQ418971",341360,341755,395
"24412","Ocbimv22021299m.g","KQ419026",290403,291308,905
"24413","Ocbimv22006999m.g","KQ417370",146043,164580,18537
"24414","Ocbimv22013647m.g","KQ418042",295745,330683,34938
"24415","Ocbimv22038826m.g","KQ423478",442911,443278,367
"24416","Ocbimv22011093m.g","KQ417747",305806,334682,28876
"24417","Ocbimv22011135m.g","KQ427653",63910,69298,5388
"24418","Ocbimv22014611m.g","KQ429012",241,441,200
"24419","Ocbimv22028549m.g","KQ416260",705452,705751,299
"24420","Ocbimv22036832m.g","KQ422867",57269,57499,230
"24421","Ocbimv22020233m.g","KQ431549",12639,14060,1421
"24422","Ocbimv22029343m.g","KQ420714",86974,107463,20489
"24423","Ocbimv22011644m.g","KQ427830",140883,141158,275
"24424","Ocbimv22025141m.g","KQ419706",179153,187831,8678
"24425","Ocbimv22001065m.g","KQ424172",75452,75911,459
"24426","Ocbimv22038042m.g","KQ416721",16686,27511,10825
"24427","Ocbimv22024872m.g","KQ419644",50744,62445,11701
"24428","Ocbimv22021700m.g","KQ432284",256201,256743,542
"24429","Ocbimv22036047m.g","KQ422636",125958,126224,266
"24430","Ocbimv22034153m.g","KQ421988",96089,169710,73621
"24431","Ocbimv22014802m.g","KQ418180",7257,7911,654
"24432","Ocbimv22037916m.g","KQ423167",56460,58918,2458
"24433","Ocbimv22001179m.g","KQ424217",67359,69292,1933
"24434","Ocbimv22002571m.g","KQ415794",14882,16100,1218
"24435","Ocbimv22029426m.g","KQ420747",618021,619479,1458
"24436","Ocbimv22021243m.g","KQ419018",667598,669315,1717
"24437","Ocbimv22006929m.g","KQ426154",30065,30331,266
"24438","Ocbimv22006488m.g","KQ425942",76605,89919,13314
"24439","Ocbimv22035568m.g","KQ422438",163755,165445,1690
"24440","Ocbimv22010585m.g","KQ427440",7095,59767,52672
"24441","Ocbimv22010718m.g","KQ427478",30951,36384,5433
"24442","Ocbimv22012865m.g","KQ417945",1042702,1043616,914
"24443","Ocbimv22025889m.g","KQ416175",569968,572127,2159
"24444","Ocbimv22012857m.g","KQ417945",796051,815421,19370
"24445","Ocbimv22030195m.g","KQ420921",67713,68666,953
"24446","Ocbimv22024627m.g","KQ419605",200730,211570,10840
"24447","Ocbimv22036992m.g","KQ422903",4647,8195,3548
"24448","Ocbimv22019247m.g","KQ431067",25895,28575,2680
"24449","Ocbimv22038778m.g","KQ416765",882774,915094,32320
"24450","Ocbimv22035948m.g","KQ416612",1351969,1420795,68826
"24451","Ocbimv22002515m.g","KQ417012",207037,212667,5630
"24452","Ocbimv22022090m.g","KQ432556",205155,205959,804
"24453","Ocbimv22000446m.g","KQ423968",63838,123226,59388
"24454","Ocbimv22007467m.g","KQ426355",7791,11871,4080
"24455","Ocbimv22023472m.g","KQ433417",1514,21883,20369
"24456","Ocbimv22031535m.g","KQ421269",20427,20630,203
"24457","Ocbimv22029310m.g","KQ420707",48368,48628,260
"24458","Ocbimv22010019m.g","KQ427207",62646,73133,10487
"24459","Ocbimv22025119m.g","KQ419696",52336,52891,555
"24460","Ocbimv22012080m.g","KQ428013",95446,99448,4002
"24461","Ocbimv22015744m.g","KQ418289",4784,26959,22175
"24462","Ocbimv22009576m.g","KQ427029",81575,81730,155
"24463","Ocbimv22005874m.g","KQ417280",365097,367609,2512
"24464","Ocbimv22000627m.g","KQ416870",197595,199480,1885
"24465","Ocbimv22009598m.g","KQ427045",96971,97465,494
"24466","Ocbimv22030638m.g","KQ421039",426287,439209,12922
"24467","Ocbimv22016351m.g","KQ415679",377902,405028,27126
"24468","Ocbimv22023412m.g","KQ419402",385570,399589,14019
"24469","Ocbimv22000414m.g","KQ423958",281178,281745,567
"24470","Ocbimv22025839m.g","KQ416171",516010,516228,218
"24471","Ocbimv22038742m.g","KQ416764",333561,358419,24858
"24472","Ocbimv22003465m.g","KQ425015",389354,391523,2169
"24473","Ocbimv22039572m.g","KQ423703",316445,320371,3926
"24474","Ocbimv22010938m.g","KQ417725",462999,465648,2649
"24475","Ocbimv22010362m.g","KQ417674",80087,81736,1649
"24476","Ocbimv22037625m.g","KQ415761",527658,528305,647
"24477","Ocbimv22022105m.g","KQ419165",4415,5275,860
"24478","Ocbimv22020474m.g","KQ418919",72269,73423,1154
"24479","Ocbimv22000353m.g","KQ423935",87379,95073,7694
"24480","Ocbimv22014357m.g","KQ418120",761530,761790,260
"24481","Ocbimv22033718m.g","KQ416494",10323,40985,30662
"24482","Ocbimv22036998m.g","KQ422903",143874,185204,41330
"24483","Ocbimv22013292m.g","KQ418007",493291,531180,37889
"24484","Ocbimv22011174m.g","KQ417756",142067,144126,2059
"24485","Ocbimv22011007m.g","KQ427587",124407,124986,579
"24486","Ocbimv22013537m.g","KQ428555",133,30789,30656
"24487","Ocbimv22013396m.g","KQ418018",1307719,1308935,1216
"24488","Ocbimv22015169m.g","KQ418202",73776,105954,32178
"24489","Ocbimv22003126m.g","KQ424891",7035,91434,84399
"24490","Ocbimv22008421m.g","KQ426635",12700,13357,657
"24491","Ocbimv22027681m.g","KQ420338",298,1230,932
"24492","Ocbimv22022012m.g","KQ432511",37846,42314,4468
"24493","Ocbimv22010548m.g","KQ427434",26444,144427,117983
"24494","Ocbimv22034691m.g","KQ416547",77820,78719,899
"24495","Ocbimv22019400m.g","KQ418760",240255,240886,631
"24496","Ocbimv22000358m.g","KQ423941",9870,17225,7355
"24497","Ocbimv22011711m.g","KQ417824",582076,582249,173
"24498","Ocbimv22030926m.g","KQ421118",19900,32210,12310
"24499","Ocbimv22004589m.g","KQ417182",50150,103932,53782
"24500","Ocbimv22025191m.g","KQ419727",123323,123894,571
"24501","Ocbimv22022888m.g","KQ433098",2319,11781,9462
"24502","Ocbimv22013442m.g","KQ428507",187699,189280,1581
"24503","Ocbimv22039269m.g","KQ423600",38127,240600,202473
"24504","Ocbimv22001618m.g","KQ416949",387178,387414,236
"24505","Ocbimv22004399m.g","KQ417158",314987,315727,740
"24506","Ocbimv22006818m.g","KQ417356",1627,6003,4376
"24507","Ocbimv22004656m.g","KQ417194",29792,31409,1617
"24508","Ocbimv22037016m.g","KQ422908",91706,91923,217
"24509","Ocbimv22000197m.g","KQ423891",79846,93670,13824
"24510","Ocbimv22000072m.g","KQ423846",367364,367555,191
"24511","Ocbimv22015128m.g","KQ418196",419991,420554,563
"24512","Ocbimv22012003m.g","KQ417853",123473,124379,906
"24513","Ocbimv22035040m.g","KQ415746",9239,11204,1965
"24514","Ocbimv22016662m.g","KQ418376",51996,58354,6358
"24515","Ocbimv22029568m.g","KQ420776",903300,943000,39700
"24516","Ocbimv22026522m.g","KQ415698",262990,265095,2105
"24517","Ocbimv22017877m.g","KQ418552",706939,707555,616
"24518","Ocbimv22025698m.g","KQ419887",71948,111547,39599
"24519","Ocbimv22012381m.g","KQ417908",66230,67396,1166
"24520","Ocbimv22000759m.g","KQ424061",116516,121885,5369
"24521","Ocbimv22026523m.g","KQ415698",361973,365295,3322
"24522","Ocbimv22028167m.g","KQ420439",313700,337042,23342
"24523","Ocbimv22006526m.g","KQ417333",382752,382916,164
"24524","Ocbimv22034309m.g","KQ422015",1258174,1313760,55586
"24525","Ocbimv22022836m.g","LGKD01683067",12,152,140
"24526","Ocbimv22023635m.g","KQ419448",166972,189465,22493
"24527","Ocbimv22037841m.g","KQ423139",485281,487070,1789
"24528","Ocbimv22025871m.g","KQ419917",432470,433051,581
"24529","Ocbimv22023415m.g","KQ433360",62781,63131,350
"24530","Ocbimv22027132m.g","KQ415701",13329,15311,1982
"24531","Ocbimv22021541m.g","KQ419073",52248,151755,99507
"24532","Ocbimv22008057m.g","KQ426556",2011,129555,127544
"24533","Ocbimv22035051m.g","KQ422261",60332,67644,7312
"24534","Ocbimv22023476m.g","KQ433417",213622,241711,28089
"24535","Ocbimv22031762m.g","KQ416404",275344,276598,1254
"24536","Ocbimv22027563m.g","KQ420306",381842,382473,631
"24537","Ocbimv22004698m.g","KQ417198",310581,314017,3436
"24538","Ocbimv22012023m.g","KQ427973",190645,207204,16559
"24539","Ocbimv22023160m.g","KQ419366",25815,26857,1042
"24540","Ocbimv22019359m.g","KQ418755",102415,136235,33820
"24541","Ocbimv22036011m.g","KQ422632",239236,239559,323
"24542","Ocbimv22032295m.g","KQ421514",537703,550118,12415
"24543","Ocbimv22018149m.g","KQ418577",192329,192497,168
"24544","Ocbimv22005634m.g","KQ425692",206460,207014,554
"24545","Ocbimv22034122m.g","KQ421984",7150,9842,2692
"24546","Ocbimv22018309m.g","KQ418600",358232,358696,464
"24547","Ocbimv22022338m.g","KQ419201",121215,122201,986
"24548","Ocbimv22021811m.g","KQ432338",1786,2141,355
"24549","Ocbimv22028861m.g","KQ420593",611612,625464,13852
"24550","Ocbimv22030549m.g","KQ416354",57557,57829,272
"24551","Ocbimv22031848m.g","KQ421357",39221,39652,431
"24552","Ocbimv22002445m.g","KQ424659",73074,111766,38692
"24553","Ocbimv22018042m.g","KQ430530",6219,9698,3479
"24554","Ocbimv22018370m.g","KQ418610",200842,201150,308
"24555","Ocbimv22015547m.g","KQ429416",28202,70332,42130
"24556","Ocbimv22037655m.g","KQ416705",1127571,1129949,2378
"24557","Ocbimv22033952m.g","KQ416501",56530,76020,19490
"24558","Ocbimv22029496m.g","KQ420765",23249,25175,1926
"24559","Ocbimv22024063m.g","KQ433779",12552,70290,57738
"24560","Ocbimv22007082m.g","KQ417377",444020,453180,9160
"24561","Ocbimv22025805m.g","KQ419907",71851,72320,469
"24562","Ocbimv22020449m.g","KQ431697",24,402,378
"24563","Ocbimv22011343m.g","KQ427727",87568,87792,224
"24564","Ocbimv22006021m.g","LGKD01542102",20,599,579
"24565","Ocbimv22014953m.g","KQ418188",36869,37054,185
"24566","Ocbimv22008468m.g","KQ415854",492436,513382,20946
"24567","Ocbimv22012688m.g","KQ417926",124057,124326,269
"24568","Ocbimv22034314m.g","KQ422015",1365135,1393255,28120
"24569","Ocbimv22022826m.g","KQ419303",13788,14072,284
"24570","Ocbimv22035918m.g","KQ416609",11453,13841,2388
"24571","Ocbimv22004462m.g","KQ425320",193697,202401,8704
"24572","Ocbimv22025921m.g","KQ419927",1398298,1399732,1434
"24573","Ocbimv22028140m.g","KQ416251",1275266,1275718,452
"24574","Ocbimv22006637m.g","KQ426043",262218,262379,161
"24575","Ocbimv22028605m.g","KQ416263",781139,787504,6365
"24576","Ocbimv22014725m.g","KQ429045",428,1013,585
"24577","Ocbimv22003587m.g","KQ417094",32466,48053,15587
"24578","Ocbimv22020787m.g","KQ418964",1075462,1089628,14166
"24579","Ocbimv22014504m.g","KQ418145",96835,109945,13110
"24580","Ocbimv22019902m.g","KQ418833",286376,286609,233
"24581","Ocbimv22012103m.g","KQ428041",34550,50113,15563
"24582","Ocbimv22001808m.g","KQ424426",4674,5081,407
"24583","Ocbimv22032875m.g","KQ416454",191054,205256,14202
"24584","Ocbimv22003307m.g","KQ417078",272123,275391,3268
"24585","Ocbimv22035505m.g","KQ422411",499994,527755,27761
"24586","Ocbimv22013803m.g","KQ418061",380376,507803,127427
"24587","Ocbimv22029445m.g","KQ416306",1906520,1909053,2533
"24588","Ocbimv22028562m.g","KQ420522",74313,176883,102570
"24589","Ocbimv22005612m.g","KQ425677",235995,236153,158
"24590","Ocbimv22014874m.g","KQ415936",85656,86066,410
"24591","Ocbimv22020455m.g","KQ416029",55784,56999,1215
"24592","Ocbimv22007184m.g","KQ426226",38221,41544,3323
"24593","Ocbimv22011942m.g","KQ417847",986875,987054,179
"24594","Ocbimv22006431m.g","KQ425921",19315,21198,1883
"24595","Ocbimv22010714m.g","KQ427476",43675,43911,236
"24596","Ocbimv22039554m.g","KQ416802",432336,433264,928
"24597","Ocbimv22031152m.g","KQ421177",21144,22300,1156
"24598","Ocbimv22007409m.g","KQ417412",147121,199742,52621
"24599","Ocbimv22004654m.g","KQ417194",22416,26661,4245
"24600","Ocbimv22003632m.g","KQ417097",11892,14707,2815
"24601","Ocbimv22003258m.g","KQ424925",15349,17054,1705
"24602","Ocbimv22012163m.g","KQ417878",407419,407637,218
"24603","Ocbimv22004571m.g","KQ425362",65910,66829,919
"24604","Ocbimv22013356m.g","KQ428462",8148,29102,20954
"24605","Ocbimv22038159m.g","KQ423221",97190,97504,314
"24606","Ocbimv22036129m.g","KQ422647",211657,216559,4902
"24607","Ocbimv22017817m.g","KQ418549",717987,718995,1008
"24608","Ocbimv22018290m.g","KQ418594",239602,252355,12753
"24609","Ocbimv22022531m.g","KQ419241",410596,412320,1724
"24610","Ocbimv22026751m.g","KQ420109",35329,36716,1387
"24611","Ocbimv22029137m.g","KQ420662",467941,468288,347
"24612","Ocbimv22026650m.g","KQ420085",382037,382720,683
"24613","Ocbimv22021277m.g","KQ416041",660602,667596,6994
"24614","Ocbimv22005639m.g","KQ425692",246324,252299,5975
"24615","Ocbimv22026841m.g","KQ420126",581247,604194,22947
"24616","Ocbimv22023786m.g","KQ416096",1523167,1526522,3355
"24617","Ocbimv22001488m.g","KQ424321",75097,76647,1550
"24618","Ocbimv22011320m.g","KQ417780",436499,459592,23093
"24619","Ocbimv22030823m.g","KQ416371",1127658,1129795,2137
"24620","Ocbimv22006266m.g","KQ417305",600756,608590,7834
"24621","Ocbimv22036667m.g","KQ422824",53856,64287,10431
"24622","Ocbimv22029904m.g","KQ420841",53834,57576,3742
"24623","Ocbimv22021818m.g","KQ432350",1337,15116,13779
"24624","Ocbimv22030213m.g","KQ420924",247980,248375,395
"24625","Ocbimv22018780m.g","KQ418673",149654,150596,942
"24626","Ocbimv22031482m.g","KQ421259",47633,47935,302
"24627","Ocbimv22005502m.g","KQ425633",54751,60251,5500
"24628","Ocbimv22019078m.g","KQ418715",111907,134454,22547
"24629","Ocbimv22033543m.g","KQ416484",93485,95650,2165
"24630","Ocbimv22033225m.g","KQ421758",259750,261489,1739
"24631","Ocbimv22015272m.g","LGKD01616404",7969,8271,302
"24632","Ocbimv22002495m.g","KQ424672",33609,65252,31643
"24633","Ocbimv22021476m.g","KQ432165",3887,4212,325
"24634","Ocbimv22022898m.g","KQ433121",1584,11541,9957
"24635","Ocbimv22016039m.g","KQ418312",341781,342575,794
"24636","Ocbimv22006047m.g","KQ417292",66014,77041,11027
"24637","Ocbimv22005167m.g","KQ425537",195692,202483,6791
"24638","Ocbimv22027803m.g","KQ416233",622471,638421,15950
"24639","Ocbimv22023866m.g","KQ419490",17974,28683,10709
"24640","Ocbimv22028643m.g","KQ420543",27514,27678,164
"24641","Ocbimv22012940m.g","KQ428307",37195,38072,877
"24642","Ocbimv22010529m.g","KQ417687",1186463,1186723,260
"24643","Ocbimv22020557m.g","KQ418924",111443,118673,7230
"24644","Ocbimv22013025m.g","KQ417975",958374,960444,2070
"24645","Ocbimv22019726m.g","KQ431280",117347,135601,18254
"24646","Ocbimv22021408m.g","KQ416044",93275,93647,372
"24647","Ocbimv22020123m.g","LGKD01656694",50,433,383
"24648","Ocbimv22026837m.g","KQ420126",434626,445163,10537
"24649","Ocbimv22025216m.g","KQ419737",68090,71355,3265
"24650","Ocbimv22027183m.g","KQ416213",235222,242853,7631
"24651","Ocbimv22010223m.g","KQ417658",697,12453,11756
"24652","Ocbimv22011615m.g","KQ427814",316,2765,2449
"24653","Ocbimv22036717m.g","KQ416654",473703,475082,1379
"24654","Ocbimv22003910m.g","KQ417122",2800,59409,56609
"24655","Ocbimv22037365m.g","KQ423019",2722,5628,2906
"24656","Ocbimv22013301m.g","KQ428442",2147,2463,316
"24657","Ocbimv22015691m.g","KQ418276",84117,97539,13422
"24658","Ocbimv22003761m.g","LGKD01524253",1733,10666,8933
"24659","Ocbimv22033366m.g","KQ421800",96551,115731,19180
"24660","Ocbimv22031419m.g","KQ421236",122309,147038,24729
"24661","Ocbimv22019527m.g","KQ416015",343953,344204,251
"24662","Ocbimv22016630m.g","KQ415967",475470,475682,212
"24663","Ocbimv22013098m.g","KQ417981",651630,651893,263
"24664","Ocbimv22026304m.g","KQ420023",448287,453567,5280
"24665","Ocbimv22031454m.g","KQ421256",235,630,395
"24666","Ocbimv22017384m.g","KQ430272",294396,314094,19698
"24667","Ocbimv22011096m.g","KQ417747",439042,444131,5089
"24668","Ocbimv22018496m.g","LGKD01250489",435,1562,1127
"24669","Ocbimv22004122m.g","KQ425206",72885,154047,81162
"24670","Ocbimv22009936m.g","KQ417623",590862,591329,467
"24671","Ocbimv22036297m.g","KQ416631",61414,117066,55652
"24672","Ocbimv22016128m.g","KQ418320",708744,709292,548
"24673","Ocbimv22005983m.g","KQ417288",319348,361519,42171
"24674","Ocbimv22028752m.g","KQ420579",70713,71102,389
"24675","Ocbimv22024812m.g","KQ419631",591741,603983,12242
"24676","Ocbimv22020632m.g","KQ418945",227485,227643,158
"24677","Ocbimv22028841m.g","KQ420592",183034,183357,323
"24678","Ocbimv22012114m.g","KQ417874",574576,575922,1346
"24679","Ocbimv22039838m.g","KQ416831",3971,13055,9084
"24680","Ocbimv22015457m.g","KQ418253",20498,20650,152
"24681","Ocbimv22026729m.g","KQ416198",160326,170407,10081
"24682","Ocbimv22016071m.g","KQ429691",1651,9663,8012
"24683","Ocbimv22010914m.g","KQ417724",733338,733508,170
"24684","Ocbimv22005627m.g","KQ425692",13920,30419,16499
"24685","Ocbimv22000793m.g","KQ424068",94091,170950,76859
"24686","Ocbimv22018698m.g","KQ430806",35009,35458,449
"24687","Ocbimv22008436m.g","KQ426637",68074,68882,808
"24688","Ocbimv22010379m.g","KQ415876",548123,548755,632
"24689","Ocbimv22030954m.g","KQ421133",2056,2343,287
"24690","Ocbimv22021495m.g","KQ432183",23579,25246,1667
"24691","Ocbimv22021659m.g","KQ416049",215075,222464,7389
"24692","Ocbimv22016443m.g","KQ418355",463473,464061,588
"24693","Ocbimv22015142m.g","KQ418200",127394,150482,23088
"24694","Ocbimv22018685m.g","KQ415996",170820,171385,565
"24695","Ocbimv22012684m.g","KQ417925",71225,74635,3410
"24696","Ocbimv22015334m.g","KQ429275",12251,12514,263
"24697","Ocbimv22029215m.g","KQ420679",69339,145220,75881
"24698","Ocbimv22032625m.g","KQ421611",64503,64787,284
"24699","Ocbimv22035708m.g","KQ416599",155889,156119,230
"24700","Ocbimv22022623m.g","KQ432932",9874,16377,6503
"24701","Ocbimv22033161m.g","KQ421737",513159,552530,39371
"24702","Ocbimv22026323m.g","KQ420026",200849,203334,2485
"24703","Ocbimv22019157m.g","KQ431024",567,1448,881
"24704","Ocbimv22003554m.g","KQ417090",1783552,1784452,900
"24705","Ocbimv22009800m.g","KQ417617",91632,92108,476
"24706","Ocbimv22010845m.g","KQ417719",262061,339854,77793
"24707","Ocbimv22038853m.g","KQ415768",406199,406759,560
"24708","Ocbimv22006958m.g","KQ417367",243727,244795,1068
"24709","Ocbimv22012687m.g","KQ428201",1,1936,1935
"24710","Ocbimv22029603m.g","KQ420780",15873,63259,47386
"24711","Ocbimv22018765m.g","KQ418671",14726,20139,5413
"24712","Ocbimv22009177m.g","KQ426911",17249,36035,18786
"24713","Ocbimv22009764m.g","KQ417611",534139,535128,989
"24714","Ocbimv22013535m.g","KQ428554",44847,46502,1655
"24715","Ocbimv22014172m.g","KQ418098",43872,53567,9695
"24716","Ocbimv22027110m.g","KQ420185",249039,249599,560
"24717","Ocbimv22030178m.g","KQ416337",196360,196619,259
"24718","Ocbimv22016608m.g","KQ418370",136559,176266,39707
"24719","Ocbimv22022360m.g","KQ419205",7258,96216,88958
"24720","Ocbimv22027855m.g","KQ420378",957,9962,9005
"24721","Ocbimv22025244m.g","KQ419743",452444,452785,341
"24722","Ocbimv22004892m.g","KQ425467",19561,24951,5390
"24723","Ocbimv22006944m.g","KQ426160",59594,60763,1169
"24724","Ocbimv22037163m.g","KQ422943",79053,79274,221
"24725","Ocbimv22032953m.g","KQ421694",22440,27389,4949
"24726","Ocbimv22003836m.g","KQ425128",419487,443881,24394
"24727","Ocbimv22032341m.g","KQ421523",1044862,1090607,45745
"24728","Ocbimv22002532m.g","KQ424678",112650,118677,6027
"24729","Ocbimv22037811m.g","KQ423139",106028,208326,102298
"24730","Ocbimv22030162m.g","KQ416336",90105,91335,1230
"24731","Ocbimv22010899m.g","KQ427563",107898,129502,21604
"24732","Ocbimv22002477m.g","KQ417010",520623,521829,1206
"24733","Ocbimv22020645m.g","KQ418945",869353,874849,5496
"24734","Ocbimv22000144m.g","KQ423870",28203,31653,3450
"24735","Ocbimv22028904m.g","KQ416274",1115773,1128257,12484
"24736","Ocbimv22036279m.g","KQ416628",1086346,1163185,76839
"24737","Ocbimv22029420m.g","KQ415710",19035,25359,6324
"24738","Ocbimv22018332m.g","KQ418608",77667,78287,620
"24739","Ocbimv22004230m.g","KQ417143",69795,70126,331
"24740","Ocbimv22000093m.g","KQ416839",188935,203709,14774
"24741","Ocbimv22006132m.g","KQ417300",453364,471997,18633
"24742","Ocbimv22039369m.g","KQ423634",11561,22133,10572
"24743","Ocbimv22029674m.g","KQ420799",341158,371475,30317
"24744","Ocbimv22035732m.g","KQ422521",335777,350090,14313
"24745","Ocbimv22034473m.g","KQ416534",559927,560600,673
"24746","Ocbimv22003985m.g","KQ425165",242630,242896,266
"24747","Ocbimv22031706m.g","KQ421325",402,1864,1462
"24748","Ocbimv22000105m.g","LGKD01116824",240,1074,834
"24749","Ocbimv22025479m.g","KQ419817",56865,57588,723
"24750","Ocbimv22031650m.g","KQ421305",516252,517352,1100
"24751","Ocbimv22017405m.g","KQ418493",4426,17200,12774
"24752","Ocbimv22002890m.g","KQ424814",488531,501331,12800
"24753","Ocbimv22028697m.g","KQ420558",9483,11190,1707
"24754","Ocbimv22022814m.g","KQ433029",69577,78482,8905
"24755","Ocbimv22022712m.g","KQ432975",131808,199468,67660
"24756","Ocbimv22036041m.g","KQ416614",1007522,1057076,49554
"24757","Ocbimv22025484m.g","KQ419818",5159,5679,520
"24758","Ocbimv22023365m.g","KQ419395",253189,257989,4800
"24759","Ocbimv22022797m.g","KQ416075",152978,153178,200
"24760","Ocbimv22018980m.g","KQ418705",107122,107298,176
"24761","Ocbimv22021353m.g","KQ416042",1774923,1775621,698
"24762","Ocbimv22027172m.g","KQ420208",184116,211695,27579
"24763","Ocbimv22003101m.g","KQ415796",376025,378756,2731
"24764","Ocbimv22024979m.g","KQ419670",462760,464548,1788
"24765","Ocbimv22009552m.g","KQ415865",1696990,1740157,43167
"24766","Ocbimv22009878m.g","KQ417621",295810,323652,27842
"24767","Ocbimv22022241m.g","KQ416063",32780,33156,376
"24768","Ocbimv22011787m.g","KQ417832",702102,702660,558
"24769","Ocbimv22036723m.g","KQ416655",105516,106096,580
"24770","Ocbimv22028455m.g","LGKD01356380",3,371,368
"24771","Ocbimv22007369m.g","KQ426313",254206,288402,34196
"24772","Ocbimv22018349m.g","KQ418610",204,11134,10930
"24773","Ocbimv22031941m.g","KQ415727",87264,87722,458
"24774","Ocbimv22017807m.g","KQ418549",153392,154701,1309
"24775","Ocbimv22010472m.g","KQ417681",126104,138705,12601
"24776","Ocbimv22012437m.g","KQ417911",921299,923162,1863
"24777","Ocbimv22032636m.g","KQ421623",10882,13820,2938
"24778","Ocbimv22024558m.g","KQ434050",2516,2860,344
"24779","Ocbimv22006982m.g","KQ417370",14372,17390,3018
"24780","Ocbimv22005275m.g","KQ417238",42539,42982,443
"24781","Ocbimv22031305m.g","KQ421217",780059,785934,5875
"24782","Ocbimv22028436m.g","KQ420488",15941,33029,17088
"24783","Ocbimv22005914m.g","KQ417284",282849,338916,56067
"24784","Ocbimv22015214m.g","KQ429209",22713,36888,14175
"24785","Ocbimv22025449m.g","KQ419803",60956,61924,968
"24786","Ocbimv22034477m.g","KQ422053",36710,49922,13212
"24787","Ocbimv22016158m.g","KQ429717",28941,75268,46327
"24788","Ocbimv22028857m.g","KQ420593",396495,426878,30383
"24789","Ocbimv22030561m.g","KQ421022",192860,193426,566
"24790","Ocbimv22033418m.g","KQ421808",538846,539103,257
"24791","Ocbimv22036739m.g","KQ422849",12,6652,6640
"24792","Ocbimv22003508m.g","KQ425021",66196,76202,10006
"24793","Ocbimv22029236m.g","KQ420690",46566,99351,52785
"24794","Ocbimv22023193m.g","KQ419368",545735,587810,42075
"24795","Ocbimv22011769m.g","KQ415891",189069,257555,68486
"24796","Ocbimv22017677m.g","KQ418527",154811,155035,224
"24797","Ocbimv22017737m.g","KQ418535",298486,299002,516
"24798","Ocbimv22026401m.g","KQ420039",440633,450652,10019
"24799","Ocbimv22003654m.g","KQ425062",187573,232086,44513
"24800","Ocbimv22038404m.g","KQ416739",25205,37912,12707
"24801","Ocbimv22010246m.g","LGKD01578208",49,249,200
"24802","Ocbimv22032598m.g","KQ416441",389584,400411,10827
"24803","Ocbimv22039132m.g","KQ416780",44503,45722,1219
"24804","Ocbimv22032325m.g","KQ421523",416196,450735,34539
"24805","Ocbimv22008525m.g","KQ426659",30920,67928,37008
"24806","Ocbimv22039230m.g","KQ423591",54276,74875,20599
"24807","Ocbimv22021892m.g","KQ419123",23310,23774,464
"24808","Ocbimv22023383m.g","KQ419395",378233,381732,3499
"24809","Ocbimv22014154m.g","LGKD01606868",646,1863,1217
"24810","Ocbimv22000430m.g","KQ423963",63732,64174,442
"24811","Ocbimv22024689m.g","KQ419615",490158,513525,23367
"24812","Ocbimv22024731m.g","KQ416128",501413,501745,332
"24813","Ocbimv22012525m.g","KQ417917",679955,681186,1231
"24814","Ocbimv22019053m.g","KQ418711",1239656,1245601,5945
"24815","Ocbimv22028602m.g","KQ416263",764658,769229,4571
"24816","Ocbimv22004359m.g","KQ417152",826777,827301,524
"24817","Ocbimv22024211m.g","KQ419550",63009,65931,2922
"24818","Ocbimv22008388m.g","KQ426624",16061,52882,36821
"24819","Ocbimv22039163m.g","KQ423555",481448,491230,9782
"24820","Ocbimv22015386m.g","KQ418237",24876,25100,224
"24821","Ocbimv22003130m.g","KQ424891",104862,117723,12861
"24822","Ocbimv22008931m.g","KQ417540",666155,666853,698
"24823","Ocbimv22018475m.g","KQ430702",130231,152829,22598
"24824","Ocbimv22035167m.g","KQ415662",132505,133467,962
"24825","Ocbimv22011001m.g","KQ427587",4418,38457,34039
"24826","Ocbimv22009238m.g","KQ426942",139334,139492,158
"24827","Ocbimv22004529m.g","KQ415805",1486886,1487167,281
"24828","Ocbimv22033904m.g","KQ421906",156288,159710,3422
"24829","Ocbimv22021826m.g","KQ415687",551013,551310,297
"24830","Ocbimv22023550m.g","KQ419432",2015,15620,13605
"24831","Ocbimv22032643m.g","KQ421625",226651,227258,607
"24832","Ocbimv22018062m.g","KQ418561",224993,225424,431
"24833","Ocbimv22038755m.g","KQ416765",90164,91528,1364
"24834","Ocbimv22024531m.g","KQ419593",14133,14303,170
"24835","Ocbimv22039072m.g","KQ423536",342867,343367,500
"24836","Ocbimv22019886m.g","KQ418832",243304,274865,31561
"24837","Ocbimv22028944m.g","KQ420605",455545,495462,39917
"24838","Ocbimv22026064m.g","LGKD01327136",36,236,200
"24839","Ocbimv22018632m.g","KQ430777",1390,2473,1083
"24840","Ocbimv22018295m.g","KQ430642",18187,19770,1583
"24841","Ocbimv22016024m.g","KQ429661",156346,170482,14136
"24842","Ocbimv22034332m.g","KQ422016",172488,174461,1973
"24843","Ocbimv22030174m.g","KQ420915",804007,814457,10450
"24844","Ocbimv22034925m.g","KQ415742",986992,1026363,39371
"24845","Ocbimv22007143m.g","KQ426210",3837,4058,221
"24846","Ocbimv22029354m.g","KQ420717",251709,253898,2189
"24847","Ocbimv22012651m.g","KQ417923",363883,407191,43308
"24848","Ocbimv22027498m.g","KQ416226",151409,151871,462
"24849","Ocbimv22028737m.g","KQ420566",90784,91293,509
"24850","Ocbimv22022853m.g","KQ419311",520427,520819,392
"24851","Ocbimv22033127m.g","KQ421731",406232,411244,5012
"24852","Ocbimv22001678m.g","KQ416953",497402,503532,6130
"24853","Ocbimv22030641m.g","KQ421039",493558,542143,48585
"24854","Ocbimv22015812m.g","KQ418295",114086,120610,6524
"24855","Ocbimv22003506m.g","KQ425021",2908,3780,872
"24856","Ocbimv22035255m.g","KQ415748",165819,166727,908
"24857","Ocbimv22002060m.g","KQ424530",468177,469254,1077
"24858","Ocbimv22033273m.g","KQ421759",108933,109142,209
"24859","Ocbimv22032363m.g","KQ421524",1826,2122,296
"24860","Ocbimv22017751m.g","KQ418537",462634,464101,1467
"24861","Ocbimv22009853m.g","KQ417620",1112743,1113258,515
"24862","Ocbimv22034940m.g","KQ416562",953448,953939,491
"24863","Ocbimv22016390m.g","KQ415962",1851703,1852399,696
"24864","Ocbimv22028084m.g","KQ420428",124233,125427,1194
"24865","Ocbimv22030237m.g","KQ420927",74506,91291,16785
"24866","Ocbimv22000059m.g","KQ423839",157288,157812,524
"24867","Ocbimv22019460m.g","KQ418770",207022,207243,221
"24868","Ocbimv22035518m.g","KQ422416",321782,324419,2637
"24869","Ocbimv22021509m.g","KQ432191",2936,9384,6448
"24870","Ocbimv22032007m.g","KQ421409",966459,967571,1112
"24871","Ocbimv22030324m.g","KQ420950",109962,114064,4102
"24872","Ocbimv22022675m.g","KQ419280",30033,37387,7354
"24873","Ocbimv22000523m.g","KQ416865",100139,120849,20710
"24874","Ocbimv22032072m.g","KQ421423",22740,36487,13747
"24875","Ocbimv22024926m.g","KQ419657",1440712,1503586,62874
"24876","Ocbimv22016075m.g","KQ418318",325513,389142,63629
"24877","Ocbimv22016037m.g","KQ418312",295197,322252,27055
"24878","Ocbimv22019452m.g","KQ418769",9216,39567,30351
"24879","Ocbimv22036162m.g","KQ422662",17256,38434,21178
"24880","Ocbimv22002012m.g","KQ424513",137722,150115,12393
"24881","Ocbimv22028554m.g","KQ416260",1385038,1385241,203
"24882","Ocbimv22025170m.g","KQ416141",619246,621847,2601
"24883","Ocbimv22016863m.g","KQ418413",265372,279432,14060
"24884","Ocbimv22018460m.g","KQ415992",806005,806802,797
"24885","Ocbimv22008183m.g","KQ426569",183326,185081,1755
"24886","Ocbimv22030271m.g","KQ415716",845782,845964,182
"24887","Ocbimv22012344m.g","KQ415907",1010562,1023616,13054
"24888","Ocbimv22035371m.g","KQ416583",211814,213734,1920
"24889","Ocbimv22017532m.g","KQ430341",5179,6696,1517
"24890","Ocbimv22020401m.g","LGKD01659950",39,131,92
"24891","Ocbimv22015529m.g","KQ429401",2889,3657,768
"24892","Ocbimv22009478m.g","KQ417596",936928,937083,155
"24893","Ocbimv22032814m.g","KQ416452",172536,179164,6628
"24894","Ocbimv22024835m.g","KQ419638",174176,174973,797
"24895","Ocbimv22004144m.g","KQ417140",113863,119225,5362
"24896","Ocbimv22035137m.g","LGKD01436736",73,552,479
"24897","Ocbimv22000265m.g","KQ423910",69753,70057,304
"24898","Ocbimv22035054m.g","KQ422263",2694,62641,59947
"24899","Ocbimv22031869m.g","KQ421368",1784,4173,2389
"24900","Ocbimv22015407m.g","KQ418240",273995,296642,22647
"24901","Ocbimv22030325m.g","KQ420950",239320,244091,4771
"24902","Ocbimv22012358m.g","KQ428130",154058,154723,665
"24903","Ocbimv22012174m.g","KQ417880",823585,824429,844
"24904","Ocbimv22020578m.g","KQ418926",254123,304712,50589
"24905","Ocbimv22038961m.g","KQ423493",1032783,1032969,186
"24906","Ocbimv22039781m.g","KQ416822",145368,170661,25293
"24907","Ocbimv22006250m.g","KQ417305",462806,478719,15913
"24908","Ocbimv22031954m.g","KQ421389",289737,289998,261
"24909","Ocbimv22011030m.g","LGKD01584281",29,433,404
"24910","Ocbimv22013336m.g","KQ428449",108521,109426,905
"24911","Ocbimv22031418m.g","KQ421236",66511,109193,42682
"24912","Ocbimv22002196m.g","KQ416995",112614,114772,2158
"24913","Ocbimv22037013m.g","LGKD01455950",468,653,185
"24914","Ocbimv22030753m.g","KQ421083",525219,552291,27072
"24915","Ocbimv22023016m.g","KQ419338",394171,394652,481
"24916","Ocbimv22025598m.g","KQ419858",87267,131233,43966
"24917","Ocbimv22028384m.g","KQ416257",467719,468220,501
"24918","Ocbimv22001812m.g","KQ424429",113319,122683,9364
"24919","Ocbimv22021704m.g","KQ419087",118756,119683,927
"24920","Ocbimv22020403m.g","KQ416026",299586,299825,239
"24921","Ocbimv22020549m.g","KQ418923",27975,28151,176
"24922","Ocbimv22025989m.g","KQ419945",1261,1592,331
"24923","Ocbimv22033144m.g","KQ421736",57032,81125,24093
"24924","Ocbimv22015449m.g","KQ429346",42476,42625,149
"24925","Ocbimv22034710m.g","KQ422117",272,15677,15405
"24926","Ocbimv22016104m.g","KQ429708",252977,262802,9825
"24927","Ocbimv22033408m.g","KQ421805",17187,18234,1047
"24928","Ocbimv22021555m.g","KQ419078",34158,186758,152600
"24929","Ocbimv22033489m.g","KQ421821",209165,277731,68566
"24930","Ocbimv22022306m.g","KQ419193",376057,376788,731
"24931","Ocbimv22020843m.g","KQ418970",2318475,2321760,3285
"24932","Ocbimv22010142m.g","KQ427275",537154,537549,395
"24933","Ocbimv22015445m.g","KQ418248",60706,64255,3549
"24934","Ocbimv22009336m.g","KQ426953",167884,247944,80060
"24935","Ocbimv22032424m.g","KQ421533",525067,531267,6200
"24936","Ocbimv22016872m.g","KQ430064",10965,12557,1592
"24937","Ocbimv22031846m.g","KQ421357",3149,16672,13523
"24938","Ocbimv22013799m.g","KQ418061",297433,299467,2034
"24939","Ocbimv22009147m.g","KQ415861",286860,347894,61034
"24940","Ocbimv22020018m.g","KQ418843",2,4569,4567
"24941","Ocbimv22003358m.g","KQ424993",339784,377255,37471
"24942","Ocbimv22022206m.g","KQ416062",7612,15289,7677
"24943","Ocbimv22009948m.g","KQ427173",93304,165430,72126
"24944","Ocbimv22030585m.g","KQ416358",258094,258407,313
"24945","Ocbimv22001344m.g","KQ416923",138359,148628,10269
"24946","Ocbimv22021084m.g","KQ419000",35702,75262,39560
"24947","Ocbimv22001444m.g","KQ416933",423651,426583,2932
"24948","Ocbimv22006325m.g","KQ425877",50386,98618,48232
"24949","Ocbimv22028074m.g","KQ416246",65071,82097,17026
"24950","Ocbimv22012474m.g","KQ417913",245080,245984,904
"24951","Ocbimv22030319m.g","KQ420947",16087,18319,2232
"24952","Ocbimv22004204m.g","KQ425224",11953,12353,400
"24953","Ocbimv22023290m.g","KQ419392",82366,83113,747
"24954","Ocbimv22017047m.g","KQ418444",387721,399636,11915
"24955","Ocbimv22035109m.g","KQ422282",1114,35871,34757
"24956","Ocbimv22034808m.g","KQ422178",296125,303058,6933
"24957","Ocbimv22000665m.g","KQ416875",67607,68150,543
"24958","Ocbimv22000460m.g","KQ416860",45504,47267,1763
"24959","Ocbimv22022517m.g","KQ419239",492532,525538,33006
"24960","Ocbimv22026398m.g","KQ420038",4604,4801,197
"24961","Ocbimv22016415m.g","LGKD01627401",994,1306,312
"24962","Ocbimv22000182m.g","KQ423887",114466,139683,25217
"24963","Ocbimv22028966m.g","KQ416278",9808,11015,1207
"24964","Ocbimv22008936m.g","KQ426815",29799,32058,2259
"24965","Ocbimv22020995m.g","KQ431922",7795,8668,873
"24966","Ocbimv22029481m.g","KQ416308",863276,879055,15779
"24967","Ocbimv22010941m.g","KQ417725",494845,501823,6978
"24968","Ocbimv22039910m.g","KQ416834",467388,468882,1494
"24969","Ocbimv22039326m.g","KQ416788",169400,175525,6125
"24970","Ocbimv22015911m.g","KQ418303",137497,148920,11423
"24971","Ocbimv22020487m.g","KQ418919",463289,471596,8307
"24972","Ocbimv22024139m.g","KQ419538",713571,714166,595
"24973","Ocbimv22031919m.g","KQ421376",1202913,1249744,46831
"24974","Ocbimv22022299m.g","KQ419193",52737,53639,902
"24975","Ocbimv22007919m.g","KQ417459",512088,521690,9602
"24976","Ocbimv22039189m.g","KQ416784",435554,465419,29865
"24977","Ocbimv22000699m.g","KQ416877",100455,101208,753
"24978","Ocbimv22032273m.g","KQ421508",33378,33896,518
"24979","Ocbimv22035654m.g","KQ422493",226207,290894,64687
"24980","Ocbimv22022323m.g","KQ419197",498981,507887,8906
"24981","Ocbimv22018684m.g","KQ415996",94177,96202,2025
"24982","Ocbimv22019272m.g","KQ418739",721608,723337,1729
"24983","Ocbimv22021656m.g","KQ416049",83744,84702,958
"24984","Ocbimv22009659m.g","KQ427059",595867,597021,1154
"24985","Ocbimv22033349m.g","KQ421792",25312,25545,233
"24986","Ocbimv22025441m.g","KQ419801",167454,190154,22700
"24987","Ocbimv22019455m.g","KQ418769",676974,677348,374
"24988","Ocbimv22023246m.g","LGKD01686936",10,599,589
"24989","Ocbimv22023870m.g","KQ419491",23014,23973,959
"24990","Ocbimv22007316m.g","KQ426287",301603,318278,16675
"24991","Ocbimv22019192m.g","KQ418732",2026,2889,863
"24992","Ocbimv22000329m.g","KQ423926",23592,25351,1759
"24993","Ocbimv22016871m.g","LGKD01631234",133,504,371
"24994","Ocbimv22034491m.g","KQ422062",142529,143578,1049
"24995","Ocbimv22036862m.g","KQ416662",864998,868805,3807
"24996","Ocbimv22004439m.g","KQ425306",94815,95959,1144
"24997","Ocbimv22008817m.g","KQ426774",255718,263639,7921
"24998","Ocbimv22006599m.g","KQ426027",115103,128034,12931
"24999","Ocbimv22008991m.g","KQ426829",200694,218616,17922
"25000","Ocbimv22013267m.g","KQ428430",32239,47138,14899
"25001","Ocbimv22002317m.g","KQ424629",22955,78568,55613
"25002","Ocbimv22029111m.g","KQ420656",74861,75055,194
"25003","Ocbimv22028719m.g","KQ416268",803214,804967,1753
"25004","Ocbimv22005134m.g","KQ415813",1330335,1355716,25381
"25005","Ocbimv22015715m.g","KQ429501",4951,5616,665
"25006","Ocbimv22022745m.g","KQ416074",666580,666859,279
"25007","Ocbimv22036676m.g","KQ422828",3254,39287,36033
"25008","Ocbimv22030886m.g","KQ421117",6266,74960,68694
"25009","Ocbimv22027731m.g","KQ420350",82776,111677,28901
"25010","Ocbimv22015056m.g","KQ418194",905770,906542,772
"25011","Ocbimv22004080m.g","KQ417133",649113,661058,11945
"25012","Ocbimv22011309m.g","KQ417780",87494,100313,12819
"25013","Ocbimv22018854m.g","LGKD01646678",38,169,131
"25014","Ocbimv22024560m.g","KQ419595",12578,18959,6381
"25015","Ocbimv22026708m.g","KQ420096",282154,304615,22461
"25016","Ocbimv22035884m.g","KQ422595",147090,156562,9472
"25017","Ocbimv22018869m.g","KQ418693",432322,441131,8809
"25018","Ocbimv22024065m.g","LGKD01695441",7,252,245
"25019","Ocbimv22010157m.g","KQ427290",46353,62362,16009
"25020","Ocbimv22035129m.g","KQ422286",84877,87321,2444
"25021","Ocbimv22022997m.g","KQ419337",55325,84100,28775
"25022","Ocbimv22014538m.g","KQ428981",54552,66331,11779
"25023","Ocbimv22027545m.g","KQ420299",1760616,1802560,41944
"25024","Ocbimv22019772m.g","KQ418812",102987,141467,38480
"25025","Ocbimv22029721m.g","KQ420813",616519,635215,18696
"25026","Ocbimv22007585m.g","KQ417432",109791,124475,14684
"25027","Ocbimv22009862m.g","KQ417620",1649415,1650035,620
"25028","Ocbimv22015627m.g","KQ418269",711225,711752,527
"25029","Ocbimv22024815m.g","KQ419631",641021,646441,5420
"25030","Ocbimv22022602m.g","KQ419270",5857,6180,323
"25031","Ocbimv22031053m.g","KQ421149",142948,146548,3600
"25032","Ocbimv22034797m.g","KQ422176",326571,326954,383
"25033","Ocbimv22002855m.g","KQ424805",44874,70033,25159
"25034","Ocbimv22020639m.g","KQ418945",766082,803804,37722
"25035","Ocbimv22004262m.g","KQ425248",122952,136815,13863
"25036","Ocbimv22025481m.g","KQ419817",137689,137982,293
"25037","Ocbimv22004893m.g","KQ425467",29560,33374,3814
"25038","Ocbimv22033798m.g","KQ421873",118542,208283,89741
"25039","Ocbimv22000147m.g","KQ423870",50961,55784,4823
"25040","Ocbimv22028694m.g","KQ420556",187948,233822,45874
"25041","Ocbimv22038718m.g","KQ423450",12052,25308,13256
"25042","Ocbimv22009685m.g","KQ427081",53837,60526,6689
"25043","Ocbimv22035435m.g","KQ422382",16574,17497,923
"25044","Ocbimv22013973m.g","KQ428716",8360,9290,930
"25045","Ocbimv22011853m.g","LGKD01590810",616,2475,1859
"25046","Ocbimv22007288m.g","KQ417398",1086481,1089282,2801
"25047","Ocbimv22004522m.g","KQ415805",119707,119901,194
"25048","Ocbimv22038549m.g","KQ423395",158075,160434,2359
"25049","Ocbimv22003915m.g","KQ417124",6529,55709,49180
"25050","Ocbimv22028278m.g","KQ420458",5116,5528,412
"25051","Ocbimv22035819m.g","KQ415753",153609,154873,1264
"25052","Ocbimv22007200m.g","KQ426236",7903,8088,185
"25053","Ocbimv22035495m.g","KQ422411",78158,80167,2009
"25054","Ocbimv22018826m.g","KQ430889",95704,97170,1466
"25055","Ocbimv22026883m.g","KQ420133",132697,132924,227
"25056","Ocbimv22009017m.g","KQ426843",79441,104542,25101
"25057","Ocbimv22033458m.g","KQ421816",1057096,1057968,872
"25058","Ocbimv22004562m.g","KQ425361",304301,331218,26917
"25059","Ocbimv22022858m.g","KQ419312",654042,663347,9305
"25060","Ocbimv22006103m.g","KQ425821",26632,27726,1094
"25061","Ocbimv22031082m.g","KQ415720",61889,63042,1153
"25062","Ocbimv22013792m.g","KQ418061",84,24809,24725
"25063","Ocbimv22002711m.g","KQ424755",270598,272648,2050
"25064","Ocbimv22025369m.g","KQ416152",340655,340912,257
"25065","Ocbimv22000226m.g","LGKD01490028",1,354,353
"25066","Ocbimv22004536m.g","KQ415805",2034199,2039312,5113
"25067","Ocbimv22025499m.g","KQ419822",62266,62803,537
"25068","Ocbimv22022275m.g","KQ419192",349133,352383,3250
"25069","Ocbimv22011123m.g","KQ427649",116608,116859,251
"25070","Ocbimv22019430m.g","KQ418765",1956,4031,2075
"25071","Ocbimv22026685m.g","KQ416196",1211380,1234713,23333
"25072","Ocbimv22004643m.g","KQ425405",19268,50589,31321
"25073","Ocbimv22016808m.g","KQ418402",253104,254419,1315
"25074","Ocbimv22038647m.g","KQ423430",771023,771529,506
"25075","Ocbimv22023757m.g","KQ416096",553456,570446,16990
"25076","Ocbimv22005169m.g","KQ425537",228660,309003,80343
"25077","Ocbimv22003412m.g","KQ417086",716701,724949,8248
"25078","Ocbimv22013797m.g","KQ418061",259679,266176,6497
"25079","Ocbimv22026250m.g","KQ416187",252228,252942,714
"25080","Ocbimv22036904m.g","KQ422894",182032,193058,11026
"25081","Ocbimv22030582m.g","KQ416357",860268,895647,35379
"25082","Ocbimv22024236m.g","KQ433876",3777,4562,785
"25083","Ocbimv22016703m.g","KQ429969",3038,167164,164126
"25084","Ocbimv22001615m.g","KQ416949",338376,340497,2121
"25085","Ocbimv22008459m.g","KQ415854",374869,411366,36497
"25086","Ocbimv22006262m.g","KQ417305",585360,595498,10138
"25087","Ocbimv22006584m.g","KQ426026",230673,234819,4146
"25088","Ocbimv22006454m.g","KQ425927",34153,61735,27582
"25089","Ocbimv22031906m.g","KQ421376",283572,283817,245
"25090","Ocbimv22036398m.g","KQ422748",3290,3529,239
"25091","Ocbimv22011421m.g","KQ415885",1431687,1436602,4915
"25092","Ocbimv22034360m.g","KQ422020",3095,3523,428
"25093","Ocbimv22020830m.g","KQ418970",1595333,1597803,2470
"25094","Ocbimv22014996m.g","KQ418193",614819,615646,827
"25095","Ocbimv22039816m.g","KQ423766",137942,138420,478
"25096","Ocbimv22011855m.g","KQ427927",49017,49597,580
"25097","Ocbimv22014552m.g","LGKD01610762",444,671,227
"25098","Ocbimv22039654m.g","KQ416811",274074,289343,15269
"25099","Ocbimv22027893m.g","KQ420392",224730,225019,289
"25100","Ocbimv22029650m.g","KQ420796",187893,189315,1422
"25101","Ocbimv22025496m.g","KQ416157",396,9510,9114
"25102","Ocbimv22016686m.g","KQ415968",63938,100176,36238
"25103","Ocbimv22008685m.g","KQ426728",6788,7117,329
"25104","Ocbimv22036031m.g","KQ416614",335659,335928,269
"25105","Ocbimv22037493m.g","KQ423047",113108,113377,269
"25106","Ocbimv22031843m.g","KQ421356",850409,863693,13284
"25107","Ocbimv22006897m.g","KQ415837",1227928,1228152,224
"25108","Ocbimv22021733m.g","KQ419092",187381,246030,58649
"25109","Ocbimv22006733m.g","LGKD01549445",3,510,507
"25110","Ocbimv22019667m.g","KQ431225",27340,49083,21743
"25111","Ocbimv22030575m.g","KQ416357",380752,388999,8247
"25112","Ocbimv22019811m.g","KQ416017",77088,77735,647
"25113","Ocbimv22014288m.g","KQ428855",39845,41680,1835
"25114","Ocbimv22034481m.g","KQ422055",117041,117494,453
"25115","Ocbimv22016699m.g","KQ429968",109256,110369,1113
"25116","Ocbimv22024445m.g","KQ416122",380259,380735,476
"25117","Ocbimv22027580m.g","KQ420308",75754,76352,598
"25118","Ocbimv22003276m.g","KQ424932",492311,534308,41997
"25119","Ocbimv22037194m.g","KQ416683",23943,24311,368
"25120","Ocbimv22028927m.g","KQ416274",2083286,2083447,161
"25121","Ocbimv22007399m.g","KQ417410",152819,239058,86239
"25122","Ocbimv22022604m.g","KQ419270",89457,93024,3567
"25123","Ocbimv22001152m.g","KQ416913",102208,114938,12730
"25124","Ocbimv22020815m.g","KQ418970",400910,401892,982
"25125","Ocbimv22033091m.g","KQ421725",24931,31689,6758
"25126","Ocbimv22005915m.g","KQ417284",299101,300774,1673
"25127","Ocbimv22030903m.g","KQ421117",1349870,1350564,694
"25128","Ocbimv22010104m.g","KQ417642",180353,261942,81589
"25129","Ocbimv22029400m.g","KQ420741",1337674,1338183,509
"25130","Ocbimv22018783m.g","LGKD01646108",1,488,487
"25131","Ocbimv22030657m.g","KQ421051",204775,204939,164
"25132","Ocbimv22009424m.g","KQ417591",1441712,1441927,215
"25133","Ocbimv22000881m.g","KQ424102",16,210,194
"25134","Ocbimv22021819m.g","KQ419112",3853,138287,134434
"25135","Ocbimv22015182m.g","KQ429185",21553,22331,778
"25136","Ocbimv22023117m.g","KQ419350",845345,873566,28221
"25137","Ocbimv22014750m.g","KQ418175",388017,393795,5778
"25138","Ocbimv22028979m.g","KQ416278",350784,364281,13497
"25139","Ocbimv22017760m.g","KQ418537",1031584,1035182,3598
"25140","Ocbimv22004847m.g","LGKD01533282",1,359,358
"25141","Ocbimv22013989m.g","KQ428718",38537,53679,15142
"25142","Ocbimv22033686m.g","KQ416490",1123322,1126247,2925
"25143","Ocbimv22013707m.g","KQ418049",231398,252200,20802
"25144","Ocbimv22013879m.g","KQ428701",14339,49879,35540
"25145","Ocbimv22009335m.g","KQ426953",149706,158508,8802
"25146","Ocbimv22017886m.g","KQ430507",2373,2522,149
"25147","Ocbimv22028213m.g","KQ420444",357037,365694,8657
"25148","Ocbimv22028359m.g","KQ420477",371108,373102,1994
"25149","Ocbimv22028531m.g","KQ420517",372009,423615,51606
"25150","Ocbimv22028567m.g","KQ420522",255865,276370,20505
"25151","Ocbimv22004340m.g","KQ425268",192,461,269
"25152","Ocbimv22012710m.g","KQ417929",58839,67819,8980
"25153","Ocbimv22011531m.g","KQ417798",307694,308359,665
"25154","Ocbimv22026518m.g","KQ420063",67866,68060,194
"25155","Ocbimv22022197m.g","KQ419184",176880,187337,10457
"25156","Ocbimv22003805m.g","KQ425115",195968,209562,13594
"25157","Ocbimv22039751m.g","KQ416821",49793,96813,47020
"25158","Ocbimv22004486m.g","KQ417173",8787,16931,8144
"25159","Ocbimv22016579m.g","KQ418368",305271,308736,3465
"25160","Ocbimv22015832m.g","KQ418295",259480,263624,4144
"25161","Ocbimv22027931m.g","KQ420404",666885,680924,14039
"25162","Ocbimv22018799m.g","KQ418682",349175,349369,194
"25163","Ocbimv22016293m.g","KQ429791",50025,51401,1376
"25164","Ocbimv22018988m.g","LGKD01647410",85,624,539
"25165","Ocbimv22020758m.g","KQ431846",23506,59367,35861
"25166","Ocbimv22019687m.g","KQ431257",34115,40575,6460
"25167","Ocbimv22036767m.g","KQ416656",49055,50203,1148
"25168","Ocbimv22027908m.g","KQ420395",47490,70675,23185
"25169","Ocbimv22005757m.g","KQ425735",30268,33162,2894
"25170","Ocbimv22020379m.g","KQ418901",995,1198,203
"25171","Ocbimv22022305m.g","KQ419193",321709,322029,320
"25172","Ocbimv22031727m.g","KQ421328",311129,311281,152
"25173","Ocbimv22034754m.g","KQ422146",11636,79981,68345
"25174","Ocbimv22039304m.g","KQ423610",10031,10815,784
"25175","Ocbimv22002779m.g","KQ424779",326125,326772,647
"25176","Ocbimv22002181m.g","KQ424568",113252,113659,407
"25177","Ocbimv22031373m.g","KQ416393",352303,355420,3117
"25178","Ocbimv22025462m.g","KQ419807",344622,344777,155
"25179","Ocbimv22010148m.g","KQ427278",10780,176795,166015
"25180","Ocbimv22020008m.g","KQ418841",29288,30030,742
"25181","Ocbimv22000955m.g","KQ415782",192819,195285,2466
"25182","Ocbimv22010293m.g","KQ417665",1365984,1366166,182
"25183","Ocbimv22033308m.g","KQ421769",100315,103739,3424
"25184","Ocbimv22012368m.g","LGKD01594856",175,426,251
"25185","Ocbimv22017641m.g","KQ418522",89677,90691,1014
"25186","Ocbimv22032244m.g","KQ421493",58763,68782,10019
"25187","Ocbimv22001397m.g","KQ416930",357630,363818,6188
"25188","Ocbimv22032575m.g","KQ416439",46733,47894,1161
"25189","Ocbimv22033055m.g","KQ421721",593972,594918,946
"25190","Ocbimv22019241m.g","KQ418738",137758,182637,44879
"25191","Ocbimv22031065m.g","KQ416383",208282,217187,8905
"25192","Ocbimv22025440m.g","KQ419801",155380,162890,7510
"25193","Ocbimv22008756m.g","KQ426760",153242,168663,15421
"25194","Ocbimv22038888m.g","KQ416771",239921,249275,9354
"25195","Ocbimv22008076m.g","KQ426561",47616,50440,2824
"25196","Ocbimv22032447m.g","KQ416431",182010,182790,780
"25197","Ocbimv22012768m.g","KQ428229",74795,94840,20045
"25198","Ocbimv22010452m.g","LGKD01579681",160,423,263
"25199","Ocbimv22037193m.g","KQ416682",140254,140667,413
"25200","Ocbimv22039333m.g","KQ416788",406865,409225,2360
"25201","Ocbimv22022906m.g","KQ419324",79444,79719,275
"25202","Ocbimv22028868m.g","KQ420595",416280,431916,15636
"25203","Ocbimv22038054m.g","KQ423210",17612,30757,13145
"25204","Ocbimv22018259m.g","KQ418587",801558,816084,14526
"25205","Ocbimv22037851m.g","KQ423139",635372,704029,68657
"25206","Ocbimv22027564m.g","KQ420308",1,560,559
"25207","Ocbimv22003842m.g","KQ425130",8189,8612,423
"25208","Ocbimv22024216m.g","KQ419550",155845,165544,9699
"25209","Ocbimv22002230m.g","KQ416996",274971,276469,1498
"25210","Ocbimv22017344m.g","KQ418483",304583,309830,5247
"25211","Ocbimv22026051m.g","KQ419973",836286,837126,840
"25212","Ocbimv22012571m.g","KQ417917",1456109,1457557,1448
"25213","Ocbimv22003536m.g","KQ417090",911840,912127,287
"25214","Ocbimv22033514m.g","KQ421823",192275,226635,34360
"25215","Ocbimv22004570m.g","KQ425362",51375,65603,14228
"25216","Ocbimv22005260m.g","KQ417237",586709,587113,404
"25217","Ocbimv22035127m.g","KQ422286",63417,72188,8771
"25218","Ocbimv22017226m.g","KQ418469",270992,271360,368
"25219","Ocbimv22028551m.g","KQ416260",865576,866292,716
"25220","Ocbimv22031126m.g","KQ415721",25487,60600,35113
"25221","Ocbimv22010518m.g","KQ427417",44155,44403,248
"25222","Ocbimv22029633m.g","KQ420787",974228,981363,7135
"25223","Ocbimv22009379m.g","KQ417588",431159,431326,167
"25224","Ocbimv22039764m.g","LGKD01485067",1,201,200
"25225","Ocbimv22007330m.g","KQ417404",10517,21611,11094
"25226","Ocbimv22027512m.g","KQ420294",496061,496243,182
"25227","Ocbimv22002722m.g","KQ424760",124476,147849,23373
"25228","Ocbimv22016856m.g","KQ418413",133715,135992,2277
"25229","Ocbimv22035125m.g","KQ422286",1,55262,55261
"25230","Ocbimv22038377m.g","KQ416738",206303,207953,1650
"25231","Ocbimv22015890m.g","KQ418299",260631,261641,1010
"25232","Ocbimv22003374m.g","KQ424998",7265,9307,2042
"25233","Ocbimv22026237m.g","KQ420017",1052626,1052913,287
"25234","Ocbimv22013426m.g","KQ428503",114945,115703,758
"25235","Ocbimv22028824m.g","KQ420587",378611,378854,243
"25236","Ocbimv22015304m.g","KQ418217",74551,79931,5380
"25237","Ocbimv22031452m.g","KQ421252",10248,10780,532
"25238","Ocbimv22037272m.g","KQ422987",103466,114369,10903
"25239","Ocbimv22018261m.g","KQ430613",2294,9004,6710
"25240","Ocbimv22005498m.g","KQ425624",145776,145934,158
"25241","Ocbimv22033104m.g","KQ421727",172021,172359,338
"25242","Ocbimv22016348m.g","KQ415679",320177,322524,2347
"25243","Ocbimv22025721m.g","KQ419887",1202319,1207533,5214
"25244","Ocbimv22039063m.g","KQ423531",319933,335580,15647
"25245","Ocbimv22021744m.g","KQ419094",39338,39517,179
"25246","Ocbimv22030757m.g","KQ421084",548,1371,823
"25247","Ocbimv22027805m.g","KQ416233",637121,670852,33731
"25248","Ocbimv22008634m.g","KQ417513",216693,216881,188
"25249","Ocbimv22029322m.g","KQ416297",121987,135535,13548
"25250","Ocbimv22039557m.g","KQ416802",481412,511293,29881
"25251","Ocbimv22021512m.g","KQ419063",346777,347223,446
"25252","Ocbimv22016969m.g","KQ418431",1363,1645,282
"25253","Ocbimv22038496m.g","KQ423378",31558,48998,17440
"25254","Ocbimv22018126m.g","KQ430573",2806,10445,7639
"25255","Ocbimv22003808m.g","KQ425115",386632,390143,3511
"25256","Ocbimv22014003m.g","KQ418075",729996,810920,80924
"25257","Ocbimv22024316m.g","KQ419565",62229,63131,902
"25258","Ocbimv22012011m.g","KQ427966",40149,40349,200
"25259","Ocbimv22038537m.g","KQ423394",9411,9935,524
"25260","Ocbimv22037887m.g","KQ423143",149460,150259,799
"25261","Ocbimv22025118m.g","KQ419695",237454,300866,63412
"25262","Ocbimv22024199m.g","KQ419548",47522,47725,203
"25263","Ocbimv22011660m.g","LGKD01588892",216,1233,1017
"25264","Ocbimv22035487m.g","KQ422403",267,9575,9308
"25265","Ocbimv22006534m.g","LGKD01547101",72,657,585
"25266","Ocbimv22018653m.g","KQ430783",13161,13659,498
"25267","Ocbimv22009317m.g","KQ415863",1180,7556,6376
"25268","Ocbimv22004525m.g","KQ415805",1143459,1143824,365
"25269","Ocbimv22024392m.g","KQ415693",353652,389996,36344
"25270","Ocbimv22005546m.g","KQ425649",580424,582248,1824
"25271","Ocbimv22026628m.g","KQ420081",286023,286340,317
"25272","Ocbimv22020530m.g","KQ418922",417601,424455,6854
"25273","Ocbimv22008265m.g","KQ417492",409911,519351,109440
"25274","Ocbimv22028223m.g","KQ420447",225,16381,16156
"25275","Ocbimv22028310m.g","KQ420468",97936,98142,206
"25276","Ocbimv22029021m.g","KQ420626",974118,974855,737
"25277","Ocbimv22039739m.g","KQ423737",90386,101886,11500
"25278","Ocbimv22015086m.g","KQ418194",1721596,1723920,2324
"25279","Ocbimv22001592m.g","KQ424366",37654,38028,374
"25280","Ocbimv22005654m.g","KQ425703",92242,92975,733
"25281","Ocbimv22026894m.g","KQ420138",207115,207372,257
"25282","Ocbimv22001495m.g","KQ416938",186493,188212,1719
"25283","Ocbimv22020966m.g","KQ418983",76758,108858,32100
"25284","Ocbimv22037294m.g","KQ422996",237504,237653,149
"25285","Ocbimv22033145m.g","KQ421736",91473,107737,16264
"25286","Ocbimv22019040m.g","KQ418711",1044034,1051327,7293
"25287","Ocbimv22005164m.g","KQ425537",40161,142047,101886
"25288","Ocbimv22007268m.g","KQ417395",495923,496456,533
"25289","Ocbimv22023609m.g","KQ433503",113534,159446,45912
"25290","Ocbimv22038128m.g","KQ423217",231546,287350,55804
"25291","Ocbimv22037394m.g","KQ416694",1168312,1212898,44586
"25292","Ocbimv22019827m.g","KQ431332",299746,300360,614
"25293","Ocbimv22010196m.g","KQ417655",77042,77488,446
"25294","Ocbimv22032991m.g","KQ421710",86493,93732,7239
"25295","Ocbimv22024149m.g","KQ416113",13995,24079,10084
"25296","Ocbimv22000640m.g","KQ424026",219187,248758,29571
"25297","Ocbimv22031458m.g","KQ416399",123346,130048,6702
"25298","Ocbimv22018100m.g","KQ430572",28232,74016,45784
"25299","Ocbimv22016365m.g","KQ415962",625288,671637,46349
"25300","Ocbimv22026018m.g","KQ419957",245816,245983,167
"25301","Ocbimv22033682m.g","KQ416490",918797,919026,229
"25302","Ocbimv22024252m.g","LGKD01697148",241,360,119
"25303","Ocbimv22026290m.g","KQ420023",223499,224674,1175
"25304","Ocbimv22011016m.g","KQ417733",874306,874611,305
"25305","Ocbimv22020334m.g","KQ431612",12837,22438,9601
"25306","Ocbimv22001513m.g","KQ424338",117288,118284,996
"25307","Ocbimv22005731m.g","KQ425731",170286,172797,2511
"25308","Ocbimv22034031m.g","KQ416508",31667,35638,3971
"25309","Ocbimv22036557m.g","KQ422792",289901,297728,7827
"25310","Ocbimv22021244m.g","KQ419018",685809,686441,632
"25311","Ocbimv22019248m.g","KQ431068",2397,2627,230
"25312","Ocbimv22011217m.g","KQ417763",149491,228357,78866
"25313","Ocbimv22024865m.g","KQ419643",396659,398426,1767
"25314","Ocbimv22005340m.g","KQ417245",398994,432000,33006
"25315","Ocbimv22014487m.g","KQ428963",54431,56969,2538
"25316","Ocbimv22007085m.g","KQ417377",525756,526045,289
"25317","Ocbimv22027863m.g","KQ416235",98692,100871,2179
"25318","Ocbimv22012419m.g","KQ417911",149501,183709,34208
"25319","Ocbimv22004572m.g","KQ425362",71408,85212,13804
"25320","Ocbimv22039728m.g","KQ423737",19014,21188,2174
"25321","Ocbimv22033466m.g","KQ421819",320435,327658,7223
"25322","Ocbimv22001565m.g","KQ415665",18912,19127,215
"25323","Ocbimv22001423m.g","KQ424303",65892,70252,4360
"25324","Ocbimv22031048m.g","KQ421147",273067,273471,404
"25325","Ocbimv22017166m.g","KQ418459",146291,159093,12802
"25326","Ocbimv22013326m.g","KQ418012",231981,269696,37715
"25327","Ocbimv22002174m.g","KQ416993",50638,51090,452
"25328","Ocbimv22038539m.g","KQ423395",3083,9306,6223
"25329","Ocbimv22036405m.g","KQ416641",108327,109356,1029
"25330","Ocbimv22032908m.g","KQ421683",143656,143955,299
"25331","Ocbimv22034072m.g","KQ416508",997456,1001750,4294
"25332","Ocbimv22024849m.g","KQ419640",126352,129537,3185
"25333","Ocbimv22023028m.g","KQ416080",506670,521832,15162
"25334","Ocbimv22022015m.g","KQ432511",47670,50043,2373
"25335","Ocbimv22021167m.g","KQ415686",276957,304357,27400
"25336","Ocbimv22006727m.g","KQ426083",916,19129,18213
"25337","Ocbimv22020034m.g","KQ418844",28477,60098,31621
"25338","Ocbimv22011785m.g","KQ417832",610357,611961,1604
"25339","Ocbimv22018810m.g","KQ416002",926485,934232,7747
"25340","Ocbimv22039168m.g","KQ423559",29158,36454,7296
"25341","Ocbimv22030112m.g","KQ420892",148573,169858,21285
"25342","Ocbimv22007078m.g","KQ417377",337799,371377,33578
"25343","Ocbimv22033691m.g","KQ416491",294666,317828,23162
"25344","Ocbimv22013048m.g","KQ417977",1157,1729,572
"25345","Ocbimv22013524m.g","KQ428545",49258,49783,525
"25346","Ocbimv22035843m.g","KQ422575",4540,4941,401
"25347","Ocbimv22039812m.g","KQ423766",8116,44212,36096
"25348","Ocbimv22002186m.g","KQ424569",172791,184428,11637
"25349","Ocbimv22016584m.g","KQ418368",371991,398563,26572
"25350","Ocbimv22023898m.g","LGKD01693870",1816,6229,4413
"25351","Ocbimv22002343m.g","KQ415791",482139,514702,32563
"25352","Ocbimv22023142m.g","KQ416081",260974,261375,401
"25353","Ocbimv22005935m.g","KQ417285",39300,56088,16788
"25354","Ocbimv22033170m.g","KQ416469",59203,59642,439
"25355","Ocbimv22032639m.g","KQ421625",34704,130768,96064
"25356","Ocbimv22033584m.g","KQ421838",173690,174630,940
"25357","Ocbimv22014549m.g","LGKD01610685",52,288,236
"25358","Ocbimv22037303m.g","KQ422997",663619,697375,33756
"25359","Ocbimv22029039m.g","KQ420631",37836,74576,36740
"25360","Ocbimv22004595m.g","KQ417182",475148,531407,56259
"25361","Ocbimv22001845m.g","KQ424446",249282,250500,1218
"25362","Ocbimv22002482m.g","KQ424671",30531,64084,33553
"25363","Ocbimv22030738m.g","KQ416368",196554,198152,1598
"25364","Ocbimv22004312m.g","KQ417147",1435355,1435846,491
"25365","Ocbimv22009485m.g","KQ415865",89257,92368,3111
"25366","Ocbimv22039787m.g","KQ416823",66738,68816,2078
"25367","Ocbimv22002562m.g","KQ415793",1480773,1502874,22101
"25368","Ocbimv22022119m.g","KQ419175",26858,79022,52164
"25369","Ocbimv22027052m.g","KQ420169",1139568,1140869,1301
"25370","Ocbimv22015831m.g","KQ418295",249935,254691,4756
"25371","Ocbimv22021707m.g","KQ419088",13968,14201,233
"25372","Ocbimv22026999m.g","KQ416208",46082,46741,659
"25373","Ocbimv22021807m.g","LGKD01671306",4,195,191
"25374","Ocbimv22000517m.g","KQ423987",28869,41871,13002
"25375","Ocbimv22037761m.g","KQ416710",887992,888249,257
"25376","Ocbimv22026596m.g","KQ416194",398402,438038,39636
"25377","Ocbimv22023590m.g","KQ419438",1701,5888,4187
"25378","Ocbimv22001603m.g","KQ424367",230920,252308,21388
"25379","Ocbimv22015483m.g","KQ418261",46854,56562,9708
"25380","Ocbimv22026574m.g","KQ416193",565009,574248,9239
"25381","Ocbimv22031617m.g","KQ421300",35406,39246,3840
"25382","Ocbimv22034953m.g","KQ422223",669300,693213,23913
"25383","Ocbimv22015545m.g","KQ429413",8106,8402,296
"25384","Ocbimv22021525m.g","KQ432208",2047,7854,5807
"25385","Ocbimv22003952m.g","KQ425160",71991,72320,329
"25386","Ocbimv22023010m.g","KQ419338",180091,204396,24305
"25387","Ocbimv22014265m.g","KQ418110",747211,786559,39348
"25388","Ocbimv22020679m.g","KQ418949",505787,537884,32097
"25389","Ocbimv22024264m.g","LGKD01697452",180,413,233
"25390","Ocbimv22012539m.g","KQ417917",815672,836547,20875
"25391","Ocbimv22018428m.g","KQ430691",1,3005,3004
"25392","Ocbimv22013778m.g","KQ428661",95846,130129,34283
"25393","Ocbimv22003572m.g","KQ417092",62457,63154,697
"25394","Ocbimv22000340m.g","KQ416854",519365,559253,39888
"25395","Ocbimv22036246m.g","KQ416627",275637,276613,976
"25396","Ocbimv22036381m.g","KQ422735",111407,122101,10694
"25397","Ocbimv22008091m.g","KQ426567",7977,8400,423
"25398","Ocbimv22005849m.g","KQ417280",200321,201574,1253
"25399","Ocbimv22005476m.g","KQ425611",665909,668860,2951
"25400","Ocbimv22001622m.g","KQ416950",203458,257798,54340
"25401","Ocbimv22010727m.g","KQ417706",102508,111392,8884
"25402","Ocbimv22015620m.g","KQ418269",291236,293065,1829
"25403","Ocbimv22022412m.g","KQ416068",49369,63133,13764
"25404","Ocbimv22013033m.g","KQ428349",205928,206659,731
"25405","Ocbimv22030841m.g","KQ421110",123396,124325,929
"25406","Ocbimv22038991m.g","KQ423506",24085,24477,392
"25407","Ocbimv22002570m.g","KQ424696",119627,123223,3596
"25408","Ocbimv22004863m.g","KQ425454",126934,142244,15310
"25409","Ocbimv22020510m.g","KQ418921",8485,10658,2173
"25410","Ocbimv22007975m.g","KQ417466",2126665,2126859,194
"25411","Ocbimv22039451m.g","KQ423671",114404,114739,335
"25412","Ocbimv22000103m.g","KQ423860",134922,136741,1819
"25413","Ocbimv22008759m.g","KQ426760",215154,258824,43670
"25414","Ocbimv22015575m.g","KQ418267",694744,740284,45540
"25415","Ocbimv22014135m.g","KQ428771",8859,11541,2682
"25416","Ocbimv22006230m.g","KQ425847",181193,231717,50524
"25417","Ocbimv22026089m.g","KQ419989",160655,177173,16518
"25418","Ocbimv22018933m.g","KQ418698",152984,163400,10416
"25419","Ocbimv22011760m.g","KQ417830",88241,88694,453
"25420","Ocbimv22026284m.g","KQ420023",84691,87017,2326
"25421","Ocbimv22030821m.g","KQ416371",642328,642630,302
"25422","Ocbimv22005387m.g","KQ417249",723757,731501,7744
"25423","Ocbimv22026672m.g","KQ416196",588737,589812,1075
"25424","Ocbimv22035574m.g","KQ422439",11556,46573,35017
"25425","Ocbimv22011188m.g","KQ427669",100931,126888,25957
"25426","Ocbimv22002231m.g","KQ416996",284653,287912,3259
"25427","Ocbimv22011324m.g","KQ417780",698979,699152,173
"25428","Ocbimv22015101m.g","KQ418194",2649378,2652190,2812
"25429","Ocbimv22015391m.g","LGKD01617847",379,1593,1214
"25430","Ocbimv22026754m.g","KQ420109",130622,131173,551
"25431","Ocbimv22009638m.g","KQ427059",222021,262631,40610
"25432","Ocbimv22022257m.g","KQ419190",365377,365559,182
"25433","Ocbimv22037941m.g","KQ423175",100069,101312,1243
"25434","Ocbimv22028920m.g","KQ416274",2032891,2039836,6945
"25435","Ocbimv22001620m.g","KQ416950",311,57739,57428
"25436","Ocbimv22003565m.g","KQ425032",29,22214,22185
"25437","Ocbimv22007903m.g","KQ417459",123052,144549,21497
"25438","Ocbimv22032687m.g","KQ416444",240311,268472,28161
"25439","Ocbimv22035052m.g","KQ422261",76163,82891,6728
"25440","Ocbimv22038902m.g","KQ416771",896108,896608,500
"25441","Ocbimv22003372m.g","KQ424997",52924,54230,1306
"25442","Ocbimv22026308m.g","KQ420023",519598,520110,512
"25443","Ocbimv22036678m.g","KQ415756",20446,29697,9251
"25444","Ocbimv22011695m.g","KQ427861",76,1302,1226
"25445","Ocbimv22007885m.g","KQ417458",192896,193822,926
"25446","Ocbimv22021191m.g","KQ416040",289649,298524,8875
"25447","Ocbimv22016903m.g","KQ430077",44255,44659,404
"25448","Ocbimv22016496m.g","KQ418361",7327,10913,3586
"25449","Ocbimv22029619m.g","KQ420787",57796,69633,11837
"25450","Ocbimv22026223m.g","KQ420017",575127,588060,12933
"25451","Ocbimv22000235m.g","KQ423903",158183,167987,9804
"25452","Ocbimv22037980m.g","KQ416717",108220,169993,61773
"25453","Ocbimv22000784m.g","KQ424065",123725,128951,5226
"25454","Ocbimv22029225m.g","KQ416293",94611,95071,460
"25455","Ocbimv22013552m.g","KQ418036",99614,186081,86467
"25456","Ocbimv22024825m.g","KQ419635",39636,54784,15148
"25457","Ocbimv22031186m.g","KQ416390",217340,243547,26207
"25458","Ocbimv22018836m.g","KQ430900",1157,29815,28658
"25459","Ocbimv22023393m.g","KQ419401",22862,70940,48078
"25460","Ocbimv22000366m.g","KQ423941",153010,190175,37165
"25461","Ocbimv22019328m.g","KQ431096",54875,56907,2032
"25462","Ocbimv22038335m.g","LGKD01469842",3370,4775,1405
"25463","Ocbimv22025860m.g","KQ419916",53503,54011,508
"25464","Ocbimv22037031m.g","KQ422909",385561,388666,3105
"25465","Ocbimv22002894m.g","KQ424814",526528,531813,5285
"25466","Ocbimv22035738m.g","KQ422521",370142,371305,1163
"25467","Ocbimv22008080m.g","KQ426561",94945,113413,18468
"25468","Ocbimv22012520m.g","KQ417917",534621,539507,4886
"25469","Ocbimv22033005m.g","KQ421715",25638,26378,740
"25470","Ocbimv22025876m.g","KQ419919",40284,41781,1497
"25471","Ocbimv22016252m.g","KQ418333",29000,52214,23214
"25472","Ocbimv22025011m.g","KQ419688",53679,54210,531
"25473","Ocbimv22025988m.g","KQ415696",224315,238213,13898
"25474","Ocbimv22029032m.g","KQ420630",60134,108390,48256
"25475","Ocbimv22036084m.g","KQ416616",1281266,1294123,12857
"25476","Ocbimv22015820m.g","KQ418295",146594,151023,4429
"25477","Ocbimv22022790m.g","LGKD01682576",3,908,905
"25478","Ocbimv22029134m.g","KQ420662",186622,213184,26562
"25479","Ocbimv22017759m.g","KQ418537",975014,976362,1348
"25480","Ocbimv22008327m.g","KQ417497",654160,676405,22245
"25481","Ocbimv22012015m.g","KQ427968",19324,51165,31841
"25482","Ocbimv22030367m.g","KQ420965",168955,169383,428
"25483","Ocbimv22015959m.g","KQ429629",40804,40996,192
"25484","Ocbimv22022043m.g","KQ419152",71828,82028,10200
"25485","Ocbimv22031507m.g","KQ421263",310696,311097,401
"25486","Ocbimv22020191m.g","KQ418873",136599,161883,25284
"25487","Ocbimv22006148m.g","KQ417300",810565,820504,9939
"25488","Ocbimv22004844m.g","KQ417209",373770,406552,32782
"25489","Ocbimv22014252m.g","KQ428821",6356,16404,10048
"25490","Ocbimv22023631m.g","KQ419448",67071,82526,15455
"25491","Ocbimv22018040m.g","KQ415985",117142,118002,860
"25492","Ocbimv22035414m.g","KQ415749",427915,429057,1142
"25493","Ocbimv22039077m.g","KQ423536",447542,465757,18215
"25494","Ocbimv22016361m.g","KQ415962",318861,320277,1416
"25495","Ocbimv22019476m.g","KQ416011",473158,511441,38283
"25496","Ocbimv22039645m.g","KQ423718",81173,81704,531
"25497","Ocbimv22037010m.g","KQ416669",273392,273625,233
"25498","Ocbimv22011476m.g","KQ417794",62326,63870,1544
"25499","Ocbimv22028205m.g","KQ420444",234660,237054,2394
"25500","Ocbimv22030934m.g","KQ421121",287881,297813,9932
"25501","Ocbimv22009525m.g","KQ415865",813814,821502,7688
"25502","Ocbimv22008528m.g","KQ426666",29955,30274,319
"25503","Ocbimv22032930m.g","KQ421685",194783,194986,203
"25504","Ocbimv22017721m.g","KQ430437",8833,39604,30771
"25505","Ocbimv22011398m.g","KQ417791",1054045,1065944,11899
"25506","Ocbimv22031066m.g","KQ416383",224165,245963,21798
"25507","Ocbimv22015242m.g","KQ418214",144933,145082,149
"25508","Ocbimv22029685m.g","KQ420801",86436,87228,792
"25509","Ocbimv22011405m.g","KQ417791",1131194,1132021,827
"25510","Ocbimv22019621m.g","KQ418789",356440,359244,2804
"25511","Ocbimv22020464m.g","KQ431708",8894,22923,14029
"25512","Ocbimv22033646m.g","KQ421856",50764,54402,3638
"25513","Ocbimv22011166m.g","KQ427657",41560,66546,24986
"25514","Ocbimv22003507m.g","KQ425021",28808,48390,19582
"25515","Ocbimv22001771m.g","KQ416962",102101,111684,9583
"25516","Ocbimv22033390m.g","KQ416479",657559,687735,30176
"25517","Ocbimv22035585m.g","KQ422447",715301,715612,311
"25518","Ocbimv22012848m.g","KQ417945",622874,623696,822
"25519","Ocbimv22013072m.g","KQ417978",35527,35820,293
"25520","Ocbimv22016140m.g","KQ418322",263920,270736,6816
"25521","Ocbimv22024377m.g","KQ433971",1992,3125,1133
"25522","Ocbimv22024563m.g","KQ434053",58339,59657,1318
"25523","Ocbimv22024500m.g","KQ419590",128202,149785,21583
"25524","Ocbimv22004623m.g","KQ415807",132642,162683,30041
"25525","Ocbimv22022202m.g","KQ419184",257025,329268,72243
"25526","Ocbimv22017754m.g","KQ418537",575007,578236,3229
"25527","Ocbimv22034478m.g","KQ422054",26810,27094,284
"25528","Ocbimv22014079m.g","KQ415924",7514,7735,221
"25529","Ocbimv22002817m.g","KQ424788",84994,86666,1672
"25530","Ocbimv22025014m.g","KQ416136",28748,47673,18925
"25531","Ocbimv22006871m.g","KQ426128",31305,31648,343
"25532","Ocbimv22031783m.g","KQ421343",231277,231516,239
"25533","Ocbimv22004838m.g","KQ417209",162585,225809,63224
"25534","Ocbimv22023655m.g","KQ433557",333,754,421
"25535","Ocbimv22016300m.g","KQ429802",10497,16713,6216
"25536","Ocbimv22019268m.g","KQ418739",523661,523825,164
"25537","Ocbimv22000599m.g","KQ424015",390408,390758,350
"25538","Ocbimv22016109m.g","KQ429708",315601,315807,206
"25539","Ocbimv22024623m.g","KQ434076",146,1274,1128
"25540","Ocbimv22015996m.g","KQ429647",5702,11242,5540
"25541","Ocbimv22009419m.g","KQ417591",1234559,1235458,899
"25542","Ocbimv22027009m.g","KQ420162",295880,296369,489
"25543","Ocbimv22017679m.g","KQ430415",3350,4630,1280
"25544","Ocbimv22001070m.g","KQ424172",119626,120160,534
"25545","Ocbimv22004396m.g","KQ417157",15384,15860,476
"25546","Ocbimv22033210m.g","KQ421754",33673,61208,27535
"25547","Ocbimv22014407m.g","KQ418128",151944,152165,221
"25548","Ocbimv22002948m.g","KQ424851",679049,717467,38418
"25549","Ocbimv22020512m.g","KQ418921",640948,642717,1769
"25550","Ocbimv22006769m.g","KQ426101",61184,65433,4249
"25551","Ocbimv22037313m.g","KQ416685",283161,283373,212
"25552","Ocbimv22039069m.g","KQ423532",6303,6800,497
"25553","Ocbimv22021875m.g","KQ432367",5501,5650,149
"25554","Ocbimv22025282m.g","KQ419759",202314,202628,314
"25555","Ocbimv22012517m.g","KQ417917",435953,461961,26008
"25556","Ocbimv22028754m.g","KQ420579",212970,216585,3615
"25557","Ocbimv22020070m.g","KQ418849",190086,225585,35499
"25558","Ocbimv22001212m.g","KQ424229",219026,269410,50384
"25559","Ocbimv22002503m.g","KQ417011",174413,176595,2182
"25560","Ocbimv22010391m.g","KQ427372",1203,38697,37494
"25561","Ocbimv22025783m.g","KQ419904",28973,58835,29862
"25562","Ocbimv22036562m.g","KQ416645",142436,205305,62869
"25563","Ocbimv22016333m.g","LGKD01626591",5,572,567
"25564","Ocbimv22032811m.g","KQ416450",263933,264815,882
"25565","Ocbimv22002699m.g","KQ417027",51367,55551,4184
"25566","Ocbimv22033891m.g","KQ421901",23136,133842,110706
"25567","Ocbimv22027661m.g","KQ420334",43940,44200,260
"25568","Ocbimv22011431m.g","KQ427746",156839,171658,14819
"25569","Ocbimv22030250m.g","KQ420928",302835,303461,626
"25570","Ocbimv22001570m.g","KQ424361",51840,52124,284
"25571","Ocbimv22038214m.g","KQ416731",627123,635546,8423
"25572","Ocbimv22012611m.g","KQ417921",202734,206749,4015
"25573","Ocbimv22022526m.g","KQ419241",245691,277140,31449
"25574","Ocbimv22037499m.g","KQ423049",28957,31120,2163
"25575","Ocbimv22017119m.g","KQ418451",246067,246859,792
"25576","Ocbimv22023168m.g","KQ419366",189899,212433,22534
"25577","Ocbimv22012418m.g","KQ417911",141089,149040,7951
"25578","Ocbimv22024577m.g","KQ419601",251657,251806,149
"25579","Ocbimv22027490m.g","KQ420291",36571,38484,1913
"25580","Ocbimv22036884m.g","KQ422889",585723,586881,1158
"25581","Ocbimv22034183m.g","KQ416518",573192,574284,1092
"25582","Ocbimv22016224m.g","KQ429756",2676,7565,4889
"25583","Ocbimv22001811m.g","KQ424429",93001,99767,6766
"25584","Ocbimv22018976m.g","KQ430934",189760,191434,1674
"25585","Ocbimv22007761m.g","KQ415847",894346,923565,29219
"25586","Ocbimv22032901m.g","KQ416458",34858,35395,537
"25587","Ocbimv22012315m.g","KQ415907",184136,185066,930
"25588","Ocbimv22003145m.g","KQ424895",14727,27423,12696
"25589","Ocbimv22026630m.g","KQ420083",7317,7673,356
"25590","Ocbimv22011413m.g","KQ417791",1342102,1342552,450
"25591","Ocbimv22026665m.g","KQ416196",355462,355781,319
"25592","Ocbimv22013764m.g","KQ418059",356968,375140,18172
"25593","Ocbimv22029558m.g","KQ420776",549842,592389,42547
"25594","Ocbimv22036232m.g","KQ416626",869608,870704,1096
"25595","Ocbimv22000878m.g","KQ424098",43707,44081,374
"25596","Ocbimv22020517m.g","KQ418922",6086,17153,11067
"25597","Ocbimv22002840m.g","KQ424801",122287,122806,519
"25598","Ocbimv22033908m.g","KQ421906",265046,266572,1526
"25599","Ocbimv22037764m.g","KQ423129",1657,23617,21960
"25600","Ocbimv22003073m.g","KQ424877",199355,202301,2946
"25601","Ocbimv22026783m.g","KQ420117",118443,118871,428
"25602","Ocbimv22008160m.g","KQ417481",1125305,1127159,1854
"25603","Ocbimv22025461m.g","KQ419807",266116,283981,17865
"25604","Ocbimv22004645m.g","KQ417192",506233,506789,556
"25605","Ocbimv22031944m.g","KQ415727",750882,751100,218
"25606","Ocbimv22039570m.g","KQ423703",303604,306193,2589
"25607","Ocbimv22004983m.g","KQ417219",235349,236022,673
"25608","Ocbimv22000510m.g","KQ415777",439939,441618,1679
"25609","Ocbimv22012455m.g","KQ428165",96247,104370,8123
"25610","Ocbimv22039648m.g","KQ416811",17538,21497,3959
"25611","Ocbimv22025075m.g","KQ416137",245314,245601,287
"25612","Ocbimv22027920m.g","KQ420404",263683,274349,10666
"25613","Ocbimv22005454m.g","KQ417253",29559,41985,12426
"25614","Ocbimv22000402m.g","KQ423954",294036,294645,609
"25615","Ocbimv22035905m.g","KQ422595",555934,583802,27868
"25616","Ocbimv22012961m.g","KQ417963",3893,18324,14431
"25617","Ocbimv22013723m.g","KQ418053",185885,225914,40029
"25618","Ocbimv22023980m.g","KQ419513",186832,188598,1766
"25619","Ocbimv22018546m.g","KQ430740",20457,52177,31720
"25620","Ocbimv22024338m.g","KQ419574",185385,197336,11951
"25621","Ocbimv22011129m.g","KQ427653",11559,25207,13648
"25622","Ocbimv22018441m.g","KQ415992",311408,350965,39557
"25623","Ocbimv22023464m.g","KQ419414",427188,427451,263
"25624","Ocbimv22005095m.g","KQ417228",5389,5841,452
"25625","Ocbimv22026749m.g","KQ420105",356530,358629,2099
"25626","Ocbimv22022201m.g","KQ419184",251561,253166,1605
"25627","Ocbimv22014143m.g","KQ418094",110867,112602,1735
"25628","Ocbimv22032986m.g","KQ416463",121972,135410,13438
"25629","Ocbimv22014243m.g","KQ428817",106319,117650,11331
"25630","Ocbimv22010811m.g","KQ427524",41096,45059,3963
"25631","Ocbimv22005274m.g","KQ417238",38611,38790,179
"25632","Ocbimv22009907m.g","KQ417622",770898,771497,599
"25633","Ocbimv22032771m.g","KQ421656",63289,63459,170
"25634","Ocbimv22011891m.g","KQ427945",13617,14868,1251
"25635","Ocbimv22037288m.g","KQ422992",48976,49452,476
"25636","Ocbimv22034991m.g","KQ422234",55396,56949,1553
"25637","Ocbimv22030581m.g","KQ416357",816936,817359,423
"25638","Ocbimv22039426m.g","KQ423655",224813,230664,5851
"25639","Ocbimv22023912m.g","KQ433699",120390,163354,42964
"25640","Ocbimv22004451m.g","KQ425308",13812,20150,6338
"25641","Ocbimv22025474m.g","KQ419813",23632,61058,37426
"25642","Ocbimv22033996m.g","KQ416504",45149,46363,1214
"25643","Ocbimv22033355m.g","KQ421796",41680,41985,305
"25644","Ocbimv22020131m.g","KQ418859",157565,188091,30526
"25645","Ocbimv22001767m.g","KQ416962",70040,73366,3326
"25646","Ocbimv22000169m.g","KQ416847",256592,261213,4621
"25647","Ocbimv22014044m.g","KQ428732",86251,86520,269
"25648","Ocbimv22009191m.g","KQ426914",150753,164742,13989
"25649","Ocbimv22011270m.g","KQ417771",1597765,1637762,39997
"25650","Ocbimv22032187m.g","KQ421473",1808,2023,215
"25651","Ocbimv22029327m.g","KQ416298",150661,156775,6114
"25652","Ocbimv22031131m.g","KQ415721",399725,410081,10356
"25653","Ocbimv22036477m.g","KQ416642",364020,364400,380
"25654","Ocbimv22033523m.g","KQ421824",90834,93424,2590
"25655","Ocbimv22030701m.g","KQ421074",141712,181837,40125
"25656","Ocbimv22024947m.g","KQ419660",305212,323188,17976
"25657","Ocbimv22028395m.g","KQ416257",764237,766840,2603
"25658","Ocbimv22028030m.g","KQ416244",37741,49091,11350
"25659","Ocbimv22039604m.g","KQ423717",4847,21673,16826
"25660","Ocbimv22027668m.g","KQ416230",110371,110727,356
"25661","Ocbimv22039868m.g","KQ416832",57038,81410,24372
"25662","Ocbimv22024678m.g","KQ419615",11111,96292,85181
"25663","Ocbimv22014218m.g","KQ418103",82457,83824,1367
"25664","Ocbimv22011327m.g","KQ417781",7161,8638,1477
"25665","Ocbimv22039034m.g","KQ423517",38716,39217,501
"25666","Ocbimv22007266m.g","KQ417395",423377,423706,329
"25667","Ocbimv22036744m.g","KQ422849",85415,86179,764
"25668","Ocbimv22039395m.g","KQ416793",3557,4220,663
"25669","Ocbimv22021612m.g","KQ432245",144885,147703,2818
"25670","Ocbimv22008196m.g","KQ426573",260305,261132,827
"25671","Ocbimv22026652m.g","KQ420085",522314,576507,54193
"25672","Ocbimv22028822m.g","KQ420587",244291,244689,398
"25673","Ocbimv22015926m.g","KQ418303",950431,953842,3411
"25674","Ocbimv22003634m.g","KQ417097",110212,112302,2090
"25675","Ocbimv22017586m.g","KQ418510",11137,11490,353
"25676","Ocbimv22026096m.g","KQ419989",253661,260042,6381
"25677","Ocbimv22032322m.g","KQ421523",289805,307750,17945
"25678","Ocbimv22008668m.g","KQ417519",610338,612971,2633
"25679","Ocbimv22026485m.g","KQ420055",846218,848775,2557
"25680","Ocbimv22025083m.g","KQ416137",422633,424339,1706
"25681","Ocbimv22010972m.g","KQ417729",1006310,1022373,16063
"25682","Ocbimv22036743m.g","KQ422849",84122,84442,320
"25683","Ocbimv22021614m.g","KQ432252",192851,208354,15503
"25684","Ocbimv22033623m.g","KQ416489",221,4711,4490
"25685","Ocbimv22019487m.g","LGKD01651170",47,262,215
"25686","Ocbimv22006993m.g","KQ417370",81187,86300,5113
"25687","Ocbimv22011840m.g","KQ417836",482904,483966,1062
"25688","Ocbimv22006513m.g","KQ417330",35881,39353,3472
"25689","Ocbimv22013683m.g","KQ418045",283701,290539,6838
"25690","Ocbimv22035488m.g","KQ422403",33495,34633,1138
"25691","Ocbimv22001338m.g","KQ424278",73181,110742,37561
"25692","Ocbimv22037643m.g","KQ423089",16066,16699,633
"25693","Ocbimv22037968m.g","KQ416716",468566,481473,12907
"25694","Ocbimv22000345m.g","KQ416854",1125401,1126412,1011
"25695","Ocbimv22022561m.g","KQ432866",7435,68639,61204
"25696","Ocbimv22000620m.g","KQ416870",1679,40128,38449
"25697","Ocbimv22008316m.g","KQ426613",298948,326768,27820
"25698","Ocbimv22011069m.g","KQ427618",8698,15661,6963
"25699","Ocbimv22034235m.g","KQ416526",416185,416505,320
"25700","Ocbimv22021140m.g","KQ419009",186687,190095,3408
"25701","Ocbimv22021148m.g","KQ419009",370596,384916,14320
"25702","Ocbimv22012203m.g","KQ417888",260880,262110,1230
"25703","Ocbimv22015854m.g","KQ418296",470697,471311,614
"25704","Ocbimv22007157m.g","KQ415838",90574,93151,2577
"25705","Ocbimv22010835m.g","KQ427538",31406,32174,768
"25706","Ocbimv22016566m.g","KQ418368",42567,72108,29541
"25707","Ocbimv22024429m.g","KQ419577",509678,512687,3009
"25708","Ocbimv22019249m.g","KQ431068",6127,6737,610
"25709","Ocbimv22017800m.g","KQ418547",794956,854290,59334
"25710","Ocbimv22012692m.g","KQ417927",32206,32724,518
"25711","Ocbimv22018391m.g","KQ430678",54200,54598,398
"25712","Ocbimv22010259m.g","KQ415873",354013,354337,324
"25713","Ocbimv22007578m.g","KQ417431",128911,130381,1470
"25714","Ocbimv22000972m.g","KQ424141",84245,85717,1472
"25715","Ocbimv22037128m.g","KQ422932",10164,35374,25210
"25716","Ocbimv22034354m.g","KQ422018",29052,43010,13958
"25717","Ocbimv22025248m.g","KQ419745",91488,91868,380
"25718","Ocbimv22035684m.g","KQ422516",455011,458966,3955
"25719","Ocbimv22000936m.g","KQ424123",19972,36928,16956
"25720","Ocbimv22008442m.g","KQ426638",56097,56641,544
"25721","Ocbimv22012019m.g","KQ427973",30781,38055,7274
"25722","Ocbimv22002970m.g","KQ417051",1997479,2016655,19176
"25723","Ocbimv22029399m.g","KQ420741",1174424,1325539,151115
"25724","Ocbimv22012038m.g","KQ427981",262,586,324
"25725","Ocbimv22034170m.g","KQ416518",317333,322072,4739
"25726","Ocbimv22013522m.g","KQ428540",71153,71504,351
"25727","Ocbimv22039427m.g","KQ423655",261314,286863,25549
"25728","Ocbimv22032305m.g","KQ421521",203508,203714,206
"25729","Ocbimv22038933m.g","KQ423492",4589,6545,1956
"25730","Ocbimv22035249m.g","KQ422341",123295,123768,473
"25731","Ocbimv22003736m.g","KQ425077",91521,108459,16938
"25732","Ocbimv22007531m.g","KQ426364",3290,3901,611
"25733","Ocbimv22007684m.g","KQ415846",174545,178368,3823
"25734","Ocbimv22019524m.g","KQ416015",168420,168641,221
"25735","Ocbimv22021231m.g","KQ432056",40059,40481,422
"25736","Ocbimv22021220m.g","KQ419014",139755,140039,284
"25737","Ocbimv22015123m.g","KQ418196",201681,217896,16215
"25738","Ocbimv22036602m.g","KQ422804",25405,25968,563
"25739","Ocbimv22012531m.g","KQ417917",731177,731785,608
"25740","Ocbimv22015828m.g","KQ418295",192426,194040,1614
"25741","Ocbimv22018498m.g","KQ418629",1877,2743,866
"25742","Ocbimv22013640m.g","KQ428581",96988,100801,3813
"25743","Ocbimv22031067m.g","KQ416383",267602,268242,640
"25744","Ocbimv22035756m.g","KQ422527",60448,60816,368
"25745","Ocbimv22037446m.g","KQ416696",74287,74487,200
"25746","Ocbimv22017887m.g","KQ430509",17593,17796,203
"25747","Ocbimv22020338m.g","KQ418897",130511,130723,212
"25748","Ocbimv22035965m.g","KQ416612",1970826,2000894,30068
"25749","Ocbimv22001919m.g","KQ424476",21487,119381,97894
"25750","Ocbimv22035970m.g","KQ422621",87595,95271,7676
"25751","Ocbimv22029976m.g","KQ420866",7,2812,2805
"25752","Ocbimv22002701m.g","KQ417027",247258,270483,23225
"25753","Ocbimv22033816m.g","KQ421880",210949,211242,293
"25754","Ocbimv22019560m.g","KQ418783",862971,916140,53169
"25755","Ocbimv22030260m.g","KQ420931",24069,24395,326
"25756","Ocbimv22019459m.g","KQ418770",112803,112961,158
"25757","Ocbimv22004729m.g","KQ417204",189536,208369,18833
"25758","Ocbimv22016147m.g","KQ418322",471124,471425,301
"25759","Ocbimv22010205m.g","KQ417655",487551,487766,215
"25760","Ocbimv22008432m.g","KQ417501",253353,321835,68482
"25761","Ocbimv22032863m.g","KQ421669",15321,26156,10835
"25762","Ocbimv22034370m.g","KQ422021",25081,28156,3075
"25763","Ocbimv22005268m.g","KQ415814",245397,246543,1146
"25764","Ocbimv22005555m.g","KQ417261",74226,74417,191
"25765","Ocbimv22024617m.g","KQ416126",616372,617842,1470
"25766","Ocbimv22009831m.g","KQ417620",483373,498495,15122
"25767","Ocbimv22017045m.g","KQ418444",164772,168535,3763
"25768","Ocbimv22025831m.g","KQ419909",391281,399669,8388
"25769","Ocbimv22038242m.g","KQ423246",86377,86664,287
"25770","Ocbimv22028837m.g","KQ420591",143492,146652,3160
"25771","Ocbimv22011851m.g","KQ417843",353,751,398
"25772","Ocbimv22021738m.g","KQ419093",15309,57947,42638
"25773","Ocbimv22030416m.g","KQ420973",63262,124813,61551
"25774","Ocbimv22008900m.g","KQ417538",79160,108623,29463
"25775","Ocbimv22033878m.g","KQ421896",523887,541524,17637
"25776","Ocbimv22039935m.g","KQ423801",104032,123324,19292
"25777","Ocbimv22015752m.g","KQ418289",224005,224848,843
"25778","Ocbimv22030208m.g","KQ420924",149751,192610,42859
"25779","Ocbimv22017483m.g","KQ418500",171929,176075,4146
"25780","Ocbimv22001777m.g","KQ424412",17611,18089,478
"25781","Ocbimv22003411m.g","KQ417086",601139,601677,538
"25782","Ocbimv22028622m.g","KQ416264",961476,962418,942
"25783","Ocbimv22009121m.g","KQ426892",28814,33861,5047
"25784","Ocbimv22017051m.g","KQ418445",7775,35189,27414
"25785","Ocbimv22014043m.g","KQ428730",26510,33607,7097
"25786","Ocbimv22009073m.g","KQ426859",32468,45636,13168
"25787","Ocbimv22012229m.g","KQ417892",38410,42341,3931
"25788","Ocbimv22017281m.g","KQ418475",285237,329999,44762
"25789","Ocbimv22012206m.g","KQ428074",38234,44611,6377
"25790","Ocbimv22036869m.g","KQ416664",214057,214251,194
"25791","Ocbimv22004680m.g","KQ425420",26631,27044,413
"25792","Ocbimv22031759m.g","KQ421338",785027,785491,464
"25793","Ocbimv22001594m.g","KQ424367",34443,49627,15184
"25794","Ocbimv22009033m.g","KQ417554",7447,8567,1120
"25795","Ocbimv22015199m.g","KQ418205",250056,261954,11898
"25796","Ocbimv22032829m.g","KQ421664",919504,920328,824
"25797","Ocbimv22038684m.g","KQ423442",102760,103296,536
"25798","Ocbimv22036788m.g","KQ416657",309663,309932,269
"25799","Ocbimv22009921m.g","KQ417623",21563,25078,3515
"25800","Ocbimv22028501m.g","KQ416259",379655,384130,4475
"25801","Ocbimv22017252m.g","LGKD01634198",90,392,302
"25802","Ocbimv22003595m.g","KQ417094",249320,250571,1251
"25803","Ocbimv22013417m.g","KQ418021",195593,200324,4731
"25804","Ocbimv22033743m.g","KQ421864",108932,109500,568
"25805","Ocbimv22001092m.g","KQ424178",20238,20954,716
"25806","Ocbimv22020207m.g","KQ418873",449439,485654,36215
"25807","Ocbimv22001609m.g","KQ416947",216441,231512,15071
"25808","Ocbimv22029082m.g","KQ420642",254482,257862,3380
"25809","Ocbimv22022397m.g","KQ419215",233653,258677,25024
"25810","Ocbimv22012485m.g","KQ417917",96754,98291,1537
"25811","Ocbimv22033004m.g","KQ421715",22484,22789,305
"25812","Ocbimv22029760m.g","KQ420820",74385,74842,457
"25813","Ocbimv22029960m.g","KQ420859",524772,536969,12197
"25814","Ocbimv22027479m.g","KQ416225",184074,193833,9759
"25815","Ocbimv22033562m.g","KQ421832",58414,64305,5891
"25816","Ocbimv22006293m.g","LGKD01544075",14,292,278
"25817","Ocbimv22006865m.g","KQ417358",853575,863497,9922
"25818","Ocbimv22033638m.g","KQ421854",204040,205032,992
"25819","Ocbimv22024990m.g","KQ419672",279710,279933,223
"25820","Ocbimv22034943m.g","KQ422220",36621,37729,1108
"25821","Ocbimv22017701m.g","KQ430417",292617,302595,9978
"25822","Ocbimv22007233m.g","KQ426258",38311,38837,526
"25823","Ocbimv22021562m.g","KQ419078",108557,108838,281
"25824","Ocbimv22039659m.g","KQ423719",52328,52549,221
"25825","Ocbimv22030362m.g","KQ420963",58956,61163,2207
"25826","Ocbimv22014077m.g","KQ418087",713917,724654,10737
"25827","Ocbimv22026374m.g","KQ416188",190765,304452,113687
"25828","Ocbimv22012920m.g","LGKD01597502",11,301,290
"25829","Ocbimv22015078m.g","KQ418194",1440138,1473902,33764
"25830","Ocbimv22022173m.g","KQ419180",519554,521654,2100
"25831","Ocbimv22002886m.g","KQ424814",331328,331699,371
"25832","Ocbimv22024838m.g","KQ419639",202236,203070,834
"25833","Ocbimv22032188m.g","KQ421476",51254,95099,43845
"25834","Ocbimv22024239m.g","KQ433876",70906,115128,44222
"25835","Ocbimv22003738m.g","KQ425078",18786,20570,1784
"25836","Ocbimv22006810m.g","KQ417353",47362,181539,134177
"25837","Ocbimv22031660m.g","LGKD01394448",56,268,212
"25838","Ocbimv22001078m.g","KQ424173",142439,151529,9090
"25839","Ocbimv22036795m.g","KQ416657",498319,507964,9645
"25840","Ocbimv22029736m.g","KQ420814",166961,167425,464
"25841","Ocbimv22000910m.g","KQ424108",2608,2857,249
"25842","Ocbimv22018776m.g","KQ418671",119931,120323,392
"25843","Ocbimv22025872m.g","KQ419917",532375,532578,203
"25844","Ocbimv22038176m.g","KQ423226",42204,42593,389
"25845","Ocbimv22027762m.g","KQ420358",365666,373939,8273
"25846","Ocbimv22013746m.g","KQ415920",9997,27655,17658
"25847","Ocbimv22019177m.g","KQ418729",11845,28755,16910
"25848","Ocbimv22036034m.g","KQ416614",752084,810775,58691
"25849","Ocbimv22004116m.g","KQ425205",1904,17838,15934
"25850","Ocbimv22026260m.g","KQ420022",233084,233260,176
"25851","Ocbimv22017075m.g","KQ430159",24312,67208,42896
"25852","Ocbimv22003601m.g","KQ425041",265150,266739,1589
"25853","Ocbimv22032641m.g","KQ421625",168748,175656,6908
"25854","Ocbimv22008771m.g","KQ417533",52159,66245,14086
"25855","Ocbimv22000137m.g","KQ423868",786,1013,227
"25856","Ocbimv22002728m.g","KQ417029",39147,42769,3622
"25857","Ocbimv22011285m.g","KQ427700",88680,91307,2627
"25858","Ocbimv22029683m.g","KQ420800",28809,36854,8045
"25859","Ocbimv22007034m.g","KQ417370",627304,628146,842
"25860","Ocbimv22024122m.g","KQ419535",891102,893395,2293
"25861","Ocbimv22000060m.g","KQ423839",189687,197577,7890
"25862","Ocbimv22034380m.g","KQ422023",13403,19022,5619
"25863","Ocbimv22009216m.g","KQ417575",84098,84403,305
"25864","Ocbimv22014274m.g","KQ418112",128183,144225,16042
"25865","Ocbimv22000765m.g","KQ416879",217479,234409,16930
"25866","Ocbimv22031355m.g","KQ421221",109400,109597,197
"25867","Ocbimv22028056m.g","KQ420424",106026,109236,3210
"25868","Ocbimv22027493m.g","KQ416226",40466,81578,41112
"25869","Ocbimv22001245m.g","KQ424238",116843,117862,1019
"25870","Ocbimv22038560m.g","KQ416751",344805,356256,11451
"25871","Ocbimv22005159m.g","KQ425533",202353,203481,1128
"25872","Ocbimv22000654m.g","KQ416874",157166,157345,179
"25873","Ocbimv22026024m.g","KQ419957",363160,363438,278
"25874","Ocbimv22001596m.g","KQ424367",52556,59005,6449
"25875","Ocbimv22026122m.g","KQ419991",121182,121457,275
"25876","Ocbimv22005859m.g","KQ417280",282935,292321,9386
"25877","Ocbimv22033275m.g","KQ421759",393845,394294,449
"25878","Ocbimv22034788m.g","KQ416552",50893,55883,4990
"25879","Ocbimv22012833m.g","KQ417945",138391,139068,677
"25880","Ocbimv22019529m.g","LGKD01651815",1,222,221
"25881","Ocbimv22014583m.g","KQ428994",194610,195119,509
"25882","Ocbimv22015866m.g","KQ418297",456944,485650,28706
"25883","Ocbimv22010762m.g","KQ417713",988326,1020704,32378
"25884","Ocbimv22000086m.g","KQ416839",54153,67692,13539
"25885","Ocbimv22012268m.g","KQ417897",480496,480726,230
"25886","Ocbimv22031914m.g","KQ421376",961915,1001877,39962
"25887","Ocbimv22013483m.g","KQ415916",54147,55447,1300
"25888","Ocbimv22004826m.g","KQ417209",76276,77184,908
"25889","Ocbimv22020071m.g","KQ418849",232550,246932,14382
"25890","Ocbimv22038999m.g","KQ423506",114755,115145,390
"25891","Ocbimv22021715m.g","KQ419091",163039,163500,461
"25892","Ocbimv22001576m.g","KQ416945",205454,404130,198676
"25893","Ocbimv22022489m.g","KQ419232",127726,129027,1301
"25894","Ocbimv22012731m.g","KQ417931",1155221,1156563,1342
"25895","Ocbimv22012646m.g","KQ428192",262629,286140,23511
"25896","Ocbimv22006037m.g","KQ417290",73826,97079,23253
"25897","Ocbimv22008504m.g","KQ417506",460776,478791,18015
"25898","Ocbimv22009914m.g","KQ427153",87756,97851,10095
"25899","Ocbimv22013065m.g","KQ428358",10890,11962,1072
"25900","Ocbimv22002806m.g","KQ417037",390413,400994,10581
"25901","Ocbimv22029920m.g","KQ420849",12349,68559,56210
"25902","Ocbimv22031224m.g","KQ421201",108230,122966,14736
"25903","Ocbimv22016795m.g","KQ418400",58271,150160,91889
"25904","Ocbimv22033950m.g","KQ416501",37208,54653,17445
"25905","Ocbimv22008768m.g","KQ426765",7620,8801,1181
"25906","Ocbimv22007726m.g","KQ426439",20330,20554,224
"25907","Ocbimv22003445m.g","KQ425015",5147,5681,534
"25908","Ocbimv22032101m.g","KQ421447",22891,24071,1180
"25909","Ocbimv22023020m.g","KQ416080",356472,356672,200
"25910","Ocbimv22002614m.g","KQ417023",349778,435516,85738
"25911","Ocbimv22036986m.g","KQ416667",56248,77185,20937
"25912","Ocbimv22006768m.g","KQ426101",30405,49005,18600
"25913","Ocbimv22028119m.g","KQ420434",269334,270130,796
"25914","Ocbimv22027772m.g","KQ420365",411326,515618,104292
"25915","Ocbimv22000954m.g","KQ415782",151579,190288,38709
"25916","Ocbimv22035365m.g","KQ416583",123472,123705,233
"25917","Ocbimv22000651m.g","KQ424033",424,10835,10411
"25918","Ocbimv22018729m.g","KQ418663",15866,112721,96855
"25919","Ocbimv22037664m.g","KQ416705",1800868,1802413,1545
"25920","Ocbimv22029944m.g","KQ416325",113509,114369,860
"25921","Ocbimv22031526m.g","KQ421265",218170,218334,164
"25922","Ocbimv22033620m.g","KQ421850",9147,11025,1878
"25923","Ocbimv22021400m.g","KQ432116",73423,105330,31907
"25924","Ocbimv22000160m.g","KQ416846",77180,106294,29114
"25925","Ocbimv22021225m.g","KQ419015",242598,244756,2158
"25926","Ocbimv22019270m.g","KQ418739",560931,570783,9852
"25927","Ocbimv22018575m.g","KQ418642",5754,49002,43248
"25928","Ocbimv22008306m.g","KQ417496",273128,273628,500
"25929","Ocbimv22018080m.g","KQ418571",103673,108519,4846
"25930","Ocbimv22034591m.g","KQ422081",141612,157721,16109
"25931","Ocbimv22014734m.g","KQ418173",106166,135878,29712
"25932","Ocbimv22017816m.g","KQ418549",710518,715780,5262
"25933","Ocbimv22020421m.g","KQ431672",5929,6441,512
"25934","Ocbimv22035277m.g","KQ422349",89891,104024,14133
"25935","Ocbimv22026709m.g","KQ420096",321939,325638,3699
"25936","Ocbimv22039442m.g","KQ416799",1042176,1042712,536
"25937","Ocbimv22018278m.g","KQ418590",372403,380657,8254
"25938","Ocbimv22009766m.g","KQ417611",571136,643719,72583
"25939","Ocbimv22025843m.g","KQ419912",5801,72214,66413
"25940","Ocbimv22039593m.g","KQ416807",11862,47798,35936
"25941","Ocbimv22011473m.g","KQ417793",330490,344757,14267
"25942","Ocbimv22014500m.g","KQ428970",2011,15316,13305
"25943","Ocbimv22025627m.g","KQ419863",33086,45644,12558
"25944","Ocbimv22032126m.g","KQ421454",180642,209040,28398
"25945","Ocbimv22007813m.g","KQ426461",149853,154823,4970
"25946","Ocbimv22034891m.g","KQ422208",351675,386445,34770
"25947","Ocbimv22031785m.g","KQ421344",3027,3911,884
"25948","Ocbimv22005645m.g","KQ425692",431370,432033,663
"25949","Ocbimv22023930m.g","KQ419500",846892,862122,15230
"25950","Ocbimv22002465m.g","KQ424662",69460,204679,135219
"25951","Ocbimv22010926m.g","KQ417725",236001,242955,6954
"25952","Ocbimv22023449m.g","KQ419413",60911,150294,89383
"25953","Ocbimv22012980m.g","KQ415912",159051,159278,227
"25954","Ocbimv22001548m.g","KQ424353",416694,418540,1846
"25955","Ocbimv22034638m.g","KQ416542",49120,49755,635
"25956","Ocbimv22035661m.g","KQ422493",416442,435352,18910
"25957","Ocbimv22039608m.g","KQ423717",76695,77156,461
"25958","Ocbimv22009314m.g","KQ417582",836172,923645,87473
"25959","Ocbimv22005408m.g","KQ417249",2423520,2452991,29471
"25960","Ocbimv22039759m.g","KQ423738",101590,111508,9918
"25961","Ocbimv22002887m.g","KQ424814",420216,432533,12317
"25962","Ocbimv22021665m.g","KQ416049",324004,328345,4341
"25963","Ocbimv22034705m.g","KQ416547",257516,263472,5956
"25964","Ocbimv22026646m.g","KQ420085",292580,315803,23223
"25965","Ocbimv22035871m.g","KQ422590",7568,7980,412
"25966","Ocbimv22002097m.g","KQ424539",371341,371852,511
"25967","Ocbimv22014262m.g","KQ428826",3,544,541
"25968","Ocbimv22013350m.g","KQ428460",12063,12746,683
"25969","Ocbimv22024841m.g","KQ419640",25331,81275,55944
"25970","Ocbimv22011546m.g","KQ427776",16712,17473,761
"25971","Ocbimv22028706m.g","KQ420562",52545,53122,577
"25972","Ocbimv22007185m.g","KQ426226",55855,90725,34870
"25973","Ocbimv22031695m.g","KQ421308",1037471,1037957,486
"25974","Ocbimv22013189m.g","KQ428420",154101,201692,47591
"25975","Ocbimv22015176m.g","KQ429178",6110,7796,1686
"25976","Ocbimv22026086m.g","KQ419989",139807,140826,1019
"25977","Ocbimv22009796m.g","KQ427137",119898,120652,754
"25978","Ocbimv22009953m.g","KQ427178",72168,90286,18118
"25979","Ocbimv22000824m.g","KQ424081",314631,315197,566
"25980","Ocbimv22039678m.g","KQ416813",1258378,1258999,621
"25981","Ocbimv22024969m.g","KQ419670",74767,88264,13497
"25982","Ocbimv22039662m.g","KQ423720",14349,103851,89502
"25983","Ocbimv22008578m.g","KQ417510",236862,253104,16242
"25984","Ocbimv22038273m.g","KQ423259",470319,470845,526
"25985","Ocbimv22033204m.g","KQ421752",6891,52395,45504
"25986","Ocbimv22002702m.g","KQ417027",338841,339363,522
"25987","Ocbimv22012612m.g","KQ417921",268497,270870,2373
"25988","Ocbimv22031252m.g","KQ421206",572923,573501,578
"25989","Ocbimv22028053m.g","KQ420424",4469,7376,2907
"25990","Ocbimv22039792m.g","KQ423752",23998,25766,1768
"25991","Ocbimv22010295m.g","KQ417665",1542546,1543838,1292
"25992","Ocbimv22026867m.g","KQ420132",705313,705540,227
"25993","Ocbimv22010795m.g","KQ417715",34598,55324,20726
"25994","Ocbimv22032712m.g","KQ421639",32147,33141,994
"25995","Ocbimv22023079m.g","KQ419344",93822,94208,386
"25996","Ocbimv22031342m.g","KQ421219",219195,219446,251
"25997","Ocbimv22001400m.g","KQ416931",180897,181837,940
"25998","Ocbimv22024510m.g","KQ419590",850423,851529,1106
"25999","Ocbimv22035323m.g","KQ422351",675555,690400,14845
"26000","Ocbimv22018125m.g","LGKD01640953",321,494,173
"26001","Ocbimv22009208m.g","KQ417574",1251375,1251692,317
"26002","Ocbimv22001960m.g","KQ424498",10765,12508,1743
"26003","Ocbimv22027831m.g","KQ420375",1310282,1327805,17523
"26004","Ocbimv22019783m.g","KQ431304",49629,67017,17388
"26005","Ocbimv22017667m.g","KQ418525",280335,285488,5153
"26006","Ocbimv22009099m.g","KQ417561",154562,154825,263
"26007","Ocbimv22024605m.g","KQ419601",1302706,1347447,44741
"26008","Ocbimv22026710m.g","KQ420096",329338,365016,35678
"26009","Ocbimv22006750m.g","KQ417347",101529,101990,461
"26010","Ocbimv22003853m.g","KQ425131",1,12499,12498
"26011","Ocbimv22001337m.g","KQ424278",63806,64710,904
"26012","Ocbimv22035624m.g","KQ422479",58451,59724,1273
"26013","Ocbimv22006664m.g","KQ417342",77363,79036,1673
"26014","Ocbimv22024810m.g","KQ419631",491231,492422,1191
"26015","Ocbimv22039866m.g","KQ423782",162166,162495,329
"26016","Ocbimv22012752m.g","KQ415909",232299,233308,1009
"26017","Ocbimv22001193m.g","KQ424222",9673,10899,1226
"26018","Ocbimv22025417m.g","KQ419796",1461,21040,19579
"26019","Ocbimv22026093m.g","KQ419989",190040,200087,10047
"26020","Ocbimv22012802m.g","KQ417942",394894,408885,13991
"26021","Ocbimv22036759m.g","KQ416656",16667,22624,5957
"26022","Ocbimv22016231m.g","KQ429763",35,15034,14999
"26023","Ocbimv22034528m.g","KQ422073",41677,41952,275
"26024","Ocbimv22039075m.g","KQ423536",435861,436067,206
"26025","Ocbimv22038989m.g","LGKD01477553",2,196,194
"26026","Ocbimv22029129m.g","KQ420661",176193,177104,911
"26027","Ocbimv22010888m.g","KQ417722",397795,461809,64014
"26028","Ocbimv22014527m.g","KQ415932",1497739,1498215,476
"26029","Ocbimv22015740m.g","LGKD01621613",52,240,188
"26030","Ocbimv22037804m.g","KQ423136",118453,122788,4335
"26031","Ocbimv22014721m.g","KQ418170",77944,105894,27950
"26032","Ocbimv22037750m.g","KQ416708",520491,521038,547
"26033","Ocbimv22003640m.g","KQ425061",107645,118467,10822
"26034","Ocbimv22019966m.g","KQ418839",435730,436098,368
"26035","Ocbimv22031492m.g","KQ421261",294967,343990,49023
"26036","Ocbimv22022166m.g","KQ419180",371869,400282,28413
"26037","Ocbimv22029927m.g","KQ420850",73827,100005,26178
"26038","Ocbimv22016853m.g","KQ418413",91351,98965,7614
"26039","Ocbimv22017796m.g","KQ418547",412522,413628,1106
"26040","Ocbimv22030404m.g","KQ420971",88893,90517,1624
"26041","Ocbimv22033064m.g","KQ421721",759724,763221,3497
"26042","Ocbimv22030881m.g","KQ421116",203360,203677,317
"26043","Ocbimv22026669m.g","KQ416196",421364,422087,723
"26044","Ocbimv22016346m.g","KQ415679",12964,19763,6799
"26045","Ocbimv22023329m.g","LGKD01687845",17,145,128
"26046","Ocbimv22028225m.g","KQ420447",5847,6134,287
"26047","Ocbimv22029221m.g","KQ420685",226590,226739,149
"26048","Ocbimv22002338m.g","KQ415791",80425,81543,1118
"26049","Ocbimv22017006m.g","KQ430115",4552,4884,332
"26050","Ocbimv22038841m.g","KQ416768",372382,383393,11011
"26051","Ocbimv22032555m.g","KQ421583",24554,35559,11005
"26052","Ocbimv22031047m.g","KQ421147",271881,272688,807
"26053","Ocbimv22035232m.g","KQ422328",7522,7964,442
"26054","Ocbimv22001555m.g","KQ424355",72225,72401,176
"26055","Ocbimv22011142m.g","KQ427654",28075,32692,4617
"26056","Ocbimv22033594m.g","KQ421843",50829,59721,8892
"26057","Ocbimv22016644m.g","KQ418373",180999,182968,1969
"26058","Ocbimv22033614m.g","KQ421847",95173,95505,332
"26059","Ocbimv22017866m.g","KQ418552",448937,450805,1868
"26060","Ocbimv22032077m.g","KQ416418",12056,59495,47439
"26061","Ocbimv22003037m.g","KQ417055",1590169,1590795,626
"26062","Ocbimv22006670m.g","KQ415833",9965,10968,1003
"26063","Ocbimv22002335m.g","KQ417002",5926,10078,4152
"26064","Ocbimv22011288m.g","KQ417776",27382,50307,22925
"26065","Ocbimv22029437m.g","KQ416306",1383824,1384372,548
"26066","Ocbimv22032798m.g","KQ421658",635363,645136,9773
"26067","Ocbimv22004626m.g","KQ417186",13207,25501,12294
"26068","Ocbimv22002987m.g","KQ424856",190656,192647,1991
"26069","Ocbimv22012029m.g","KQ427974",156397,195335,38938
"26070","Ocbimv22016383m.g","KQ415962",1654851,1655355,504
"26071","Ocbimv22030136m.g","KQ416333",50032,50280,248
"26072","Ocbimv22025885m.g","KQ416175",430228,430674,446
"26073","Ocbimv22011383m.g","KQ417791",615922,616134,212
"26074","Ocbimv22005468m.g","KQ425611",510541,632861,122320
"26075","Ocbimv22009806m.g","KQ417618",24786,25873,1087
"26076","Ocbimv22002734m.g","KQ417030",1231088,1231465,377
"26077","Ocbimv22004699m.g","KQ417198",344550,360276,15726
"26078","Ocbimv22038744m.g","KQ416764",436068,437986,1918
"26079","Ocbimv22028873m.g","KQ420595",687076,687453,377
"26080","Ocbimv22008840m.g","KQ417537",171280,171474,194
"26081","Ocbimv22034349m.g","KQ422016",364337,466700,102363
"26082","Ocbimv22026464m.g","KQ420053",605566,606000,434
"26083","Ocbimv22035829m.g","KQ422567",33690,44397,10707
"26084","Ocbimv22006207m.g","KQ417304",134582,141291,6709
"26085","Ocbimv22005290m.g","KQ425571",86091,98943,12852
"26086","Ocbimv22026965m.g","KQ420154",174583,177075,2492
"26087","Ocbimv22010770m.g","KQ427511",108594,112143,3549
"26088","Ocbimv22029095m.g","KQ420647",3042,5063,2021
"26089","Ocbimv22026124m.g","KQ419991",136165,137109,944
"26090","Ocbimv22010307m.g","KQ427350",18532,34080,15548
"26091","Ocbimv22024537m.g","KQ419593",64155,74957,10802
"26092","Ocbimv22009132m.g","KQ417566",75846,76786,940
"26093","Ocbimv22029116m.g","KQ420658",1,487,486
"26094","Ocbimv22018440m.g","KQ415992",288409,295509,7100
"26095","Ocbimv22016195m.g","KQ429745",956,1105,149
"26096","Ocbimv22025053m.g","KQ416136",980548,981960,1412
"26097","Ocbimv22015216m.g","KQ429209",51194,61882,10688
"26098","Ocbimv22032623m.g","KQ416442",89489,90414,925
"26099","Ocbimv22010858m.g","KQ417720",13889,39490,25601
"26100","Ocbimv22029363m.g","KQ416300",20328,22775,2447
"26101","Ocbimv22009005m.g","KQ417549",367800,368184,384
"26102","Ocbimv22008128m.g","KQ417481",121745,133748,12003
"26103","Ocbimv22035983m.g","KQ422621",250685,251089,404
"26104","Ocbimv22016522m.g","KQ418364",247374,285330,37956
"26105","Ocbimv22030340m.g","KQ420957",8247,8492,245
"26106","Ocbimv22005656m.g","KQ417271",158,1714,1556
"26107","Ocbimv22023491m.g","KQ416088",587039,587344,305
"26108","Ocbimv22011798m.g","KQ427906",81330,82707,1377
"26109","Ocbimv22013966m.g","LGKD01605363",1,403,402
"26110","Ocbimv22034206m.g","KQ416523",416209,418532,2323
"26111","Ocbimv22019117m.g","KQ418718",156434,176696,20262
"26112","Ocbimv22031873m.g","KQ421368",118486,158997,40511
"26113","Ocbimv22002449m.g","KQ424659",160223,170443,10220
"26114","Ocbimv22016066m.g","KQ429689",67743,67922,179
"26115","Ocbimv22017303m.g","KQ415681",473325,473675,350
"26116","Ocbimv22025576m.g","KQ419849",162513,167278,4765
"26117","Ocbimv22027440m.g","LGKD01345758",3,278,275
"26118","Ocbimv22015526m.g","KQ415945",874708,909756,35048
"26119","Ocbimv22004512m.g","KQ417173",3848879,3892444,43565
"26120","Ocbimv22013070m.g","LGKD01599037",735,1534,799
"26121","Ocbimv22039783m.g","KQ416822",156070,156999,929
"26122","Ocbimv22014541m.g","KQ428981",89754,107581,17827
"26123","Ocbimv22027041m.g","KQ416209",71991,72826,835
"26124","Ocbimv22035714m.g","KQ422521",159626,167368,7742
"26125","Ocbimv22009561m.g","KQ427019",4986,5219,233
"26126","Ocbimv22032720m.g","KQ421646",4181,5299,1118
"26127","Ocbimv22003371m.g","KQ424997",37674,39462,1788
"26128","Ocbimv22039928m.g","KQ423797",216561,237272,20711
"26129","Ocbimv22038621m.g","KQ423422",245917,246505,588
"26130","Ocbimv22012759m.g","KQ417936",105644,112128,6484
"26131","Ocbimv22014515m.g","KQ415932",665852,729095,63243
"26132","Ocbimv22026562m.g","KQ416193",101993,113247,11254
"26133","Ocbimv22026022m.g","KQ419957",308360,310616,2256
"26134","Ocbimv22035562m.g","KQ422438",29619,30230,611
"26135","Ocbimv22016118m.g","KQ418320",383511,453826,70315
"26136","Ocbimv22037599m.g","KQ423077",611100,611652,552
"26137","Ocbimv22036490m.g","KQ422777",68640,68912,272
"26138","Ocbimv22000233m.g","KQ423903",138117,156451,18334
"26139","Ocbimv22028435m.g","KQ420486",285322,285681,359
"26140","Ocbimv22004237m.g","KQ417143",167053,170048,2995
"26141","Ocbimv22033342m.g","KQ416474",13036,13608,572
"26142","Ocbimv22014804m.g","KQ418180",80787,202368,121581
"26143","Ocbimv22000142m.g","LGKD01489215",18,290,272
"26144","Ocbimv22025130m.g","KQ419698",162411,163180,769
"26145","Ocbimv22025608m.g","KQ419858",255573,281252,25679
"26146","Ocbimv22008049m.g","KQ417477",26487,42587,16100
"26147","Ocbimv22015357m.g","KQ429292",6022,15975,9953
"26148","Ocbimv22016127m.g","KQ418320",706032,706391,359
"26149","Ocbimv22007066m.g","KQ417374",170545,170851,306
"26150","Ocbimv22018691m.g","KQ418653",288471,292137,3666
"26151","Ocbimv22019385m.g","KQ431108",94583,101295,6712
"26152","Ocbimv22037300m.g","KQ422997",427422,428053,631
"26153","Ocbimv22000916m.g","KQ424114",57602,60467,2865
"26154","Ocbimv22034645m.g","KQ422103",32241,32735,494
"26155","Ocbimv22030870m.g","KQ416373",917637,933382,15745
"26156","Ocbimv22025034m.g","KQ416136",499554,514009,14455
"26157","Ocbimv22032810m.g","KQ416450",252081,304943,52862
"26158","Ocbimv22006682m.g","KQ417343",138350,142038,3688
"26159","Ocbimv22009768m.g","KQ417611",642224,652077,9853
"26160","Ocbimv22039709m.g","KQ416815",502199,502642,443
"26161","Ocbimv22019166m.g","KQ418726",210335,210820,485
"26162","Ocbimv22003734m.g","KQ425077",45,8405,8360
"26163","Ocbimv22037784m.g","KQ416711",120595,122245,1650
"26164","Ocbimv22030686m.g","KQ421067",33069,38826,5757
"26165","Ocbimv22025633m.g","KQ416162",122574,122921,347
"26166","Ocbimv22018420m.g","KQ430686",156,20194,20038
"26167","Ocbimv22012317m.g","KQ415907",197358,197880,522
"26168","Ocbimv22024129m.g","KQ419537",995075,1027045,31970
"26169","Ocbimv22001954m.g","KQ416976",75482,75884,402
"26170","Ocbimv22030473m.g","KQ420992",285481,295098,9617
"26171","Ocbimv22015439m.g","KQ429340",35769,61403,25634
"26172","Ocbimv22013815m.g","KQ428678",3040,27498,24458
"26173","Ocbimv22016227m.g","KQ429756",27531,27653,122
"26174","Ocbimv22004852m.g","KQ415809",210887,241818,30931
"26175","Ocbimv22017627m.g","KQ430388",35696,117199,81503
"26176","Ocbimv22012034m.g","KQ427980",67063,67605,542
"26177","Ocbimv22030914m.g","KQ421117",1779600,1791274,11674
"26178","Ocbimv22010006m.g","KQ427204",44928,75302,30374
"26179","Ocbimv22019140m.g","KQ418721",2570,8743,6173
"26180","Ocbimv22039466m.g","KQ423675",22966,50885,27919
"26181","Ocbimv22005707m.g","KQ425725",35882,37247,1365
"26182","Ocbimv22014715m.g","KQ429040",88496,88690,194
"26183","Ocbimv22000058m.g","KQ423837",14592,14807,215
"26184","Ocbimv22003688m.g","KQ425066",163002,184011,21009
"26185","Ocbimv22019391m.g","KQ416010",24923,29825,4902
"26186","Ocbimv22015855m.g","KQ418296",478609,481065,2456
"26187","Ocbimv22032464m.g","KQ421549",184872,202598,17726
"26188","Ocbimv22016880m.g","KQ418417",272,7006,6734
"26189","Ocbimv22032933m.g","KQ421685",203411,208946,5535
"26190","Ocbimv22030759m.g","KQ421084",6306,8196,1890
"26191","Ocbimv22008195m.g","KQ426573",123820,124215,395
"26192","Ocbimv22021235m.g","KQ419018",142768,143070,302
"26193","Ocbimv22006323m.g","KQ425876",138609,140170,1561
"26194","Ocbimv22034413m.g","KQ422033",75530,86221,10691
"26195","Ocbimv22036132m.g","KQ422651",163059,278686,115627
"26196","Ocbimv22015542m.g","KQ429412",267,23496,23229
"26197","Ocbimv22025952m.g","KQ419933",212433,278289,65856
"26198","Ocbimv22015921m.g","KQ418303",665051,665275,224
"26199","Ocbimv22023798m.g","KQ419478",12545,24264,11719
"26200","Ocbimv22014573m.g","KQ428994",31968,34885,2917
"26201","Ocbimv22012310m.g","KQ415907",118314,135065,16751
"26202","Ocbimv22004455m.g","KQ425315",9711,10055,344
"26203","Ocbimv22012428m.g","KQ417911",319838,321386,1548
"26204","Ocbimv22019171m.g","KQ431030",17813,30215,12402
"26205","Ocbimv22034540m.g","KQ416536",295137,311959,16822
"26206","Ocbimv22015340m.g","KQ415942",22516,24263,1747
"26207","Ocbimv22000150m.g","KQ423870",61615,61914,299
"26208","Ocbimv22006758m.g","KQ417347",1015877,1025781,9904
"26209","Ocbimv22037770m.g","LGKD01463888",2739,3786,1047
"26210","Ocbimv22020331m.g","KQ418895",149795,150109,314
"26211","Ocbimv22026914m.g","KQ420140",231539,235400,3861
"26212","Ocbimv22004976m.g","KQ425492",244891,328058,83167
"26213","Ocbimv22003551m.g","KQ417090",1735503,1777552,42049
"26214","Ocbimv22002692m.g","KQ424745",4540,15525,10985
"26215","Ocbimv22034861m.g","KQ416560",41722,48359,6637
"26216","Ocbimv22005703m.g","KQ417274",399553,454803,55250
"26217","Ocbimv22019388m.g","KQ431108",122098,146381,24283
"26218","Ocbimv22013113m.g","KQ428371",54219,55757,1538
"26219","Ocbimv22018476m.g","KQ430702",166752,174029,7277
"26220","Ocbimv22026255m.g","KQ420022",163757,171260,7503
"26221","Ocbimv22014940m.g","KQ429139",376504,391836,15332
"26222","Ocbimv22024787m.g","KQ419631",124234,141822,17588
"26223","Ocbimv22030855m.g","KQ416373",463649,469104,5455
"26224","Ocbimv22010423m.g","KQ427380",45981,46886,905
"26225","Ocbimv22011533m.g","KQ427773",767,11002,10235
"26226","Ocbimv22039089m.g","KQ423546",4037,5719,1682
"26227","Ocbimv22031513m.g","KQ421263",734586,734876,290
"26228","Ocbimv22005436m.g","KQ417252",105317,105859,542
"26229","Ocbimv22011292m.g","KQ417776",239646,239998,352
"26230","Ocbimv22026069m.g","KQ419982",26742,120723,93981
"26231","Ocbimv22024042m.g","LGKD01695061",11,286,275
"26232","Ocbimv22013280m.g","KQ418007",18007,42767,24760
"26233","Ocbimv22034772m.g","KQ422166",363572,379954,16382
"26234","Ocbimv22036898m.g","KQ422894",105969,120206,14237
"26235","Ocbimv22004073m.g","KQ417133",65633,67883,2250
"26236","Ocbimv22000682m.g","KQ424055",283453,317624,34171
"26237","Ocbimv22024064m.g","LGKD01695421",350,938,588
"26238","Ocbimv22027902m.g","KQ416239",306298,308889,2591
"26239","Ocbimv22023963m.g","KQ419508",321105,321323,218
"26240","Ocbimv22021236m.g","KQ419018",190977,191132,155
"26241","Ocbimv22023940m.g","KQ416106",312410,312721,311
"26242","Ocbimv22020631m.g","KQ418945",148777,149034,257
"26243","Ocbimv22015384m.g","KQ418236",233105,233805,700
"26244","Ocbimv22030939m.g","KQ421124",115320,115718,398
"26245","Ocbimv22016688m.g","KQ429959",30122,96198,66076
"26246","Ocbimv22028377m.g","KQ416257",189223,190418,1195
"26247","Ocbimv22018636m.g","KQ418648",175811,177351,1540
"26248","Ocbimv22013770m.g","LGKD01604149",13,249,236
"26249","Ocbimv22013086m.g","LGKD01599174",17,304,287
"26250","Ocbimv22011550m.g","KQ417802",2014,3358,1344
"26251","Ocbimv22026015m.g","KQ419957",33863,35527,1664
"26252","Ocbimv22030559m.g","KQ421022",156408,157930,1522
"26253","Ocbimv22003710m.g","KQ425068",7292,7945,653
"26254","Ocbimv22036877m.g","KQ422887",189037,228404,39367
"26255","Ocbimv22020985m.g","KQ431915",174784,175149,365
"26256","Ocbimv22035957m.g","KQ416612",1678254,1761419,83165
"26257","Ocbimv22027431m.g","KQ420273",145003,145904,901
"26258","Ocbimv22004908m.g","KQ417213",579884,609351,29467
"26259","Ocbimv22006509m.g","KQ425966",147924,148569,645
"26260","Ocbimv22032828m.g","KQ421664",847458,848964,1506
"26261","Ocbimv22002528m.g","KQ424677",12395,17847,5452
"26262","Ocbimv22015747m.g","KQ418289",54331,55316,985
"26263","Ocbimv22029174m.g","KQ420672",461920,487856,25936
"26264","Ocbimv22029074m.g","KQ420642",151526,151858,332
"26265","Ocbimv22024265m.g","KQ416120",13906,92230,78324
"26266","Ocbimv22039017m.g","KQ423509",66061,66305,244
"26267","Ocbimv22037063m.g","KQ422913",79146,108679,29533
"26268","Ocbimv22029889m.g","KQ420837",43250,44159,909
"26269","Ocbimv22019183m.g","KQ418729",478741,479705,964
"26270","Ocbimv22009228m.g","KQ426934",34034,34732,698
"26271","Ocbimv22035711m.g","KQ422519",71879,72678,799
"26272","Ocbimv22009592m.g","KQ427035",49634,50097,463
"26273","Ocbimv22032993m.g","KQ421710",104687,104938,251
"26274","Ocbimv22039916m.g","KQ423795",48952,54233,5281
"26275","Ocbimv22014440m.g","LGKD01609464",1,405,404
"26276","Ocbimv22015456m.g","KQ429358",6945,8735,1790
"26277","Ocbimv22006181m.g","KQ425837",27878,28198,320
"26278","Ocbimv22013539m.g","KQ418033",25397,25684,287
"26279","Ocbimv22010432m.g","KQ427385",25232,40466,15234
"26280","Ocbimv22037207m.g","KQ416683",139352,142852,3500
"26281","Ocbimv22015991m.g","KQ418307",95318,118302,22984
"26282","Ocbimv22019221m.g","KQ418736",20971,21288,317
"26283","Ocbimv22022301m.g","KQ419193",72891,106359,33468
"26284","Ocbimv22030565m.g","KQ421022",250297,250805,508
"26285","Ocbimv22003326m.g","KQ417081",8064,15903,7839
"26286","Ocbimv22006143m.g","KQ417300",757150,762333,5183
"26287","Ocbimv22014640m.g","KQ418160",443186,472074,28888
"26288","Ocbimv22031394m.g","KQ416395",134642,138424,3782
"26289","Ocbimv22038120m.g","KQ423217",152907,153232,325
"26290","Ocbimv22034192m.g","KQ416520",61066,62977,1911
"26291","Ocbimv22007158m.g","KQ415838",269788,271745,1957
"26292","Ocbimv22016204m.g","KQ418327",129795,130477,682
"26293","Ocbimv22017147m.g","KQ430169",42233,57937,15704
"26294","Ocbimv22031910m.g","KQ421376",610311,610511,200
"26295","Ocbimv22006763m.g","KQ417347",1167024,1167278,254
"26296","Ocbimv22021313m.g","KQ419028",50372,50584,212
"26297","Ocbimv22004263m.g","KQ425248",207196,207483,287
"26298","Ocbimv22000015m.g","KQ423822",14785,15161,376
"26299","Ocbimv22026826m.g","KQ420125",21911,36831,14920
"26300","Ocbimv22032820m.g","KQ421661",131474,138958,7484
"26301","Ocbimv22006018m.g","KQ425779",425226,445052,19826
"26302","Ocbimv22016032m.g","KQ429665",35665,38868,3203
"26303","Ocbimv22025847m.g","KQ419912",84681,95092,10411
"26304","Ocbimv22004147m.g","KQ417141",319802,357900,38098
"26305","Ocbimv22015061m.g","KQ418194",992197,1047284,55087
"26306","Ocbimv22026834m.g","KQ420126",383664,385935,2271
"26307","Ocbimv22023781m.g","KQ416096",1324014,1350131,26117
"26308","Ocbimv22022944m.g","KQ419327",130776,131196,420
"26309","Ocbimv22034839m.g","KQ416559",333425,336271,2846
"26310","Ocbimv22003237m.g","KQ424913",158337,167342,9005
"26311","Ocbimv22000033m.g","KQ423831",4552,5412,860
"26312","Ocbimv22002213m.g","KQ424575",19123,70708,51585
"26313","Ocbimv22002555m.g","KQ424690",322,705,383
"26314","Ocbimv22022118m.g","KQ419175",2448,23331,20883
"26315","Ocbimv22015525m.g","KQ415945",861373,868914,7541
"26316","Ocbimv22014359m.g","LGKD01219445",173,673,500
"26317","Ocbimv22034448m.g","KQ416533",947,6644,5697
"26318","Ocbimv22018466m.g","KQ415993",75788,76147,359
"26319","Ocbimv22018550m.g","KQ430742",47825,49971,2146
"26320","Ocbimv22020940m.g","KQ418982",59773,60422,649
"26321","Ocbimv22003188m.g","KQ417063",233283,399240,165957
"26322","Ocbimv22038283m.g","KQ423260",107033,107248,215
"26323","Ocbimv22026188m.g","KQ420015",180100,181156,1056
"26324","Ocbimv22036821m.g","KQ422861",8163,8360,197
"26325","Ocbimv22006695m.g","KQ426075",336268,337081,813
"26326","Ocbimv22019947m.g","KQ418838",568095,598800,30705
"26327","Ocbimv22001699m.g","KQ424387",228146,244184,16038
"26328","Ocbimv22022660m.g","KQ419278",114568,114930,362
"26329","Ocbimv22010807m.g","KQ427524",4563,6444,1881
"26330","Ocbimv22013801m.g","KQ418061",304939,305193,254
"26331","Ocbimv22036154m.g","KQ422659",186177,187121,944
"26332","Ocbimv22027207m.g","KQ420218",63702,63941,239
"26333","Ocbimv22027238m.g","KQ416215",297607,297942,335
"26334","Ocbimv22018599m.g","KQ418644",660936,663297,2361
"26335","Ocbimv22003885m.g","KQ415799",18262,36689,18427
"26336","Ocbimv22024398m.g","KQ415693",480359,480604,245
"26337","Ocbimv22009845m.g","KQ417620",745316,753470,8154
"26338","Ocbimv22019172m.g","LGKD01648913",291,590,299
"26339","Ocbimv22031570m.g","KQ421281",242861,243469,608
"26340","Ocbimv22018284m.g","KQ430624",18593,19727,1134
"26341","Ocbimv22026407m.g","KQ420047",17172,43238,26066
"26342","Ocbimv22037682m.g","KQ423100",199434,230499,31065
"26343","Ocbimv22014763m.g","KQ418176",180113,192200,12087
"26344","Ocbimv22032695m.g","KQ421637",107188,107391,203
"26345","Ocbimv22036769m.g","KQ416656",60872,61522,650
"26346","Ocbimv22004635m.g","KQ417189",249384,249626,242
"26347","Ocbimv22003802m.g","KQ425111",31557,43234,11677
"26348","Ocbimv22024450m.g","KQ419581",210758,211651,893
"26349","Ocbimv22022488m.g","KQ432789",3335,3565,230
"26350","Ocbimv22025010m.g","KQ419685",169087,171334,2247
"26351","Ocbimv22025047m.g","KQ416136",783035,793150,10115
"26352","Ocbimv22023145m.g","KQ419358",193364,195988,2624
"26353","Ocbimv22034201m.g","KQ422008",15742,16138,396
"26354","Ocbimv22022552m.g","KQ432842",2176,17811,15635
"26355","Ocbimv22017158m.g","KQ418457",55232,56485,1253
"26356","Ocbimv22025657m.g","KQ419877",126978,147729,20751
"26357","Ocbimv22003053m.g","KQ424867",111267,112292,1025
"26358","Ocbimv22017734m.g","KQ430454",4925,18957,14032
"26359","Ocbimv22025176m.g","KQ416141",993974,995162,1188
"26360","Ocbimv22024077m.g","KQ419533",8062,84350,76288
"26361","Ocbimv22023114m.g","KQ419350",694785,747868,53083
"26362","Ocbimv22024103m.g","KQ419533",1322300,1322518,218
"26363","Ocbimv22002308m.g","KQ424627",213381,222998,9617
"26364","Ocbimv22009291m.g","KQ417579",402525,403309,784
"26365","Ocbimv22036362m.g","KQ416635",383995,384372,377
"26366","Ocbimv22031959m.g","KQ421389",498965,541818,42853
"26367","Ocbimv22004037m.g","KQ425190",73355,74378,1023
"26368","Ocbimv22017518m.g","KQ418504",41697,44594,2897
"26369","Ocbimv22003045m.g","KQ417055",1806951,1813932,6981
"26370","Ocbimv22037319m.g","KQ423001",242076,322190,80114
"26371","Ocbimv22005428m.g","KQ425603",41711,65962,24251
"26372","Ocbimv22037265m.g","KQ422986",330133,331086,953
"26373","Ocbimv22009784m.g","KQ427131",68600,73805,5205
"26374","Ocbimv22032737m.g","KQ421649",40823,41197,374
"26375","Ocbimv22027211m.g","KQ420220",70707,79363,8656
"26376","Ocbimv22023133m.g","KQ419354",174706,176302,1596
"26377","Ocbimv22014030m.g","KQ428722",373,543,170
"26378","Ocbimv22032474m.g","KQ421549",569254,569731,477
"26379","Ocbimv22013963m.g","KQ418073",412128,433790,21662
"26380","Ocbimv22022791m.g","LGKD01682600",54,221,167
"26381","Ocbimv22004062m.g","KQ425191",164739,185738,20999
"26382","Ocbimv22003505m.g","KQ417089",1783896,1784061,165
"26383","Ocbimv22014886m.g","KQ429131",135335,146071,10736
"26384","Ocbimv22026388m.g","KQ420035",133288,136042,2754
"26385","Ocbimv22039133m.g","KQ416780",45729,57613,11884
"26386","Ocbimv22014637m.g","KQ418160",370830,397838,27008
"26387","Ocbimv22024010m.g","LGKD01694757",3,317,314
"26388","Ocbimv22019701m.g","KQ418801",160022,160712,690
"26389","Ocbimv22011886m.g","KQ417845",241882,242439,557
"26390","Ocbimv22012297m.g","KQ428115",7672,8331,659
"26391","Ocbimv22011983m.g","KQ417850",91530,94594,3064
"26392","Ocbimv22028459m.g","KQ416258",81458,81841,383
"26393","Ocbimv22011323m.g","KQ417780",608341,608508,167
"26394","Ocbimv22021068m.g","LGKD01665118",4,291,287
"26395","Ocbimv22024245m.g","KQ419552",20086,43561,23475
"26396","Ocbimv22017242m.g","KQ418469",600875,634455,33580
"26397","Ocbimv22027591m.g","KQ420313",163233,188263,25030
"26398","Ocbimv22010103m.g","KQ417642",171916,172393,477
"26399","Ocbimv22005890m.g","KQ425750",554,2230,1676
"26400","Ocbimv22020423m.g","LGKD01660232",14,175,161
"26401","Ocbimv22019279m.g","KQ418740",387836,394859,7023
"26402","Ocbimv22028858m.g","KQ420593",553936,554396,460
"26403","Ocbimv22025801m.g","KQ419906",161926,162632,706
"26404","Ocbimv22010429m.g","KQ427382",33308,33499,191
"26405","Ocbimv22032775m.g","KQ421656",288270,289750,1480
"26406","Ocbimv22003251m.g","KQ424914",15712,29804,14092
"26407","Ocbimv22033303m.g","KQ421769",63372,82600,19228
"26408","Ocbimv22027014m.g","KQ420162",730113,730442,329
"26409","Ocbimv22017640m.g","KQ418522",88364,91720,3356
"26410","Ocbimv22029235m.g","KQ420690",45365,46511,1146
"26411","Ocbimv22029470m.g","KQ416308",482353,506751,24398
"26412","Ocbimv22010185m.g","KQ417653",671546,688655,17109
"26413","Ocbimv22028988m.g","KQ420622",182269,182532,263
"26414","Ocbimv22009995m.g","KQ427202",112562,112993,431
"26415","Ocbimv22023700m.g","KQ416093",239117,239455,338
"26416","Ocbimv22008231m.g","KQ426596",98384,99281,897
"26417","Ocbimv22019196m.g","KQ418732",313432,313584,152
"26418","Ocbimv22017607m.g","KQ430378",52908,59543,6635
"26419","Ocbimv22025880m.g","KQ416175",369307,370809,1502
"26420","Ocbimv22007016m.g","KQ417370",474698,502572,27874
"26421","Ocbimv22007324m.g","KQ426291",54488,73424,18936
"26422","Ocbimv22023498m.g","KQ433423",614,1607,993
"26423","Ocbimv22038393m.g","KQ423313",6356,49771,43415
"26424","Ocbimv22030261m.g","KQ420932",1679,3801,2122
"26425","Ocbimv22025430m.g","KQ419797",382626,383743,1117
"26426","Ocbimv22013398m.g","KQ428489",1,724,723
"26427","Ocbimv22002668m.g","KQ424728",80175,81455,1280
"26428","Ocbimv22033226m.g","KQ421758",262012,264475,2463
"26429","Ocbimv22026763m.g","KQ420110",424227,425428,1201
"26430","Ocbimv22012995m.g","KQ428333",34570,34854,284
"26431","Ocbimv22029743m.g","KQ420815",37495,55854,18359
"26432","Ocbimv22011378m.g","KQ417791",512590,513409,819
"26433","Ocbimv22012921m.g","KQ428284",155,1897,1742
"26434","Ocbimv22000828m.g","KQ424085",24814,89948,65134
"26435","Ocbimv22004829m.g","KQ417209",90984,91337,353
"26436","Ocbimv22005655m.g","KQ425704",40134,40304,170
"26437","Ocbimv22039238m.g","KQ423591",206008,210258,4250
"26438","Ocbimv22011484m.g","KQ417795",311241,311865,624
"26439","Ocbimv22037343m.g","KQ423006",129766,130056,290
"26440","Ocbimv22010756m.g","KQ417713",711267,727042,15775
"26441","Ocbimv22017619m.g","KQ418513",30315,30566,251
"26442","Ocbimv22014091m.g","KQ418088",51259,51447,188
"26443","Ocbimv22026648m.g","KQ420085",331701,357716,26015
"26444","Ocbimv22028369m.g","KQ420477",483295,504442,21147
"26445","Ocbimv22015299m.g","KQ418217",16261,21325,5064
"26446","Ocbimv22017206m.g","KQ430209",115195,126754,11559
"26447","Ocbimv22037904m.g","KQ423156",5084,5319,235
"26448","Ocbimv22034941m.g","KQ416562",993664,994212,548
"26449","Ocbimv22016598m.g","KQ429926",43909,44079,170
"26450","Ocbimv22035934m.g","KQ422613",28205,30452,2247
"26451","Ocbimv22035272m.g","KQ422349",37286,38412,1126
"26452","Ocbimv22009688m.g","KQ417604",120,1144,1024
"26453","Ocbimv22013146m.g","KQ417988",37940,38712,772
"26454","Ocbimv22027360m.g","KQ420265",150638,182862,32224
"26455","Ocbimv22008848m.g","KQ426790",30966,32129,1163
"26456","Ocbimv22029159m.g","KQ420671",368203,368499,296
"26457","Ocbimv22017293m.g","KQ430242",26798,27837,1039
"26458","Ocbimv22031522m.g","KQ421265",173117,214996,41879
"26459","Ocbimv22013842m.g","KQ418068",30571,33935,3364
"26460","Ocbimv22006981m.g","KQ417370",8944,10044,1100
"26461","Ocbimv22014863m.g","KQ418184",16941,203881,186940
"26462","Ocbimv22030800m.g","KQ416370",398698,414583,15885
"26463","Ocbimv22001108m.g","KQ424182",212909,214175,1266
"26464","Ocbimv22012672m.g","KQ417924",555288,565820,10532
"26465","Ocbimv22022617m.g","KQ432913",13216,22904,9688
"26466","Ocbimv22006273m.g","KQ417309",88120,129081,40961
"26467","Ocbimv22034624m.g","KQ422092",107714,108571,857
"26468","Ocbimv22003781m.g","KQ417112",335396,409570,74174
"26469","Ocbimv22036810m.g","KQ416658",879094,879483,389
"26470","Ocbimv22017449m.g","KQ418497",100934,101709,775
"26471","Ocbimv22036008m.g","KQ422632",180914,205452,24538
"26472","Ocbimv22026605m.g","KQ420078",445724,446295,571
"26473","Ocbimv22029078m.g","KQ420642",161745,165388,3643
"26474","Ocbimv22000821m.g","KQ424081",286424,290831,4407
"26475","Ocbimv22035750m.g","KQ422522",888,4226,3338
"26476","Ocbimv22037218m.g","KQ422970",45984,92911,46927
"26477","Ocbimv22000866m.g","KQ424096",445725,446778,1053
"26478","Ocbimv22024515m.g","KQ416125",276902,277141,239
"26479","Ocbimv22018198m.g","KQ415990",953266,959166,5900
"26480","Ocbimv22001680m.g","KQ416953",557023,559321,2298
"26481","Ocbimv22007745m.g","KQ415847",534338,548895,14557
"26482","Ocbimv22023397m.g","KQ419401",86924,163725,76801
"26483","Ocbimv22024565m.g","KQ434054",5120,5401,281
"26484","Ocbimv22026624m.g","KQ420080",578820,584421,5601
"26485","Ocbimv22010933m.g","KQ417725",343859,350973,7114
"26486","Ocbimv22008124m.g","KQ417481",109630,116676,7046
"26487","Ocbimv22022022m.g","KQ432511",86896,89649,2753
"26488","Ocbimv22036036m.g","KQ416614",832087,853817,21730
"26489","Ocbimv22015490m.g","KQ429393",11594,12296,702
"26490","Ocbimv22003534m.g","KQ417090",381622,381843,221
"26491","Ocbimv22006112m.g","KQ425828",131074,132174,1100
"26492","Ocbimv22020895m.g","KQ418974",198436,202082,3646
"26493","Ocbimv22024227m.g","KQ419550",320446,338163,17717
"26494","Ocbimv22026528m.g","KQ420065",29484,30920,1436
"26495","Ocbimv22025609m.g","KQ416161",9167,43520,34353
"26496","Ocbimv22021271m.g","KQ416041",159712,160368,656
"26497","Ocbimv22031527m.g","KQ421265",220951,311440,90489
"26498","Ocbimv22019380m.g","KQ431105",15429,15851,422
"26499","Ocbimv22000911m.g","KQ416892",88408,100050,11642
"26500","Ocbimv22034198m.g","KQ422005",42533,67321,24788
"26501","Ocbimv22020677m.g","KQ418949",337636,337827,191
"26502","Ocbimv22030793m.g","KQ416370",103532,103958,426
"26503","Ocbimv22021539m.g","KQ432218",1,844,843
"26504","Ocbimv22027337m.g","KQ420261",755466,755660,194
"26505","Ocbimv22024899m.g","KQ416131",303074,360334,57260
"26506","Ocbimv22035212m.g","KQ422314",19563,20517,954
"26507","Ocbimv22029353m.g","KQ420717",227350,255842,28492
"26508","Ocbimv22024851m.g","KQ419640",151278,163511,12233
"26509","Ocbimv22027115m.g","KQ420188",76189,76462,273
"26510","Ocbimv22028095m.g","KQ420429",65953,91176,25223
"26511","Ocbimv22019679m.g","KQ431249",1588,28857,27269
"26512","Ocbimv22032918m.g","KQ421684",114834,136144,21310
"26513","Ocbimv22005834m.g","KQ417280",111685,111933,248
"26514","Ocbimv22009908m.g","KQ417622",811280,811708,428
"26515","Ocbimv22003702m.g","KQ417101",248446,256616,8170
"26516","Ocbimv22034186m.g","KQ416518",916132,917429,1297
"26517","Ocbimv22028356m.g","KQ420477",268455,269312,857
"26518","Ocbimv22033648m.g","KQ421856",115053,115712,659
"26519","Ocbimv22001436m.g","KQ416933",164204,182767,18563
"26520","Ocbimv22007878m.g","KQ426474",64554,93360,28806
"26521","Ocbimv22026112m.g","KQ419989",605390,607860,2470
"26522","Ocbimv22019149m.g","KQ431020",36821,45123,8302
"26523","Ocbimv22007905m.g","KQ417459",167315,179148,11833
"26524","Ocbimv22009445m.g","KQ426997",38388,39959,1571
"26525","Ocbimv22029117m.g","KQ420659",559967,560149,182
"26526","Ocbimv22011055m.g","KQ417741",311689,312246,557
"26527","Ocbimv22016307m.g","KQ418338",196998,221133,24135
"26528","Ocbimv22031973m.g","KQ416415",7142,20297,13155
"26529","Ocbimv22001484m.g","KQ424318",52305,54066,1761
"26530","Ocbimv22019968m.g","KQ418839",514413,534019,19606
"26531","Ocbimv22032025m.g","KQ421411",203840,204049,209
"26532","Ocbimv22017869m.g","KQ418552",502147,541205,39058
"26533","Ocbimv22017129m.g","KQ418453",48592,49121,529
"26534","Ocbimv22029593m.g","KQ420779",387210,415262,28052
"26535","Ocbimv22035200m.g","KQ422303",84272,96635,12363
"26536","Ocbimv22030441m.g","KQ420990",111187,145589,34402
"26537","Ocbimv22026744m.g","KQ416198",455438,468904,13466
"26538","Ocbimv22022805m.g","KQ419300",624671,642449,17778
"26539","Ocbimv22034162m.g","KQ416516",675,221655,220980
"26540","Ocbimv22014368m.g","KQ428883",248409,333701,85292
"26541","Ocbimv22007056m.g","KQ417372",106133,115898,9765
"26542","Ocbimv22021352m.g","KQ416042",1750374,1751162,788
"26543","Ocbimv22035474m.g","KQ422393",100512,102258,1746
"26544","Ocbimv22007101m.g","KQ426196",15419,15709,290
"26545","Ocbimv22033482m.g","KQ421821",84604,85134,530
"26546","Ocbimv22024231m.g","KQ416117",67131,76437,9306
"26547","Ocbimv22022378m.g","KQ432708",1521,1682,161
"26548","Ocbimv22003340m.g","KQ424979",33329,37999,4670
"26549","Ocbimv22012890m.g","KQ417949",4656,14739,10083
"26550","Ocbimv22031859m.g","KQ421360",55180,71825,16645
"26551","Ocbimv22030024m.g","KQ420886",16564,30086,13522
"26552","Ocbimv22030391m.g","KQ420970",195869,208268,12399
"26553","Ocbimv22036406m.g","KQ416641",121000,122864,1864
"26554","Ocbimv22000691m.g","KQ424055",660534,661037,503
"26555","Ocbimv22037691m.g","KQ423101",73192,80638,7446
"26556","Ocbimv22038498m.g","KQ423378",78178,81237,3059
"26557","Ocbimv22032937m.g","KQ421686",184050,192251,8201
"26558","Ocbimv22034302m.g","KQ422015",1193340,1193583,243
"26559","Ocbimv22007650m.g","KQ426409",15020,24667,9647
"26560","Ocbimv22012216m.g","LGKD01593832",8,121,113
"26561","Ocbimv22001626m.g","KQ416950",457942,465484,7542
"26562","Ocbimv22012694m.g","KQ417927",64911,65111,200
"26563","Ocbimv22021574m.g","KQ432242",10178,10528,350
"26564","Ocbimv22022184m.g","KQ419180",800011,803449,3438
"26565","Ocbimv22018195m.g","KQ415990",720989,773612,52623
"26566","Ocbimv22034048m.g","KQ416508",515525,516296,771
"26567","Ocbimv22021959m.g","KQ432471",9631,14468,4837
"26568","Ocbimv22024501m.g","KQ419590",146411,158259,11848
"26569","Ocbimv22003067m.g","KQ424877",92950,114722,21772
"26570","Ocbimv22031923m.g","KQ416413",596599,596883,284
"26571","Ocbimv22015698m.g","LGKD01620727",495,2039,1544
"26572","Ocbimv22007315m.g","KQ426287",295728,296630,902
"26573","Ocbimv22033847m.g","KQ421894",157003,157869,866
"26574","Ocbimv22030134m.g","KQ420903",8136,8621,485
"26575","Ocbimv22005830m.g","KQ417280",103064,107896,4832
"26576","Ocbimv22012847m.g","KQ417945",606362,609167,2805
"26577","Ocbimv22016513m.g","KQ429904",171075,172987,1912
"26578","Ocbimv22020844m.g","KQ418970",2325736,2329112,3376
"26579","Ocbimv22007818m.g","KQ426461",369984,370508,524
"26580","Ocbimv22025631m.g","KQ419864",83863,84225,362
"26581","Ocbimv22023671m.g","KQ419458",74237,74401,164
"26582","Ocbimv22013392m.g","KQ418018",1113913,1141238,27325
"26583","Ocbimv22019305m.g","KQ418747",118399,121015,2616
"26584","Ocbimv22004862m.g","LGKD01533412",4,276,272
"26585","Ocbimv22026488m.g","KQ420055",936173,955840,19667
"26586","Ocbimv22004188m.g","KQ425220",381612,381905,293
"26587","Ocbimv22023013m.g","KQ419338",267113,329662,62549
"26588","Ocbimv22011032m.g","KQ427605",14709,28182,13473
"26589","Ocbimv22019325m.g","KQ418749",296808,303875,7067
"26590","Ocbimv22015148m.g","KQ418200",430852,458396,27544
"26591","Ocbimv22016124m.g","KQ418320",591297,595391,4094
"26592","Ocbimv22021681m.g","KQ416051",376052,377858,1806
"26593","Ocbimv22008750m.g","KQ426760",27721,36946,9225
"26594","Ocbimv22007889m.g","KQ417458",304767,316568,11801
"26595","Ocbimv22022267m.g","LGKD01676552",54,326,272
"26596","Ocbimv22029125m.g","KQ420660",140069,146561,6492
"26597","Ocbimv22030554m.g","KQ421022",65631,68440,2809
"26598","Ocbimv22017736m.g","KQ430455",47666,67049,19383
"26599","Ocbimv22034871m.g","KQ422198",7935,10200,2265
"26600","Ocbimv22010368m.g","KQ415876",154496,184584,30088
"26601","Ocbimv22023410m.g","KQ419402",366212,383572,17360
"26602","Ocbimv22018045m.g","KQ415682",551320,551568,248
"26603","Ocbimv22017297m.g","KQ418479",94335,124633,30298
"26604","Ocbimv22003161m.g","KQ417062",51068,51775,707
"26605","Ocbimv22025131m.g","KQ419701",89384,99740,10356
"26606","Ocbimv22032047m.g","KQ415660",487897,488374,477
"26607","Ocbimv22025905m.g","KQ419921",26290,88359,62069
"26608","Ocbimv22012648m.g","KQ428193",13398,13598,200
"26609","Ocbimv22019020m.g","KQ418711",470382,485262,14880
"26610","Ocbimv22023254m.g","KQ419380",461189,461816,627
"26611","Ocbimv22027844m.g","KQ420377",1205,39870,38665
"26612","Ocbimv22034694m.g","KQ416547",91472,95238,3766
"26613","Ocbimv22039569m.g","KQ423703",299746,302880,3134
"26614","Ocbimv22016134m.g","KQ429712",23522,39349,15827
"26615","Ocbimv22019925m.g","KQ431376",435110,444550,9440
"26616","Ocbimv22032269m.g","KQ421507",165472,166319,847
"26617","Ocbimv22017890m.g","KQ418555",23563,24262,699
"26618","Ocbimv22014744m.g","KQ418175",160508,188607,28099
"26619","Ocbimv22032677m.g","KQ416444",153747,155058,1311
"26620","Ocbimv22032318m.g","KQ421523",236932,238273,1341
"26621","Ocbimv22032299m.g","KQ421518",38639,45163,6524
"26622","Ocbimv22000649m.g","LGKD01119870",2,217,215
"26623","Ocbimv22000752m.g","KQ416878",458597,459106,509
"26624","Ocbimv22022400m.g","KQ419215",305815,321978,16163
"26625","Ocbimv22026701m.g","KQ420095",107959,113939,5980
"26626","Ocbimv22032778m.g","KQ421658",10754,29912,19158
"26627","Ocbimv22022507m.g","LGKD01678949",1,228,227
"26628","Ocbimv22020997m.g","KQ431922",10903,63165,52262
"26629","Ocbimv22017260m.g","KQ418474",32888,33569,681
"26630","Ocbimv22027300m.g","KQ416220",386014,386235,221
"26631","Ocbimv22017905m.g","KQ418558",25264,42604,17340
"26632","Ocbimv22033616m.g","KQ416488",483072,483281,209
"26633","Ocbimv22027729m.g","KQ420350",65729,69166,3437
"26634","Ocbimv22018995m.g","KQ418708",680543,682920,2377
"26635","Ocbimv22037782m.g","KQ416711",32759,49184,16425
"26636","Ocbimv22024887m.g","KQ419648",134016,135872,1856
"26637","Ocbimv22039520m.g","KQ423686",1627,10181,8554
"26638","Ocbimv22014163m.g","KQ418096",401990,402375,385
"26639","Ocbimv22027775m.g","KQ420366",24687,34436,9749
"26640","Ocbimv22009785m.g","KQ427131",83643,84026,383
"26641","Ocbimv22026907m.g","KQ420140",109809,110689,880
"26642","Ocbimv22002157m.g","KQ416990",446147,446374,227
"26643","Ocbimv22008934m.g","LGKD01566372",165,734,569
"26644","Ocbimv22010222m.g","KQ427317",8942,24354,15412
"26645","Ocbimv22011130m.g","KQ427653",16068,16523,455
"26646","Ocbimv22001411m.g","KQ424302",104330,112320,7990
"26647","Ocbimv22029931m.g","KQ420854",7,2850,2843
"26648","Ocbimv22026683m.g","KQ416196",1186093,1200251,14158
"26649","Ocbimv22006702m.g","KQ426075",386524,400144,13620
"26650","Ocbimv22024693m.g","KQ419615",543831,558267,14436
"26651","Ocbimv22013361m.g","KQ428462",94345,94617,272
"26652","Ocbimv22020104m.g","KQ418855",141175,143370,2195
"26653","Ocbimv22011304m.g","KQ417778",2,857,855
"26654","Ocbimv22018827m.g","KQ430889",120181,147703,27522
"26655","Ocbimv22004552m.g","KQ425358",1268,17451,16183
"26656","Ocbimv22037426m.g","KQ416694",2795262,2795555,293
"26657","Ocbimv22021171m.g","KQ415686",437762,450448,12686
"26658","Ocbimv22030569m.g","KQ421025",5836,38122,32286
"26659","Ocbimv22039738m.g","KQ423737",85119,89002,3883
"26660","Ocbimv22018171m.g","KQ430593",8740,19382,10642
"26661","Ocbimv22009717m.g","KQ427096",205867,211396,5529
"26662","Ocbimv22007900m.g","KQ426486",55506,56687,1181
"26663","Ocbimv22021410m.g","KQ419041",492094,492348,254
"26664","Ocbimv22002394m.g","KQ424656",43417,70169,26752
"26665","Ocbimv22032540m.g","KQ421579",113060,115607,2547
"26666","Ocbimv22016268m.g","KQ429784",115037,117682,2645
"26667","Ocbimv22024289m.g","KQ416121",1040679,1041345,666
"26668","Ocbimv22015619m.g","KQ418269",199012,212089,13077
"26669","Ocbimv22035023m.g","KQ416568",137669,272921,135252
"26670","Ocbimv22037975m.g","KQ423188",157100,159064,1964
"26671","Ocbimv22032448m.g","KQ416431",207097,233616,26519
"26672","Ocbimv22028061m.g","KQ420424",135628,139593,3965
"26673","Ocbimv22032561m.g","KQ421590",13662,13883,221
"26674","Ocbimv22020282m.g","KQ418883",34661,43164,8503
"26675","Ocbimv22000865m.g","KQ424096",143458,389142,245684
"26676","Ocbimv22036724m.g","KQ416655",114028,139270,25242
"26677","Ocbimv22026462m.g","KQ420053",448253,449112,859
"26678","Ocbimv22025235m.g","KQ419743",117653,176630,58977
"26679","Ocbimv22016262m.g","KQ418333",493527,493835,308
"26680","Ocbimv22023899m.g","KQ419496",19127,19701,574
"26681","Ocbimv22032895m.g","KQ421678",33109,34339,1230
"26682","Ocbimv22000827m.g","KQ416887",28188,28532,344
"26683","Ocbimv22030456m.g","KQ416350",361447,361800,353
"26684","Ocbimv22033528m.g","KQ421824",371455,372297,842
"26685","Ocbimv22029316m.g","KQ416297",42705,75035,32330
"26686","Ocbimv22009528m.g","KQ415865",912023,916194,4171
"26687","Ocbimv22013737m.g","KQ428636",66358,74701,8343
"26688","Ocbimv22026604m.g","KQ420078",313905,334472,20567
"26689","Ocbimv22031868m.g","KQ421365",83763,108550,24787
"26690","Ocbimv22003798m.g","KQ425107",44382,45587,1205
"26691","Ocbimv22000820m.g","KQ424081",263513,284934,21421
"26692","Ocbimv22027888m.g","KQ420388",354618,355010,392
"26693","Ocbimv22006499m.g","KQ425961",4439,32123,27684
"26694","Ocbimv22014128m.g","KQ418093",281790,361408,79618
"26695","Ocbimv22024238m.g","KQ433876",69372,70189,817
"26696","Ocbimv22008208m.g","KQ426582",79097,79756,659
"26697","Ocbimv22033703m.g","KQ416491",702754,738203,35449
"26698","Ocbimv22029629m.g","KQ420787",938779,939552,773
"26699","Ocbimv22027750m.g","KQ420357",114713,143054,28341
"26700","Ocbimv22010175m.g","KQ427304",40641,42036,1395
"26701","Ocbimv22002357m.g","KQ424645",123427,123903,476
"26702","Ocbimv22006937m.g","KQ417364",542584,542787,203
"26703","Ocbimv22014553m.g","KQ418152",197501,197830,329
"26704","Ocbimv22008330m.g","KQ417497",785088,811694,26606
"26705","Ocbimv22032218m.g","KQ421482",310823,312775,1952
"26706","Ocbimv22004821m.g","KQ417208",411363,427794,16431
"26707","Ocbimv22015316m.g","KQ418220",8111,13586,5475
"26708","Ocbimv22022161m.g","KQ419180",230332,244840,14508
"26709","Ocbimv22032821m.g","KQ421661",166413,175624,9211
"26710","Ocbimv22026909m.g","KQ420140",141143,158392,17249
"26711","Ocbimv22029435m.g","KQ416306",1040802,1040996,194
"26712","Ocbimv22017168m.g","KQ418459",232073,291137,59064
"26713","Ocbimv22019273m.g","KQ418739",724450,743463,19013
"26714","Ocbimv22025709m.g","KQ419887",852290,856931,4641
"26715","Ocbimv22028088m.g","KQ420428",129104,141142,12038
"26716","Ocbimv22039642m.g","KQ416810",1340133,1341686,1553
"26717","Ocbimv22022254m.g","KQ419190",45659,46021,362
"26718","Ocbimv22036095m.g","KQ416616",2452063,2452454,391
"26719","Ocbimv22011264m.g","KQ417771",1058206,1071849,13643
"26720","Ocbimv22012761m.g","KQ417936",205643,205885,242
"26721","Ocbimv22016202m.g","KQ418327",48053,115497,67444
"26722","Ocbimv22008815m.g","KQ426774",239444,239801,357
"26723","Ocbimv22038320m.g","KQ423280",245856,272767,26911
"26724","Ocbimv22002596m.g","KQ424714",18019,20128,2109
"26725","Ocbimv22028535m.g","KQ420517",533385,574862,41477
"26726","Ocbimv22035067m.g","KQ422263",240511,243295,2784
"26727","Ocbimv22005907m.g","KQ417284",161511,162029,518
"26728","Ocbimv22030667m.g","KQ421056",190374,191070,696
"26729","Ocbimv22023493m.g","KQ419417",98905,107956,9051
"26730","Ocbimv22038675m.g","KQ423436",43591,44319,728
"26731","Ocbimv22028071m.g","KQ416246",11891,12040,149
"26732","Ocbimv22031209m.g","KQ421200",226488,245255,18767
"26733","Ocbimv22010381m.g","KQ415876",946289,946831,542
"26734","Ocbimv22012844m.g","KQ417945",529427,573256,43829
"26735","Ocbimv22013487m.g","KQ415916",311748,313415,1667
"26736","Ocbimv22023967m.g","KQ419510",8760,8921,161
"26737","Ocbimv22006228m.g","LGKD01543569",34,309,275
"26738","Ocbimv22011765m.g","KQ427905",78804,79130,326
"26739","Ocbimv22020088m.g","KQ431445",74062,103119,29057
"26740","Ocbimv22001928m.g","KQ416974",224372,357290,132918
"26741","Ocbimv22036950m.g","KQ416666",1403492,1403794,302
"26742","Ocbimv22031994m.g","KQ421405",56561,63031,6470
"26743","Ocbimv22013143m.g","KQ417987",106956,107757,801
"26744","Ocbimv22029518m.g","KQ416311",621547,769709,148162
"26745","Ocbimv22037780m.g","KQ416711",27287,32685,5398
"26746","Ocbimv22035445m.g","KQ422385",15886,93789,77903
"26747","Ocbimv22018481m.g","LGKD01643436",55,252,197
"26748","Ocbimv22009265m.g","KQ417578",1279990,1329540,49550
"26749","Ocbimv22035604m.g","KQ422460",45766,46041,275
"26750","Ocbimv22016454m.g","KQ429878",97445,117376,19931
"26751","Ocbimv22034911m.g","KQ422214",196,585,389
"26752","Ocbimv22000810m.g","KQ424077",13501,15873,2372
"26753","Ocbimv22014568m.g","KQ428991",5169,5859,690
"26754","Ocbimv22004101m.g","KQ425202",113558,113893,335
"26755","Ocbimv22008897m.g","KQ426798",31514,86434,54920
"26756","Ocbimv22018312m.g","KQ418600",630899,631144,245
"26757","Ocbimv22004109m.g","KQ417137",160668,163735,3067
"26758","Ocbimv22028625m.g","KQ420535",215265,217613,2348
"26759","Ocbimv22031390m.g","KQ421226",138664,139576,912
"26760","Ocbimv22015976m.g","KQ415949",673551,673718,167
"26761","Ocbimv22034733m.g","KQ422137",17516,18709,1193
"26762","Ocbimv22003260m.g","KQ417073",95263,95844,581
"26763","Ocbimv22008543m.g","KQ426673",9937,44706,34769
"26764","Ocbimv22014587m.g","KQ428994",229271,281260,51989
"26765","Ocbimv22010377m.g","KQ415876",496599,498880,2281
"26766","Ocbimv22035427m.g","KQ422381",229526,311734,82208
"26767","Ocbimv22019255m.g","KQ431069",169,567,398
"26768","Ocbimv22020195m.g","KQ418873",188971,250336,61365
"26769","Ocbimv22013745m.g","KQ428640",92946,93377,431
"26770","Ocbimv22036568m.g","KQ416645",377998,378701,703
"26771","Ocbimv22014629m.g","KQ418159",159236,161128,1892
"26772","Ocbimv22027312m.g","KQ420255",99781,143457,43676
"26773","Ocbimv22029599m.g","KQ420779",458472,468389,9917
"26774","Ocbimv22037898m.g","KQ423154",30132,33942,3810
"26775","Ocbimv22026118m.g","KQ419989",984060,985452,1392
"26776","Ocbimv22023007m.g","KQ419338",105797,113148,7351
"26777","Ocbimv22029441m.g","KQ416306",1546651,1547749,1098
"26778","Ocbimv22030978m.g","KQ421139",8351,9652,1301
"26779","Ocbimv22036583m.g","KQ422794",206503,207087,584
"26780","Ocbimv22037051m.g","KQ422909",1218335,1275012,56677
"26781","Ocbimv22036006m.g","KQ422631",21197,21693,496
"26782","Ocbimv22019378m.g","KQ418758",219059,219742,683
"26783","Ocbimv22007786m.g","KQ426456",252680,267672,14992
"26784","Ocbimv22022867m.g","KQ419315",42126,44492,2366
"26785","Ocbimv22011896m.g","KQ415894",86619,103534,16915
"26786","Ocbimv22023274m.g","KQ419390",136421,136606,185
"26787","Ocbimv22035130m.g","KQ422286",96952,102128,5176
"26788","Ocbimv22018517m.g","KQ415994",86827,87021,194
"26789","Ocbimv22008761m.g","KQ426760",330241,360963,30722
"26790","Ocbimv22030965m.g","LGKD01386673",35,406,371
"26791","Ocbimv22035992m.g","KQ422628",103187,104500,1313
"26792","Ocbimv22023470m.g","KQ419414",441670,442293,623
"26793","Ocbimv22004100m.g","KQ425202",106631,110397,3766
"26794","Ocbimv22001111m.g","KQ424182",313630,331118,17488
"26795","Ocbimv22018365m.g","KQ418610",136207,137390,1183
"26796","Ocbimv22038324m.g","KQ423283",18723,28185,9462
"26797","Ocbimv22003895m.g","KQ425137",52854,53030,176
"26798","Ocbimv22035013m.g","KQ422246",66799,67827,1028
"26799","Ocbimv22029527m.g","KQ420770",64367,77600,13233
"26800","Ocbimv22001899m.g","KQ424463",131810,135890,4080
"26801","Ocbimv22027631m.g","LGKD01348246",136,285,149
"26802","Ocbimv22039177m.g","LGKD01111492",74,964,890
"26803","Ocbimv22001522m.g","KQ424343",29594,29935,341
"26804","Ocbimv22021866m.g","KQ419114",27403,70253,42850
"26805","Ocbimv22016349m.g","KQ415679",324603,338761,14158
"26806","Ocbimv22010479m.g","KQ417681",611076,644706,33630
"26807","Ocbimv22009654m.g","KQ427059",561458,574412,12954
"26808","Ocbimv22000125m.g","KQ416841",790909,794464,3555
"26809","Ocbimv22031110m.g","KQ416385",1317227,1317406,179
"26810","Ocbimv22018318m.g","KQ430646",87017,87455,438
"26811","Ocbimv22006762m.g","KQ417347",1143750,1144809,1059
"26812","Ocbimv22032475m.g","KQ421549",620650,620943,293
"26813","Ocbimv22036318m.g","KQ415755",93,5373,5280
"26814","Ocbimv22012371m.g","KQ428139",3878,21269,17391
"26815","Ocbimv22019981m.g","KQ418840",1091755,1111749,19994
"26816","Ocbimv22026048m.g","KQ419973",515875,516323,448
"26817","Ocbimv22022019m.g","KQ432511",64976,69281,4305
"26818","Ocbimv22006400m.g","KQ417318",430762,448399,17637
"26819","Ocbimv22010584m.g","LGKD01580694",17,376,359
"26820","Ocbimv22023827m.g","KQ416099",8046,9492,1446
"26821","Ocbimv22034058m.g","KQ416508",653878,665823,11945
"26822","Ocbimv22000400m.g","KQ423954",263292,264143,851
"26823","Ocbimv22000342m.g","KQ416854",606977,607144,167
"26824","Ocbimv22030775m.g","KQ421086",18460,19735,1275
"26825","Ocbimv22000628m.g","KQ416870",199491,199658,167
"26826","Ocbimv22027400m.g","KQ416223",265605,279331,13726
"26827","Ocbimv22031275m.g","KQ421216",20892,189511,168619
"26828","Ocbimv22031069m.g","KQ421152",31505,31921,416
"26829","Ocbimv22034407m.g","KQ422031",115382,147796,32414
"26830","Ocbimv22011342m.g","KQ417783",200153,202720,2567
"26831","Ocbimv22024864m.g","KQ419643",379171,384538,5367
"26832","Ocbimv22037935m.g","KQ423171",161332,162137,805
"26833","Ocbimv22013627m.g","KQ418040",32707,34940,2233
"26834","Ocbimv22010992m.g","KQ417731",282942,298702,15760
"26835","Ocbimv22015305m.g","KQ418217",90622,96641,6019
"26836","Ocbimv22010422m.g","KQ427380",2556,3152,596
"26837","Ocbimv22021577m.g","KQ419080",5717,6377,660
"26838","Ocbimv22014327m.g","KQ428874",30016,30216,200
"26839","Ocbimv22026948m.g","KQ420146",499981,502221,2240
"26840","Ocbimv22035854m.g","KQ416605",175076,176109,1033
"26841","Ocbimv22034862m.g","KQ416560",51127,57077,5950
"26842","Ocbimv22034714m.g","KQ422121",254056,254463,407
"26843","Ocbimv22014087m.g","KQ415924",403185,404998,1813
"26844","Ocbimv22028894m.g","KQ416274",512214,527127,14913
"26845","Ocbimv22038347m.g","KQ416737",1224317,1232557,8240
"26846","Ocbimv22034661m.g","KQ416545",99953,100177,224
"26847","Ocbimv22015673m.g","KQ429470",23990,92320,68330
"26848","Ocbimv22010482m.g","KQ417681",903671,933719,30048
"26849","Ocbimv22004673m.g","KQ417196",26895,27193,298
"26850","Ocbimv22013197m.g","KQ418001",218394,219625,1231
"26851","Ocbimv22019555m.g","KQ418783",575934,576615,681
"26852","Ocbimv22003549m.g","KQ417090",1721430,1724971,3541
"26853","Ocbimv22016338m.g","KQ429822",29276,38450,9174
"26854","Ocbimv22001047m.g","KQ424160",128091,129398,1307
"26855","Ocbimv22022945m.g","KQ419327",137939,149938,11999
"26856","Ocbimv22029790m.g","KQ420822",102854,104575,1721
"26857","Ocbimv22004475m.g","LGKD01530604",1732,1992,260
"26858","Ocbimv22029626m.g","KQ420787",892921,908265,15344
"26859","Ocbimv22038363m.g","KQ423292",21124,42905,21781
"26860","Ocbimv22028499m.g","KQ416259",63330,104278,40948
"26861","Ocbimv22036714m.g","KQ416654",406542,428490,21948
"26862","Ocbimv22029580m.g","KQ420777",273101,301853,28752
"26863","Ocbimv22037329m.g","KQ423001",473329,539684,66355
"26864","Ocbimv22021263m.g","KQ419022",51274,53613,2339
"26865","Ocbimv22035278m.g","KQ422349",104725,105696,971
"26866","Ocbimv22038754m.g","KQ416765",88878,90057,1179
"26867","Ocbimv22000514m.g","KQ423985",8528,9210,682
"26868","Ocbimv22012417m.g","KQ417911",121765,124953,3188
"26869","Ocbimv22019536m.g","KQ418783",55346,78806,23460
"26870","Ocbimv22010067m.g","KQ417640",150167,158416,8249
"26871","Ocbimv22038774m.g","KQ416765",628810,629286,476
"26872","Ocbimv22035236m.g","KQ422338",235321,250770,15449
"26873","Ocbimv22027503m.g","KQ416226",451869,452441,572
"26874","Ocbimv22038239m.g","KQ423244",221537,221818,281
"26875","Ocbimv22010735m.g","KQ427485",2592,10815,8223
"26876","Ocbimv22010652m.g","KQ427464",129973,135950,5977
"26877","Ocbimv22038783m.g","KQ423464",96106,98444,2338
"26878","Ocbimv22000660m.g","KQ424043",3517,4050,533
"26879","Ocbimv22017865m.g","KQ418552",412284,447724,35440
"26880","Ocbimv22015130m.g","KQ418196",500414,500731,317
"26881","Ocbimv22015220m.g","KQ415939",89572,89856,284
"26882","Ocbimv22019819m.g","KQ431332",143483,143767,284
"26883","Ocbimv22016781m.g","LGKD01236916",22,132,110
"26884","Ocbimv22020988m.g","KQ418989",104806,105451,645
"26885","Ocbimv22012025m.g","KQ427973",248525,248893,368
"26886","Ocbimv22028434m.g","KQ420486",202416,202682,266
"26887","Ocbimv22006501m.g","KQ425961",19783,22203,2420
"26888","Ocbimv22004870m.g","KQ417211",32532,83504,50972
"26889","Ocbimv22003826m.g","KQ425124",34513,80933,46420
"26890","Ocbimv22025594m.g","KQ419857",267252,287568,20316
"26891","Ocbimv22001772m.g","KQ416962",112753,117490,4737
"26892","Ocbimv22006931m.g","KQ426154",135714,143347,7633
"26893","Ocbimv22016889m.g","KQ430071",238798,239037,239
"26894","Ocbimv22028864m.g","KQ420595",32475,32657,182
"26895","Ocbimv22038160m.g","KQ423221",137553,137756,203
"26896","Ocbimv22013871m.g","KQ418069",111965,114098,2133
"26897","Ocbimv22036765m.g","KQ416656",38445,43889,5444
"26898","Ocbimv22034698m.g","KQ416547",111173,111616,443
"26899","Ocbimv22030928m.g","KQ421121",17571,18258,687
"26900","Ocbimv22020078m.g","KQ418849",350477,350753,276
"26901","Ocbimv22007700m.g","KQ417442",1315,47296,45981
"26902","Ocbimv22018769m.g","KQ418671",53435,54568,1133
"26903","Ocbimv22004311m.g","KQ417147",1404192,1404479,287
"26904","Ocbimv22025995m.g","KQ419947",32199,32561,362
"26905","Ocbimv22027522m.g","KQ420297",362106,362423,317
"26906","Ocbimv22023271m.g","KQ419390",34772,34963,191
"26907","Ocbimv22022591m.g","KQ419268",93863,97325,3462
"26908","Ocbimv22008228m.g","KQ415852",679533,687013,7480
"26909","Ocbimv22039702m.g","KQ423732",71675,72128,453
"26910","Ocbimv22010191m.g","KQ417654",72651,74161,1510
"26911","Ocbimv22019534m.g","KQ418783",42673,55238,12565
"26912","Ocbimv22036251m.g","KQ416627",365007,431060,66053
"26913","Ocbimv22024449m.g","KQ419581",185101,281282,96181
"26914","Ocbimv22029770m.g","KQ420820",532636,548641,16005
"26915","Ocbimv22014028m.g","KQ418079",483368,515084,31716
"26916","Ocbimv22012348m.g","KQ428124",100,1803,1703
"26917","Ocbimv22016554m.g","KQ418367",434639,467621,32982
"26918","Ocbimv22013813m.g","KQ428677",165540,217390,51850
"26919","Ocbimv22005172m.g","KQ425538",10984,11296,312
"26920","Ocbimv22036411m.g","KQ416641",172046,251407,79361
"26921","Ocbimv22007047m.g","KQ417371",178462,179470,1008
"26922","Ocbimv22023856m.g","KQ416102",158411,178721,20310
"26923","Ocbimv22034030m.g","KQ421953",36545,38858,2313
"26924","Ocbimv22010412m.g","KQ417676",2024210,2024512,302
"26925","Ocbimv22034487m.g","KQ422061",39073,56128,17055
"26926","Ocbimv22002505m.g","KQ417011",191609,199218,7609
"26927","Ocbimv22001059m.g","KQ424168",443166,443684,518
"26928","Ocbimv22002820m.g","KQ424796",252,838,586
"26929","Ocbimv22038097m.g","KQ423214",79458,83611,4153
"26930","Ocbimv22002526m.g","KQ417013",28353,41076,12723
"26931","Ocbimv22036454m.g","KQ422770",76186,182730,106544
"26932","Ocbimv22016254m.g","KQ418333",78628,85007,6379
"26933","Ocbimv22004098m.g","KQ425202",50305,83931,33626
"26934","Ocbimv22017133m.g","KQ418453",87487,102986,15499
"26935","Ocbimv22002537m.g","KQ424680",9012,54974,45962
"26936","Ocbimv22009391m.g","KQ426987",146494,146691,197
"26937","Ocbimv22035046m.g","KQ415746",261105,261758,653
"26938","Ocbimv22000065m.g","KQ423841",2537,5311,2774
"26939","Ocbimv22005798m.g","KQ415823",1038308,1054576,16268
"26940","Ocbimv22003137m.g","KQ417061",429713,429874,161
"26941","Ocbimv22017874m.g","KQ418552",631994,655750,23756
"26942","Ocbimv22014258m.g","KQ418108",56521,78999,22478
"26943","Ocbimv22027651m.g","KQ420330",274334,276124,1790
"26944","Ocbimv22022230m.g","KQ432637",2922,22477,19555
"26945","Ocbimv22015903m.g","KQ429626",94583,94798,215
"26946","Ocbimv22031431m.g","KQ421241",570475,571254,779
"26947","Ocbimv22033814m.g","KQ421880",88034,88783,749
"26948","Ocbimv22021904m.g","KQ419127",1885,2166,281
"26949","Ocbimv22009797m.g","KQ427137",128818,232934,104116
"26950","Ocbimv22011518m.g","KQ417796",783955,796969,13014
"26951","Ocbimv22020445m.g","LGKD01660563",14,383,369
"26952","Ocbimv22015794m.g","KQ429578",91877,92380,503
"26953","Ocbimv22024811m.g","KQ419631",554695,555187,492
"26954","Ocbimv22036464m.g","KQ422771",98427,98621,194
"26955","Ocbimv22029716m.g","KQ420813",492808,528472,35664
"26956","Ocbimv22013319m.g","KQ428445",2968,3159,191
"26957","Ocbimv22006229m.g","KQ425847",83028,83267,239
"26958","Ocbimv22038336m.g","KQ423287",66030,66587,557
"26959","Ocbimv22039302m.g","KQ423610",7102,8268,1166
"26960","Ocbimv22023895m.g","KQ433690",2528,2824,296
"26961","Ocbimv22028115m.g","KQ420432",119367,128542,9175
"26962","Ocbimv22036711m.g","KQ416654",332952,334701,1749
"26963","Ocbimv22014858m.g","KQ418183",84131,85061,930
"26964","Ocbimv22004137m.g","KQ425217",13958,15390,1432
"26965","Ocbimv22009811m.g","KQ417619",14273,28487,14214
"26966","Ocbimv22020363m.g","KQ418900",383205,387388,4183
"26967","Ocbimv22034009m.g","KQ421946",61519,62304,785
"26968","Ocbimv22030907m.g","KQ421117",1550824,1574959,24135
"26969","Ocbimv22037181m.g","KQ416680",493403,493639,236
"26970","Ocbimv22010375m.g","KQ415876",447283,468237,20954
"26971","Ocbimv22037593m.g","KQ423077",382720,392253,9533
"26972","Ocbimv22035927m.g","KQ416610",62904,63097,193
"26973","Ocbimv22026608m.g","KQ420079",381722,382923,1201
"26974","Ocbimv22002254m.g","KQ424585",135940,137152,1212
"26975","Ocbimv22006355m.g","KQ417315",246567,253933,7366
"26976","Ocbimv22008463m.g","KQ415854",448651,465166,16515
"26977","Ocbimv22012527m.g","KQ417917",693059,693795,736
"26978","Ocbimv22020713m.g","KQ416032",483400,514453,31053
"26979","Ocbimv22022844m.g","KQ433054",30648,68710,38062
"26980","Ocbimv22021660m.g","KQ416049",229022,234369,5347
"26981","Ocbimv22006685m.g","KQ417343",270166,271489,1323
"26982","Ocbimv22004025m.g","KQ425190",3445,114445,111000
"26983","Ocbimv22006714m.g","KQ426075",547968,565862,17894
"26984","Ocbimv22009367m.g","LGKD01570113",7,6220,6213
"26985","Ocbimv22039851m.g","KQ423780",392454,392765,311
"26986","Ocbimv22031319m.g","KQ421217",1181556,1181756,200
"26987","Ocbimv22018143m.g","KQ415987",406677,407003,326
"26988","Ocbimv22030439m.g","KQ420990",77058,79460,2402
"26989","Ocbimv22008973m.g","KQ417544",435275,484632,49357
"26990","Ocbimv22002993m.g","KQ424859",159810,160022,212
"26991","Ocbimv22019369m.g","KQ416009",601170,601705,535
"26992","Ocbimv22010950m.g","KQ417726",350052,353381,3329
"26993","Ocbimv22029873m.g","KQ420828",2030674,2052174,21500
"26994","Ocbimv22005075m.g","KQ425516",134249,161416,27167
"26995","Ocbimv22036024m.g","KQ422633",141873,142112,239
"26996","Ocbimv22001345m.g","KQ416923",159204,222923,63719
"26997","Ocbimv22022893m.g","KQ433112",4861,17247,12386
"26998","Ocbimv22016466m.g","KQ418359",409616,412407,2791
"26999","Ocbimv22013289m.g","KQ418007",426809,429108,2299
"27000","Ocbimv22004636m.g","KQ425403",152669,159672,7003
"27001","Ocbimv22014203m.g","KQ428799",53059,54132,1073
"27002","Ocbimv22000094m.g","KQ416839",206098,210216,4118
"27003","Ocbimv22014891m.g","KQ429131",194508,194843,335
"27004","Ocbimv22018704m.g","KQ418657",230764,259290,28526
"27005","Ocbimv22027292m.g","KQ416218",123210,139020,15810
"27006","Ocbimv22019330m.g","KQ418750",46432,56235,9803
"27007","Ocbimv22023627m.g","KQ433524",49676,86573,36897
"27008","Ocbimv22000143m.g","KQ423870",4441,20137,15696
"27009","Ocbimv22021933m.g","KQ419134",53260,53481,221
"27010","Ocbimv22021113m.g","KQ419008",213671,279403,65732
"27011","Ocbimv22019042m.g","KQ418711",1132391,1135992,3601
"27012","Ocbimv22007696m.g","KQ415846",1367683,1368469,786
"27013","Ocbimv22017382m.g","KQ430272",90919,91613,694
"27014","Ocbimv22021651m.g","LGKD01669954",9,287,278
"27015","Ocbimv22006809m.g","KQ417353",11668,13623,1955
"27016","Ocbimv22022694m.g","KQ419281",596814,598350,1536
"27017","Ocbimv22037757m.g","KQ416710",135935,138888,2953
"27018","Ocbimv22000204m.g","KQ423898",53070,53530,460
"27019","Ocbimv22019799m.g","KQ431316",197473,198516,1043
"27020","Ocbimv22037671m.g","KQ416705",2966239,2966460,221
"27021","Ocbimv22024682m.g","KQ419615",96293,101660,5367
"27022","Ocbimv22038254m.g","KQ423250",436977,452163,15186
"27023","Ocbimv22001887m.g","KQ424459",1287154,1293813,6659
"27024","Ocbimv22020790m.g","KQ418964",1147923,1166359,18436
"27025","Ocbimv22005904m.g","KQ417284",84107,88015,3908
"27026","Ocbimv22001854m.g","KQ416971",68753,87841,19088
"27027","Ocbimv22028624m.g","KQ420535",135779,135970,191
"27028","Ocbimv22029823m.g","KQ420828",886844,890240,3396
"27029","Ocbimv22038344m.g","KQ416737",864668,866697,2029
"27030","Ocbimv22027424m.g","KQ420272",254258,255075,817
"27031","Ocbimv22030869m.g","KQ416373",909598,910613,1015
"27032","Ocbimv22019111m.g","KQ418717",16401,16943,542
"27033","Ocbimv22007509m.g","KQ417417",269909,276430,6521
"27034","Ocbimv22031250m.g","KQ421206",487943,514482,26539
"27035","Ocbimv22033297m.g","KQ421766",120212,121390,1178
"27036","Ocbimv22007864m.g","KQ417455",394883,407695,12812
"27037","Ocbimv22028123m.g","KQ416251",116737,119078,2341
"27038","Ocbimv22008374m.g","KQ417498",921922,922320,398
"27039","Ocbimv22026204m.g","KQ420016",479688,480113,425
"27040","Ocbimv22039755m.g","KQ416821",315336,315572,236
"27041","Ocbimv22010312m.g","KQ427350",120063,120482,419
"27042","Ocbimv22005368m.g","KQ425599",47019,47171,152
"27043","Ocbimv22029005m.g","KQ416279",446951,447265,314
"27044","Ocbimv22027728m.g","KQ420350",55956,57041,1085
"27045","Ocbimv22034889m.g","KQ422208",311047,318333,7286
"27046","Ocbimv22021836m.g","KQ415687",1042575,1042742,167
"27047","Ocbimv22007381m.g","KQ426315",1991,4179,2188
"27048","Ocbimv22000939m.g","KQ424123",86535,87182,647
"27049","Ocbimv22015701m.g","KQ429484",20308,30832,10524
"27050","Ocbimv22033483m.g","KQ421821",102520,115499,12979
"27051","Ocbimv22017621m.g","KQ430384",4663,12724,8061
"27052","Ocbimv22022605m.g","KQ419271",40880,51798,10918
"27053","Ocbimv22024002m.g","KQ419518",29721,30092,371
"27054","Ocbimv22026438m.g","KQ420052",46897,49473,2576
"27055","Ocbimv22014333m.g","KQ418119",66520,68613,2093
"27056","Ocbimv22024056m.g","KQ419527",123867,128204,4337
"27057","Ocbimv22033661m.g","KQ421858",246398,248248,1850
"27058","Ocbimv22007305m.g","KQ426287",239821,246744,6923
"27059","Ocbimv22017295m.g","KQ430242",96207,115441,19234
"27060","Ocbimv22011758m.g","KQ427892",69355,73706,4351
"27061","Ocbimv22012887m.g","KQ428271",4191,5662,1471
"27062","Ocbimv22029373m.g","KQ420733",49009,49641,632
"27063","Ocbimv22012193m.g","LGKD01593569",225,380,155
"27064","Ocbimv22023680m.g","KQ419458",330265,330963,698
"27065","Ocbimv22039836m.g","KQ423775",30444,30725,281
"27066","Ocbimv22007388m.g","KQ426315",126976,152643,25667
"27067","Ocbimv22019594m.g","KQ418789",252053,252968,915
"27068","Ocbimv22003492m.g","KQ425016",1521,2359,838
"27069","Ocbimv22022186m.g","KQ419180",884215,916356,32141
"27070","Ocbimv22022416m.g","KQ419216",1190,1547,357
"27071","Ocbimv22015778m.g","KQ429563",32578,34402,1824
"27072","Ocbimv22032949m.g","KQ421688",249820,259651,9831
"27073","Ocbimv22038417m.g","KQ423329",103892,104041,149
"27074","Ocbimv22021247m.g","KQ419020",9966,39025,29059
"27075","Ocbimv22035432m.g","LGKD01439316",68,214,146
"27076","Ocbimv22020252m.g","LGKD01658215",560,839,279
"27077","Ocbimv22021206m.g","KQ432038",200972,204649,3677
"27078","Ocbimv22036312m.g","KQ422711",439876,441289,1413
"27079","Ocbimv22001852m.g","KQ424450",170300,170935,635
"27080","Ocbimv22034668m.g","KQ416546",56183,57511,1328
"27081","Ocbimv22008429m.g","KQ417501",187216,189977,2761
"27082","Ocbimv22024546m.g","KQ419593",97555,97764,209
"27083","Ocbimv22008622m.g","KQ417510",939395,962273,22878
"27084","Ocbimv22035896m.g","KQ422595",261684,266350,4666
"27085","Ocbimv22015919m.g","KQ418303",241152,241539,387
"27086","Ocbimv22032306m.g","KQ421521",503598,506972,3374
"27087","Ocbimv22027913m.g","KQ420397",301035,301418,383
"27088","Ocbimv22038470m.g","KQ423354",356076,356918,842
"27089","Ocbimv22031303m.g","KQ421217",538350,568721,30371
"27090","Ocbimv22031197m.g","KQ415723",151619,151858,239
"27091","Ocbimv22006357m.g","KQ417315",304812,305183,371
"27092","Ocbimv22024423m.g","KQ419577",439488,441212,1724
"27093","Ocbimv22007169m.g","KQ417386",1431071,1457982,26911
"27094","Ocbimv22005044m.g","KQ415812",320371,321305,934
"27095","Ocbimv22014557m.g","KQ418153",41312,65612,24300
"27096","Ocbimv22002910m.g","KQ417047",11436,23419,11983
"27097","Ocbimv22021768m.g","KQ419098",224556,225028,472
"27098","Ocbimv22030121m.g","KQ420902",22794,23455,661
"27099","Ocbimv22020441m.g","LGKD01660467",84,1241,1157
"27100","Ocbimv22024272m.g","KQ419562",72580,89661,17081
"27101","Ocbimv22011712m.g","KQ417824",689933,690208,275
"27102","Ocbimv22015623m.g","KQ418269",424059,424782,723
"27103","Ocbimv22003681m.g","KQ425065",50260,87461,37201
"27104","Ocbimv22031546m.g","KQ421273",272228,459455,187227
"27105","Ocbimv22008995m.g","KQ417549",58387,62404,4017
"27106","Ocbimv22012497m.g","KQ417917",233672,240455,6783
"27107","Ocbimv22009410m.g","KQ417591",936964,945715,8751
"27108","Ocbimv22020989m.g","KQ418989",117885,118843,958
"27109","Ocbimv22039737m.g","KQ423737",80434,83433,2999
"27110","Ocbimv22002045m.g","KQ424530",140980,143696,2716
"27111","Ocbimv22031610m.g","KQ421296",46894,49935,3041
"27112","Ocbimv22011357m.g","KQ417791",152891,173529,20638
"27113","Ocbimv22015223m.g","KQ429221",42954,43322,368
"27114","Ocbimv22030383m.g","KQ420970",101920,116475,14555
"27115","Ocbimv22034980m.g","KQ422233",459021,472710,13689
"27116","Ocbimv22003146m.g","KQ424897",159844,160103,259
"27117","Ocbimv22020170m.g","KQ418866",98644,104972,6328
"27118","Ocbimv22035405m.g","KQ422367",330934,332221,1287
"27119","Ocbimv22019856m.g","KQ418823",4937,5948,1011
"27120","Ocbimv22033014m.g","KQ421718",230557,297473,66916
"27121","Ocbimv22024210m.g","KQ419550",56312,61200,4888
"27122","Ocbimv22027349m.g","KQ416222",141528,143203,1675
"27123","Ocbimv22029067m.g","KQ420640",88389,137548,49159
"27124","Ocbimv22010957m.g","LGKD01583508",12,128,116
"27125","Ocbimv22014812m.g","KQ429096",327726,341020,13294
"27126","Ocbimv22032178m.g","KQ421469",7268,7741,473
"27127","Ocbimv22028332m.g","KQ420475",536793,537242,449
"27128","Ocbimv22028729m.g","KQ416270",1147045,1149181,2136
"27129","Ocbimv22032967m.g","KQ421702",403685,415746,12061
"27130","Ocbimv22022567m.g","KQ419260",719523,719675,152
"27131","Ocbimv22027101m.g","KQ420181",1016661,1017099,438
"27132","Ocbimv22014113m.g","KQ428763",22968,23774,806
"27133","Ocbimv22032418m.g","KQ421533",337623,363241,25618
"27134","Ocbimv22013990m.g","KQ428718",53865,106592,52727
"27135","Ocbimv22003757m.g","KQ425086",20518,23050,2532
"27136","Ocbimv22008169m.g","KQ417481",1601142,1628401,27259
"27137","Ocbimv22027229m.g","LGKD01342397",1196,2431,1235
"27138","Ocbimv22005003m.g","KQ415811",830321,831887,1566
"27139","Ocbimv22025098m.g","KQ416137",479492,480252,760
"27140","Ocbimv22038073m.g","KQ416725",270045,276746,6701
"27141","Ocbimv22002277m.g","KQ424614",34744,78655,43911
"27142","Ocbimv22005258m.g","KQ425558",25936,26887,951
"27143","Ocbimv22032832m.g","KQ421664",1127420,1129037,1617
"27144","Ocbimv22004235m.g","KQ417143",93277,94107,830
"27145","Ocbimv22033183m.g","KQ421741",134291,138861,4570
"27146","Ocbimv22005756m.g","KQ425735",15400,91527,76127
"27147","Ocbimv22031325m.g","KQ421218",189027,190208,1181
"27148","Ocbimv22033581m.g","KQ421838",125354,137857,12503
"27149","Ocbimv22018837m.g","LGKD01646549",215,1624,1409
"27150","Ocbimv22024673m.g","KQ419611",173742,174636,894
"27151","Ocbimv22025015m.g","KQ416136",100688,129470,28782
"27152","Ocbimv22007638m.g","KQ415845",520244,585263,65019
"27153","Ocbimv22027998m.g","KQ420415",548083,569034,20951
"27154","Ocbimv22014737m.g","KQ429055",3735,4279,544
"27155","Ocbimv22008612m.g","KQ417510",841662,844943,3281
"27156","Ocbimv22038001m.g","KQ416719",232230,246501,14271
"27157","Ocbimv22011396m.g","KQ417791",1014280,1030601,16321
"27158","Ocbimv22015801m.g","KQ418294",3347,3598,251
"27159","Ocbimv22038634m.g","KQ415766",8474,9333,859
"27160","Ocbimv22020956m.g","KQ416036",112637,112918,281
"27161","Ocbimv22037141m.g","KQ422938",131617,145725,14108
"27162","Ocbimv22032253m.g","KQ421505",226687,227034,347
"27163","Ocbimv22032311m.g","KQ421523",126972,132770,5798
"27164","Ocbimv22013256m.g","KQ428426",111700,182771,71071
"27165","Ocbimv22007553m.g","LGKD01556686",3,233,230
"27166","Ocbimv22022100m.g","KQ432566",10232,26130,15898
"27167","Ocbimv22033403m.g","KQ421804",15627,22540,6913
"27168","Ocbimv22002145m.g","KQ415788",1039385,1044072,4687
"27169","Ocbimv22013986m.g","KQ428717",346353,346685,332
"27170","Ocbimv22034406m.g","KQ422029",196947,197516,569
"27171","Ocbimv22023749m.g","KQ419473",233599,243848,10249
"27172","Ocbimv22024953m.g","KQ419663",206129,222659,16530
"27173","Ocbimv22027895m.g","KQ420393",31199,32098,899
"27174","Ocbimv22017761m.g","KQ418537",1040962,1041535,573
"27175","Ocbimv22008336m.g","KQ417497",1194746,1199264,4518
"27176","Ocbimv22031506m.g","KQ421263",289837,307978,18141
"27177","Ocbimv22014916m.g","KQ418187",405347,463654,58307
"27178","Ocbimv22011417m.g","KQ415885",251296,252525,1229
"27179","Ocbimv22036517m.g","KQ422783",97484,101868,4384
"27180","Ocbimv22024176m.g","KQ419544",47969,48118,149
"27181","Ocbimv22007899m.g","KQ426486",40945,41100,155
"27182","Ocbimv22020327m.g","KQ418895",24608,24841,233
"27183","Ocbimv22005908m.g","KQ417284",185106,188799,3693
"27184","Ocbimv22006186m.g","KQ417301",60443,117952,57509
"27185","Ocbimv22031183m.g","KQ415722",77556,79541,1985
"27186","Ocbimv22016497m.g","KQ418361",22466,22917,451
"27187","Ocbimv22018896m.g","KQ430924",65804,81721,15917
"27188","Ocbimv22027528m.g","KQ420299",228120,229542,1422
"27189","Ocbimv22027105m.g","KQ420183",26434,39679,13245
"27190","Ocbimv22020695m.g","KQ418954",466524,481278,14754
"27191","Ocbimv22036644m.g","KQ422818",105827,117649,11822
"27192","Ocbimv22003522m.g","KQ425021",276075,300280,24205
"27193","Ocbimv22021547m.g","KQ432227",419,21106,20687
"27194","Ocbimv22039895m.g","KQ416834",106693,169341,62648
"27195","Ocbimv22017559m.g","KQ418506",44470,44679,209
"27196","Ocbimv22037137m.g","KQ422938",97792,98549,757
"27197","Ocbimv22002934m.g","KQ424850",43032,51704,8672
"27198","Ocbimv22004587m.g","KQ417182",8316,8606,290
"27199","Ocbimv22017069m.g","KQ430152",88476,90044,1568
"27200","Ocbimv22036396m.g","KQ416639",53882,54214,332
"27201","Ocbimv22026208m.g","KQ420017",234652,234957,305
"27202","Ocbimv22016937m.g","KQ418427",30044,71315,41271
"27203","Ocbimv22003965m.g","KQ425160",582674,624040,41366
"27204","Ocbimv22005956m.g","KQ417285",231841,238368,6527
"27205","Ocbimv22000975m.g","KQ424142",29442,30602,1160
"27206","Ocbimv22015960m.g","KQ429629",95226,104721,9495
"27207","Ocbimv22023628m.g","KQ419448",1224,1667,443
"27208","Ocbimv22017766m.g","KQ418543",87400,180552,93152
"27209","Ocbimv22011985m.g","KQ417851",169043,169644,601
"27210","Ocbimv22004815m.g","KQ417208",279630,293956,14326
"27211","Ocbimv22032510m.g","KQ421567",728,1559,831
"27212","Ocbimv22034582m.g","KQ422079",33917,34743,826
"27213","Ocbimv22031143m.g","KQ421175",31488,31664,176
"27214","Ocbimv22001045m.g","KQ424160",89301,99281,9980
"27215","Ocbimv22002273m.g","KQ424608",68690,74142,5452
"27216","Ocbimv22007722m.g","KQ417446",298143,306860,8717
"27217","Ocbimv22037091m.g","KQ422919",1615849,1617046,1197
"27218","Ocbimv22004178m.g","KQ425220",286769,295230,8461
"27219","Ocbimv22029846m.g","KQ420828",1374361,1376369,2008
"27220","Ocbimv22001908m.g","KQ424469",126005,126157,152
"27221","Ocbimv22013438m.g","KQ428507",31212,34238,3026
"27222","Ocbimv22031127m.g","KQ415721",58265,58730,465
"27223","Ocbimv22004553m.g","KQ425361",15322,16685,1363
"27224","Ocbimv22011879m.g","KQ417844",979917,980105,188
"27225","Ocbimv22027078m.g","KQ420175",186788,201623,14835
"27226","Ocbimv22022216m.g","KQ416062",84459,105995,21536
"27227","Ocbimv22003672m.g","KQ417100",494342,505520,11178
"27228","Ocbimv22005009m.g","KQ415811",1553887,1555361,1474
"27229","Ocbimv22035872m.g","KQ416608",304578,305088,510
"27230","Ocbimv22031967m.g","KQ421389",1248175,1248612,437
"27231","Ocbimv22007340m.g","KQ426303",224471,234543,10072
"27232","Ocbimv22017475m.g","KQ430313",21489,29639,8150
"27233","Ocbimv22036611m.g","KQ416648",298164,324630,26466
"27234","Ocbimv22017046m.g","KQ418444",170637,173769,3132
"27235","Ocbimv22022274m.g","KQ419192",347264,347683,419
"27236","Ocbimv22008182m.g","KQ417481",2074498,2078161,3663
"27237","Ocbimv22033100m.g","KQ421727",94867,109082,14215
"27238","Ocbimv22038443m.g","KQ423341",11848,13363,1515
"27239","Ocbimv22038427m.g","KQ423336",339113,339688,575
"27240","Ocbimv22037335m.g","LGKD01459738",10,480,470
"27241","Ocbimv22038988m.g","KQ423499",161549,176253,14704
"27242","Ocbimv22008937m.g","KQ426815",48349,48660,311
"27243","Ocbimv22008773m.g","KQ426768",33366,33680,314
"27244","Ocbimv22008165m.g","KQ417481",1517240,1534048,16808
"27245","Ocbimv22006284m.g","KQ425850",295896,296374,478
"27246","Ocbimv22030215m.g","KQ420924",294576,300356,5780
"27247","Ocbimv22026478m.g","KQ420055",286441,287584,1143
"27248","Ocbimv22009946m.g","KQ427168",26777,48557,21780
"27249","Ocbimv22003479m.g","KQ425015",790662,815288,24626
"27250","Ocbimv22018048m.g","KQ430536",1812,31505,29693
"27251","Ocbimv22030017m.g","KQ416330",292516,349675,57159
"27252","Ocbimv22022610m.g","KQ432909",42569,42922,353
"27253","Ocbimv22038696m.g","KQ423444",283989,284676,687
"27254","Ocbimv22034322m.g","KQ422016",32550,33644,1094
"27255","Ocbimv22037639m.g","KQ423084",227466,228407,941
"27256","Ocbimv22028952m.g","LGKD01361746",322,618,296
"27257","Ocbimv22029268m.g","KQ420696",255204,274222,19018
"27258","Ocbimv22028687m.g","KQ420555",108835,109326,491
"27259","Ocbimv22018986m.g","KQ418706",138019,138766,747
"27260","Ocbimv22015108m.g","KQ429157",336152,339587,3435
"27261","Ocbimv22036306m.g","KQ416631",400136,433850,33714
"27262","Ocbimv22008940m.g","KQ426816",2638,35971,33333
"27263","Ocbimv22002217m.g","KQ424575",77156,77547,391
"27264","Ocbimv22005263m.g","KQ425560",23000,39245,16245
"27265","Ocbimv22038429m.g","KQ423338",95434,99912,4478
"27266","Ocbimv22023566m.g","KQ419432",230561,241287,10726
"27267","Ocbimv22013562m.g","KQ418038",39618,40499,881
"27268","Ocbimv22014551m.g","KQ428985",13282,14431,1149
"27269","Ocbimv22022290m.g","KQ419192",728223,729799,1576
"27270","Ocbimv22037290m.g","KQ422993",254183,254350,167
"27271","Ocbimv22025654m.g","KQ419877",63560,116535,52975
"27272","Ocbimv22025738m.g","KQ415694",51103,59063,7960
"27273","Ocbimv22002131m.g","KQ415788",417474,424778,7304
"27274","Ocbimv22031116m.g","KQ416385",1536132,1536551,419
"27275","Ocbimv22007188m.g","KQ426231",60933,61259,326
"27276","Ocbimv22029779m.g","KQ420821",129375,130090,715
"27277","Ocbimv22021439m.g","KQ419049",95948,103996,8048
"27278","Ocbimv22029227m.g","KQ416294",179650,223326,43676
"27279","Ocbimv22002023m.g","KQ424513",184351,200859,16508
"27280","Ocbimv22019807m.g","KQ418818",646,4369,3723
"27281","Ocbimv22010874m.g","KQ417721",1042600,1043082,482
"27282","Ocbimv22038582m.g","KQ423411",245198,298788,53590
"27283","Ocbimv22018863m.g","KQ418693",350822,355322,4500
"27284","Ocbimv22037180m.g","KQ416680",69678,70055,377
"27285","Ocbimv22010755m.g","KQ417713",286159,286647,488
"27286","Ocbimv22016909m.g","KQ418422",320363,321671,1308
"27287","Ocbimv22034924m.g","KQ415742",967386,973253,5867
"27288","Ocbimv22025853m.g","KQ419913",76625,76886,261
"27289","Ocbimv22003724m.g","KQ425076",103913,161525,57612
"27290","Ocbimv22003502m.g","KQ417089",828179,829062,883
"27291","Ocbimv22017202m.g","KQ418466",61022,61271,249
"27292","Ocbimv22003167m.g","KQ417062",68097,68979,882
"27293","Ocbimv22012339m.g","KQ415907",816168,858730,42562
"27294","Ocbimv22006350m.g","KQ417315",26037,26725,688
"27295","Ocbimv22035883m.g","KQ422595",124222,131219,6997
"27296","Ocbimv22022399m.g","KQ419215",288941,304628,15687
"27297","Ocbimv22030279m.g","KQ416340",410921,411569,648
"27298","Ocbimv22037723m.g","KQ423122",11949,13113,1164
"27299","Ocbimv22026400m.g","KQ420039",16008,16993,985
"27300","Ocbimv22014889m.g","KQ429131",168425,171271,2846
"27301","Ocbimv22013985m.g","KQ428717",342942,379545,36603
"27302","Ocbimv22024013m.g","LGKD01694811",340,648,308
"27303","Ocbimv22033652m.g","KQ421858",117946,118251,305
"27304","Ocbimv22031427m.g","KQ421241",438124,439433,1309
"27305","Ocbimv22018890m.g","KQ430918",1279,27709,26430
"27306","Ocbimv22032869m.g","KQ416454",90257,99852,9595
"27307","Ocbimv22000042m.g","KQ423834",76358,88240,11882
"27308","Ocbimv22019341m.g","KQ431100",12053,32210,20157
"27309","Ocbimv22026153m.g","KQ420004",397838,398101,263
"27310","Ocbimv22001748m.g","KQ416960",216847,217386,539
"27311","Ocbimv22018459m.g","KQ415992",726885,727325,440
"27312","Ocbimv22028262m.g","KQ415659",1436822,1436998,176
"27313","Ocbimv22037412m.g","KQ416694",2503304,2505961,2657
"27314","Ocbimv22019368m.g","KQ416009",557753,558952,1199
"27315","Ocbimv22019985m.g","KQ418840",1120986,1122897,1911
"27316","Ocbimv22006333m.g","KQ425878",73809,74126,317
"27317","Ocbimv22023256m.g","KQ419380",591759,592774,1015
"27318","Ocbimv22018120m.g","KQ430572",461949,486020,24071
"27319","Ocbimv22004450m.g","KQ425308",9210,11036,1826
"27320","Ocbimv22009968m.g","LGKD01574932",243,818,575
"27321","Ocbimv22007279m.g","KQ417397",166833,197218,30385
"27322","Ocbimv22007270m.g","KQ426278",7278,34144,26866
"27323","Ocbimv22031199m.g","KQ421200",22048,23933,1885
"27324","Ocbimv22024603m.g","KQ419601",1245112,1286967,41855
"27325","Ocbimv22018829m.g","KQ418685",75511,75975,464
"27326","Ocbimv22027796m.g","KQ416233",513963,514214,251
"27327","Ocbimv22005459m.g","KQ425611",12203,12731,528
"27328","Ocbimv22013351m.g","KQ428460",15034,45807,30773
"27329","Ocbimv22029476m.g","KQ416308",598149,701826,103677
"27330","Ocbimv22008606m.g","KQ417510",675520,676370,850
"27331","Ocbimv22033822m.g","LGKD01420912",65,259,194
"27332","Ocbimv22016335m.g","LGKD01626662",21,329,308
"27333","Ocbimv22017315m.g","KQ415681",1922217,1922405,188
"27334","Ocbimv22009209m.g","KQ417574",1264743,1266695,1952
"27335","Ocbimv22003909m.g","KQ417122",1082,2757,1675
"27336","Ocbimv22013653m.g","KQ428583",101512,101835,323
"27337","Ocbimv22005887m.g","KQ417281",749588,820582,70994
"27338","Ocbimv22031140m.g","KQ421173",218280,218681,401
"27339","Ocbimv22012271m.g","KQ428092",2304,4093,1789
"27340","Ocbimv22036685m.g","KQ422834",63299,63873,574
"27341","Ocbimv22026285m.g","KQ420023",88077,90812,2735
"27342","Ocbimv22025757m.g","KQ416166",446329,450986,4657
"27343","Ocbimv22027457m.g","KQ416225",4,3034,3030
"27344","Ocbimv22000448m.g","KQ423968",159768,163403,3635
"27345","Ocbimv22002151m.g","KQ424561",317414,318172,758
"27346","Ocbimv22026544m.g","KQ420068",106811,107270,459
"27347","Ocbimv22004900m.g","KQ417213",317883,331372,13489
"27348","Ocbimv22001208m.g","KQ424229",166703,168799,2096
"27349","Ocbimv22038164m.g","KQ423221",308050,308217,167
"27350","Ocbimv22017692m.g","KQ430417",184185,241713,57528
"27351","Ocbimv22016217m.g","KQ418328",418534,480069,61535
"27352","Ocbimv22008503m.g","KQ417506",448454,453465,5011
"27353","Ocbimv22018212m.g","KQ415990",1533690,1538106,4416
"27354","Ocbimv22015989m.g","KQ418307",11417,24440,13023
"27355","Ocbimv22015899m.g","KQ429620",170706,206467,35761
"27356","Ocbimv22039960m.g","KQ423812",1622,27868,26246
"27357","Ocbimv22035537m.g","KQ422423",155011,155265,254
"27358","Ocbimv22005993m.g","KQ425779",22154,23380,1226
"27359","Ocbimv22030732m.g","KQ421080",66451,82713,16262
"27360","Ocbimv22033184m.g","KQ421741",149054,149413,359
"27361","Ocbimv22026983m.g","KQ420157",332468,336205,3737
"27362","Ocbimv22020144m.g","KQ416020",159828,160708,880
"27363","Ocbimv22032333m.g","KQ421523",733073,737601,4528
"27364","Ocbimv22031786m.g","KQ421344",3399,4647,1248
"27365","Ocbimv22015068m.g","KQ418194",1270781,1274117,3336
"27366","Ocbimv22007162m.g","KQ417386",629660,630223,563
"27367","Ocbimv22023287m.g","KQ419392",59969,72618,12649
"27368","Ocbimv22032923m.g","KQ421685",99606,110534,10928
"27369","Ocbimv22009893m.g","KQ417621",623783,661421,37638
"27370","Ocbimv22025459m.g","KQ419807",222206,253529,31323
"27371","Ocbimv22009038m.g","KQ415859",164337,165550,1213
"27372","Ocbimv22000546m.g","KQ423995",123512,143306,19794
"27373","Ocbimv22024986m.g","KQ419672",147319,148437,1118
"27374","Ocbimv22015494m.g","KQ418263",223460,223675,215
"27375","Ocbimv22034417m.g","KQ422034",107879,108383,504
"27376","Ocbimv22013841m.g","KQ418068",28933,29869,936
"27377","Ocbimv22004688m.g","KQ417198",189086,198867,9781
"27378","Ocbimv22011655m.g","KQ427833",363437,364184,747
"27379","Ocbimv22000466m.g","KQ416861",757818,769613,11795
"27380","Ocbimv22016210m.g","KQ429753",120565,120849,284
"27381","Ocbimv22009776m.g","KQ417613",487910,488132,222
"27382","Ocbimv22012284m.g","KQ428101",90697,119544,28847
"27383","Ocbimv22025066m.g","KQ419691",95725,97631,1906
"27384","Ocbimv22014476m.g","LGKD01610198",17,148,131
"27385","Ocbimv22032615m.g","KQ421607",303630,304334,704
"27386","Ocbimv22031046m.g","KQ421147",171949,355326,183377
"27387","Ocbimv22027660m.g","KQ420334",26535,32113,5578
"27388","Ocbimv22017526m.g","KQ418504",270232,293415,23183
"27389","Ocbimv22023343m.g","KQ419395",107266,107733,467
"27390","Ocbimv22025116m.g","KQ419695",154376,185919,31543
"27391","Ocbimv22028307m.g","KQ420468",51188,53213,2025
"27392","Ocbimv22008837m.g","KQ417537",106107,135618,29511
"27393","Ocbimv22023247m.g","KQ419380",52008,52187,179
"27394","Ocbimv22003025m.g","KQ417055",901584,904075,2491
"27395","Ocbimv22024237m.g","KQ433876",4646,55355,50709
"27396","Ocbimv22004433m.g","KQ425304",45377,47359,1982
"27397","Ocbimv22017540m.g","KQ430345",102494,109824,7330
"27398","Ocbimv22006619m.g","KQ417337",105983,141047,35064
"27399","Ocbimv22011225m.g","KQ417763",551492,552077,585
"27400","Ocbimv22021766m.g","KQ419098",90426,91739,1313
"27401","Ocbimv22027988m.g","KQ420415",177965,179765,1800
"27402","Ocbimv22032596m.g","KQ416441",330452,333468,3016
"27403","Ocbimv22038930m.g","KQ423490",252757,253821,1064
"27404","Ocbimv22026797m.g","KQ420117",1395066,1509733,114667
"27405","Ocbimv22026892m.g","KQ420137",152504,165052,12548
"27406","Ocbimv22018957m.g","KQ418702",388119,396736,8617
"27407","Ocbimv22027604m.g","KQ420313",698889,742137,43248
"27408","Ocbimv22014501m.g","KQ428970",46852,47390,538
"27409","Ocbimv22013235m.g","KQ418003",99152,109821,10669
"27410","Ocbimv22012165m.g","KQ428056",949,8694,7745
"27411","Ocbimv22006978m.g","LGKD01551709",9,675,666
"27412","Ocbimv22038274m.g","KQ423259",485064,527981,42917
"27413","Ocbimv22026219m.g","KQ420017",545354,545649,295
"27414","Ocbimv22026643m.g","KQ420085",168573,207015,38442
"27415","Ocbimv22009077m.g","KQ426860",27666,55565,27899
"27416","Ocbimv22039846m.g","KQ416831",154604,183572,28968
"27417","Ocbimv22012701m.g","KQ428204",5209,11035,5826
"27418","Ocbimv22013288m.g","KQ418007",422873,424830,1957
"27419","Ocbimv22014617m.g","KQ415934",147684,169298,21614
"27420","Ocbimv22018334m.g","KQ430665",57290,74834,17544
"27421","Ocbimv22000609m.g","KQ424018",62140,76109,13969
"27422","Ocbimv22019193m.g","KQ418732",3418,4025,607
"27423","Ocbimv22000643m.g","KQ424026",281438,281989,551
"27424","Ocbimv22015713m.g","LGKD01621003",43,336,293
"27425","Ocbimv22010330m.g","KQ417670",243608,281876,38268
"27426","Ocbimv22005372m.g","KQ417249",206344,249159,42815
"27427","Ocbimv22036741m.g","KQ422849",29320,43529,14209
"27428","Ocbimv22032656m.g","KQ421628",172550,172762,212
"27429","Ocbimv22010864m.g","LGKD01583162",1,156,155
"27430","Ocbimv22017137m.g","KQ418453",158960,193796,34836
"27431","Ocbimv22034155m.g","KQ421988",111301,111624,323
"27432","Ocbimv22009582m.g","KQ427029",551045,552872,1827
"27433","Ocbimv22008563m.g","KQ426704",15700,25496,9796
"27434","Ocbimv22008212m.g","KQ417487",368205,368504,299
"27435","Ocbimv22009310m.g","KQ417582",163744,163911,167
"27436","Ocbimv22036987m.g","KQ422901",12022,12345,323
"27437","Ocbimv22026341m.g","KQ420029",452713,452919,206
"27438","Ocbimv22012799m.g","KQ417942",252621,252800,179
"27439","Ocbimv22001390m.g","KQ416930",298116,309706,11590
"27440","Ocbimv22006115m.g","KQ417298",235388,235708,320
"27441","Ocbimv22009810m.g","KQ417619",6638,7147,509
"27442","Ocbimv22011866m.g","KQ427941",78627,80201,1574
"27443","Ocbimv22011990m.g","KQ417851",464278,479091,14813
"27444","Ocbimv22001952m.g","KQ416976",11523,12212,689
"27445","Ocbimv22007954m.g","KQ426504",13349,14123,774
"27446","Ocbimv22006354m.g","KQ417315",118089,118259,170
"27447","Ocbimv22004664m.g","KQ425412",171880,178797,6917
"27448","Ocbimv22024935m.g","KQ419660",1105,51911,50806
"27449","Ocbimv22010435m.g","KQ427385",146327,261005,114678
"27450","Ocbimv22015387m.g","KQ429315",33059,33661,602
"27451","Ocbimv22014666m.g","KQ418166",61137,90533,29396
"27452","Ocbimv22028725m.g","KQ416270",664245,664754,509
"27453","Ocbimv22021780m.g","KQ432315",79439,80531,1092
"27454","Ocbimv22005643m.g","KQ425692",327059,327822,763
"27455","Ocbimv22035600m.g","KQ422458",73781,85672,11891
"27456","Ocbimv22005737m.g","KQ425732",170732,184114,13382
"27457","Ocbimv22023529m.g","KQ419425",530578,532044,1466
"27458","Ocbimv22037892m.g","KQ423146",69328,70104,776
"27459","Ocbimv22039756m.g","KQ423738",65178,76024,10846
"27460","Ocbimv22018770m.g","KQ418671",60283,62778,2495
"27461","Ocbimv22023921m.g","KQ419500",538190,680880,142690
"27462","Ocbimv22022769m.g","KQ419290",79752,133037,53285
"27463","Ocbimv22019365m.g","KQ416009",194187,197509,3322
"27464","Ocbimv22006971m.g","KQ417369",53044,53409,365
"27465","Ocbimv22032847m.g","KQ421665",239738,241192,1454
"27466","Ocbimv22005976m.g","KQ425769",144947,147150,2203
"27467","Ocbimv22029113m.g","KQ420656",353974,355909,1935
"27468","Ocbimv22000893m.g","KQ424106",15629,23736,8107
"27469","Ocbimv22009472m.g","KQ417596",623109,718904,95795
"27470","Ocbimv22004352m.g","KQ417152",149706,150077,371
"27471","Ocbimv22015900m.g","KQ429620",228131,253835,25704
"27472","Ocbimv22028599m.g","KQ416263",575902,576560,658
"27473","Ocbimv22015787m.g","KQ418293",104068,104415,347
"27474","Ocbimv22014285m.g","KQ418114",229092,231020,1928
"27475","Ocbimv22033223m.g","KQ421758",227995,238697,10702
"27476","Ocbimv22011692m.g","LGKD01589360",301,474,173
"27477","Ocbimv22019394m.g","KQ416010",299759,332029,32270
"27478","Ocbimv22016142m.g","KQ418322",299682,321851,22169
"27479","Ocbimv22014971m.g","KQ418188",369809,396041,26232
"27480","Ocbimv22015754m.g","KQ418289",250142,288173,38031
"27481","Ocbimv22015117m.g","KQ418196",16507,27365,10858
"27482","Ocbimv22010967m.g","KQ427571",171488,277830,106342
"27483","Ocbimv22004291m.g","KQ417146",109041,117616,8575
"27484","Ocbimv22008697m.g","KQ426737",42732,43632,900
"27485","Ocbimv22000908m.g","KQ424107",26620,33917,7297
"27486","Ocbimv22028319m.g","KQ420475",35676,63368,27692
"27487","Ocbimv22031207m.g","KQ421200",202751,222186,19435
"27488","Ocbimv22005696m.g","KQ417274",92034,92765,731
"27489","Ocbimv22016640m.g","KQ418371",308967,309314,347
"27490","Ocbimv22025433m.g","KQ419798",6111,6392,281
"27491","Ocbimv22031334m.g","KQ421218",413177,414538,1361
"27492","Ocbimv22007245m.g","KQ426259",138055,183200,45145
"27493","Ocbimv22023503m.g","KQ433427",135063,136399,1336
"27494","Ocbimv22019340m.g","KQ418751",166800,173764,6964
"27495","Ocbimv22025534m.g","KQ419831",611961,615259,3298
"27496","Ocbimv22003855m.g","KQ425131",71848,86120,14272
"27497","Ocbimv22020572m.g","KQ418926",152315,156222,3907
"27498","Ocbimv22002529m.g","KQ424677",21438,22655,1217
"27499","Ocbimv22014406m.g","KQ418128",134313,187517,53204
"27500","Ocbimv22033865m.g","KQ421896",281129,281489,360
"27501","Ocbimv22013826m.g","KQ428682",47260,58048,10788
"27502","Ocbimv22036538m.g","KQ422788",12278,14596,2318
"27503","Ocbimv22007151m.g","KQ426215",30111,61603,31492
"27504","Ocbimv22036030m.g","KQ416614",98512,100362,1850
"27505","Ocbimv22031413m.g","KQ421233",203685,236503,32818
"27506","Ocbimv22025816m.g","KQ419909",16808,21142,4334
"27507","Ocbimv22030211m.g","KQ420924",200113,201677,1564
"27508","Ocbimv22008556m.g","LGKD01170297",7,198,191
"27509","Ocbimv22036482m.g","KQ422772",22833,23147,314
"27510","Ocbimv22020267m.g","KQ418880",2890,13616,10726
"27511","Ocbimv22012647m.g","KQ428192",347282,349726,2444
"27512","Ocbimv22001410m.g","KQ424302",54293,80619,26326
"27513","Ocbimv22035001m.g","KQ422241",110193,110414,221
"27514","Ocbimv22015196m.g","KQ418205",44552,119532,74980
"27515","Ocbimv22006466m.g","KQ417324",367269,382454,15185
"27516","Ocbimv22036401m.g","KQ422750",8236,27214,18978
"27517","Ocbimv22035598m.g","KQ422458",10972,42164,31192
"27518","Ocbimv22001782m.g","KQ424414",61461,72587,11126
"27519","Ocbimv22032619m.g","KQ416442",49593,56186,6593
"27520","Ocbimv22037147m.g","KQ416677",179092,179679,587
"27521","Ocbimv22025980m.g","KQ419940",81440,82370,930
"27522","Ocbimv22026004m.g","KQ419952",301714,329916,28202
"27523","Ocbimv22019493m.g","KQ431166",117,25925,25808
"27524","Ocbimv22013872m.g","KQ418069",114111,115434,1323
"27525","Ocbimv22004168m.g","KQ425220",203311,203817,506
"27526","Ocbimv22028117m.g","KQ420432",402535,402762,227
"27527","Ocbimv22037909m.g","KQ416715",429641,431788,2147
"27528","Ocbimv22038758m.g","KQ416765",95757,95990,233
"27529","Ocbimv22002627m.g","KQ417023",837289,847622,10333
"27530","Ocbimv22038397m.g","KQ423316",59954,60106,152
"27531","Ocbimv22009895m.g","KQ417621",795919,864527,68608
"27532","Ocbimv22025490m.g","KQ419819",2432,9232,6800
"27533","Ocbimv22028484m.g","KQ420502",234084,238449,4365
"27534","Ocbimv22022612m.g","KQ419272",115610,116290,680
"27535","Ocbimv22004574m.g","KQ425367",181611,182183,572
"27536","Ocbimv22011724m.g","KQ417827",4,3384,3380
"27537","Ocbimv22005799m.g","KQ415823",1080303,1106440,26137
"27538","Ocbimv22011984m.g","KQ417850",112915,113328,413
"27539","Ocbimv22021932m.g","KQ419133",448275,482867,34592
"27540","Ocbimv22008976m.g","KQ417544",980475,1023322,42847
"27541","Ocbimv22033856m.g","KQ421896",147635,221715,74080
"27542","Ocbimv22018240m.g","KQ430604",15252,16923,1671
"27543","Ocbimv22004354m.g","KQ417152",203842,236675,32833
"27544","Ocbimv22026855m.g","KQ420130",861461,862451,990
"27545","Ocbimv22020969m.g","KQ418985",117752,163609,45857
"27546","Ocbimv22017146m.g","KQ430169",17680,30889,13209
"27547","Ocbimv22003839m.g","KQ425128",454869,455438,569
"27548","Ocbimv22023372m.g","KQ419395",284663,284821,158
"27549","Ocbimv22021392m.g","KQ432116",31223,36645,5422
"27550","Ocbimv22003266m.g","KQ424932",177064,196564,19500
"27551","Ocbimv22032384m.g","KQ416430",539676,540527,851
"27552","Ocbimv22004288m.g","KQ417146",36133,37821,1688
"27553","Ocbimv22016945m.g","KQ430102",150817,151702,885
"27554","Ocbimv22028192m.g","KQ420442",58253,65342,7089
"27555","Ocbimv22028565m.g","KQ420522",235236,236747,1511
"27556","Ocbimv22020438m.g","KQ431677",3536,3880,344
"27557","Ocbimv22033238m.g","KQ421758",788651,788962,311
"27558","Ocbimv22024712m.g","KQ419621",290029,291869,1840
"27559","Ocbimv22014584m.g","KQ428994",225346,225922,576
"27560","Ocbimv22026309m.g","KQ420023",546489,547619,1130
"27561","Ocbimv22024375m.g","KQ419574",1123350,1124487,1137
"27562","Ocbimv22017224m.g","KQ418469",245699,252170,6471
"27563","Ocbimv22025304m.g","KQ419766",13909,14487,578
"27564","Ocbimv22027280m.g","KQ420241",133160,134047,887
"27565","Ocbimv22024260m.g","KQ433896",55187,55423,236
"27566","Ocbimv22026844m.g","KQ420126",758315,760375,2060
"27567","Ocbimv22038883m.g","KQ423486",124158,146094,21936
"27568","Ocbimv22026688m.g","KQ416197",4458,27821,23363
"27569","Ocbimv22017249m.g","KQ418469",777350,809076,31726
"27570","Ocbimv22018524m.g","KQ418633",229604,237622,8018
"27571","Ocbimv22029910m.g","KQ416322",93988,94260,272
"27572","Ocbimv22037059m.g","KQ422913",49549,56354,6805
"27573","Ocbimv22028833m.g","KQ420591",42423,84580,42157
"27574","Ocbimv22020355m.g","KQ418900",120997,126484,5487
"27575","Ocbimv22013888m.g","KQ418070",115941,116138,197
"27576","Ocbimv22023925m.g","KQ419500",701946,735071,33125
"27577","Ocbimv22008096m.g","KQ426567",81591,83309,1718
"27578","Ocbimv22027114m.g","KQ420188",31656,67782,36126
"27579","Ocbimv22030541m.g","KQ421018",97283,132796,35513
"27580","Ocbimv22030683m.g","KQ416363",9069,9467,398
"27581","Ocbimv22026426m.g","KQ420047",408810,478034,69224
"27582","Ocbimv22019280m.g","KQ418740",631321,641925,10604
"27583","Ocbimv22021910m.g","KQ432421",48635,48808,173
"27584","Ocbimv22008967m.g","KQ417544",301558,344926,43368
"27585","Ocbimv22028249m.g","KQ415659",141204,143200,1996
"27586","Ocbimv22024387m.g","KQ415693",281051,282365,1314
"27587","Ocbimv22038859m.g","KQ415768",673112,711825,38713
"27588","Ocbimv22033319m.g","KQ421772",5950,9723,3773
"27589","Ocbimv22012657m.g","KQ417923",625629,636220,10591
"27590","Ocbimv22035548m.g","KQ415751",111630,111941,311
"27591","Ocbimv22016805m.g","KQ418402",178020,242142,64122
"27592","Ocbimv22013375m.g","KQ418018",569097,593457,24360
"27593","Ocbimv22027823m.g","KQ420375",1079627,1079862,235
"27594","Ocbimv22011824m.g","KQ415893",825407,838379,12972
"27595","Ocbimv22019867m.g","KQ431342",890,1177,287
"27596","Ocbimv22025935m.g","KQ419930",532280,532743,463
"27597","Ocbimv22024488m.g","KQ419588",292621,309663,17042
"27598","Ocbimv22006820m.g","KQ426123",54838,70310,15472
"27599","Ocbimv22009579m.g","KQ427029",282059,282265,206
"27600","Ocbimv22002623m.g","KQ417023",754546,776938,22392
"27601","Ocbimv22020974m.g","KQ418986",37868,77110,39242
"27602","Ocbimv22016732m.g","KQ429984",73711,79536,5825
"27603","Ocbimv22026337m.g","KQ420029",215731,222964,7233
"27604","Ocbimv22001912m.g","KQ424470",33889,42300,8411
"27605","Ocbimv22022874m.g","KQ419318",135511,159303,23792
"27606","Ocbimv22003351m.g","KQ424993",157612,173139,15527
"27607","Ocbimv22024553m.g","KQ419593",127449,138261,10812
"27608","Ocbimv22009194m.g","KQ417569",124904,147805,22901
"27609","Ocbimv22025969m.g","KQ419937",236758,237573,815
"27610","Ocbimv22031643m.g","KQ421305",363924,480783,116859
"27611","Ocbimv22031462m.g","KQ416399",224730,233723,8993
"27612","Ocbimv22020187m.g","LGKD01657902",15,692,677
"27613","Ocbimv22018549m.g","KQ430742",20151,20666,515
"27614","Ocbimv22021168m.g","KQ415686",324082,381384,57302
"27615","Ocbimv22013641m.g","KQ418042",4722,72732,68010
"27616","Ocbimv22002136m.g","KQ415788",700355,701179,824
"27617","Ocbimv22020181m.g","KQ431512",181986,182147,161
"27618","Ocbimv22024190m.g","KQ433854",2340,2771,431
"27619","Ocbimv22023021m.g","KQ416080",369993,370454,461
"27620","Ocbimv22032452m.g","KQ421548",20499,25336,4837
"27621","Ocbimv22000996m.g","KQ416902",277925,279790,1865
"27622","Ocbimv22006734m.g","KQ417345",135455,151071,15616
"27623","Ocbimv22025329m.g","KQ419775",10935,20447,9512
"27624","Ocbimv22022072m.g","KQ432553",40594,42842,2248
"27625","Ocbimv22002192m.g","KQ415790",13510,13849,339
"27626","Ocbimv22024406m.g","KQ419577",24231,24548,317
"27627","Ocbimv22008329m.g","KQ417497",768318,769584,1266
"27628","Ocbimv22004952m.g","KQ417216",159827,172070,12243
"27629","Ocbimv22022194m.g","KQ419184",35938,38629,2691
"27630","Ocbimv22015002m.g","KQ418194",87676,94513,6837
"27631","Ocbimv22036185m.g","KQ422667",203146,216051,12905
"27632","Ocbimv22012068m.g","KQ428000",3931,10534,6603
"27633","Ocbimv22029616m.g","KQ420787",381,698,317
"27634","Ocbimv22001795m.g","KQ424420",218105,233296,15191
"27635","Ocbimv22000257m.g","KQ423908",33353,33860,507
"27636","Ocbimv22021239m.g","KQ419018",413899,416481,2582
"27637","Ocbimv22000141m.g","KQ423868",221419,234804,13385
"27638","Ocbimv22032509m.g","KQ416435",96871,97095,224
"27639","Ocbimv22019258m.g","KQ418739",79267,81950,2683
"27640","Ocbimv22019835m.g","KQ418821",135356,135745,389
"27641","Ocbimv22000054m.g","KQ423834",191362,191649,287
"27642","Ocbimv22009114m.g","KQ417563",572872,573387,515
"27643","Ocbimv22038140m.g","KQ423217",531161,559785,28624
"27644","Ocbimv22001826m.g","KQ424439",19600,27354,7754
"27645","Ocbimv22031178m.g","KQ415722",10258,13977,3719
"27646","Ocbimv22036515m.g","KQ422783",84399,88487,4088
"27647","Ocbimv22005198m.g","LGKD01018776",902,2072,1170
"27648","Ocbimv22011447m.g","KQ427751",30046,31230,1184
"27649","Ocbimv22030278m.g","KQ416340",381481,382050,569
"27650","Ocbimv22038545m.g","KQ423395",65660,66674,1014
"27651","Ocbimv22013056m.g","KQ417977",192197,206301,14104
"27652","Ocbimv22038126m.g","KQ423217",209723,221230,11507
"27653","Ocbimv22020405m.g","KQ431665",169871,170278,407
"27654","Ocbimv22016266m.g","KQ429784",84699,128298,43599
"27655","Ocbimv22035311m.g","KQ422351",476553,476885,332
"27656","Ocbimv22021289m.g","KQ419026",9209,18276,9067
"27657","Ocbimv22004310m.g","KQ417147",982407,982740,333
"27658","Ocbimv22020842m.g","KQ418970",2311581,2317774,6193
"27659","Ocbimv22013111m.g","KQ428371",9123,54045,44922
"27660","Ocbimv22003494m.g","KQ425019",36539,66463,29924
"27661","Ocbimv22018954m.g","KQ418702",338265,346963,8698
"27662","Ocbimv22006493m.g","KQ425946",30822,33902,3080
"27663","Ocbimv22001091m.g","KQ424178",2352,3068,716
"27664","Ocbimv22008581m.g","KQ417510",285068,285427,359
"27665","Ocbimv22029417m.g","KQ416305",383864,385171,1307
"27666","Ocbimv22015672m.g","KQ429470",8891,10677,1786
"27667","Ocbimv22014031m.g","KQ428724",8191,21564,13373
"27668","Ocbimv22015356m.g","KQ429290",81040,82080,1040
"27669","Ocbimv22031231m.g","KQ421203",105713,124279,18566
"27670","Ocbimv22004306m.g","KQ417147",494539,494802,263
"27671","Ocbimv22028633m.g","KQ420538",59165,76458,17293
"27672","Ocbimv22023601m.g","KQ416092",121013,128106,7093
"27673","Ocbimv22024702m.g","KQ419616",296958,322726,25768
"27674","Ocbimv22024763m.g","KQ419623",170469,171350,881
"27675","Ocbimv22004407m.g","KQ415804",124240,130427,6187
"27676","Ocbimv22020564m.g","KQ418926",123457,124404,947
"27677","Ocbimv22011289m.g","KQ417776",78302,161870,83568
"27678","Ocbimv22012188m.g","KQ428065",18781,21232,2451
"27679","Ocbimv22027352m.g","KQ420263",1,622,621
"27680","Ocbimv22022435m.g","KQ419216",131921,141531,9610
"27681","Ocbimv22038478m.g","KQ416745",305990,306211,221
"27682","Ocbimv22002827m.g","KQ417040",121122,121540,418
"27683","Ocbimv22025153m.g","KQ419712",289492,290417,925
"27684","Ocbimv22038946m.g","KQ423493",581822,582445,623
"27685","Ocbimv22022200m.g","KQ419184",217245,226338,9093
"27686","Ocbimv22004442m.g","LGKD01530200",133,1150,1017
"27687","Ocbimv22031083m.g","KQ415720",70569,70727,158
"27688","Ocbimv22005932m.g","KQ425758",49687,64739,15052
"27689","Ocbimv22004911m.g","KQ417213",644897,646597,1700
"27690","Ocbimv22011197m.g","KQ427674",1979,3601,1622
"27691","Ocbimv22004986m.g","KQ417220",12105,23659,11554
"27692","Ocbimv22003236m.g","KQ424913",122011,129331,7320
"27693","Ocbimv22027197m.g","KQ420217",98491,100781,2290
"27694","Ocbimv22005367m.g","KQ425599",45224,45547,323
"27695","Ocbimv22023508m.g","KQ419420",184749,186183,1434
"27696","Ocbimv22006436m.g","KQ417319",22224,23990,1766
"27697","Ocbimv22024397m.g","KQ415693",450483,450689,206
"27698","Ocbimv22016196m.g","KQ415678",189723,189983,260
"27699","Ocbimv22002361m.g","KQ424646",21471,22139,668
"27700","Ocbimv22028110m.g","KQ416249",635897,637159,1262
"27701","Ocbimv22021575m.g","KQ432242",25832,28659,2827
"27702","Ocbimv22008551m.g","KQ426687",19182,20798,1616
"27703","Ocbimv22002783m.g","KQ424779",614917,615090,173
"27704","Ocbimv22037660m.g","KQ416705",1345757,1352451,6694
"27705","Ocbimv22019167m.g","KQ418726",211674,213185,1511
"27706","Ocbimv22006338m.g","KQ425879",126121,145205,19084
"27707","Ocbimv22028869m.g","KQ420595",479709,480035,326
"27708","Ocbimv22002559m.g","KQ415793",615938,616096,158
"27709","Ocbimv22005609m.g","KQ425676",814217,814953,736
"27710","Ocbimv22029127m.g","KQ420660",193296,203270,9974
"27711","Ocbimv22023886m.g","KQ419491",208612,233284,24672
"27712","Ocbimv22019029m.g","KQ418711",834397,835858,1461
"27713","Ocbimv22030341m.g","KQ420958",2619,66956,64337
"27714","Ocbimv22020649m.g","KQ418945",892272,894880,2608
"27715","Ocbimv22017380m.g","KQ418487",156100,156467,367
"27716","Ocbimv22004650m.g","KQ417193",68682,69169,487
"27717","Ocbimv22037720m.g","LGKD01463580",29,742,713
"27718","Ocbimv22037465m.g","KQ415759",138092,143538,5446
"27719","Ocbimv22001118m.g","KQ424184",494521,494784,263
"27720","Ocbimv22037977m.g","KQ423189",43778,93773,49995
"27721","Ocbimv22021594m.g","KQ432245",37326,48671,11345
"27722","Ocbimv22030969m.g","KQ416379",574494,578942,4448
"27723","Ocbimv22000128m.g","KQ416841",1023920,1024102,182
"27724","Ocbimv22011415m.g","KQ417791",1410147,1410874,727
"27725","Ocbimv22009329m.g","KQ426951",14173,14376,203
"27726","Ocbimv22001689m.g","KQ416955",876,22635,21759
"27727","Ocbimv22000442m.g","KQ423968",5691,6715,1024
"27728","Ocbimv22024443m.g","KQ416122",33953,65539,31586
"27729","Ocbimv22014965m.g","KQ418188",252231,252547,316
"27730","Ocbimv22009900m.g","KQ417622",158722,194789,36067
"27731","Ocbimv22006756m.g","KQ417347",528533,530092,1559
"27732","Ocbimv22001155m.g","KQ416913",128951,139910,10959
"27733","Ocbimv22013796m.g","KQ418061",248105,249719,1614
"27734","Ocbimv22008950m.g","LGKD01566522",25,483,458
"27735","Ocbimv22004520m.g","KQ415805",48863,49603,740
"27736","Ocbimv22011430m.g","KQ427746",136874,137757,883
"27737","Ocbimv22003989m.g","KQ425170",20595,22165,1570
"27738","Ocbimv22019409m.g","KQ418760",542697,546342,3645
"27739","Ocbimv22010156m.g","KQ427290",32976,43715,10739
"27740","Ocbimv22026005m.g","KQ419952",353274,368145,14871
"27741","Ocbimv22035814m.g","KQ416601",951120,951269,149
"27742","Ocbimv22008924m.g","KQ417540",20379,36323,15944
"27743","Ocbimv22036719m.g","KQ416655",17409,19649,2240
"27744","Ocbimv22027284m.g","KQ420242",165,47495,47330
"27745","Ocbimv22011119m.g","KQ417750",52891,54344,1453
"27746","Ocbimv22036803m.g","KQ416657",837968,843432,5464
"27747","Ocbimv22035541m.g","KQ422426",105247,105547,300
"27748","Ocbimv22004145m.g","KQ417140",144692,159951,15259
"27749","Ocbimv22024173m.g","KQ419543",578414,599242,20828
"27750","Ocbimv22012689m.g","KQ417926",320859,321203,344
"27751","Ocbimv22038446m.g","KQ423341",74620,75213,593
"27752","Ocbimv22039244m.g","KQ423591",333420,338873,5453
"27753","Ocbimv22007802m.g","KQ417453",21863,22576,713
"27754","Ocbimv22010775m.g","KQ427511",173268,206356,33088
"27755","Ocbimv22006795m.g","KQ426112",86939,87444,505
"27756","Ocbimv22016572m.g","KQ418368",127084,127791,707
"27757","Ocbimv22008971m.g","KQ417544",403080,405001,1921
"27758","Ocbimv22001533m.g","KQ424350",232121,233739,1618
"27759","Ocbimv22020565m.g","KQ418926",127278,130230,2952
"27760","Ocbimv22039432m.g","KQ423659",149342,166668,17326
"27761","Ocbimv22000336m.g","KQ416854",329738,331275,1537
"27762","Ocbimv22016264m.g","KQ418334",26058,26327,269
"27763","Ocbimv22033119m.g","KQ421731",261726,261896,170
"27764","Ocbimv22016022m.g","KQ429661",72994,73338,344
"27765","Ocbimv22007256m.g","KQ426271",83923,85448,1525
"27766","Ocbimv22018811m.g","KQ416002",981602,1024678,43076
"27767","Ocbimv22007430m.g","KQ417413",1318,5549,4231
"27768","Ocbimv22012326m.g","KQ415907",416188,417439,1251
"27769","Ocbimv22023178m.g","KQ419368",128279,129179,900
"27770","Ocbimv22032285m.g","KQ416427",48690,49190,500
"27771","Ocbimv22017563m.g","KQ418506",340931,438642,97711
"27772","Ocbimv22007354m.g","KQ426312",27387,27782,395
"27773","Ocbimv22013073m.g","KQ417978",98358,98555,197
"27774","Ocbimv22023847m.g","KQ433674",5140,6389,1249
"27775","Ocbimv22015769m.g","KQ415676",309462,311671,2209
"27776","Ocbimv22038018m.g","KQ416719",500174,500706,532
"27777","Ocbimv22016675m.g","KQ418380",25292,25684,392
"27778","Ocbimv22024552m.g","KQ419593",119812,123112,3300
"27779","Ocbimv22010724m.g","KQ427478",200598,200954,356
"27780","Ocbimv22027934m.g","KQ420404",731387,734708,3321
"27781","Ocbimv22015429m.g","KQ429332",210,33988,33778
"27782","Ocbimv22027910m.g","KQ420395",72617,73875,1258
"27783","Ocbimv22027941m.g","KQ420404",1288078,1288563,485
"27784","Ocbimv22002848m.g","KQ424803",159685,182621,22936
"27785","Ocbimv22004918m.g","KQ417213",839948,840118,170
"27786","Ocbimv22014378m.g","KQ418124",4700,51214,46514
"27787","Ocbimv22032884m.g","KQ416456",267374,272649,5275
"27788","Ocbimv22004628m.g","KQ417186",37543,52856,15313
"27789","Ocbimv22036323m.g","KQ415755",34858,92537,57679
"27790","Ocbimv22000493m.g","KQ415777",38906,51528,12622
"27791","Ocbimv22038568m.g","KQ423405",70725,71465,740
"27792","Ocbimv22031387m.g","KQ421226",129285,133182,3897
"27793","Ocbimv22005046m.g","KQ425504",84854,85426,572
"27794","Ocbimv22011244m.g","KQ417769",50291,105714,55423
"27795","Ocbimv22001999m.g","KQ416979",1316516,1344896,28380
"27796","Ocbimv22003255m.g","KQ424917",8951,10866,1915
"27797","Ocbimv22004855m.g","KQ415809",284869,296108,11239
"27798","Ocbimv22016615m.g","KQ418370",267424,288923,21499
"27799","Ocbimv22011750m.g","KQ417828",157805,210038,52233
"27800","Ocbimv22004713m.g","KQ417199",128189,130329,2140
"27801","Ocbimv22028880m.g","KQ420600",185488,187047,1559
"27802","Ocbimv22018173m.g","KQ430593",33176,35221,2045
"27803","Ocbimv22017706m.g","LGKD01638078",214,426,212
"27804","Ocbimv22021122m.g","KQ416039",1036522,1036734,212
"27805","Ocbimv22008365m.g","KQ417498",661112,661991,879
"27806","Ocbimv22004481m.g","KQ425333",88978,186101,97123
"27807","Ocbimv22039436m.g","LGKD01112566",1,724,723
"27808","Ocbimv22016609m.g","KQ418370",176996,178822,1826
"27809","Ocbimv22039110m.g","KQ416779",536357,537514,1157
"27810","Ocbimv22012309m.g","KQ415907",112204,118151,5947
"27811","Ocbimv22039158m.g","KQ423555",274539,342265,67726
"27812","Ocbimv22023723m.g","KQ416094",949355,953997,4642
"27813","Ocbimv22038776m.g","KQ416765",799623,799868,245
"27814","Ocbimv22009312m.g","KQ417582",336491,337347,856
"27815","Ocbimv22023607m.g","LGKD01690592",52,222,170
"27816","Ocbimv22020090m.g","KQ431445",75474,78135,2661
"27817","Ocbimv22024327m.g","KQ433944",10179,11205,1026
"27818","Ocbimv22032537m.g","KQ421579",24713,25944,1231
"27819","Ocbimv22004368m.g","KQ415803",299932,300651,719
"27820","Ocbimv22019786m.g","LGKD01261953",319,474,155
"27821","Ocbimv22000778m.g","KQ416881",46109,56618,10509
"27822","Ocbimv22006934m.g","KQ426157",254862,263008,8146
"27823","Ocbimv22032280m.g","KQ421510",82729,94482,11753
"27824","Ocbimv22037971m.g","KQ423187",19820,22603,2783
"27825","Ocbimv22023727m.g","KQ416095",72991,73797,806
"27826","Ocbimv22016136m.g","KQ429712",79224,81708,2484
"27827","Ocbimv22011585m.g","KQ417807",2634,3334,700
"27828","Ocbimv22026733m.g","KQ416198",263967,296180,32213
"27829","Ocbimv22026950m.g","KQ420147",855,2025,1170
"27830","Ocbimv22010781m.g","KQ427521",57132,71455,14323
"27831","Ocbimv22012157m.g","LGKD01593240",3,458,455
"27832","Ocbimv22007549m.g","KQ426371",356256,375463,19207
"27833","Ocbimv22030353m.g","KQ416345",1088574,1088771,197
"27834","Ocbimv22039966m.g","KQ423813",263650,263883,233
"27835","Ocbimv22007901m.g","KQ417459",42867,65908,23041
"27836","Ocbimv22018147m.g","KQ418577",128352,151532,23180
"27837","Ocbimv22037877m.g","KQ423141",207222,207434,212
"27838","Ocbimv22013706m.g","KQ418049",228121,229130,1009
"27839","Ocbimv22012741m.g","KQ417934",472474,472758,284
"27840","Ocbimv22004600m.g","KQ417182",687891,689987,2096
"27841","Ocbimv22010125m.g","KQ417645",370234,379760,9526
"27842","Ocbimv22032243m.g","KQ421491",1914,2564,650
"27843","Ocbimv22002166m.g","KQ424565",58430,58834,404
"27844","Ocbimv22015462m.g","KQ418254",86805,87236,431
"27845","Ocbimv22026205m.g","KQ420016",747093,747254,161
"27846","Ocbimv22001000m.g","KQ424145",1580,1870,290
"27847","Ocbimv22001606m.g","KQ424367",292081,306445,14364
"27848","Ocbimv22034103m.g","KQ421975",50176,87661,37485
"27849","Ocbimv22000237m.g","KQ423903",168856,171376,2520
"27850","Ocbimv22038013m.g","KQ416719",429892,430383,491
"27851","Ocbimv22015810m.g","KQ418295",100702,103646,2944
"27852","Ocbimv22010183m.g","KQ417653",635845,636322,477
"27853","Ocbimv22038386m.g","KQ423304",78793,96759,17966
"27854","Ocbimv22018720m.g","KQ418660",86489,92879,6390
"27855","Ocbimv22004181m.g","KQ425220",303878,308373,4495
"27856","Ocbimv22024094m.g","KQ419533",451857,477312,25455
"27857","Ocbimv22019851m.g","KQ418821",799664,818771,19107
"27858","Ocbimv22034775m.g","KQ422169",3310,3862,552
"27859","Ocbimv22003984m.g","KQ425165",219584,250576,30992
"27860","Ocbimv22035842m.g","KQ422575",1386,17747,16361
"27861","Ocbimv22015273m.g","KQ415941",1,10360,10359
"27862","Ocbimv22038300m.g","KQ416735",40513,47202,6689
"27863","Ocbimv22007810m.g","KQ426461",95307,133925,38618
"27864","Ocbimv22005461m.g","KQ425611",85296,86662,1366
"27865","Ocbimv22003675m.g","LGKD01523414",176,559,383
"27866","Ocbimv22015416m.g","KQ418241",161382,310347,148965
"27867","Ocbimv22011569m.g","KQ427785",96087,97024,937
"27868","Ocbimv22013532m.g","KQ428554",4580,21310,16730
"27869","Ocbimv22000671m.g","KQ424049",1636,1860,224
"27870","Ocbimv22011424m.g","KQ415885",1631934,1647361,15427
"27871","Ocbimv22006550m.g","KQ426009",169,9439,9270
"27872","Ocbimv22003366m.g","KQ417085",295531,296226,695
"27873","Ocbimv22018718m.g","KQ418660",58058,59254,1196
"27874","Ocbimv22001816m.g","KQ416964",8933,166538,157605
"27875","Ocbimv22004543m.g","KQ425354",48772,124773,76001
"27876","Ocbimv22005899m.g","KQ415825",138187,138480,293
"27877","Ocbimv22007106m.g","KQ417379",1092,3718,2626
"27878","Ocbimv22021278m.g","KQ416041",734490,734687,197
"27879","Ocbimv22018951m.g","KQ418702",267080,335540,68460
"27880","Ocbimv22030963m.g","KQ421138",241878,257504,15626
"27881","Ocbimv22011022m.g","KQ427597",2677,28657,25980
"27882","Ocbimv22009756m.g","KQ427112",1780,2560,780
"27883","Ocbimv22028197m.g","KQ420442",101488,121025,19537
"27884","Ocbimv22036782m.g","KQ416657",9639,9979,340
"27885","Ocbimv22029752m.g","KQ415712",706348,706587,239
"27886","Ocbimv22012838m.g","KQ417945",229081,291127,62046
"27887","Ocbimv22034044m.g","KQ416508",447365,489810,42445
"27888","Ocbimv22008616m.g","KQ417510",883202,886311,3109
"27889","Ocbimv22032928m.g","KQ421685",185739,185927,188
"27890","Ocbimv22004901m.g","KQ417213",334615,342375,7760
"27891","Ocbimv22030993m.g","KQ416381",137728,137910,182
"27892","Ocbimv22021911m.g","KQ416054",206121,206399,278
"27893","Ocbimv22031020m.g","KQ421144",126073,185082,59009
"27894","Ocbimv22039844m.g","KQ416831",123218,123418,200
"27895","Ocbimv22003437m.g","KQ417087",1075338,1095023,19685
"27896","Ocbimv22017899m.g","KQ418555",1661030,1661347,317
"27897","Ocbimv22013270m.g","KQ428430",39598,40962,1364
"27898","Ocbimv22009350m.g","KQ417585",559738,559905,167
"27899","Ocbimv22025207m.g","LGKD01314650",3,185,182
"27900","Ocbimv22032936m.g","KQ421686",171161,175596,4435
"27901","Ocbimv22029509m.g","KQ416311",118111,168618,50507
"27902","Ocbimv22023152m.g","LGKD01685973",98,304,206
"27903","Ocbimv22038831m.g","KQ416768",90441,121295,30854
"27904","Ocbimv22022367m.g","KQ432701",10658,13509,2851
"27905","Ocbimv22038165m.g","KQ423221",309543,310200,657
"27906","Ocbimv22008629m.g","KQ417512",15345,19567,4222
"27907","Ocbimv22004944m.g","KQ417216",13159,74128,60969
"27908","Ocbimv22002803m.g","KQ417037",300796,322843,22047
"27909","Ocbimv22003670m.g","KQ417100",458395,458568,173
"27910","Ocbimv22014923m.g","KQ418187",635254,637285,2031
"27911","Ocbimv22027592m.g","KQ420313",212125,226563,14438
"27912","Ocbimv22039307m.g","KQ416788",20,1128,1108
"27913","Ocbimv22027926m.g","KQ420404",514825,525094,10269
"27914","Ocbimv22013671m.g","KQ428590",40515,120428,79913
"27915","Ocbimv22008887m.g","KQ426791",720509,731410,10901
"27916","Ocbimv22011971m.g","KQ415895",539269,546091,6822
"27917","Ocbimv22025815m.g","KQ419909",15916,16326,410
"27918","Ocbimv22013323m.g","KQ418012",126576,148394,21818
"27919","Ocbimv22008089m.g","KQ426567",2340,3182,842
"27920","Ocbimv22010607m.g","KQ417699",150637,151182,545
"27921","Ocbimv22029865m.g","KQ420828",1874172,1899251,25079
"27922","Ocbimv22033947m.g","KQ421919",100927,101935,1008
"27923","Ocbimv22027075m.g","KQ420175",142706,159509,16803
"27924","Ocbimv22004197m.g","KQ425223",33984,34939,955
"27925","Ocbimv22005456m.g","KQ417253",54403,60173,5770
"27926","Ocbimv22036033m.g","KQ416614",616870,634068,17198
"27927","Ocbimv22026129m.g","KQ419991",242205,254284,12079
"27928","Ocbimv22001501m.g","KQ424337",50802,64285,13483
"27929","Ocbimv22030480m.g","KQ420993",130994,184330,53336
"27930","Ocbimv22025154m.g","KQ419712",309820,344549,34729
"27931","Ocbimv22004170m.g","KQ425220",228055,248993,20938
"27932","Ocbimv22038889m.g","KQ416771",249275,284783,35508
"27933","Ocbimv22002069m.g","KQ424530",1071167,1071493,326
"27934","Ocbimv22002942m.g","KQ424851",286940,328533,41593
"27935","Ocbimv22012712m.g","KQ417929",98186,143193,45007
"27936","Ocbimv22029345m.g","KQ420714",111509,118895,7386
"27937","Ocbimv22025180m.g","KQ419721",641793,642233,440
"27938","Ocbimv22022053m.g","KQ432533",6097,6711,614
"27939","Ocbimv22003253m.g","KQ417069",23260,23454,194
"27940","Ocbimv22006088m.g","KQ417294",391057,398782,7725
"27941","Ocbimv22021934m.g","KQ432433",264,12143,11879
"27942","Ocbimv22001138m.g","KQ424206",21191,26809,5618
"27943","Ocbimv22024830m.g","KQ419638",9888,11397,1509
"27944","Ocbimv22016848m.g","KQ418413",66405,67584,1179
"27945","Ocbimv22017070m.g","KQ430152",145360,169094,23734
"27946","Ocbimv22012545m.g","KQ417917",930153,942238,12085
"27947","Ocbimv22018966m.g","KQ418703",13425,13589,164
"27948","Ocbimv22027195m.g","KQ420215",196097,199709,3612
"27949","Ocbimv22019210m.g","KQ418734",86298,86894,596
"27950","Ocbimv22025456m.g","KQ419807",171681,173735,2054
"27951","Ocbimv22031368m.g","KQ421224",181096,192700,11604
"27952","Ocbimv22033182m.g","KQ421741",122073,123435,1362
"27953","Ocbimv22038368m.g","KQ423295",211140,211648,508
"27954","Ocbimv22000692m.g","KQ424055",665066,665688,622
"27955","Ocbimv22010916m.g","KQ417725",27651,31009,3358
"27956","Ocbimv22000658m.g","KQ424042",2105,89381,87276
"27957","Ocbimv22034087m.g","KQ416511",84,15867,15783
"27958","Ocbimv22021417m.g","KQ432138",15795,16370,575
"27959","Ocbimv22013290m.g","KQ418007",455760,460576,4816
"27960","Ocbimv22026262m.g","KQ420022",431318,431936,618
"27961","Ocbimv22027787m.g","KQ416233",191046,327685,136639
"27962","Ocbimv22013894m.g","KQ428707",88511,90897,2386
"27963","Ocbimv22014870m.g","KQ429122",25517,25705,188
"27964","Ocbimv22002741m.g","KQ424770",154805,155110,305
"27965","Ocbimv22003658m.g","KQ425062",431812,448389,16577
"27966","Ocbimv22009642m.g","KQ427059",355037,355855,818
"27967","Ocbimv22016290m.g","KQ429791",33768,39793,6025
"27968","Ocbimv22010809m.g","KQ427524",17257,17568,311
"27969","Ocbimv22031979m.g","KQ416415",105633,117711,12078
"27970","Ocbimv22029017m.g","KQ416279",883773,906113,22340
"27971","Ocbimv22037245m.g","KQ422973",40524,42609,2085
"27972","Ocbimv22023265m.g","KQ433311",380,916,536
"27973","Ocbimv22036000m.g","KQ422629",611299,654563,43264
"27974","Ocbimv22031194m.g","KQ421196",11110,11669,559
"27975","Ocbimv22015862m.g","KQ418297",402609,413961,11352
"27976","Ocbimv22039091m.g","KQ423546",36477,36632,155
"27977","Ocbimv22003849m.g","KQ415798",44985,45752,767
"27978","Ocbimv22022584m.g","KQ416072",357410,359405,1995
"27979","Ocbimv22023722m.g","KQ416094",883285,883886,601
"27980","Ocbimv22014510m.g","KQ415932",88659,88907,248
"27981","Ocbimv22027344m.g","KQ420261",1268983,1269379,396
"27982","Ocbimv22028148m.g","KQ416251",1606689,1606931,242
"27983","Ocbimv22038525m.g","KQ423384",330386,368440,38054
"27984","Ocbimv22012935m.g","KQ417957",206786,233337,26551
"27985","Ocbimv22020524m.g","KQ418922",65889,71812,5923
"27986","Ocbimv22026898m.g","KQ420138",546243,546413,170
"27987","Ocbimv22025786m.g","KQ419904",55344,58514,3170
"27988","Ocbimv22001316m.g","KQ424265",8623,39562,30939
"27989","Ocbimv22003496m.g","KQ417089",108327,153456,45129
"27990","Ocbimv22018374m.g","KQ418610",240856,241597,741
"27991","Ocbimv22033432m.g","KQ421810",190586,191182,596
"27992","Ocbimv22012936m.g","KQ417957",317479,317676,197
"27993","Ocbimv22012109m.g","KQ417874",353361,358652,5291
"27994","Ocbimv22017630m.g","KQ418516",257641,263575,5934
"27995","Ocbimv22021753m.g","KQ419094",271184,319008,47824
"27996","Ocbimv22024270m.g","LGKD01697561",12,161,149
"27997","Ocbimv22036242m.g","KQ416627",138350,138577,227
"27998","Ocbimv22008917m.g","KQ426806",77059,95604,18545
"27999","Ocbimv22039454m.g","KQ423671",140774,182677,41903
"28000","Ocbimv22034191m.g","KQ421998",36903,37088,185
"28001","Ocbimv22016970m.g","KQ418431",28767,28964,197
"28002","Ocbimv22029083m.g","KQ420642",263718,264275,557
"28003","Ocbimv22019959m.g","KQ418839",113324,118253,4929
"28004","Ocbimv22022308m.g","KQ419194",57336,57839,503
"28005","Ocbimv22019424m.g","KQ418762",63503,68658,5155
"28006","Ocbimv22037474m.g","KQ423042",65203,65475,272
"28007","Ocbimv22033619m.g","KQ421848",7798,21393,13595
"28008","Ocbimv22030438m.g","KQ420990",25547,63719,38172
"28009","Ocbimv22015465m.g","KQ418255",2180,58386,56206
"28010","Ocbimv22003722m.g","KQ417104",156518,158107,1589
"28011","Ocbimv22012369m.g","KQ428137",15530,20406,4876
"28012","Ocbimv22007323m.g","KQ426291",33404,34561,1157
"28013","Ocbimv22007159m.g","KQ417386",801,986,185
"28014","Ocbimv22025313m.g","KQ419766",438221,438604,383
"28015","Ocbimv22034399m.g","KQ422028",298982,299614,632
"28016","Ocbimv22036567m.g","KQ416645",367177,377720,10543
"28017","Ocbimv22038945m.g","KQ423493",479422,482052,2630
"28018","Ocbimv22008406m.g","KQ426632",181899,184585,2686
"28019","Ocbimv22008155m.g","KQ417481",1072620,1074915,2295
"28020","Ocbimv22017558m.g","KQ415978",352159,363178,11019
"28021","Ocbimv22038098m.g","KQ423214",107869,108228,359
"28022","Ocbimv22011465m.g","KQ417793",9120,86363,77243
"28023","Ocbimv22033290m.g","KQ421766",38941,51646,12705
"28024","Ocbimv22000779m.g","KQ416881",76435,158279,81844
"28025","Ocbimv22025318m.g","KQ419773",143511,177025,33514
"28026","Ocbimv22030369m.g","KQ420966",78737,125894,47157
"28027","Ocbimv22029335m.g","KQ420711",651575,664141,12566
"28028","Ocbimv22004629m.g","KQ417186",72573,73480,907
"28029","Ocbimv22004182m.g","KQ425220",311861,313070,1209
"28030","Ocbimv22003177m.g","KQ424901",2162,3303,1141
"28031","Ocbimv22026065m.g","KQ419981",23334,33383,10049
"28032","Ocbimv22005877m.g","KQ417280",385318,397847,12529
"28033","Ocbimv22034000m.g","KQ416507",286744,322213,35469
"28034","Ocbimv22024496m.g","KQ419590",30897,43021,12124
"28035","Ocbimv22035443m.g","KQ422383",7281,8184,903
"28036","Ocbimv22029963m.g","KQ420861",18950,19168,218
"28037","Ocbimv22037700m.g","KQ423101",156200,156412,212
"28038","Ocbimv22003708m.g","KQ425068",5848,6096,248
"28039","Ocbimv22004510m.g","KQ417173",3104267,3104473,206
"28040","Ocbimv22023599m.g","KQ416092",82279,89034,6755
"28041","Ocbimv22014310m.g","KQ428859",71151,87446,16295
"28042","Ocbimv22032334m.g","KQ421523",739383,791910,52527
"28043","Ocbimv22020315m.g","KQ431600",42275,56419,14144
"28044","Ocbimv22023312m.g","KQ416087",1580672,1592832,12160
"28045","Ocbimv22010342m.g","KQ415875",338926,339372,446
"28046","Ocbimv22025000m.g","KQ419679",23634,24167,533
"28047","Ocbimv22032167m.g","KQ421464",376580,408060,31480
"28048","Ocbimv22009428m.g","KQ417591",1587259,1589771,2512
"28049","Ocbimv22016375m.g","KQ415962",1056365,1058069,1704
"28050","Ocbimv22015614m.g","KQ418269",26147,55556,29409
"28051","Ocbimv22018585m.g","KQ418642",327993,328160,167
"28052","Ocbimv22015482m.g","KQ429386",36804,37154,350
"28053","Ocbimv22025899m.g","KQ416175",868106,877309,9203
"28054","Ocbimv22031800m.g","LGKD01396527",398,601,203
"28055","Ocbimv22001340m.g","KQ416921",140259,156177,15918
"28056","Ocbimv22002641m.g","KQ417023",1283264,1294226,10962
"28057","Ocbimv22031553m.g","KQ421273",624745,655241,30496
"28058","Ocbimv22019741m.g","KQ418810",301266,301433,167
"28059","Ocbimv22035095m.g","KQ422276",58742,59026,284
"28060","Ocbimv22037535m.g","KQ423058",153542,154231,689
"28061","Ocbimv22016019m.g","KQ418310",640627,655800,15173
"28062","Ocbimv22014395m.g","KQ415929",59564,63196,3632
"28063","Ocbimv22031288m.g","KQ421217",130928,133804,2876
"28064","Ocbimv22008142m.g","KQ417481",263592,283650,20058
"28065","Ocbimv22022667m.g","KQ419279",81973,107244,25271
"28066","Ocbimv22021551m.g","KQ432234",31218,44476,13258
"28067","Ocbimv22027957m.g","KQ420409",460389,473782,13393
"28068","Ocbimv22024292m.g","KQ416121",1401455,1402333,878
"28069","Ocbimv22012076m.g","KQ428007",182821,195376,12555
"28070","Ocbimv22035428m.g","KQ422381",333576,335959,2383
"28071","Ocbimv22022239m.g","KQ432647",16807,21463,4656
"28072","Ocbimv22003696m.g","KQ417101",2441,39585,37144
"28073","Ocbimv22033047m.g","KQ421721",298294,329408,31114
"28074","Ocbimv22004406m.g","KQ415804",110288,120936,10648
"28075","Ocbimv22001858m.g","KQ416971",315340,335640,20300
"28076","Ocbimv22016417m.g","KQ418350",272001,281514,9513
"28077","Ocbimv22005709m.g","KQ425725",60799,109116,48317
"28078","Ocbimv22034723m.g","KQ416548",395710,396444,734
"28079","Ocbimv22034802m.g","KQ416556",84517,123812,39295
"28080","Ocbimv22017254m.g","KQ430222",268555,269508,953
"28081","Ocbimv22010370m.g","KQ415876",191619,300714,109095
"28082","Ocbimv22031915m.g","KQ421376",1037610,1132329,94719
"28083","Ocbimv22012237m.g","KQ417892",374121,391399,17278
"28084","Ocbimv22010944m.g","LGKD01583487",2,226,224
"28085","Ocbimv22027685m.g","KQ420340",2003,65701,63698
"28086","Ocbimv22000570m.g","KQ423998",212539,216521,3982
"28087","Ocbimv22010653m.g","KQ427464",134307,134959,652
"28088","Ocbimv22008041m.g","KQ417475",240089,242271,2182
"28089","Ocbimv22036814m.g","KQ416658",1615167,1615577,410
"28090","Ocbimv22005249m.g","KQ425551",49562,49944,382
"28091","Ocbimv22020676m.g","KQ418949",336816,344626,7810
"28092","Ocbimv22034551m.g","KQ416536",1131515,1133331,1816
"28093","Ocbimv22002279m.g","KQ424615",45562,45872,310
"28094","Ocbimv22009827m.g","KQ417620",364983,373163,8180
"28095","Ocbimv22002058m.g","KQ424530",348910,352573,3663
"28096","Ocbimv22006138m.g","KQ417300",638671,641487,2816
"28097","Ocbimv22030645m.g","KQ421042",73069,168653,95584
"28098","Ocbimv22032430m.g","KQ421533",786190,786611,421
"28099","Ocbimv22011198m.g","KQ427674",3656,14694,11038
"28100","Ocbimv22039051m.g","KQ423525",245151,246503,1352
"28101","Ocbimv22000227m.g","KQ423901",59144,59768,624
"28102","Ocbimv22011488m.g","KQ417795",403970,405336,1366
"28103","Ocbimv22018874m.g","KQ418693",559317,580205,20888
"28104","Ocbimv22029352m.g","KQ420717",149412,157874,8462
"28105","Ocbimv22025767m.g","KQ416166",745821,746407,586
"28106","Ocbimv22001987m.g","KQ416979",116329,120458,4129
"28107","Ocbimv22008017m.g","KQ415849",365498,441059,75561
"28108","Ocbimv22009299m.g","KQ417581",81992,103810,21818
"28109","Ocbimv22008500m.g","KQ417506",343421,388977,45556
"28110","Ocbimv22013383m.g","KQ418018",805065,823979,18914
"28111","Ocbimv22004965m.g","KQ425487",307394,308334,940
"28112","Ocbimv22016445m.g","KQ429874",400,663,263
"28113","Ocbimv22029767m.g","KQ420820",500543,509031,8488
"28114","Ocbimv22006765m.g","KQ417347",1218005,1218828,823
"28115","Ocbimv22032065m.g","KQ421417",57328,78588,21260
"28116","Ocbimv22000742m.g","KQ416877",1253129,1298560,45431
"28117","Ocbimv22007999m.g","KQ426530",7273,7629,356
"28118","Ocbimv22037372m.g","KQ416694",74066,83257,9191
"28119","Ocbimv22028193m.g","KQ420442",68316,69205,889
"28120","Ocbimv22027581m.g","KQ420308",84103,84915,812
"28121","Ocbimv22022179m.g","KQ419180",568763,571423,2660
"28122","Ocbimv22028573m.g","KQ420524",220119,234112,13993
"28123","Ocbimv22037307m.g","KQ422999",52106,52504,398
"28124","Ocbimv22018842m.g","KQ416003",642377,645702,3325
"28125","Ocbimv22037060m.g","KQ422913",59088,62449,3361
"28126","Ocbimv22037854m.g","KQ423139",713707,738214,24507
"28127","Ocbimv22013825m.g","KQ428682",10317,33840,23523
"28128","Ocbimv22004229m.g","KQ417143",68271,68915,644
"28129","Ocbimv22022295m.g","KQ419192",828354,881791,53437
"28130","Ocbimv22032659m.g","KQ421628",225761,227821,2060
"28131","Ocbimv22006649m.g","LGKD01548766",43,228,185
"28132","Ocbimv22003128m.g","KQ424891",61211,61585,374
"28133","Ocbimv22000170m.g","KQ416847",310629,322292,11663
"28134","Ocbimv22023235m.g","LGKD01686748",1,198,197
"28135","Ocbimv22036439m.g","KQ422762",94049,136552,42503
"28136","Ocbimv22025299m.g","KQ419763",183093,188847,5754
"28137","Ocbimv22034455m.g","KQ422046",10942,12258,1316
"28138","Ocbimv22027390m.g","KQ416223",65985,122184,56199
"28139","Ocbimv22013787m.g","KQ418060",41042,47415,6373
"28140","Ocbimv22033585m.g","KQ421838",175740,176772,1032
"28141","Ocbimv22036002m.g","KQ422629",655358,656727,1369
"28142","Ocbimv22027469m.g","KQ416225",68225,80723,12498
"28143","Ocbimv22028127m.g","KQ416251",304341,329625,25284
"28144","Ocbimv22020811m.g","KQ418970",165484,182229,16745
"28145","Ocbimv22031900m.g","KQ421375",43265,43588,323
"28146","Ocbimv22027530m.g","KQ420299",512447,512761,314
"28147","Ocbimv22034454m.g","KQ416533",77215,86392,9177
"28148","Ocbimv22003143m.g","KQ417061",961551,1030907,69356
"28149","Ocbimv22016724m.g","KQ429980",140822,141196,374
"28150","Ocbimv22037848m.g","KQ423139",576802,582787,5985
"28151","Ocbimv22020808m.g","KQ431864",8136,9820,1684
"28152","Ocbimv22012661m.g","KQ428198",12992,13858,866
"28153","Ocbimv22014733m.g","KQ418173",55539,56158,619
"28154","Ocbimv22003530m.g","KQ425022",35055,103581,68526
"28155","Ocbimv22022946m.g","KQ419327",146057,146515,458
"28156","Ocbimv22018324m.g","LGKD01642399",15,293,278
"28157","Ocbimv22008926m.g","KQ417540",99945,174477,74532
"28158","Ocbimv22006537m.g","KQ425992",222030,230794,8764
"28159","Ocbimv22030356m.g","KQ420961",898686,898964,278
"28160","Ocbimv22008787m.g","KQ426774",74970,81946,6976
"28161","Ocbimv22019770m.g","KQ418812",56262,95724,39462
"28162","Ocbimv22000541m.g","LGKD01492656",9,1013,1004
"28163","Ocbimv22019796m.g","KQ431315",62335,63201,866
"28164","Ocbimv22000162m.g","KQ416846",195098,224053,28955
"28165","Ocbimv22008744m.g","KQ417528",490519,515704,25185
"28166","Ocbimv22031551m.g","KQ421273",599736,615391,15655
"28167","Ocbimv22037302m.g","KQ422997",517093,519182,2089
"28168","Ocbimv22037008m.g","KQ422903",531837,534313,2476
"28169","Ocbimv22019411m.g","LGKD01258968",8,136,128
"28170","Ocbimv22013264m.g","KQ428426",279819,280545,726
"28171","Ocbimv22034818m.g","KQ422186",109322,111241,1919
"28172","Ocbimv22004423m.g","KQ415804",439452,448361,8909
"28173","Ocbimv22017618m.g","KQ418513",5706,5888,182
"28174","Ocbimv22021281m.g","KQ419023",30959,31606,647
"28175","Ocbimv22027705m.g","KQ420346",554456,586011,31555
"28176","Ocbimv22006663m.g","KQ417342",44654,46244,1590
"28177","Ocbimv22005094m.g","KQ425519",275382,275582,200
"28178","Ocbimv22016964m.g","KQ418430",264077,279757,15680
"28179","Ocbimv22014364m.g","KQ428883",223314,231595,8281
"28180","Ocbimv22036589m.g","KQ422794",334051,334774,723
"28181","Ocbimv22004649m.g","KQ417193",63066,67565,4499
"28182","Ocbimv22014223m.g","KQ418104",102545,102904,359
"28183","Ocbimv22009681m.g","KQ415866",8430,10319,1889
"28184","Ocbimv22015760m.g","KQ418290",77608,143161,65553
"28185","Ocbimv22007701m.g","KQ426423",23372,35489,12117
"28186","Ocbimv22027133m.g","KQ420198",20663,29812,9149
"28187","Ocbimv22035900m.g","KQ422595",382199,386656,4457
"28188","Ocbimv22024003m.g","KQ419520",22229,58686,36457
"28189","Ocbimv22005492m.g","KQ425621",2356,71684,69328
"28190","Ocbimv22034518m.g","KQ422068",31842,48745,16903
"28191","Ocbimv22011880m.g","KQ417844",1046737,1054907,8170
"28192","Ocbimv22025096m.g","KQ416137",475331,477545,2214
"28193","Ocbimv22021817m.g","KQ419108",477196,477679,483
"28194","Ocbimv22011019m.g","KQ417735",58264,59475,1211
"28195","Ocbimv22014449m.g","KQ415930",283040,283507,467
"28196","Ocbimv22027038m.g","KQ416209",7308,37026,29718
"28197","Ocbimv22021069m.g","LGKD01665142",9,1225,1216
"28198","Ocbimv22001745m.g","KQ424399",99332,124868,25536
"28199","Ocbimv22034728m.g","KQ422133",204332,204789,457
"28200","Ocbimv22007353m.g","KQ417407",119244,119624,380
"28201","Ocbimv22037598m.g","KQ423077",597954,602538,4584
"28202","Ocbimv22003316m.g","KQ424969",43791,43994,203
"28203","Ocbimv22037244m.g","KQ422973",39820,40443,623
"28204","Ocbimv22000724m.g","KQ416877",618062,624082,6020
"28205","Ocbimv22025447m.g","KQ419803",17936,21170,3234
"28206","Ocbimv22007395m.g","LGKD01555036",190,372,182
"28207","Ocbimv22000748m.g","KQ416878",136548,158114,21566
"28208","Ocbimv22036357m.g","KQ422722",18817,19386,569
"28209","Ocbimv22023120m.g","KQ419350",965381,972460,7079
"28210","Ocbimv22003042m.g","KQ417055",1738565,1752770,14205
"28211","Ocbimv22038036m.g","KQ415762",511697,512314,617
"28212","Ocbimv22026645m.g","KQ420085",267347,292353,25006
"28213","Ocbimv22003625m.g","KQ417095",129999,168838,38839
"28214","Ocbimv22003270m.g","KQ424932",293964,298664,4700
"28215","Ocbimv22006151m.g","KQ417300",863955,912728,48773
"28216","Ocbimv22036245m.g","KQ416627",242986,249206,6220
"28217","Ocbimv22019121m.g","KQ430983",121193,121549,356
"28218","Ocbimv22001705m.g","KQ424387",556408,634260,77852
"28219","Ocbimv22027448m.g","KQ420279",220770,221578,808
"28220","Ocbimv22001037m.g","KQ424157",718332,718786,454
"28221","Ocbimv22031557m.g","KQ421273",855323,948970,93647
"28222","Ocbimv22032653m.g","KQ421628",24966,84377,59411
"28223","Ocbimv22007027m.g","KQ417370",572000,576363,4363
"28224","Ocbimv22037189m.g","KQ422962",20703,27939,7236
"28225","Ocbimv22003527m.g","KQ425022",11506,11903,397
"28226","Ocbimv22022245m.g","KQ432655",45882,46163,281
"28227","Ocbimv22011330m.g","KQ417781",30958,32403,1445
"28228","Ocbimv22000468m.g","KQ416862",44,664,620
"28229","Ocbimv22038657m.g","KQ423432",21092,45113,24021
"28230","Ocbimv22023198m.g","KQ419368",744874,745269,395
"28231","Ocbimv22000872m.g","KQ424096",603261,623742,20481
"28232","Ocbimv22026430m.g","KQ420048",76133,92871,16738
"28233","Ocbimv22026677m.g","KQ416196",831897,833221,1324
"28234","Ocbimv22004057m.g","KQ425191",97550,136288,38738
"28235","Ocbimv22031356m.g","KQ421221",123105,127655,4550
"28236","Ocbimv22024624m.g","KQ434076",5575,7372,1797
"28237","Ocbimv22007295m.g","KQ417401",109920,111419,1499
"28238","Ocbimv22021572m.g","KQ432240",7428,9077,1649
"28239","Ocbimv22028294m.g","KQ420462",189626,189869,243
"28240","Ocbimv22004749m.g","KQ425434",98671,126002,27331
"28241","Ocbimv22037508m.g","KQ416699",40776,41012,236
"28242","Ocbimv22022580m.g","KQ419265",218166,220376,2210
"28243","Ocbimv22006457m.g","KQ425931",20675,24170,3495
"28244","Ocbimv22021384m.g","KQ432110",20554,22414,1860
"28245","Ocbimv22017163m.g","KQ415974",119041,137242,18201
"28246","Ocbimv22014987m.g","KQ429148",58896,59635,739
"28247","Ocbimv22013083m.g","KQ428368",2434,86776,84342
"28248","Ocbimv22006729m.g","KQ417344",156238,165703,9465
"28249","Ocbimv22031170m.g","KQ421190",13817,30054,16237
"28250","Ocbimv22029238m.g","KQ420690",176766,201502,24736
"28251","Ocbimv22039591m.g","KQ416806",488596,488859,263
"28252","Ocbimv22032343m.g","KQ421523",1134918,1135187,269
"28253","Ocbimv22012357m.g","KQ428130",117736,157482,39746
"28254","Ocbimv22019518m.g","KQ416014",6729,80668,73939
"28255","Ocbimv22025411m.g","KQ419792",251,773,522
"28256","Ocbimv22036535m.g","KQ422787",50817,51047,230
"28257","Ocbimv22008501m.g","KQ417506",417716,418003,287
"28258","Ocbimv22005383m.g","KQ417249",470992,486088,15096
"28259","Ocbimv22008645m.g","KQ417516",5490,53559,48069
"28260","Ocbimv22006692m.g","KQ426075",305747,314919,9172
"28261","Ocbimv22036496m.g","KQ422777",192582,199207,6625
"28262","Ocbimv22006884m.g","KQ426132",30,718,688
"28263","Ocbimv22014039m.g","KQ428727",6250,11504,5254
"28264","Ocbimv22024777m.g","KQ419629",272724,273311,587
"28265","Ocbimv22011874m.g","KQ417844",590762,593551,2789
"28266","Ocbimv22030573m.g","KQ416357",11166,12230,1064
"28267","Ocbimv22037186m.g","KQ416681",123030,125215,2185
"28268","Ocbimv22025804m.g","KQ419907",68961,69553,592
"28269","Ocbimv22014951m.g","KQ429139",632688,633798,1110
"28270","Ocbimv22028070m.g","KQ420424",324202,327028,2826
"28271","Ocbimv22014728m.g","KQ418171",12245,34890,22645
"28272","Ocbimv22037934m.g","KQ423171",60157,60525,368
"28273","Ocbimv22015852m.g","KQ418296",229289,229477,188
"28274","Ocbimv22026538m.g","KQ420065",315955,347946,31991
"28275","Ocbimv22019165m.g","KQ418726",843,30473,29630
"28276","Ocbimv22025292m.g","KQ419763",68927,69202,275
"28277","Ocbimv22006952m.g","KQ426164",81929,82255,326
"28278","Ocbimv22000155m.g","KQ423874",14506,15528,1022
"28279","Ocbimv22011248m.g","KQ417771",22293,67616,45323
"28280","Ocbimv22024275m.g","KQ419562",190702,191122,420
"28281","Ocbimv22022154m.g","KQ419176",765882,766965,1083
"28282","Ocbimv22020045m.g","KQ431412",59048,60039,991
"28283","Ocbimv22004133m.g","KQ417138",623638,623793,155
"28284","Ocbimv22014042m.g","LGKD01605862",629,2185,1556
"28285","Ocbimv22004913m.g","KQ417213",674557,683369,8812
"28286","Ocbimv22011440m.g","KQ427746",530359,550792,20433
"28287","Ocbimv22031248m.g","KQ421206",479982,480818,836
"28288","Ocbimv22021037m.g","KQ418995",12661,13288,627
"28289","Ocbimv22010392m.g","KQ427372",10027,10774,747
"28290","Ocbimv22019123m.g","LGKD01648226",2,341,339
"28291","Ocbimv22035350m.g","KQ416582",5,10017,10012
"28292","Ocbimv22029097m.g","KQ420648",5013,5817,804
"28293","Ocbimv22018323m.g","KQ418602",67248,69972,2724
"28294","Ocbimv22002539m.g","KQ424680",58357,97406,39049
"28295","Ocbimv22039121m.g","KQ416779",813186,828362,15176
"28296","Ocbimv22031157m.g","KQ421181",266969,267280,311
"28297","Ocbimv22017538m.g","KQ430345",54372,55097,725
"28298","Ocbimv22011768m.g","KQ415891",167018,167811,793
"28299","Ocbimv22023241m.g","KQ433284",161222,161506,284
"28300","Ocbimv22022990m.g","KQ419334",277665,279064,1399
"28301","Ocbimv22038735m.g","KQ416764",202373,232975,30602
"28302","Ocbimv22029425m.g","KQ420747",572994,575360,2366
"28303","Ocbimv22017815m.g","KQ418549",706793,709941,3148
"28304","Ocbimv22022744m.g","KQ416074",623352,681848,58496
"28305","Ocbimv22032588m.g","KQ421602",202084,203726,1642
"28306","Ocbimv22022336m.g","KQ419201",15399,104085,88686
"28307","Ocbimv22017376m.g","KQ418486",630701,803214,172513
"28308","Ocbimv22012125m.g","KQ415902",59404,76176,16772
"28309","Ocbimv22028333m.g","KQ420475",608490,617468,8978
"28310","Ocbimv22035334m.g","KQ422359",11946,12137,191
"28311","Ocbimv22024714m.g","KQ419621",339529,340100,571
"28312","Ocbimv22012645m.g","KQ428192",190831,191788,957
"28313","Ocbimv22003677m.g","KQ425064",86884,87171,287
"28314","Ocbimv22002977m.g","KQ417051",2431044,2431253,209
"28315","Ocbimv22022249m.g","KQ432656",231956,232366,410
"28316","Ocbimv22011662m.g","LGKD01588922",32,526,494
"28317","Ocbimv22015432m.g","KQ418243",486,22392,21906
"28318","Ocbimv22035853m.g","KQ416605",173568,173777,209
"28319","Ocbimv22006171m.g","KQ417300",2393886,2394529,643
"28320","Ocbimv22004616m.g","KQ417183",504526,534140,29614
"28321","Ocbimv22024932m.g","KQ419659",117621,135245,17624
"28322","Ocbimv22019673m.g","LGKD01652516",107,418,311
"28323","Ocbimv22012319m.g","KQ415907",313763,347227,33464
"28324","Ocbimv22030698m.g","KQ421074",9824,37846,28022
"28325","Ocbimv22010902m.g","KQ427565",87754,114383,26629
"28326","Ocbimv22011261m.g","KQ417771",792473,1031524,239051
"28327","Ocbimv22032312m.g","KQ421523",142622,162936,20314
"28328","Ocbimv22017516m.g","KQ430333",7527,24983,17456
"28329","Ocbimv22006623m.g","KQ417337",206569,209550,2981
"28330","Ocbimv22003830m.g","KQ425128",185137,194040,8903
"28331","Ocbimv22007610m.g","KQ417438",26078,29121,3043
"28332","Ocbimv22037445m.g","KQ416696",73453,73605,152
"28333","Ocbimv22013265m.g","KQ428426",299463,301502,2039
"28334","Ocbimv22003144m.g","KQ424895",4184,4516,332
"28335","Ocbimv22009110m.g","LGKD01173299",611,769,158
"28336","Ocbimv22018124m.g","LGKD01640929",138,338,200
"28337","Ocbimv22007697m.g","KQ415846",1581962,1582869,907
"28338","Ocbimv22013869m.g","KQ418069",91233,92193,960
"28339","Ocbimv22027918m.g","KQ420404",227523,232901,5378
"28340","Ocbimv22018938m.g","KQ416004",285906,296954,11048
"28341","Ocbimv22018663m.g","KQ418651",356587,358971,2384
"28342","Ocbimv22008179m.g","KQ417481",2011845,2033723,21878
"28343","Ocbimv22011892m.g","KQ427945",14907,28993,14086
"28344","Ocbimv22002947m.g","KQ424851",650968,675595,24627
"28345","Ocbimv22016940m.g","KQ430098",42348,43733,1385
"28346","Ocbimv22026000m.g","KQ419952",25279,28534,3255
"28347","Ocbimv22012008m.g","KQ415896",290884,299528,8644
"28348","Ocbimv22029612m.g","KQ420782",128384,134402,6018
"28349","Ocbimv22031540m.g","KQ421270",153518,154718,1200
"28350","Ocbimv22006227m.g","KQ425846",130840,134893,4053
"28351","Ocbimv22019596m.g","KQ418789",331766,336089,4323
"28352","Ocbimv22032125m.g","KQ421454",169138,180905,11767
"28353","Ocbimv22011122m.g","KQ417751",78523,78735,212
"28354","Ocbimv22016098m.g","KQ429708",201430,207031,5601
"28355","Ocbimv22031166m.g","KQ421186",42575,42943,368
"28356","Ocbimv22028331m.g","KQ420475",516829,522870,6041
"28357","Ocbimv22033768m.g","KQ421866",173946,203238,29292
"28358","Ocbimv22012985m.g","KQ415913",164645,164953,308
"28359","Ocbimv22036738m.g","KQ422845",10538,10891,353
"28360","Ocbimv22030748m.g","KQ421083",418090,426063,7973
"28361","Ocbimv22019208m.g","KQ418734",62331,105513,43182
"28362","Ocbimv22015679m.g","KQ429470",131954,155350,23396
"28363","Ocbimv22017390m.g","KQ430274",4486,5745,1259
"28364","Ocbimv22027137m.g","KQ420199",23754,41529,17775
"28365","Ocbimv22024480m.g","KQ416124",390604,395531,4927
"28366","Ocbimv22015781m.g","KQ429566",101615,134968,33353
"28367","Ocbimv22001663m.g","KQ416951",439770,440114,344
"28368","Ocbimv22014991m.g","KQ418193",270819,271580,761
"28369","Ocbimv22004526m.g","KQ415805",1381284,1381553,269
"28370","Ocbimv22001328m.g","KQ424266",35737,36114,377
"28371","Ocbimv22011764m.g","KQ427903",35772,35969,197
"28372","Ocbimv22032571m.g","KQ421594",103,21065,20962
"28373","Ocbimv22014613m.g","KQ415934",48769,62216,13447
"28374","Ocbimv22021458m.g","KQ416046",73520,73947,427
"28375","Ocbimv22017794m.g","LGKD01639126",60,912,852
"28376","Ocbimv22005126m.g","KQ415813",736383,736547,164
"28377","Ocbimv22032774m.g","KQ421656",204311,250090,45779
"28378","Ocbimv22011262m.g","KQ417771",820846,821202,356
"28379","Ocbimv22013101m.g","KQ417981",798723,798926,203
"28380","Ocbimv22001322m.g","KQ424265",192734,194726,1992
"28381","Ocbimv22021603m.g","KQ432245",89292,91154,1862
"28382","Ocbimv22002410m.g","KQ417009",14463,65372,50909
"28383","Ocbimv22024700m.g","KQ419616",252912,253187,275
"28384","Ocbimv22032407m.g","KQ421532",197842,198681,839
"28385","Ocbimv22004718m.g","KQ417199",410690,410933,243
"28386","Ocbimv22010613m.g","KQ415669",546181,546852,671
"28387","Ocbimv22001430m.g","KQ416933",110696,132990,22294
"28388","Ocbimv22021438m.g","KQ419049",79262,87569,8307
"28389","Ocbimv22034590m.g","KQ422081",100769,113161,12392
"28390","Ocbimv22019725m.g","KQ431280",112052,112443,391
"28391","Ocbimv22039408m.g","KQ423651",1422833,1429462,6629
"28392","Ocbimv22024649m.g","KQ419607",1349,3587,2238
"28393","Ocbimv22012245m.g","KQ417893",424212,424349,137
"28394","Ocbimv22013324m.g","KQ418012",148427,162566,14139
"28395","Ocbimv22018281m.g","KQ418590",549290,551144,1854
"28396","Ocbimv22010269m.g","KQ427339",151515,152348,833
"28397","Ocbimv22038641m.g","KQ423430",361035,361292,257
"28398","Ocbimv22036284m.g","KQ422694",83401,118119,34718
"28399","Ocbimv22021827m.g","KQ415687",576077,622451,46374
"28400","Ocbimv22013695m.g","KQ428612",208435,221238,12803
"28401","Ocbimv22011448m.g","KQ427751",35268,68886,33618
"28402","Ocbimv22007320m.g","KQ417403",309652,323217,13565
"28403","Ocbimv22008350m.g","KQ417497",2046774,2072666,25892
"28404","Ocbimv22006705m.g","KQ426075",448217,449512,1295
"28405","Ocbimv22008016m.g","KQ415849",334502,364824,30322
"28406","Ocbimv22008626m.g","KQ426706",203103,203832,729
"28407","Ocbimv22023588m.g","KQ419436",41219,43182,1963
"28408","Ocbimv22033874m.g","KQ421896",444843,497031,52188
"28409","Ocbimv22015446m.g","LGKD01618462",264,503,239
"28410","Ocbimv22022171m.g","KQ419180",490415,505818,15403
"28411","Ocbimv22014535m.g","KQ428981",7525,14733,7208
"28412","Ocbimv22004825m.g","KQ417209",57794,59833,2039
"28413","Ocbimv22003207m.g","KQ424906",6898,8033,1135
"28414","Ocbimv22014478m.g","KQ428960",48229,48492,263
"28415","Ocbimv22039571m.g","KQ423703",316150,316440,290
"28416","Ocbimv22003538m.g","KQ417090",1527515,1548390,20875
"28417","Ocbimv22033382m.g","KQ416479",486838,489804,2966
"28418","Ocbimv22022696m.g","KQ419281",621205,623222,2017
"28419","Ocbimv22011107m.g","KQ427639",11865,18525,6660
"28420","Ocbimv22018462m.g","KQ418619",33535,56046,22511
"28421","Ocbimv22034547m.g","KQ416536",378053,399945,21892
"28422","Ocbimv22032111m.g","KQ421451",195258,195566,308
"28423","Ocbimv22003606m.g","KQ425041",328346,329816,1470
"28424","Ocbimv22037921m.g","KQ423169",47185,110242,63057
"28425","Ocbimv22019195m.g","KQ418732",175360,175569,209
"28426","Ocbimv22006390m.g","KQ417318",147092,174183,27091
"28427","Ocbimv22037512m.g","KQ423056",9962,10228,266
"28428","Ocbimv22032691m.g","KQ416444",680690,689156,8466
"28429","Ocbimv22007117m.g","KQ417381",19990,21090,1100
"28430","Ocbimv22014339m.g","KQ418120",194865,195212,347
"28431","Ocbimv22019044m.g","KQ418711",1148035,1155521,7486
"28432","Ocbimv22038856m.g","KQ415768",625711,626066,355
"28433","Ocbimv22021585m.g","KQ432245",5189,7864,2675
"28434","Ocbimv22000806m.g","KQ416885",555488,568175,12687
"28435","Ocbimv22001199m.g","KQ424224",394511,396493,1982
"28436","Ocbimv22011663m.g","KQ427838",18215,19240,1025
"28437","Ocbimv22029631m.g","KQ420787",948398,958508,10110
"28438","Ocbimv22002401m.g","KQ424657",226390,264495,38105
"28439","Ocbimv22038967m.g","KQ423494",328932,336340,7408
"28440","Ocbimv22022074m.g","KQ419158",92945,93136,191
"28441","Ocbimv22031991m.g","KQ421403",54090,54371,281
"28442","Ocbimv22015345m.g","KQ415942",131094,132832,1738
"28443","Ocbimv22004960m.g","KQ425483",51631,51930,299
"28444","Ocbimv22019066m.g","KQ416006",114622,115616,994
"28445","Ocbimv22033113m.g","KQ421731",52396,116162,63766
"28446","Ocbimv22001742m.g","KQ424399",2111,10102,7991
"28447","Ocbimv22025790m.g","KQ416167",8587,13495,4908
"28448","Ocbimv22016276m.g","KQ429784",289922,290465,543
"28449","Ocbimv22039127m.g","KQ416779",920544,920936,392
"28450","Ocbimv22032834m.g","KQ421664",1310249,1337187,26938
"28451","Ocbimv22006969m.g","KQ426169",8386,8778,392
"28452","Ocbimv22017755m.g","KQ418537",841463,883205,41742
"28453","Ocbimv22024290m.g","KQ416121",1139320,1139928,608
"28454","Ocbimv22026541m.g","KQ420065",462273,462475,202
"28455","Ocbimv22016220m.g","KQ418328",569214,569559,345
"28456","Ocbimv22010463m.g","KQ427400",655,15764,15109
"28457","Ocbimv22031811m.g","KQ415726",202003,232927,30924
"28458","Ocbimv22032806m.g","KQ421658",743955,790060,46105
"28459","Ocbimv22017802m.g","KQ418548",204561,204953,392
"28460","Ocbimv22026918m.g","KQ416205",48132,49190,1058
"28461","Ocbimv22037564m.g","KQ423066",139269,139538,269
"28462","Ocbimv22030774m.g","KQ421086",9234,10941,1707
"28463","Ocbimv22015853m.g","KQ418296",321906,348808,26902
"28464","Ocbimv22002056m.g","KQ424530",227162,310864,83702
"28465","Ocbimv22009266m.g","KQ417578",1289511,1289675,164
"28466","Ocbimv22029850m.g","KQ420828",1506167,1512819,6652
"28467","Ocbimv22010839m.g","KQ417719",83851,85344,1493
"28468","Ocbimv22017698m.g","KQ430417",273913,284836,10923
"28469","Ocbimv22016813m.g","KQ430038",71578,72474,896
"28470","Ocbimv22028823m.g","KQ420587",260931,261258,327
"28471","Ocbimv22011698m.g","KQ427865",270388,272795,2407
"28472","Ocbimv22022466m.g","KQ419223",483161,483415,254
"28473","Ocbimv22003227m.g","KQ417066",273306,273578,272
"28474","Ocbimv22034855m.g","KQ416560",9657,15996,6339
"28475","Ocbimv22005911m.g","KQ417284",250913,252288,1375
"28476","Ocbimv22029879m.g","KQ420828",2291918,2352277,60359
"28477","Ocbimv22000183m.g","KQ423887",178431,180536,2105
"28478","Ocbimv22032091m.g","KQ421442",38191,38862,671
"28479","Ocbimv22014073m.g","KQ418087",290278,293925,3647
"28480","Ocbimv22026759m.g","KQ420109",335789,336421,632
"28481","Ocbimv22009859m.g","KQ417620",1425465,1445283,19818
"28482","Ocbimv22002664m.g","KQ424723",37504,37999,495
"28483","Ocbimv22035022m.g","KQ416568",121507,123605,2098
"28484","Ocbimv22033051m.g","KQ421721",541720,544397,2677
"28485","Ocbimv22035508m.g","KQ422412",27801,28259,458
"28486","Ocbimv22012521m.g","KQ417917",547248,547558,310
"28487","Ocbimv22006380m.g","KQ417316",47332,55794,8462
"28488","Ocbimv22030830m.g","KQ421100",168960,171801,2841
"28489","Ocbimv22002669m.g","KQ424728",91300,99940,8640
"28490","Ocbimv22024097m.g","KQ419533",499392,499708,316
"28491","Ocbimv22033898m.g","KQ421906",41666,59847,18181
"28492","Ocbimv22034977m.g","KQ422233",378861,379405,544
"28493","Ocbimv22034133m.g","KQ421984",175077,176535,1458
"28494","Ocbimv22039932m.g","KQ416835",237173,237850,677
"28495","Ocbimv22007687m.g","KQ415846",193439,215239,21800
"28496","Ocbimv22011464m.g","KQ417793",8234,8573,339
"28497","Ocbimv22005050m.g","KQ425507",62722,96246,33524
"28498","Ocbimv22002020m.g","KQ424513",157276,182798,25522
"28499","Ocbimv22022721m.g","KQ419287",98227,99200,973
"28500","Ocbimv22034387m.g","KQ422024",179327,270605,91278
"28501","Ocbimv22002798m.g","KQ417037",178761,180324,1563
"28502","Ocbimv22004379m.g","KQ415803",753378,753770,392
"28503","Ocbimv22024991m.g","KQ419672",314840,315016,176
"28504","Ocbimv22006627m.g","LGKD01548220",2,217,215
"28505","Ocbimv22014986m.g","KQ429148",28707,64398,35691
"28506","Ocbimv22028707m.g","KQ420562",60174,101240,41066
"28507","Ocbimv22008090m.g","KQ426567",6536,49333,42797
"28508","Ocbimv22014758m.g","KQ418175",723299,761498,38199
"28509","Ocbimv22012081m.g","KQ428014",4495,5931,1436
"28510","Ocbimv22024517m.g","KQ416125",354544,356257,1713
"28511","Ocbimv22014133m.g","KQ428771",1733,8622,6889
"28512","Ocbimv22021995m.g","KQ419142",69697,70633,936
"28513","Ocbimv22030596m.g","KQ421034",373434,374468,1034
"28514","Ocbimv22009360m.g","KQ426964",43111,43488,377
"28515","Ocbimv22003590m.g","KQ417094",185994,196363,10369
"28516","Ocbimv22026825m.g","KQ420125",2547,7027,4480
"28517","Ocbimv22022450m.g","KQ419216",473625,520611,46986
"28518","Ocbimv22021409m.g","KQ419041",103509,103907,398
"28519","Ocbimv22029952m.g","KQ420859",115218,132804,17586
"28520","Ocbimv22027625m.g","KQ420314",153276,174934,21658
"28521","Ocbimv22037657m.g","KQ416705",1252607,1305689,53082
"28522","Ocbimv22002684m.g","KQ424738",108752,122930,14178
"28523","Ocbimv22021359m.g","KQ416042",2028810,2042885,14075
"28524","Ocbimv22038146m.g","KQ423217",684765,686321,1556
"28525","Ocbimv22025797m.g","KQ419905",252210,253344,1134
"28526","Ocbimv22018800m.g","KQ418682",449190,449441,251
"28527","Ocbimv22006159m.g","KQ417300",1140621,1141664,1043
"28528","Ocbimv22015079m.g","KQ418194",1483222,1521149,37927
"28529","Ocbimv22009352m.g","KQ417585",965637,966521,884
"28530","Ocbimv22014920m.g","KQ418187",510007,572717,62710
"28531","Ocbimv22005033m.g","KQ425501",96924,102388,5464
"28532","Ocbimv22024875m.g","KQ419644",289729,365892,76163
"28533","Ocbimv22018203m.g","KQ415990",1376242,1376755,513
"28534","Ocbimv22027007m.g","KQ420162",260149,261667,1518
"28535","Ocbimv22032579m.g","KQ421601",326898,327560,662
"28536","Ocbimv22036226m.g","KQ416626",314868,325570,10702
"28537","Ocbimv22010047m.g","KQ427227",129909,190771,60862
"28538","Ocbimv22033211m.g","KQ421754",106090,107216,1126
"28539","Ocbimv22028168m.g","KQ420439",339631,340385,754
"28540","Ocbimv22011727m.g","LGKD01589776",4,331,327
"28541","Ocbimv22027942m.g","KQ420406",1623,3579,1956
"28542","Ocbimv22035805m.g","KQ422556",398739,406419,7680
"28543","Ocbimv22024012m.g","KQ433746",1,381,380
"28544","Ocbimv22002727m.g","KQ424762",92024,102814,10790
"28545","Ocbimv22022247m.g","KQ432656",148265,200520,52255
"28546","Ocbimv22016323m.g","KQ418338",448621,502821,54200
"28547","Ocbimv22023399m.g","KQ419401",190429,191831,1402
"28548","Ocbimv22025475m.g","KQ419814",2476,3830,1354
"28549","Ocbimv22006313m.g","KQ425873",152566,153814,1248
"28550","Ocbimv22035097m.g","KQ422278",18689,23009,4320
"28551","Ocbimv22025750m.g","KQ419903",127256,130652,3396
"28552","Ocbimv22014408m.g","LGKD01609049",6,293,287
"28553","Ocbimv22028441m.g","KQ420488",162581,163081,500
"28554","Ocbimv22000798m.g","KQ424071",131408,145904,14496
"28555","Ocbimv22021041m.g","KQ418995",103933,110738,6805
"28556","Ocbimv22024540m.g","KQ419593",75716,81892,6176
"28557","Ocbimv22029620m.g","KQ420787",98293,100261,1968
"28558","Ocbimv22033603m.g","KQ416487",462567,463259,692
"28559","Ocbimv22019705m.g","KQ418804",200699,243123,42424
"28560","Ocbimv22006915m.g","KQ426142",12264,13306,1042
"28561","Ocbimv22025681m.g","KQ419886",218825,231337,12512
"28562","Ocbimv22003861m.g","KQ425133",22082,29105,7023
"28563","Ocbimv22017778m.g","KQ430471",9911,11690,1779
"28564","Ocbimv22011078m.g","KQ417743",4030,4260,230
"28565","Ocbimv22000751m.g","KQ416878",427089,464867,37778
"28566","Ocbimv22031561m.g","KQ421277",1,3662,3661
"28567","Ocbimv22027655m.g","KQ420330",614788,615108,320
"28568","Ocbimv22000350m.g","KQ423934",2085,2654,569
"28569","Ocbimv22030118m.g","KQ420900",16491,17802,1311
"28570","Ocbimv22008168m.g","KQ417481",1570827,1591926,21099
"28571","Ocbimv22011091m.g","KQ417747",224692,258624,33932
"28572","Ocbimv22026031m.g","KQ419959",2913,4228,1315
"28573","Ocbimv22030503m.g","KQ416353",332402,333226,824
"28574","Ocbimv22019301m.g","KQ418745",161116,162379,1263
"28575","Ocbimv22025635m.g","KQ419868",57277,87024,29747
"28576","Ocbimv22027809m.g","KQ416233",1063304,1064015,711
"28577","Ocbimv22019965m.g","KQ418839",411556,412108,552
"28578","Ocbimv22028211m.g","KQ420444",338791,339169,378
"28579","Ocbimv22009567m.g","KQ427028",275089,352093,77004
"28580","Ocbimv22015690m.g","KQ418276",15056,52456,37400
"28581","Ocbimv22028145m.g","KQ416251",1580016,1580168,152
"28582","Ocbimv22001239m.g","KQ424231",685392,685728,336
"28583","Ocbimv22032181m.g","KQ421470",42278,44164,1886
"28584","Ocbimv22022622m.g","KQ432930",31216,31569,353
"28585","Ocbimv22031999m.g","KQ421409",648102,648392,290
"28586","Ocbimv22039261m.g","KQ423598",182010,203384,21374
"28587","Ocbimv22003182m.g","KQ424903",25872,26799,927
"28588","Ocbimv22037619m.g","KQ423078",97138,97713,575
"28589","Ocbimv22033510m.g","KQ421821",886553,890049,3496
"28590","Ocbimv22016072m.g","KQ429693",51921,52139,218
"28591","Ocbimv22008029m.g","KQ417471",96970,97263,293
"28592","Ocbimv22032410m.g","KQ421532",232493,268156,35663
"28593","Ocbimv22021879m.g","KQ432378",6264,6455,191
"28594","Ocbimv22025857m.g","KQ419916",37945,44553,6608
"28595","Ocbimv22000952m.g","KQ415782",136593,146952,10359
"28596","Ocbimv22025966m.g","KQ419937",84630,85518,888
"28597","Ocbimv22022606m.g","KQ419271",52170,92890,40720
"28598","Ocbimv22039584m.g","KQ423712",210145,212122,1977
"28599","Ocbimv22028423m.g","KQ420483",256523,258309,1786
"28600","Ocbimv22007139m.g","KQ426206",19143,41868,22725
"28601","Ocbimv22015748m.g","KQ418289",55656,93899,38243
"28602","Ocbimv22029243m.g","KQ420690",372857,376231,3374
"28603","Ocbimv22031136m.g","KQ421173",112871,142774,29903
"28604","Ocbimv22032866m.g","KQ416454",1957,12477,10520
"28605","Ocbimv22021568m.g","KQ419078",418834,435432,16598
"28606","Ocbimv22018150m.g","KQ418577",221706,227535,5829
"28607","Ocbimv22013580m.g","KQ418038",392498,407858,15360
"28608","Ocbimv22025315m.g","KQ416148",1197,24821,23624
"28609","Ocbimv22013215m.g","KQ418002",294089,294891,802
"28610","Ocbimv22017882m.g","KQ430499",1081,10821,9740
"28611","Ocbimv22007071m.g","KQ417377",50202,63795,13593
"28612","Ocbimv22003242m.g","KQ417067",393418,393739,321
"28613","Ocbimv22018311m.g","KQ418600",628749,630379,1630
"28614","Ocbimv22032526m.g","KQ421575",66053,66585,532
"28615","Ocbimv22028358m.g","KQ420477",284707,328143,43436
"28616","Ocbimv22001864m.g","KQ416971",390253,405362,15109
"28617","Ocbimv22028136m.g","KQ416251",1067222,1072498,5276
"28618","Ocbimv22008334m.g","KQ417497",1142437,1142616,179
"28619","Ocbimv22005538m.g","KQ425649",64218,97501,33283
"28620","Ocbimv22027874m.g","KQ420384",1,16742,16741
"28621","Ocbimv22000127m.g","KQ416841",1017944,1018099,155
"28622","Ocbimv22007264m.g","KQ417395",364042,392590,28548
"28623","Ocbimv22028049m.g","KQ416244",253117,264550,11433
"28624","Ocbimv22010896m.g","KQ427563",72151,93018,20867
"28625","Ocbimv22029924m.g","KQ420849",134545,135144,599
"28626","Ocbimv22006381m.g","KQ417316",141744,142847,1103
"28627","Ocbimv22004384m.g","KQ425286",38919,50032,11113
"28628","Ocbimv22000284m.g","KQ423912",14973,25514,10541
"28629","Ocbimv22032612m.g","KQ421607",214566,216673,2107
"28630","Ocbimv22020470m.g","KQ418919",20066,20260,194
"28631","Ocbimv22012913m.g","KQ417953",158933,159886,953
"28632","Ocbimv22018569m.g","KQ418640",463,864,401
"28633","Ocbimv22038486m.g","KQ423365",14242,14616,374
"28634","Ocbimv22017426m.g","KQ418495",310419,322583,12164
"28635","Ocbimv22032513m.g","KQ421570",74707,76239,1532
"28636","Ocbimv22014054m.g","KQ428738",1713,14083,12370
"28637","Ocbimv22008635m.g","KQ417515",34647,37411,2764
"28638","Ocbimv22013009m.g","KQ417972",161900,166026,4126
"28639","Ocbimv22035105m.g","KQ422281",20553,20900,347
"28640","Ocbimv22000525m.g","KQ416865",124826,139269,14443
"28641","Ocbimv22025960m.g","KQ416177",224598,225802,1204
"28642","Ocbimv22013561m.g","KQ418038",36576,50054,13478
"28643","Ocbimv22035861m.g","KQ422585",16637,38609,21972
"28644","Ocbimv22038703m.g","KQ416761",193037,259992,66955
"28645","Ocbimv22031696m.g","KQ421310",179912,180172,260
"28646","Ocbimv22000666m.g","KQ416875",73745,75907,2162
"28647","Ocbimv22007964m.g","KQ417464",195563,195904,341
"28648","Ocbimv22026843m.g","KQ420126",607741,627004,19263
"28649","Ocbimv22025261m.g","KQ419750",269890,284659,14769
"28650","Ocbimv22026930m.g","KQ416205",606965,609325,2360
"28651","Ocbimv22034125m.g","KQ421984",54052,54853,801
"28652","Ocbimv22037093m.g","KQ422920",255352,262130,6778
"28653","Ocbimv22021112m.g","KQ419008",105174,105458,284
"28654","Ocbimv22008494m.g","KQ417506",157089,254351,97262
"28655","Ocbimv22036840m.g","KQ422874",28987,29749,762
"28656","Ocbimv22033083m.g","KQ421724",651593,652652,1059
"28657","Ocbimv22013309m.g","KQ418009",554571,555272,701
"28658","Ocbimv22013804m.g","KQ418061",384902,385165,263
"28659","Ocbimv22000071m.g","KQ423846",166393,166716,323
"28660","Ocbimv22007672m.g","KQ426422",931,2753,1822
"28661","Ocbimv22026186m.g","KQ420013",8796,15536,6740
"28662","Ocbimv22026499m.g","KQ420059",312767,314885,2118
"28663","Ocbimv22030591m.g","KQ421034",22316,22750,434
"28664","Ocbimv22034825m.g","KQ422187",463348,494865,31517
"28665","Ocbimv22031050m.g","KQ421147",486423,487272,849
"28666","Ocbimv22033131m.g","KQ416468",90653,138983,48330
"28667","Ocbimv22012570m.g","KQ417917",1445669,1446370,701
"28668","Ocbimv22002037m.g","KQ416982",24,6845,6821
"28669","Ocbimv22006346m.g","KQ425887",22925,30915,7990
"28670","Ocbimv22037156m.g","KQ416678",298314,298940,626
"28671","Ocbimv22003103m.g","KQ417058",8287,25601,17314
"28672","Ocbimv22008420m.g","KQ426635",6150,6842,692
"28673","Ocbimv22012824m.g","LGKD01596979",535,1271,736
"28674","Ocbimv22037824m.g","KQ423139",209128,221353,12225
"28675","Ocbimv22032935m.g","KQ421686",85249,85518,269
"28676","Ocbimv22036094m.g","KQ416616",2433720,2440370,6650
"28677","Ocbimv22005078m.g","KQ425516",177199,196208,19009
"28678","Ocbimv22039190m.g","KQ416784",478174,478341,167
"28679","Ocbimv22004300m.g","KQ417147",94881,104466,9585
"28680","Ocbimv22007160m.g","KQ417386",360376,360912,536
"28681","Ocbimv22027532m.g","KQ420299",755989,756911,922
"28682","Ocbimv22033942m.g","KQ421907",159832,159990,158
"28683","Ocbimv22024484m.g","KQ416124",448656,519617,70961
"28684","Ocbimv22021613m.g","KQ432245",146369,147475,1106
"28685","Ocbimv22002737m.g","KQ417030",1550592,1551554,962
"28686","Ocbimv22038819m.g","KQ423473",208810,208962,152
"28687","Ocbimv22002046m.g","KQ424530",149375,157576,8201
"28688","Ocbimv22028789m.g","KQ416272",275976,276179,203
"28689","Ocbimv22033925m.g","KQ416499",28586,107235,78649
"28690","Ocbimv22039911m.g","KQ416834",606176,607297,1121
"28691","Ocbimv22031588m.g","KQ421283",29109,29345,236
"28692","Ocbimv22004448m.g","KQ417160",219344,220287,943
"28693","Ocbimv22006799m.g","KQ417350",27410,75973,48563
"28694","Ocbimv22007972m.g","KQ417466",1965310,1969226,3916
"28695","Ocbimv22030740m.g","KQ416368",545474,547002,1528
"28696","Ocbimv22039324m.g","KQ416788",135136,139697,4561
"28697","Ocbimv22029652m.g","KQ420796",504810,505724,914
"28698","Ocbimv22013833m.g","KQ428689",81866,82373,507
"28699","Ocbimv22033931m.g","KQ416499",196623,196913,290
"28700","Ocbimv22003894m.g","KQ425136",55105,55306,201
"28701","Ocbimv22038483m.g","KQ423362",6353,8303,1950
"28702","Ocbimv22021534m.g","KQ419071",164207,188864,24657
"28703","Ocbimv22007224m.g","KQ426253",67914,68276,362
"28704","Ocbimv22031147m.g","KQ421175",688525,688816,291
"28705","Ocbimv22021361m.g","KQ419034",5535,33100,27565
"28706","Ocbimv22037640m.g","KQ423084",236624,238031,1407
"28707","Ocbimv22019812m.g","LGKD01654345",77,319,242
"28708","Ocbimv22007148m.g","KQ426214",189656,190021,365
"28709","Ocbimv22038248m.g","KQ423248",377808,401168,23360
"28710","Ocbimv22008693m.g","KQ426737",21608,22057,449
"28711","Ocbimv22012754m.g","KQ415909",324054,324224,170
"28712","Ocbimv22023110m.g","KQ419350",193782,194923,1141
"28713","Ocbimv22016479m.g","KQ429891",8078,15073,6995
"28714","Ocbimv22006260m.g","KQ417305",553449,576118,22669
"28715","Ocbimv22020831m.g","KQ418970",1655105,1658334,3229
"28716","Ocbimv22021224m.g","KQ419015",146684,146893,209
"28717","Ocbimv22027695m.g","KQ416231",100694,101363,669
"28718","Ocbimv22007385m.g","KQ426315",82255,110633,28378
"28719","Ocbimv22021713m.g","KQ432292",1580,1927,347
"28720","Ocbimv22030586m.g","KQ421031",128761,128922,161
"28721","Ocbimv22011754m.g","KQ427890",27838,28380,542
"28722","Ocbimv22003007m.g","KQ424863",345190,345377,187
"28723","Ocbimv22016537m.g","KQ418365",372684,372977,293
"28724","Ocbimv22038670m.g","KQ423432",561922,576869,14947
"28725","Ocbimv22023833m.g","KQ416099",242215,242418,203
"28726","Ocbimv22027260m.g","KQ420240",19882,38871,18989
"28727","Ocbimv22031606m.g","KQ416402",2203,3611,1408
"28728","Ocbimv22039014m.g","KQ416777",407422,408605,1183
"28729","Ocbimv22038712m.g","KQ423448",30548,31159,611
"28730","Ocbimv22006903m.g","KQ426136",100972,101193,221
"28731","Ocbimv22024233m.g","KQ419551",41329,213637,172308
"28732","Ocbimv22017587m.g","KQ418510",24064,24315,251
"28733","Ocbimv22009252m.g","KQ417578",583127,584421,1294
"28734","Ocbimv22000359m.g","KQ423941",19828,29150,9322
"28735","Ocbimv22000876m.g","KQ424096",792636,808453,15817
"28736","Ocbimv22033013m.g","KQ421718",171637,218042,46405
"28737","Ocbimv22012347m.g","KQ428123",1928,4603,2675
"28738","Ocbimv22020859m.g","KQ418971",22630,50995,28365
"28739","Ocbimv22001106m.g","KQ424182",139389,204814,65425
"28740","Ocbimv22021984m.g","KQ419141",166829,182237,15408
"28741","Ocbimv22009030m.g","KQ426847",60980,61713,733
"28742","Ocbimv22036268m.g","KQ416628",488877,490502,1625
"28743","Ocbimv22013794m.g","KQ418061",213487,224967,11480
"28744","Ocbimv22037158m.g","KQ416678",367506,369274,1768
"28745","Ocbimv22028128m.g","KQ416251",420737,422080,1343
"28746","Ocbimv22017892m.g","KQ418555",134118,146176,12058
"28747","Ocbimv22015186m.g","KQ418204",20985,21186,201
"28748","Ocbimv22014634m.g","KQ418159",928742,929062,320
"28749","Ocbimv22039210m.g","KQ423576",378821,379149,328
"28750","Ocbimv22012820m.g","KQ428247",39201,40161,960
"28751","Ocbimv22032066m.g","KQ421417",104459,119898,15439
"28752","Ocbimv22029369m.g","KQ420731",21920,22201,281
"28753","Ocbimv22036668m.g","KQ422824",70186,73642,3456
"28754","Ocbimv22015366m.g","KQ418231",132040,132828,788
"28755","Ocbimv22002771m.g","KQ417034",8906,9997,1091
"28756","Ocbimv22005562m.g","KQ425654",115678,141587,25909
"28757","Ocbimv22026621m.g","KQ420080",455487,468288,12801
"28758","Ocbimv22007326m.g","KQ426291",75779,76200,421
"28759","Ocbimv22008597m.g","KQ417510",505951,507903,1952
"28760","Ocbimv22030787m.g","KQ421086",264863,265432,569
"28761","Ocbimv22031701m.g","KQ421318",134700,177185,42485
"28762","Ocbimv22004157m.g","KQ425220",81149,87694,6545
"28763","Ocbimv22003312m.g","KQ417079",7787,9381,1594
"28764","Ocbimv22000973m.g","KQ424142",213,29363,29150
"28765","Ocbimv22019017m.g","KQ418711",221419,221953,534
"28766","Ocbimv22005350m.g","KQ425591",34878,35692,814
"28767","Ocbimv22000380m.g","KQ423941",470515,473333,2818
"28768","Ocbimv22026216m.g","KQ420017",484634,488789,4155
"28769","Ocbimv22033010m.g","KQ421718",15552,15902,350
"28770","Ocbimv22037449m.g","KQ423031",38361,38730,369
"28771","Ocbimv22024995m.g","KQ419674",13779,29058,15279
"28772","Ocbimv22029291m.g","KQ420698",40829,42466,1637
"28773","Ocbimv22035885m.g","KQ422595",158483,170620,12137
"28774","Ocbimv22007876m.g","KQ426474",36368,37231,863
"28775","Ocbimv22031940m.g","KQ421385",303411,303656,245
"28776","Ocbimv22035434m.g","KQ422382",3747,4373,626
"28777","Ocbimv22023537m.g","KQ433448",1632,14159,12527
"28778","Ocbimv22012867m.g","KQ417945",1297818,1298498,680
"28779","Ocbimv22020981m.g","LGKD01664186",140,328,188
"28780","Ocbimv22022307m.g","KQ419194",21445,22159,714
"28781","Ocbimv22004848m.g","KQ415809",17234,17455,221
"28782","Ocbimv22033976m.g","KQ421934",72568,76503,3935
"28783","Ocbimv22031384m.g","KQ421226",48328,72002,23674
"28784","Ocbimv22023501m.g","KQ433425",2425,4524,2099
"28785","Ocbimv22009655m.g","KQ427059",577462,655413,77951
"28786","Ocbimv22034257m.g","KQ422015",162861,164473,1612
"28787","Ocbimv22008201m.g","KQ417485",14831,53615,38784
"28788","Ocbimv22008276m.g","KQ417493",78244,78414,170
"28789","Ocbimv22025326m.g","KQ419774",120703,120933,230
"28790","Ocbimv22008440m.g","KQ426638",38688,43990,5302
"28791","Ocbimv22026620m.g","KQ420080",357321,398666,41345
"28792","Ocbimv22028963m.g","KQ420618",29726,56401,26675
"28793","Ocbimv22031970m.g","KQ421390",92518,92958,440
"28794","Ocbimv22021921m.g","KQ419132",971978,972178,200
"28795","Ocbimv22031641m.g","KQ421305",323612,324092,480
"28796","Ocbimv22025296m.g","KQ419763",165833,176998,11165
"28797","Ocbimv22037281m.g","KQ422989",54554,91520,36966
"28798","Ocbimv22037254m.g","KQ422978",137185,154797,17612
"28799","Ocbimv22008351m.g","KQ417497",2065117,2071158,6041
"28800","Ocbimv22009792m.g","KQ427134",3622,3987,365
"28801","Ocbimv22021403m.g","KQ432116",120923,130149,9226
"28802","Ocbimv22029054m.g","KQ420639",63611,63772,161
"28803","Ocbimv22015850m.g","KQ418296",216013,216174,161
"28804","Ocbimv22039461m.g","KQ423672",10310,11687,1377
"28805","Ocbimv22025368m.g","KQ416152",248133,248546,413
"28806","Ocbimv22026566m.g","KQ416193",325455,353962,28507
"28807","Ocbimv22023927m.g","KQ419500",740407,766082,25675
"28808","Ocbimv22024785m.g","KQ419631",85709,105074,19365
"28809","Ocbimv22023025m.g","KQ416080",470893,487761,16868
"28810","Ocbimv22000756m.g","KQ424061",16053,25058,9005
"28811","Ocbimv22032686m.g","KQ416444",227186,230474,3288
"28812","Ocbimv22035783m.g","KQ422535",33854,34360,506
"28813","Ocbimv22014326m.g","KQ428869",12550,21493,8943
"28814","Ocbimv22016578m.g","KQ418368",301892,303479,1587
"28815","Ocbimv22004422m.g","KQ415804",383944,421326,37382
"28816","Ocbimv22026276m.g","KQ420022",619733,621013,1280
"28817","Ocbimv22029438m.g","KQ416306",1407618,1408211,593
"28818","Ocbimv22022811m.g","KQ433024",48875,49392,517
"28819","Ocbimv22027884m.g","KQ420388",68168,70810,2642
"28820","Ocbimv22026862m.g","KQ420132",592697,614940,22243
"28821","Ocbimv22007165m.g","KQ417386",1059141,1118060,58919
"28822","Ocbimv22039195m.g","KQ423574",140,43025,42885
"28823","Ocbimv22037153m.g","KQ416677",664227,665610,1383
"28824","Ocbimv22030979m.g","KQ421139",23605,47298,23693
"28825","Ocbimv22001139m.g","KQ424206",29126,29522,396
"28826","Ocbimv22029988m.g","KQ420872",160446,203210,42764
"28827","Ocbimv22020079m.g","KQ418849",471840,530291,58451
"28828","Ocbimv22010221m.g","KQ427316",125,3710,3585
"28829","Ocbimv22006395m.g","KQ417318",290443,367357,76914
"28830","Ocbimv22007682m.g","KQ415846",152230,152930,700
"28831","Ocbimv22027328m.g","KQ420260",764638,764808,170
"28832","Ocbimv22036527m.g","KQ422784",8325,9134,809
"28833","Ocbimv22029443m.g","KQ416306",1789675,1790122,447
"28834","Ocbimv22000739m.g","KQ416877",1179444,1184292,4848
"28835","Ocbimv22001382m.g","KQ416929",929114,931048,1934
"28836","Ocbimv22023324m.g","KQ433338",3840,4130,290
"28837","Ocbimv22023589m.g","KQ419437",3800,4240,440
"28838","Ocbimv22028272m.g","KQ415659",1944128,1958123,13995
"28839","Ocbimv22030394m.g","KQ420971",9669,10466,797
"28840","Ocbimv22019512m.g","KQ431182",10248,10628,380
"28841","Ocbimv22031360m.g","KQ421221",528003,528254,251
"28842","Ocbimv22014235m.g","KQ428812",7918,8413,495
"28843","Ocbimv22018255m.g","KQ418587",618597,629192,10595
"28844","Ocbimv22008422m.g","KQ417501",2186,133665,131479
"28845","Ocbimv22032996m.g","KQ421712",35125,45972,10847
"28846","Ocbimv22002399m.g","KQ424657",54052,54831,779
"28847","Ocbimv22000038m.g","KQ423831",312599,312988,389
"28848","Ocbimv22031619m.g","KQ415725",18423,18611,188
"28849","Ocbimv22016582m.g","KQ418368",341675,360531,18856
"28850","Ocbimv22036983m.g","LGKD01455752",169,336,167
"28851","Ocbimv22039788m.g","KQ416823",135085,135750,665
"28852","Ocbimv22015077m.g","KQ418194",1359996,1407722,47726
"28853","Ocbimv22011671m.g","KQ417816",93566,94055,489
"28854","Ocbimv22000346m.g","KQ416854",1131008,1131175,167
"28855","Ocbimv22029034m.g","KQ420630",151883,230406,78523
"28856","Ocbimv22025563m.g","KQ419844",11560,14579,3019
"28857","Ocbimv22021852m.g","KQ415687",1411260,1443880,32620
"28858","Ocbimv22028465m.g","KQ420496",136179,136406,227
"28859","Ocbimv22014709m.g","KQ418168",649645,650238,593
"28860","Ocbimv22026222m.g","KQ420017",565122,573946,8824
"28861","Ocbimv22039867m.g","KQ423782",197922,198329,407
"28862","Ocbimv22033948m.g","KQ421919",227837,256125,28288
"28863","Ocbimv22034161m.g","KQ421991",37115,37546,431
"28864","Ocbimv22008867m.g","KQ426791",377581,382123,4542
"28865","Ocbimv22013929m.g","KQ428714",168285,216934,48649
"28866","Ocbimv22025655m.g","KQ419877",77120,77365,245
"28867","Ocbimv22027708m.g","KQ420346",802189,804407,2218
"28868","Ocbimv22028965m.g","KQ416278",6244,7854,1610
"28869","Ocbimv22008830m.g","KQ426786",53130,66552,13422
"28870","Ocbimv22026325m.g","KQ420026",208241,211807,3566
"28871","Ocbimv22039494m.g","KQ423677",113362,114117,755
"28872","Ocbimv22034433m.g","KQ422036",566779,574581,7802
"28873","Ocbimv22008963m.g","LGKD01566612",1168,1415,247
"28874","Ocbimv22029410m.g","KQ420742",252213,253034,821
"28875","Ocbimv22030490m.g","KQ416352",147651,148460,809
"28876","Ocbimv22003047m.g","KQ424867",20630,27258,6628
"28877","Ocbimv22011356m.g","KQ417791",114588,141004,26416
"28878","Ocbimv22001965m.g","KQ424504",51407,51625,218
"28879","Ocbimv22009660m.g","KQ427059",663592,663846,254
"28880","Ocbimv22013078m.g","KQ417979",47036,85265,38229
"28881","Ocbimv22004372m.g","KQ415803",582803,583249,446
"28882","Ocbimv22038286m.g","KQ423260",274832,277963,3131
"28883","Ocbimv22033472m.g","KQ416482",167585,210050,42465
"28884","Ocbimv22010216m.g","KQ427311",119598,119958,360
"28885","Ocbimv22037972m.g","KQ423187",51727,59154,7427
"28886","Ocbimv22013665m.g","KQ418043",71870,81853,9983
"28887","Ocbimv22011025m.g","KQ427597",36729,51154,14425
"28888","Ocbimv22010650m.g","KQ427464",97277,97947,670
"28889","Ocbimv22034150m.g","KQ421988",28139,60871,32732
"28890","Ocbimv22002753m.g","KQ417032",637732,644328,6596
"28891","Ocbimv22019070m.g","KQ416006",268480,294863,26383
"28892","Ocbimv22021831m.g","KQ415687",829834,869615,39781
"28893","Ocbimv22015867m.g","KQ418297",508461,510374,1913
"28894","Ocbimv22003628m.g","KQ425049",20072,20638,566
"28895","Ocbimv22011040m.g","KQ417740",201088,210407,9319
"28896","Ocbimv22000443m.g","KQ423968",9035,25082,16047
"28897","Ocbimv22032700m.g","KQ421638",38730,75754,37024
"28898","Ocbimv22000357m.g","KQ423938",101708,101929,221
"28899","Ocbimv22020029m.g","KQ418843",217764,231388,13624
"28900","Ocbimv22014978m.g","KQ418190",75863,125194,49331
"28901","Ocbimv22008293m.g","KQ426610",374220,429161,54941
"28902","Ocbimv22012834m.g","KQ417945",162987,188143,25156
"28903","Ocbimv22024504m.g","KQ419590",362411,362620,209
"28904","Ocbimv22012244m.g","KQ417893",227595,229139,1544
"28905","Ocbimv22008751m.g","KQ426760",41746,43213,1467
"28906","Ocbimv22033709m.g","KQ416492",379262,379636,374
"28907","Ocbimv22029016m.g","KQ416279",848732,870436,21704
"28908","Ocbimv22024644m.g","KQ419605",1033830,1034096,266
"28909","Ocbimv22033577m.g","KQ421837",10,207,197
"28910","Ocbimv22030528m.g","KQ421014",9504,10796,1292
"28911","Ocbimv22032972m.g","KQ421705",141536,142829,1293
"28912","Ocbimv22038925m.g","KQ423490",109758,136682,26924
"28913","Ocbimv22007002m.g","KQ417370",185044,203531,18487
"28914","Ocbimv22035864m.g","KQ422586",368970,370083,1113
"28915","Ocbimv22032605m.g","KQ421605",111391,112804,1413
"28916","Ocbimv22028146m.g","KQ416251",1580676,1580978,302
"28917","Ocbimv22038941m.g","KQ423493",45002,45454,452
"28918","Ocbimv22012953m.g","KQ417960",581459,581620,161
"28919","Ocbimv22037015m.g","KQ422908",2075,2272,197
"28920","Ocbimv22039315m.g","KQ416788",48285,48521,236
"28921","Ocbimv22029917m.g","KQ420844",115390,152444,37054
"28922","Ocbimv22032964m.g","KQ421702",56035,72289,16254
"28923","Ocbimv22036205m.g","KQ422677",16842,22329,5487
"28924","Ocbimv22016884m.g","KQ418418",411,15679,15268
"28925","Ocbimv22037676m.g","KQ423093",13890,46181,32291
"28926","Ocbimv22009182m.g","KQ426911",149460,169449,19989
"28927","Ocbimv22008643m.g","KQ426717",15690,45194,29504
"28928","Ocbimv22024921m.g","KQ419657",695599,696348,749
"28929","Ocbimv22036470m.g","KQ422771",174970,188443,13473
"28930","Ocbimv22016062m.g","KQ415952",243569,247209,3640
"28931","Ocbimv22036102m.g","KQ422641",888384,926473,38089
"28932","Ocbimv22031735m.g","KQ421332",778545,792128,13583
"28933","Ocbimv22031689m.g","KQ421308",705987,742135,36148
"28934","Ocbimv22018478m.g","KQ418623",51505,133896,82391
"28935","Ocbimv22022060m.g","KQ419155",203637,239054,35417
"28936","Ocbimv22004356m.g","KQ417152",443520,443723,203
"28937","Ocbimv22031856m.g","KQ421360",26980,28869,1889
"28938","Ocbimv22021229m.g","KQ419016",507257,583636,76379
"28939","Ocbimv22029570m.g","KQ420777",7923,9599,1676
"28940","Ocbimv22023313m.g","KQ416087",1599891,1705505,105614
"28941","Ocbimv22010416m.g","KQ427377",10637,75411,64774
"28942","Ocbimv22028997m.g","KQ416279",194238,223285,29047
"28943","Ocbimv22016775m.g","KQ418398",37974,38683,709
"28944","Ocbimv22015264m.g","KQ418216",640669,658947,18278
"28945","Ocbimv22000077m.g","KQ423849",24545,25029,484
"28946","Ocbimv22021248m.g","KQ419020",40961,63877,22916
"28947","Ocbimv22009047m.g","KQ415859",730552,748295,17743
"28948","Ocbimv22001389m.g","KQ416930",287764,298379,10615
"28949","Ocbimv22007387m.g","KQ426315",123724,124279,555
"28950","Ocbimv22003518m.g","KQ425021",206046,236454,30408
"28951","Ocbimv22005744m.g","KQ425732",249166,249348,182
"28952","Ocbimv22039171m.g","KQ416783",81279,81521,242
"28953","Ocbimv22004172m.g","KQ425220",249679,262411,12732
"28954","Ocbimv22012499m.g","KQ417917",247729,258107,10378
"28955","Ocbimv22007113m.g","KQ417380",5031,6887,1856
"28956","Ocbimv22024284m.g","KQ416121",454695,455276,581
"28957","Ocbimv22012012m.g","KQ427966",54343,54522,179
"28958","Ocbimv22006059m.g","KQ417293",234716,235096,380
"28959","Ocbimv22001046m.g","KQ424160",105495,127215,21720
"28960","Ocbimv22039594m.g","KQ416807",55482,56881,1399
"28961","Ocbimv22036541m.g","KQ422788",139155,143306,4151
"28962","Ocbimv22032946m.g","KQ421688",249096,249784,688
"28963","Ocbimv22009295m.g","KQ417581",1599,14651,13052
"28964","Ocbimv22001117m.g","KQ424184",228129,230784,2655
"28965","Ocbimv22020883m.g","KQ418971",698866,705668,6802
"28966","Ocbimv22017308m.g","KQ415681",823133,823318,185
"28967","Ocbimv22031201m.g","KQ421200",65966,70047,4081
"28968","Ocbimv22024204m.g","KQ419549",25673,36070,10397
"28969","Ocbimv22019800m.g","KQ431316",225364,244369,19005
"28970","Ocbimv22006545m.g","KQ426003",16079,16831,752
"28971","Ocbimv22039229m.g","KQ423590",152812,159765,6953
"28972","Ocbimv22011670m.g","KQ417816",92884,93565,681
"28973","Ocbimv22002757m.g","KQ415795",6468,7958,1490
"28974","Ocbimv22020461m.g","KQ431706",1643,1915,272
"28975","Ocbimv22025345m.g","KQ419780",20774,20965,191
"28976","Ocbimv22014838m.g","KQ415935",28770,105916,77146
"28977","Ocbimv22024557m.g","LGKD01699609",52,495,443
"28978","Ocbimv22025188m.g","KQ419726",143219,143431,212
"28979","Ocbimv22033401m.g","KQ416479",938235,980317,42082
"28980","Ocbimv22018075m.g","KQ418569",33689,33946,257
"28981","Ocbimv22012159m.g","KQ417878",258415,258621,206
"28982","Ocbimv22008070m.g","KQ426557",104901,119900,14999
"28983","Ocbimv22012415m.g","KQ417911",113966,114691,725
"28984","Ocbimv22030106m.g","KQ420892",92246,92548,302
"28985","Ocbimv22019202m.g","KQ418733",100911,137332,36421
"28986","Ocbimv22038964m.g","KQ423494",174268,194112,19844
"28987","Ocbimv22028931m.g","KQ416274",2158141,2158527,386
"28988","Ocbimv22037187m.g","KQ422962",2859,18835,15976
"28989","Ocbimv22003011m.g","KQ417054",196628,196822,194
"28990","Ocbimv22019708m.g","KQ418804",682452,683253,801
"28991","Ocbimv22002176m.g","KQ424568",21391,23345,1954
"28992","Ocbimv22022627m.g","KQ432932",216028,337249,121221
"28993","Ocbimv22015893m.g","KQ418300",15,173,158
"28994","Ocbimv22031581m.g","KQ416401",202642,216914,14272
"28995","Ocbimv22021746m.g","KQ419094",52134,60996,8862
"28996","Ocbimv22035213m.g","KQ422314",33570,45271,11701
"28997","Ocbimv22030734m.g","KQ416367",12551,12997,446
"28998","Ocbimv22026115m.g","KQ419989",727506,727976,470
"28999","Ocbimv22022271m.g","KQ419192",217307,217772,465
"29000","Ocbimv22010769m.g","KQ427511",105424,108264,2840
"29001","Ocbimv22021630m.g","KQ419081",8946,105775,96829
"29002","Ocbimv22015009m.g","KQ418194",143169,189410,46241
"29003","Ocbimv22008025m.g","KQ417471",82,1115,1033
"29004","Ocbimv22033922m.g","KQ421906",601044,602639,1595
"29005","Ocbimv22009097m.g","KQ417561",143240,197907,54667
"29006","Ocbimv22008053m.g","KQ426552",20860,21225,365
"29007","Ocbimv22032375m.g","KQ416430",187785,252190,64405
"29008","Ocbimv22030418m.g","KQ420978",10607,11215,608
"29009","Ocbimv22034748m.g","KQ422141",95902,97644,1742
"29010","Ocbimv22028628m.g","KQ420537",31435,33252,1817
"29011","Ocbimv22011212m.g","KQ417763",59477,65558,6081
"29012","Ocbimv22033241m.g","KQ421758",883033,883452,419
"29013","Ocbimv22000055m.g","KQ423834",195433,200108,4675
"29014","Ocbimv22020878m.g","KQ418971",499867,503477,3610
"29015","Ocbimv22033697m.g","KQ416491",448271,454303,6032
"29016","Ocbimv22025511m.g","KQ419829",3993,53288,49295
"29017","Ocbimv22006855m.g","KQ417358",736471,737795,1324
"29018","Ocbimv22030239m.g","KQ420927",102610,105837,3227
"29019","Ocbimv22013118m.g","LGKD01599361",40,255,215
"29020","Ocbimv22020652m.g","KQ418945",951767,959501,7734
"29021","Ocbimv22017655m.g","KQ418525",32358,41295,8937
"29022","Ocbimv22007728m.g","KQ417447",100880,101125,245
"29023","Ocbimv22029699m.g","KQ420809",142397,143309,912
"29024","Ocbimv22012624m.g","KQ417921",1100858,1134993,34135
"29025","Ocbimv22038157m.g","KQ415763",1095686,1096027,341
"29026","Ocbimv22034217m.g","KQ422009",463541,499633,36092
"29027","Ocbimv22022636m.g","KQ432934",7750,24962,17212
"29028","Ocbimv22013320m.g","KQ418011",2667,20068,17401
"29029","Ocbimv22034374m.g","KQ422021",186462,186716,254
"29030","Ocbimv22000875m.g","KQ424096",738220,760997,22777
"29031","Ocbimv22020190m.g","KQ418873",68043,72141,4098
"29032","Ocbimv22012729m.g","KQ417931",894904,895906,1002
"29033","Ocbimv22037085m.g","KQ422919",1216344,1218955,2611
"29034","Ocbimv22032999m.g","KQ421712",597603,604095,6492
"29035","Ocbimv22033134m.g","KQ416468",146602,169418,22816
"29036","Ocbimv22018709m.g","KQ418658",24753,40500,15747
"29037","Ocbimv22032152m.g","KQ421460",249730,250634,904
"29038","Ocbimv22021287m.g","KQ432067",42466,42726,260
"29039","Ocbimv22010997m.g","KQ427583",17985,18080,95
"29040","Ocbimv22034867m.g","KQ416560",85896,93333,7437
"29041","Ocbimv22019898m.g","KQ418832",640555,702377,61822
"29042","Ocbimv22019081m.g","KQ418715",532139,592779,60640
"29043","Ocbimv22020828m.g","KQ418970",1493952,1514945,20993
"29044","Ocbimv22030191m.g","KQ420920",26128,30358,4230
"29045","Ocbimv22014098m.g","KQ428759",3988,63385,59397
"29046","Ocbimv22008424m.g","KQ417501",143992,170653,26661
"29047","Ocbimv22039066m.g","KQ423531",420657,438856,18199
"29048","Ocbimv22002128m.g","KQ415788",361128,380271,19143
"29049","Ocbimv22017357m.g","KQ418484",12341,18445,6104
"29050","Ocbimv22020745m.g","KQ431819",221550,228697,7147
"29051","Ocbimv22034529m.g","KQ422073",85708,85947,239
"29052","Ocbimv22037829m.g","KQ423139",258213,258530,317
"29053","Ocbimv22009243m.g","KQ417578",225448,238776,13328
"29054","Ocbimv22017588m.g","KQ418510",124502,126728,2226
"29055","Ocbimv22002441m.g","KQ424659",60875,61701,826
"29056","Ocbimv22023463m.g","KQ419414",423470,425014,1544
"29057","Ocbimv22031101m.g","KQ416385",105096,105434,338
"29058","Ocbimv22038653m.g","KQ416758",3340,24568,21228
"29059","Ocbimv22021429m.g","KQ432146",8914,9123,209
"29060","Ocbimv22030863m.g","KQ416373",855254,855549,295
"29061","Ocbimv22032360m.g","KQ421523",1635337,1641847,6510
"29062","Ocbimv22021769m.g","KQ419098",227297,228841,1544
"29063","Ocbimv22004375m.g","KQ415803",625637,659280,33643
"29064","Ocbimv22024059m.g","KQ419527",207694,207873,179
"29065","Ocbimv22010484m.g","KQ417681",984627,984947,320
"29066","Ocbimv22008661m.g","KQ426725",28800,29648,848
"29067","Ocbimv22002712m.g","KQ424755",272780,274431,1651
"29068","Ocbimv22030507m.g","KQ421009",270186,272093,1907
"29069","Ocbimv22023523m.g","KQ416090",641,16865,16224
"29070","Ocbimv22007327m.g","KQ426291",94724,105943,11219
"29071","Ocbimv22032011m.g","KQ421409",1034673,1035377,704
"29072","Ocbimv22031604m.g","KQ421291",153950,155363,1413
"29073","Ocbimv22006129m.g","KQ417300",290189,302865,12676
"29074","Ocbimv22025901m.g","KQ416175",1161671,1161859,188
"29075","Ocbimv22005719m.g","KQ425728",235825,237343,1518
"29076","Ocbimv22035925m.g","KQ416610",15699,62865,47166
"29077","Ocbimv22034275m.g","KQ422015",669357,747384,78027
"29078","Ocbimv22025144m.g","KQ419708",10737,10991,254
"29079","Ocbimv22018624m.g","LGKD01644460",1381,2346,965
"29080","Ocbimv22021306m.g","KQ419026",969594,972848,3254
"29081","Ocbimv22027582m.g","KQ420308",85048,85974,926
"29082","Ocbimv22024855m.g","KQ419640",200233,203057,2824
"29083","Ocbimv22008549m.g","KQ426686",26057,28332,2275
"29084","Ocbimv22038204m.g","KQ416731",539616,545934,6318
"29085","Ocbimv22024686m.g","KQ419615",370483,442885,72402
"29086","Ocbimv22028662m.g","KQ420545",285237,324033,38796
"29087","Ocbimv22003343m.g","KQ424987",6594,16602,10008
"29088","Ocbimv22039486m.g","KQ423675",519832,521924,2092
"29089","Ocbimv22015178m.g","KQ429180",5250,5794,544
"29090","Ocbimv22010948m.g","KQ417726",234591,235043,452
"29091","Ocbimv22022009m.g","KQ432511",26313,29786,3473
"29092","Ocbimv22024524m.g","KQ434034",1284,14259,12975
"29093","Ocbimv22038409m.g","KQ416739",221977,240186,18209
"29094","Ocbimv22021882m.g","KQ432380",28037,28462,425
"29095","Ocbimv22034961m.g","KQ422230",13676,14167,491
"29096","Ocbimv22038202m.g","KQ416731",346086,346481,395
"29097","Ocbimv22034969m.g","KQ422232",5981,13702,7721
"29098","Ocbimv22018576m.g","KQ418642",49992,112063,62071
"29099","Ocbimv22007669m.g","KQ426420",7161,21857,14696
"29100","Ocbimv22035536m.g","KQ422423",152422,152973,551
"29101","Ocbimv22028650m.g","KQ420545",80880,125408,44528
"29102","Ocbimv22014058m.g","KQ415672",147838,148089,251
"29103","Ocbimv22011258m.g","KQ417771",411673,428057,16384
"29104","Ocbimv22018077m.g","KQ430558",132108,133769,1661
"29105","Ocbimv22022481m.g","KQ419230",245918,246178,260
"29106","Ocbimv22013614m.g","KQ418039",550747,584140,33393
"29107","Ocbimv22013443m.g","KQ428508",52475,57483,5008
"29108","Ocbimv22021689m.g","KQ416051",892051,892680,629
"29109","Ocbimv22005103m.g","KQ415813",51844,112526,60682
"29110","Ocbimv22012683m.g","KQ417925",45742,49133,3391
"29111","Ocbimv22009149m.g","KQ415861",391720,417504,25784
"29112","Ocbimv22024579m.g","KQ419601",442140,463688,21548
"29113","Ocbimv22019900m.g","KQ418832",883302,883598,296
"29114","Ocbimv22035754m.g","KQ422527",20250,55621,35371
"29115","Ocbimv22013262m.g","KQ428426",184627,245927,61300
"29116","Ocbimv22001307m.g","KQ424264",296479,296869,390
"29117","Ocbimv22015409m.g","KQ429325",1620,68198,66578
"29118","Ocbimv22020404m.g","KQ431665",72570,72785,215
"29119","Ocbimv22005953m.g","KQ417285",168769,171191,2422
"29120","Ocbimv22017126m.g","KQ418453",31051,31355,304
"29121","Ocbimv22020283m.g","KQ418883",75239,76398,1159
"29122","Ocbimv22033991m.g","KQ416504",5150,7112,1962
"29123","Ocbimv22004308m.g","KQ417147",549888,550091,203
"29124","Ocbimv22002411m.g","KQ417009",65455,87131,21676
"29125","Ocbimv22034401m.g","KQ422028",484209,501441,17232
"29126","Ocbimv22006287m.g","KQ425854",16436,16588,152
"29127","Ocbimv22031694m.g","KQ421308",983083,1038963,55880
"29128","Ocbimv22011114m.g","KQ427641",97647,103792,6145
"29129","Ocbimv22019870m.g","KQ431346",25561,26805,1244
"29130","Ocbimv22026390m.g","KQ420035",169806,169985,179
"29131","Ocbimv22001512m.g","KQ424338",67265,69793,2528
"29132","Ocbimv22027959m.g","KQ416242",4,580,576
"29133","Ocbimv22001531m.g","KQ424349",85245,85535,290
"29134","Ocbimv22007890m.g","KQ417458",478202,480283,2081
"29135","Ocbimv22017064m.g","LGKD01632779",130,297,167
"29136","Ocbimv22019820m.g","KQ431332",168015,193986,25971
"29137","Ocbimv22036257m.g","KQ416628",3140,7369,4229
"29138","Ocbimv22016798m.g","KQ418400",166657,193258,26601
"29139","Ocbimv22008394m.g","KQ426629",69443,70226,783
"29140","Ocbimv22012033m.g","KQ427980",24970,66796,41826
"29141","Ocbimv22014522m.g","KQ415932",928916,929796,880
"29142","Ocbimv22005722m.g","KQ425728",242034,245382,3348
"29143","Ocbimv22017246m.g","KQ418469",673925,704721,30796
"29144","Ocbimv22011491m.g","KQ427766",2642,4952,2310
"29145","Ocbimv22035184m.g","KQ416577",60091,60816,725
"29146","Ocbimv22035019m.g","KQ416568",84236,88168,3932
"29147","Ocbimv22010064m.g","KQ417640",90061,98125,8064
"29148","Ocbimv22012185m.g","KQ417884",282575,282730,155
"29149","Ocbimv22007706m.g","KQ426429",3730,4137,407
"29150","Ocbimv22031180m.g","KQ415722",27519,39451,11932
"29151","Ocbimv22009057m.g","KQ417556",85804,86016,212
"29152","Ocbimv22035972m.g","KQ422621",100269,106966,6697
"29153","Ocbimv22015506m.g","KQ418263",1161950,1163562,1612
"29154","Ocbimv22024352m.g","KQ419574",412415,475968,63553
"29155","Ocbimv22023132m.g","KQ419354",141720,211935,70215
"29156","Ocbimv22029210m.g","KQ416291",848470,849169,699
"29157","Ocbimv22012664m.g","KQ417924",390746,434809,44063
"29158","Ocbimv22019222m.g","KQ418736",132555,133724,1169
"29159","Ocbimv22024508m.g","KQ419590",826750,827616,866
"29160","Ocbimv22019404m.g","KQ418760",383915,398081,14166
"29161","Ocbimv22017680m.g","KQ430417",11328,12858,1530
"29162","Ocbimv22026340m.g","KQ420029",422517,422999,482
"29163","Ocbimv22026158m.g","KQ420006",242660,243589,929
"29164","Ocbimv22033559m.g","KQ421832",31262,44090,12828
"29165","Ocbimv22005985m.g","KQ417288",396930,454627,57697
"29166","Ocbimv22006402m.g","KQ417318",475787,502414,26627
"29167","Ocbimv22008353m.g","KQ417498",27663,102233,74570
"29168","Ocbimv22037826m.g","KQ423139",233104,234649,1545
"29169","Ocbimv22001839m.g","KQ416969",562002,562253,251
"29170","Ocbimv22022731m.g","KQ416074",402093,409787,7694
"29171","Ocbimv22016326m.g","KQ418338",570355,643434,73079
"29172","Ocbimv22003214m.g","KQ424908",3705,15994,12289
"29173","Ocbimv22030125m.g","KQ420902",86413,123164,36751
"29174","Ocbimv22039012m.g","KQ416777",375560,375772,212
"29175","Ocbimv22026305m.g","KQ420023",455847,460013,4166
"29176","Ocbimv22018590m.g","KQ418644",379353,379577,224
"29177","Ocbimv22035887m.g","KQ422595",172236,180780,8544
"29178","Ocbimv22006456m.g","LGKD01545773",675,941,266
"29179","Ocbimv22027334m.g","KQ420261",387650,388768,1118
"29180","Ocbimv22028980m.g","KQ420621",42266,42913,647
"29181","Ocbimv22010359m.g","KQ427364",163886,164530,644
"29182","Ocbimv22015480m.g","KQ429383",59235,60250,1015
"29183","Ocbimv22025531m.g","KQ419831",387640,388231,591
"29184","Ocbimv22019091m.g","KQ430963",76175,84719,8544
"29185","Ocbimv22009313m.g","KQ417582",742667,742816,149
"29186","Ocbimv22009180m.g","KQ426911",103287,127466,24179
"29187","Ocbimv22039597m.g","KQ416807",82638,107914,25276
"29188","Ocbimv22009548m.g","KQ415865",1267475,1345295,77820
"29189","Ocbimv22024928m.g","KQ419658",222676,223395,719
"29190","Ocbimv22037145m.g","KQ416676",122891,123472,581
"29191","Ocbimv22004932m.g","KQ425475",101994,102515,521
"29192","Ocbimv22038408m.g","KQ416739",124382,125098,716
"29193","Ocbimv22030109m.g","KQ420892",121937,122959,1022
"29194","Ocbimv22028280m.g","KQ420458",15309,16340,1031
"29195","Ocbimv22035085m.g","KQ422274",106852,111766,4914
"29196","Ocbimv22003929m.g","KQ417125",215961,221651,5690
"29197","Ocbimv22032397m.g","KQ421531",100676,109010,8334
"29198","Ocbimv22027067m.g","KQ420174",39833,93741,53908
"29199","Ocbimv22032877m.g","KQ416454",233303,263259,29956
"29200","Ocbimv22027601m.g","KQ420313",460383,461147,764
"29201","Ocbimv22023159m.g","KQ419362",103196,103822,626
"29202","Ocbimv22020542m.g","KQ418922",1375099,1375319,220
"29203","Ocbimv22023829m.g","KQ416099",34085,72387,38302
"29204","Ocbimv22010250m.g","KQ415873",97416,135952,38536
"29205","Ocbimv22013125m.g","KQ417985",2020,3850,1830
"29206","Ocbimv22031688m.g","KQ421308",669785,682766,12981
"29207","Ocbimv22027275m.g","KQ420241",97527,97817,290
"29208","Ocbimv22008417m.g","KQ417500",9469,11795,2326
"29209","Ocbimv22005299m.g","KQ417239",81,6945,6864
"29210","Ocbimv22008081m.g","KQ426561",101651,108004,6353
"29211","Ocbimv22032698m.g","KQ421638",32230,32651,421
"29212","Ocbimv22025977m.g","KQ419940",48286,50837,2551
"29213","Ocbimv22003277m.g","LGKD01520079",1,285,284
"29214","Ocbimv22002974m.g","KQ417051",2114071,2165203,51132
"29215","Ocbimv22017306m.g","KQ415681",693865,708094,14229
"29216","Ocbimv22000252m.g","KQ423906",40207,40383,176
"29217","Ocbimv22032128m.g","KQ421454",212488,213828,1340
"29218","Ocbimv22016404m.g","KQ418345",290197,351872,61675
"29219","Ocbimv22017652m.g","KQ418523",374576,377332,2756
"29220","Ocbimv22013116m.g","KQ428371",97712,118821,21109
"29221","Ocbimv22029427m.g","KQ420747",631700,632056,356
"29222","Ocbimv22019598m.g","KQ418789",338035,339131,1096
"29223","Ocbimv22005026m.g","KQ417224",276430,291660,15230
"29224","Ocbimv22036113m.g","KQ422643",228799,229233,434
"29225","Ocbimv22001825m.g","KQ424439",3358,4455,1097
"29226","Ocbimv22014692m.g","KQ418168",493284,494475,1191
"29227","Ocbimv22006408m.g","KQ425905",3213,3985,772
"29228","Ocbimv22023402m.g","KQ419401",213469,228138,14669
"29229","Ocbimv22011858m.g","KQ427927",113832,114371,539
"29230","Ocbimv22027779m.g","KQ420370",136618,140523,3905
"29231","Ocbimv22037936m.g","KQ423172",2151,25062,22911
"29232","Ocbimv22035447m.g","KQ422385",99462,100085,623
"29233","Ocbimv22002872m.g","KQ424812",442039,455975,13936
"29234","Ocbimv22010110m.g","KQ427263",71387,71851,464
"29235","Ocbimv22008163m.g","KQ417481",1342201,1343436,1235
"29236","Ocbimv22027455m.g","KQ420287",543197,674090,130893
"29237","Ocbimv22037947m.g","KQ423179",10353,12488,2135
"29238","Ocbimv22020575m.g","KQ418926",210373,219278,8905
"29239","Ocbimv22026361m.g","KQ420033",117182,154112,36930
"29240","Ocbimv22029861m.g","KQ420828",1832424,1851817,19393
"29241","Ocbimv22034656m.g","KQ416544",217097,225963,8866
"29242","Ocbimv22039220m.g","KQ423587",45546,99869,54323
"29243","Ocbimv22007799m.g","KQ426457",70477,96930,26453
"29244","Ocbimv22015208m.g","KQ429207",2518,5124,2606
"29245","Ocbimv22021092m.g","KQ431983",28706,29029,323
"29246","Ocbimv22034699m.g","KQ416547",120213,121066,853
"29247","Ocbimv22012625m.g","KQ417921",1150248,1152460,2212
"29248","Ocbimv22005869m.g","KQ417280",342515,343754,1239
"29249","Ocbimv22038899m.g","KQ416771",756889,758645,1756
"29250","Ocbimv22018781m.g","KQ418675",12594,37579,24985
"29251","Ocbimv22003314m.g","KQ417079",65382,65882,500
"29252","Ocbimv22015212m.g","KQ429209",2821,18690,15869
"29253","Ocbimv22014946m.g","KQ429139",465714,497334,31620
"29254","Ocbimv22001875m.g","KQ424457",166922,171656,4734
"29255","Ocbimv22038288m.g","KQ423260",326858,343235,16377
"29256","Ocbimv22004388m.g","KQ425289",293588,294314,726
"29257","Ocbimv22017204m.g","KQ430209",85637,100671,15034
"29258","Ocbimv22005958m.g","KQ417285",314451,315515,1064
"29259","Ocbimv22018470m.g","KQ430702",9054,51419,42365
"29260","Ocbimv22020882m.g","KQ418971",689497,690742,1245
"29261","Ocbimv22032733m.g","KQ416449",115308,115472,164
"29262","Ocbimv22025501m.g","KQ419823",203454,203771,317
"29263","Ocbimv22004691m.g","KQ417198",222282,222798,516
"29264","Ocbimv22021977m.g","KQ419141",39679,68522,28843
"29265","Ocbimv22013701m.g","KQ418049",141224,155704,14480
"29266","Ocbimv22002267m.g","KQ424600",35481,101387,65906
"29267","Ocbimv22019480m.g","KQ416011",717281,718311,1030
"29268","Ocbimv22019342m.g","KQ431100",40002,44021,4019
"29269","Ocbimv22033288m.g","KQ421766",8700,34058,25358
"29270","Ocbimv22019034m.g","KQ418711",1006904,1014156,7252
"29271","Ocbimv22019060m.g","KQ430958",35055,35489,434
"29272","Ocbimv22020012m.g","KQ431395",9853,18855,9002
"29273","Ocbimv22001058m.g","KQ424168",364173,367583,3410
"29274","Ocbimv22039085m.g","KQ423542",21789,92651,70862
"29275","Ocbimv22039020m.g","KQ423511",8602,8817,215
"29276","Ocbimv22036130m.g","KQ422650",21275,21580,305
"29277","Ocbimv22001090m.g","KQ424177",84566,85535,969
"29278","Ocbimv22029482m.g","KQ416308",880625,898257,17632
"29279","Ocbimv22030883m.g","KQ421116",238697,259695,20998
"29280","Ocbimv22004050m.g","KQ425190",136315,141866,5551
"29281","Ocbimv22001817m.g","KQ416964",205511,206017,506
"29282","Ocbimv22001876m.g","KQ424457",196191,202635,6444
"29283","Ocbimv22035083m.g","KQ422274",97206,101545,4339
"29284","Ocbimv22018504m.g","KQ430724",226501,226767,266
"29285","Ocbimv22028525m.g","KQ420517",155213,160189,4976
"29286","Ocbimv22003057m.g","KQ424867",149346,155783,6437
"29287","Ocbimv22009094m.g","KQ417561",36207,41000,4793
"29288","Ocbimv22027415m.g","KQ420270",32755,54812,22057
"29289","Ocbimv22027976m.g","KQ420414",582992,583141,149
"29290","Ocbimv22000675m.g","KQ424054",58680,58859,179
"29291","Ocbimv22025101m.g","KQ416137",635199,640379,5180
"29292","Ocbimv22029136m.g","KQ420662",368147,404765,36618
"29293","Ocbimv22000371m.g","KQ423941",211550,236585,25035
"29294","Ocbimv22002645m.g","KQ417023",1380440,1381147,707
"29295","Ocbimv22005237m.g","LGKD01149892",3,371,368
"29296","Ocbimv22038885m.g","KQ423486",177178,177929,751
"29297","Ocbimv22037211m.g","KQ416683",198368,200829,2461
"29298","Ocbimv22015326m.g","KQ429267",53956,96090,42134
"29299","Ocbimv22024542m.g","KQ419593",82691,84028,1337
"29300","Ocbimv22030649m.g","KQ416361",11812,16384,4572
"29301","Ocbimv22014621m.g","KQ429014",14797,15656,859
"29302","Ocbimv22015743m.g","KQ429537",4272,138116,133844
"29303","Ocbimv22001721m.g","KQ416957",10904,12403,1499
"29304","Ocbimv22032608m.g","KQ421605",306557,306814,257
"29305","Ocbimv22029695m.g","KQ420806",31506,63168,31662
"29306","Ocbimv22015030m.g","KQ418194",448910,477195,28285
"29307","Ocbimv22034681m.g","KQ416547",39424,41356,1932
"29308","Ocbimv22010210m.g","KQ417656",238937,286156,47219
"29309","Ocbimv22027429m.g","KQ420273",137801,142807,5006
"29310","Ocbimv22007618m.g","KQ417438",268891,276226,7335
"29311","Ocbimv22001281m.g","KQ424250",403281,403785,504
"29312","Ocbimv22011295m.g","KQ417777",48483,49064,581
"29313","Ocbimv22001128m.g","KQ424193",60291,61441,1150
"29314","Ocbimv22034313m.g","KQ422015",1344890,1361464,16574
"29315","Ocbimv22001055m.g","KQ424168",182573,187655,5082
"29316","Ocbimv22001478m.g","LGKD01502368",8,196,188
"29317","Ocbimv22002626m.g","KQ417023",800462,827751,27289
"29318","Ocbimv22010176m.g","KQ417653",182621,183259,638
"29319","Ocbimv22010055m.g","KQ427235",4896,8855,3959
"29320","Ocbimv22013139m.g","KQ417985",1027213,1027566,353
"29321","Ocbimv22027427m.g","KQ420273",113609,118541,4932
"29322","Ocbimv22026929m.g","KQ416205",602439,603664,1225
"29323","Ocbimv22026294m.g","KQ420023",308383,327196,18813
"29324","Ocbimv22016358m.g","KQ429827",14476,14943,467
"29325","Ocbimv22011883m.g","KQ427943",5447,24065,18618
"29326","Ocbimv22029386m.g","KQ416303",212375,212602,227
"29327","Ocbimv22021172m.g","KQ415686",450924,518452,67528
"29328","Ocbimv22027907m.g","KQ416240",215549,215929,380
"29329","Ocbimv22010631m.g","KQ415669",3111112,3111267,155
"29330","Ocbimv22014672m.g","KQ418168",55277,57614,2337
"29331","Ocbimv22007040m.g","KQ417371",10089,25927,15838
"29332","Ocbimv22005241m.g","KQ425549",76919,77298,379
"29333","Ocbimv22007529m.g","KQ417421",236283,240526,4243
"29334","Ocbimv22015813m.g","KQ418295",121119,128769,7650
"29335","Ocbimv22001815m.g","KQ424432",76913,77170,257
"29336","Ocbimv22024881m.g","KQ419646",18305,27983,9678
"29337","Ocbimv22004161m.g","KQ425220",118429,118784,355
"29338","Ocbimv22025580m.g","LGKD01320230",1,201,200
"29339","Ocbimv22024734m.g","KQ419622",5783,6417,634
"29340","Ocbimv22021185m.g","KQ416040",57179,110563,53384
"29341","Ocbimv22017291m.g","KQ430242",19769,20306,537
"29342","Ocbimv22004612m.g","KQ417183",334666,385526,50860
"29343","Ocbimv22010856m.g","KQ417719",594959,597116,2157
"29344","Ocbimv22039799m.g","KQ416825",454549,454815,266
"29345","Ocbimv22000906m.g","KQ416890",113801,132048,18247
"29346","Ocbimv22026320m.g","KQ420026",139580,144137,4557
"29347","Ocbimv22025659m.g","KQ419878",35372,58485,23113
"29348","Ocbimv22019333m.g","KQ418750",550334,602260,51926
"29349","Ocbimv22000982m.g","KQ424142",237240,237389,149
"29350","Ocbimv22018536m.g","KQ415995",105793,106571,778
"29351","Ocbimv22001679m.g","KQ416953",554222,554407,185
"29352","Ocbimv22010114m.g","KQ427263",403374,613662,210288
"29353","Ocbimv22030385m.g","KQ420970",172251,173338,1087
"29354","Ocbimv22035924m.g","KQ416610",11588,13466,1878
"29355","Ocbimv22002459m.g","KQ424660",62875,63249,374
"29356","Ocbimv22036842m.g","KQ422874",99380,99637,257
"29357","Ocbimv22035416m.g","KQ422370",12,610,598
"29358","Ocbimv22009876m.g","KQ417621",286261,288930,2669
"29359","Ocbimv22026856m.g","KQ420130",867373,909624,42251
"29360","Ocbimv22027242m.g","KQ416216",152528,166925,14397
"29361","Ocbimv22002628m.g","KQ417023",854402,881409,27007
"29362","Ocbimv22001455m.g","KQ416933",777940,787280,9340
"29363","Ocbimv22018237m.g","KQ415990",2434848,2435168,320
"29364","Ocbimv22023617m.g","LGKD01690860",2,430,428
"29365","Ocbimv22005629m.g","KQ425692",38383,44970,6587
"29366","Ocbimv22016499m.g","KQ429902",22,608,586
"29367","Ocbimv22003858m.g","KQ417117",42105,42371,266
"29368","Ocbimv22038024m.g","KQ416719",822773,864065,41292
"29369","Ocbimv22027364m.g","KQ420265",482454,512372,29918
"29370","Ocbimv22007373m.g","KQ426313",354248,354738,490
"29371","Ocbimv22024145m.g","KQ419539",215562,229062,13500
"29372","Ocbimv22018417m.g","KQ430684",747665,763639,15974
"29373","Ocbimv22006772m.g","KQ426101",100591,101206,615
"29374","Ocbimv22002042m.g","KQ416984",31596,32728,1132
"29375","Ocbimv22037585m.g","KQ423077",214443,229904,15461
"29376","Ocbimv22004793m.g","KQ417207",285787,285945,158
"29377","Ocbimv22031502m.g","KQ421263",216086,231555,15469
"29378","Ocbimv22019406m.g","KQ418760",483438,483905,467
"29379","Ocbimv22011574m.g","KQ417806",132806,133369,563
"29380","Ocbimv22002696m.g","KQ424748",3215,3385,170
"29381","Ocbimv22021999m.g","KQ432502",46978,47517,539
"29382","Ocbimv22024143m.g","KQ419539",145117,153627,8510
"29383","Ocbimv22035211m.g","KQ422314",11879,23910,12031
"29384","Ocbimv22032881m.g","KQ416455",2301,5082,2781
"29385","Ocbimv22021583m.g","KQ419080",572165,572656,491
"29386","Ocbimv22034848m.g","KQ422194",39862,48838,8976
"29387","Ocbimv22030854m.g","KQ416373",406645,448680,42035
"29388","Ocbimv22002618m.g","KQ417023",638770,676125,37355
"29389","Ocbimv22018788m.g","KQ430873",1894,8616,6722
"29390","Ocbimv22025983m.g","KQ419944",58534,73228,14694
"29391","Ocbimv22016237m.g","KQ429763",109484,109675,191
"29392","Ocbimv22032535m.g","KQ421578",453448,462200,8752
"29393","Ocbimv22014109m.g","LGKD01606499",1452,1727,275
"29394","Ocbimv22013732m.g","KQ418054",486824,487321,497
"29395","Ocbimv22031366m.g","KQ421224",78859,106107,27248
"29396","Ocbimv22021208m.g","KQ432038",266130,273874,7744
"29397","Ocbimv22029668m.g","KQ420799",182175,184114,1939
"29398","Ocbimv22035440m.g","KQ415750",122154,122712,558
"29399","Ocbimv22013389m.g","KQ418018",900605,945681,45076
"29400","Ocbimv22012116m.g","KQ417875",19760,20413,653
"29401","Ocbimv22001892m.g","KQ415786",65765,66501,736
"29402","Ocbimv22015795m.g","KQ429579",10203,10535,332
"29403","Ocbimv22036811m.g","KQ416658",981840,982091,251
"29404","Ocbimv22023407m.g","KQ419402",110781,112089,1308
"29405","Ocbimv22025700m.g","KQ419887",155419,156644,1225
"29406","Ocbimv22030758m.g","KQ421084",1616,2479,863
"29407","Ocbimv22038490m.g","KQ423371",53160,54248,1088
"29408","Ocbimv22016536m.g","KQ418365",234838,235531,693
"29409","Ocbimv22010666m.g","KQ427464",640783,646699,5916
"29410","Ocbimv22035032m.g","KQ422252",139683,140186,503
"29411","Ocbimv22012372m.g","KQ417906",2471,2756,285
"29412","Ocbimv22033440m.g","KQ421816",81276,82017,741
"29413","Ocbimv22019767m.g","KQ418812",18949,20732,1783
"29414","Ocbimv22016857m.g","KQ418413",136878,153921,17043
"29415","Ocbimv22015874m.g","KQ429599",2322,6138,3816
"29416","Ocbimv22003857m.g","KQ417117",14110,25111,11001
"29417","Ocbimv22001744m.g","KQ424399",51343,65063,13720
"29418","Ocbimv22010895m.g","KQ427563",68298,70893,2595
"29419","Ocbimv22014752m.g","KQ418175",483739,487820,4081
"29420","Ocbimv22006921m.g","KQ426143",52208,52618,410
"29421","Ocbimv22007448m.g","KQ415842",234591,234875,284
"29422","Ocbimv22004315m.g","KQ417147",1578263,1578460,197
"29423","Ocbimv22012176m.g","KQ417881",5655,6014,359
"29424","Ocbimv22034970m.g","KQ422232",45358,63279,17921
"29425","Ocbimv22006829m.g","KQ417358",50587,53453,2866
"29426","Ocbimv22027026m.g","KQ420166",176858,225414,48556
"29427","Ocbimv22014488m.g","KQ428965",711,1010,299
"29428","Ocbimv22015084m.g","KQ418194",1676237,1676395,158
"29429","Ocbimv22023376m.g","KQ419395",296621,298294,1673
"29430","Ocbimv22029315m.g","KQ416297",25460,40387,14927
"29431","Ocbimv22014283m.g","KQ418113",90443,92244,1801
"29432","Ocbimv22016485m.g","KQ418360",10142,28945,18803
"29433","Ocbimv22014130m.g","KQ418093",376106,376372,266
"29434","Ocbimv22022385m.g","KQ432728",17545,18222,677
"29435","Ocbimv22016725m.g","LGKD01236511",87,239,152
"29436","Ocbimv22035835m.g","KQ422573",118568,122344,3776
"29437","Ocbimv22007648m.g","KQ417439",246885,248025,1140
"29438","Ocbimv22009000m.g","KQ417549",245219,245455,236
"29439","Ocbimv22017687m.g","KQ430417",65947,72049,6102
"29440","Ocbimv22035567m.g","KQ422438",144155,146359,2204
"29441","Ocbimv22037159m.g","KQ416678",373944,381040,7096
"29442","Ocbimv22035497m.g","KQ422411",107167,126745,19578
"29443","Ocbimv22020393m.g","KQ431646",171415,206565,35150
"29444","Ocbimv22002689m.g","KQ424742",144733,161640,16907
"29445","Ocbimv22013755m.g","KQ418059",7718,16575,8857
"29446","Ocbimv22003226m.g","KQ417066",93767,93952,185
"29447","Ocbimv22004569m.g","KQ425361",426559,426809,250
"29448","Ocbimv22016223m.g","KQ418328",656479,672831,16352
"29449","Ocbimv22018646m.g","KQ418649",489610,490862,1252
"29450","Ocbimv22012292m.g","KQ428109",3329,11715,8386
"29451","Ocbimv22007589m.g","KQ426386",20728,20967,239
"29452","Ocbimv22019488m.g","KQ431160",10246,13851,3605
"29453","Ocbimv22000273m.g","KQ423910",203759,316574,112815
"29454","Ocbimv22011444m.g","KQ427751",6357,8550,2193
"29455","Ocbimv22025478m.g","KQ419817",42133,42459,326
"29456","Ocbimv22028411m.g","KQ420483",2019,19712,17693
"29457","Ocbimv22020850m.g","KQ418970",2350868,2352381,1513
"29458","Ocbimv22000419m.g","KQ423958",321825,346887,25062
"29459","Ocbimv22015122m.g","KQ418196",188199,190588,2389
"29460","Ocbimv22001728m.g","KQ416957",47806,50634,2828
"29461","Ocbimv22036099m.g","KQ422641",182170,186051,3881
"29462","Ocbimv22000703m.g","KQ416877",293208,293699,491
"29463","Ocbimv22028730m.g","KQ416270",1407927,1408439,512
"29464","Ocbimv22004500m.g","KQ417173",1047904,1048155,251
"29465","Ocbimv22009355m.g","KQ417585",1113757,1114592,835
"29466","Ocbimv22037974m.g","KQ415663",68298,100818,32520
"29467","Ocbimv22007357m.g","KQ426312",38708,95219,56511
"29468","Ocbimv22036601m.g","KQ416647",370166,370531,365
"29469","Ocbimv22039560m.g","KQ416802",548657,553537,4880
"29470","Ocbimv22011152m.g","KQ427654",160720,166153,5433
"29471","Ocbimv22028182m.g","KQ420441",116951,117259,308
"29472","Ocbimv22003000m.g","KQ424861",17691,50131,32440
"29473","Ocbimv22033610m.g","KQ421847",64074,104162,40088
"29474","Ocbimv22015667m.g","KQ429453",17027,17362,335
"29475","Ocbimv22004575m.g","KQ425368",4924,37766,32842
"29476","Ocbimv22021510m.g","KQ432197",461,3136,2675
"29477","Ocbimv22017439m.g","KQ418496",87258,168119,80861
"29478","Ocbimv22020801m.g","KQ431862",40837,50900,10063
"29479","Ocbimv22008222m.g","KQ417489",1303,1452,149
"29480","Ocbimv22006939m.g","KQ426160",2938,12259,9321
"29481","Ocbimv22031911m.g","KQ421376",727304,728704,1400
"29482","Ocbimv22007871m.g","KQ417455",499829,500283,454
"29483","Ocbimv22019651m.g","KQ431217",96331,96681,350
"29484","Ocbimv22005679m.g","KQ417272",177310,179340,2030
"29485","Ocbimv22012536m.g","KQ417917",805405,808763,3358
"29486","Ocbimv22031770m.g","KQ421342",111377,117267,5890
"29487","Ocbimv22005409m.g","KQ417249",2480732,2561062,80330
"29488","Ocbimv22038086m.g","KQ423213",164342,212200,47858
"29489","Ocbimv22006608m.g","KQ426030",5316,11715,6399
"29490","Ocbimv22023993m.g","KQ419514",1143733,1145572,1839
"29491","Ocbimv22039286m.g","KQ423605",39193,61127,21934
"29492","Ocbimv22016359m.g","KQ429827",21429,31386,9957
"29493","Ocbimv22010134m.g","LGKD01577015",1623,2641,1018
"29494","Ocbimv22023887m.g","KQ419491",314108,322083,7975
"29495","Ocbimv22001332m.g","KQ424269",63952,65262,1310
"29496","Ocbimv22003982m.g","KQ425165",185801,189998,4197
"29497","Ocbimv22014992m.g","KQ418193",275003,275398,395
"29498","Ocbimv22038811m.g","KQ423471",31559,34785,3226
"29499","Ocbimv22003396m.g","KQ417086",63485,64674,1189
"29500","Ocbimv22037753m.g","KQ416709",19964,21737,1773
"29501","Ocbimv22029875m.g","KQ420828",2062826,2063143,317
"29502","Ocbimv22024859m.g","KQ419643",15985,17266,1281
"29503","Ocbimv22009316m.g","KQ417582",927558,929086,1528
"29504","Ocbimv22028899m.g","KQ416274",838564,839175,611
"29505","Ocbimv22015591m.g","KQ415946",222082,229950,7868
"29506","Ocbimv22028463m.g","KQ420496",45912,46643,731
"29507","Ocbimv22014070m.g","KQ428746",1348,4385,3037
"29508","Ocbimv22012535m.g","KQ417917",804045,804443,398
"29509","Ocbimv22018666m.g","KQ418652",15751,16359,608
"29510","Ocbimv22015336m.g","KQ418224",31801,32610,809
"29511","Ocbimv22027639m.g","KQ415703",280043,292563,12520
"29512","Ocbimv22003016m.g","KQ417055",38416,38781,365
"29513","Ocbimv22007620m.g","KQ417438",547938,580236,32298
"29514","Ocbimv22020333m.g","KQ418895",153492,154972,1480
"29515","Ocbimv22023695m.g","KQ419460",221047,227271,6224
"29516","Ocbimv22025842m.g","KQ419912",4506,5060,554
"29517","Ocbimv22012512m.g","KQ417917",385681,396500,10819
"29518","Ocbimv22038060m.g","KQ423210",71396,79441,8045
"29519","Ocbimv22012794m.g","KQ428240",156733,180443,23710
"29520","Ocbimv22030607m.g","KQ416359",898639,900913,2274
"29521","Ocbimv22026799m.g","KQ420117",1608090,1609282,1192
"29522","Ocbimv22000811m.g","KQ424077",60676,61257,581
"29523","Ocbimv22029004m.g","KQ416279",441716,442084,368
"29524","Ocbimv22015328m.g","KQ429267",110492,136750,26258
"29525","Ocbimv22033465m.g","KQ421819",261011,270602,9591
"29526","Ocbimv22022882m.g","KQ419318",404024,406087,2063
"29527","Ocbimv22039115m.g","KQ416779",758515,761458,2943
"29528","Ocbimv22037552m.g","KQ423061",26309,54682,28373
"29529","Ocbimv22011410m.g","KQ417791",1274340,1295639,21299
"29530","Ocbimv22038602m.g","KQ416754",39381,57062,17681
"29531","Ocbimv22008841m.g","KQ417537",177120,177497,377
"29532","Ocbimv22014875m.g","KQ415936",86190,86567,377
"29533","Ocbimv22029618m.g","KQ420787",27095,47275,20180
"29534","Ocbimv22003440m.g","KQ417087",1123781,1147384,23603
"29535","Ocbimv22022366m.g","KQ432701",6125,8052,1927
"29536","Ocbimv22005640m.g","KQ425692",252350,255956,3606
"29537","Ocbimv22036089m.g","KQ416616",2032344,2034568,2224
"29538","Ocbimv22036778m.g","KQ422859",99649,115046,15397
"29539","Ocbimv22029627m.g","KQ420787",900651,900806,155
"29540","Ocbimv22024431m.g","KQ419577",529762,535039,5277
"29541","Ocbimv22006815m.g","KQ417354",67442,109476,42034
"29542","Ocbimv22028285m.g","KQ420458",61809,72928,11119
"29543","Ocbimv22023955m.g","KQ419507",51345,51756,411
"29544","Ocbimv22004888m.g","KQ425464",9694,10517,823
"29545","Ocbimv22002299m.g","KQ424627",38182,40665,2483
"29546","Ocbimv22019998m.g","KQ418840",1782442,1796276,13834
"29547","Ocbimv22004117m.g","KQ425206",12614,23003,10389
"29548","Ocbimv22039912m.g","KQ423794",397,894,497
"29549","Ocbimv22029803m.g","KQ420827",35819,39722,3903
"29550","Ocbimv22019037m.g","KQ418711",1030909,1034620,3711
"29551","Ocbimv22020145m.g","KQ431481",10020,11268,1248
"29552","Ocbimv22018303m.g","KQ418599",83236,83460,224
"29553","Ocbimv22008920m.g","KQ426806",122398,131533,9135
"29554","Ocbimv22009815m.g","KQ417620",102267,111101,8834
"29555","Ocbimv22009202m.g","KQ417573",678299,679803,1504
"29556","Ocbimv22033766m.g","KQ421866",57150,57600,450
"29557","Ocbimv22027746m.g","KQ420357",28241,38949,10708
"29558","Ocbimv22014353m.g","KQ418120",556719,584846,28127
"29559","Ocbimv22032871m.g","KQ416454",100259,116059,15800
"29560","Ocbimv22008996m.g","KQ417549",233011,238641,5630
"29561","Ocbimv22033797m.g","KQ421873",89327,97934,8607
"29562","Ocbimv22037096m.g","KQ422920",424960,452409,27449
"29563","Ocbimv22006184m.g","KQ417301",18778,32937,14159
"29564","Ocbimv22004014m.g","KQ425188",142015,142395,380
"29565","Ocbimv22021256m.g","KQ419020",327630,328820,1190
"29566","Ocbimv22014384m.g","KQ418125",51069,51332,263
"29567","Ocbimv22029071m.g","LGKD01363621",42,511,469
"29568","Ocbimv22000154m.g","KQ423871",94053,147485,53432
"29569","Ocbimv22021880m.g","KQ432379",16016,31360,15344
"29570","Ocbimv22004711m.g","KQ417199",105415,105800,385
"29571","Ocbimv22020493m.g","KQ418919",525696,529120,3424
"29572","Ocbimv22027268m.g","KQ420240",272890,273507,617
"29573","Ocbimv22010367m.g","KQ415876",45488,100562,55074
"29574","Ocbimv22029294m.g","KQ420698",96169,101832,5663
"29575","Ocbimv22019841m.g","KQ418821",554106,555483,1377
"29576","Ocbimv22017479m.g","KQ430313",120981,124741,3760
"29577","Ocbimv22036946m.g","KQ416666",1046151,1064290,18139
"29578","Ocbimv22007571m.g","KQ417430",687849,689675,1826
"29579","Ocbimv22032379m.g","KQ416430",276934,278212,1278
"29580","Ocbimv22016915m.g","KQ418422",855181,855985,804
"29581","Ocbimv22029066m.g","KQ420640",33573,71600,38027
"29582","Ocbimv22010350m.g","KQ427364",15934,40356,24422
"29583","Ocbimv22038773m.g","KQ416765",590996,591223,227
"29584","Ocbimv22035123m.g","KQ422284",83345,84502,1157
"29585","Ocbimv22000653m.g","KQ424035",63003,63453,450
"29586","Ocbimv22032747m.g","KQ421652",57,8991,8934
"29587","Ocbimv22030661m.g","KQ421053",112571,117961,5390
"29588","Ocbimv22025468m.g","KQ419810",15250,30963,15713
"29589","Ocbimv22002492m.g","KQ424671",280641,282097,1456
"29590","Ocbimv22013203m.g","KQ415914",365546,365884,338
"29591","Ocbimv22036379m.g","KQ422735",64961,66155,1194
"29592","Ocbimv22001257m.g","KQ424243",195575,199443,3868
"29593","Ocbimv22011210m.g","KQ417763",40948,50856,9908
"29594","Ocbimv22019717m.g","KQ418804",903448,960452,57004
"29595","Ocbimv22007637m.g","KQ415845",458516,491244,32728
"29596","Ocbimv22033674m.g","KQ421858",297499,299879,2380
"29597","Ocbimv22015868m.g","KQ418297",515944,516183,239
"29598","Ocbimv22037522m.g","KQ423057",108063,108614,551
"29599","Ocbimv22032730m.g","KQ421646",64832,66148,1316
"29600","Ocbimv22021102m.g","LGKD01665547",41,199,158
"29601","Ocbimv22021598m.g","KQ432245",59531,60979,1448
"29602","Ocbimv22036627m.g","KQ416651",1435507,1457354,21847
"29603","Ocbimv22027596m.g","KQ420313",269771,273131,3360
"29604","Ocbimv22000122m.g","KQ416841",389993,390256,263
"29605","Ocbimv22032952m.g","KQ421694",3272,18556,15284
"29606","Ocbimv22025548m.g","KQ416158",25219,44943,19724
"29607","Ocbimv22011694m.g","LGKD01194861",677,1197,520
"29608","Ocbimv22033159m.g","KQ421737",449331,474465,25134
"29609","Ocbimv22005016m.g","KQ417224",138860,160539,21679
"29610","Ocbimv22024894m.g","KQ416131",70349,71027,678
"29611","Ocbimv22018851m.g","KQ430904",76584,79672,3088
"29612","Ocbimv22008478m.g","KQ415854",782453,787865,5412
"29613","Ocbimv22032074m.g","KQ421424",33908,34105,197
"29614","Ocbimv22020304m.g","KQ418887",46145,55621,9476
"29615","Ocbimv22009819m.g","KQ417620",250815,266164,15349
"29616","Ocbimv22001134m.g","KQ424203",84409,85155,746
"29617","Ocbimv22039772m.g","KQ423745",12527,14409,1882
"29618","Ocbimv22005373m.g","KQ417249",210518,211274,756
"29619","Ocbimv22012201m.g","KQ417888",66228,66711,483
"29620","Ocbimv22034195m.g","KQ422000",84964,123763,38799
"29621","Ocbimv22015447m.g","KQ418250",81255,81458,203
"29622","Ocbimv22019822m.g","KQ431332",198408,198719,311
"29623","Ocbimv22033949m.g","KQ416501",12721,18752,6031
"29624","Ocbimv22030784m.g","KQ421086",237793,238403,610
"29625","Ocbimv22020991m.g","KQ416037",125440,127518,2078
"29626","Ocbimv22020098m.g","KQ416019",348821,350767,1946
"29627","Ocbimv22003812m.g","KQ417113",449496,451767,2271
"29628","Ocbimv22022358m.g","KQ419204",329184,331053,1869
"29629","Ocbimv22008725m.g","KQ417528",1281,3154,1873
"29630","Ocbimv22017703m.g","KQ430419",219323,219867,544
"29631","Ocbimv22021030m.g","KQ418994",298618,349286,50668
"29632","Ocbimv22005460m.g","KQ425611",42513,69562,27049
"29633","Ocbimv22020619m.g","LGKD01662087",3,347,344
"29634","Ocbimv22037440m.g","KQ423024",164136,164309,173
"29635","Ocbimv22031964m.g","KQ421389",839069,839464,395
"29636","Ocbimv22016073m.g","KQ418318",210080,212080,2000
"29637","Ocbimv22031882m.g","KQ421371",6082,6576,494
"29638","Ocbimv22016357m.g","KQ429827",4947,5896,949
"29639","Ocbimv22008256m.g","KQ426605",61921,67076,5155
"29640","Ocbimv22000842m.g","KQ415664",129357,129650,293
"29641","Ocbimv22010126m.g","KQ427268",4410,6566,2156
"29642","Ocbimv22037201m.g","KQ416683",55648,123559,67911
"29643","Ocbimv22012145m.g","KQ417877",476623,476856,233
"29644","Ocbimv22024288m.g","KQ416121",976107,976586,479
"29645","Ocbimv22025675m.g","KQ419886",32636,32902,266
"29646","Ocbimv22017377m.g","KQ418487",22132,22495,363
"29647","Ocbimv22005236m.g","KQ417233",61516,81402,19886
"29648","Ocbimv22025054m.g","KQ416136",1022906,1023500,594
"29649","Ocbimv22006314m.g","KQ425873",256032,257455,1423
"29650","Ocbimv22034619m.g","KQ416540",517649,517810,161
"29651","Ocbimv22026196m.g","KQ420016",109574,109801,227
"29652","Ocbimv22022773m.g","LGKD01682373",567,1115,548
"29653","Ocbimv22013057m.g","KQ417977",217144,228239,11095
"29654","Ocbimv22026640m.g","KQ420085",52916,58236,5320
"29655","Ocbimv22009273m.g","KQ426944",178865,179773,908
"29656","Ocbimv22039566m.g","KQ423703",191677,192007,330
"29657","Ocbimv22018443m.g","KQ415992",421097,426676,5579
"29658","Ocbimv22034613m.g","KQ416539",425644,426189,545
"29659","Ocbimv22031892m.g","KQ421373",261533,316524,54991
"29660","Ocbimv22033433m.g","KQ421810",200248,200671,423
"29661","Ocbimv22029194m.g","KQ420673",463295,513445,50150
"29662","Ocbimv22009492m.g","KQ415865",396875,397577,702
"29663","Ocbimv22004778m.g","KQ417205",140737,144977,4240
"29664","Ocbimv22020340m.g","KQ431630",25437,45023,19586
"29665","Ocbimv22032197m.g","KQ421476",276297,276996,699
"29666","Ocbimv22010028m.g","KQ415869",141637,141918,281
"29667","Ocbimv22028787m.g","KQ416272",5860,33420,27560
"29668","Ocbimv22016087m.g","KQ429704",215494,215823,329
"29669","Ocbimv22034978m.g","KQ422233",392924,458803,65879
"29670","Ocbimv22037651m.g","KQ416705",389203,435160,45957
"29671","Ocbimv22023150m.g","KQ419360",153065,155133,2068
"29672","Ocbimv22024525m.g","KQ434034",18766,30383,11617
"29673","Ocbimv22036387m.g","KQ422738",39483,65623,26140
"29674","Ocbimv22000198m.g","KQ416848",577676,577981,305
"29675","Ocbimv22023280m.g","KQ419391",161213,180360,19147
"29676","Ocbimv22033102m.g","KQ421727",115677,116499,822
"29677","Ocbimv22009686m.g","KQ427081",61037,76117,15080
"29678","Ocbimv22034329m.g","KQ422016",110876,112852,1976
"29679","Ocbimv22038596m.g","KQ423414",97056,97726,670
"29680","Ocbimv22031001m.g","KQ421143",150291,180289,29998
"29681","Ocbimv22023057m.g","KQ433194",62733,161169,98436
"29682","Ocbimv22019146m.g","KQ431015",3758,3982,224
"29683","Ocbimv22019086m.g","KQ430963",1127,17948,16821
"29684","Ocbimv22036625m.g","KQ416651",1293476,1325070,31594
"29685","Ocbimv22001295m.g","KQ424257",2158,40929,38771
"29686","Ocbimv22018450m.g","KQ415992",594804,598911,4107
"29687","Ocbimv22024152m.g","KQ419541",34408,64178,29770
"29688","Ocbimv22005816m.g","KQ417280",29780,31955,2175
"29689","Ocbimv22025551m.g","KQ416158",116166,118001,1835
"29690","Ocbimv22036412m.g","KQ416641",263988,292050,28062
"29691","Ocbimv22002849m.g","KQ424803",185482,192843,7361
"29692","Ocbimv22002123m.g","KQ415788",151957,202509,50552
"29693","Ocbimv22002772m.g","KQ417034",28792,34476,5684
"29694","Ocbimv22022635m.g","KQ432932",380466,381412,946
"29695","Ocbimv22018893m.g","KQ430918",103486,108483,4997
"29696","Ocbimv22013998m.g","KQ418075",517976,518242,266
"29697","Ocbimv22022922m.g","KQ419326",464717,475450,10733
"29698","Ocbimv22008948m.g","KQ426816",209700,239525,29825
"29699","Ocbimv22038746m.g","KQ416765",21964,30928,8964
"29700","Ocbimv22030765m.g","KQ421085",96855,107118,10263
"29701","Ocbimv22036395m.g","KQ416639",45565,45996,431
"29702","Ocbimv22009405m.g","KQ417591",409837,414037,4200
"29703","Ocbimv22006337m.g","KQ425879",16477,17316,839
"29704","Ocbimv22028887m.g","KQ416274",271132,284849,13717
"29705","Ocbimv22000704m.g","KQ416877",298494,301172,2678
"29706","Ocbimv22018777m.g","KQ418673",12802,21011,8209
"29707","Ocbimv22004010m.g","KQ417132",496341,544823,48482
"29708","Ocbimv22023161m.g","KQ419366",27243,28305,1062
"29709","Ocbimv22027816m.g","KQ420375",299273,306826,7553
"29710","Ocbimv22008448m.g","KQ415854",111968,113441,1473
"29711","Ocbimv22005235m.g","KQ417233",29494,49646,20152
"29712","Ocbimv22007240m.g","KQ426259",74551,77461,2910
"29713","Ocbimv22038075m.g","LGKD01106313",119,328,209
"29714","Ocbimv22012869m.g","KQ417945",1427870,1435203,7333
"29715","Ocbimv22015491m.g","KQ429393",12624,15011,2387
"29716","Ocbimv22005881m.g","KQ417280",420640,429356,8716
"29717","Ocbimv22025392m.g","KQ419788",57040,91195,34155
"29718","Ocbimv22021968m.g","KQ432473",25835,26044,209
"29719","Ocbimv22035183m.g","KQ422295",336442,351123,14681
"29720","Ocbimv22033203m.g","KQ421751",439,16176,15737
"29721","Ocbimv22034639m.g","KQ422097",311726,317791,6065
"29722","Ocbimv22032301m.g","KQ421519",159633,159887,254
"29723","Ocbimv22026261m.g","KQ420022",412148,419365,7217
"29724","Ocbimv22015385m.g","KQ429314",2677,3429,752
"29725","Ocbimv22026469m.g","KQ420053",988209,989913,1704
"29726","Ocbimv22006588m.g","KQ426027",1,5300,5299
"29727","Ocbimv22035791m.g","LGKD01444616",96,380,284
"29728","Ocbimv22010879m.g","KQ417722",100818,101558,740
"29729","Ocbimv22023936m.g","LGKD01302201",56,420,364
"29730","Ocbimv22030270m.g","KQ415716",682628,682942,314
"29731","Ocbimv22014556m.g","KQ418153",19533,20885,1352
"29732","Ocbimv22015857m.g","KQ418297",241108,334956,93848
"29733","Ocbimv22032646m.g","KQ421626",23591,45243,21652
"29734","Ocbimv22033026m.g","KQ421720",107426,108193,767
"29735","Ocbimv22022891m.g","KQ419319",3314,3511,197
"29736","Ocbimv22033017m.g","KQ421718",454520,455239,719
"29737","Ocbimv22036581m.g","KQ422794",197665,198468,803
"29738","Ocbimv22000229m.g","KQ423903",14478,58850,44372
"29739","Ocbimv22022048m.g","KQ419152",181966,183868,1902
"29740","Ocbimv22034631m.g","KQ422094",167530,169907,2377
"29741","Ocbimv22018293m.g","KQ418596",80071,83899,3828
"29742","Ocbimv22001780m.g","KQ424414",27414,45239,17825
"29743","Ocbimv22018083m.g","KQ418571",288554,289395,841
"29744","Ocbimv22024257m.g","KQ419555",138952,141398,2446
"29745","Ocbimv22011087m.g","KQ417747",18076,163940,145864
"29746","Ocbimv22020414m.g","KQ431670",5556,5744,188
"29747","Ocbimv22013976m.g","KQ428716",21457,23292,1835
"29748","Ocbimv22010198m.g","KQ417655",187090,187239,149
"29749","Ocbimv22037408m.g","KQ416694",2442512,2453882,11370
"29750","Ocbimv22004447m.g","KQ417160",180216,214230,34014
"29751","Ocbimv22034731m.g","KQ422135",53953,54123,170
"29752","Ocbimv22023878m.g","KQ419491",81569,115407,33838
"29753","Ocbimv22026116m.g","KQ419989",910884,911417,533
"29754","Ocbimv22000533m.g","KQ423988",91781,112514,20733
"29755","Ocbimv22010105m.g","LGKD01576698",65,523,458
"29756","Ocbimv22033078m.g","KQ421724",283275,283517,242
"29757","Ocbimv22022671m.g","KQ419279",212304,214671,2367
"29758","Ocbimv22031115m.g","KQ416385",1464248,1465911,1663
"29759","Ocbimv22013518m.g","KQ428539",21810,23659,1849
"29760","Ocbimv22024916m.g","KQ419657",42105,42815,710
"29761","Ocbimv22005644m.g","KQ425692",393623,395156,1533
"29762","Ocbimv22019051m.g","KQ418711",1230219,1235501,5282
"29763","Ocbimv22018791m.g","KQ430875",79097,106777,27680
"29764","Ocbimv22010053m.g","KQ417636",19846,48238,28392
"29765","Ocbimv22030310m.g","KQ420942",505170,523007,17837
"29766","Ocbimv22024620m.g","KQ416126",1095136,1184656,89520
"29767","Ocbimv22001044m.g","KQ424160",43263,81042,37779
"29768","Ocbimv22027208m.g","LGKD01342106",143,313,170
"29769","Ocbimv22006753m.g","KQ417347",325153,325419,266
"29770","Ocbimv22033813m.g","KQ421880",23157,23732,575
"29771","Ocbimv22011176m.g","KQ427660",11663,22124,10461
"29772","Ocbimv22001814m.g","KQ424432",4054,4485,431
"29773","Ocbimv22025469m.g","KQ419810",51008,70187,19179
"29774","Ocbimv22025352m.g","KQ419780",121912,123154,1242
"29775","Ocbimv22031221m.g","KQ421201",35374,103666,68292
"29776","Ocbimv22005585m.g","KQ425655",424844,425200,356
"29777","Ocbimv22001241m.g","KQ424236",8557,25824,17267
"29778","Ocbimv22030435m.g","KQ420985",144945,148853,3908
"29779","Ocbimv22015561m.g","KQ429424",6261,36640,30379
"29780","Ocbimv22000729m.g","KQ416877",642864,643181,317
"29781","Ocbimv22037084m.g","KQ422919",953170,981905,28735
"29782","Ocbimv22022238m.g","KQ432647",4283,15838,11555
"29783","Ocbimv22038704m.g","KQ416761",199765,199935,170
"29784","Ocbimv22021073m.g","KQ418998",108257,132616,24359
"29785","Ocbimv22023336m.g","KQ419395",68962,72733,3771
"29786","Ocbimv22012438m.g","KQ417911",926768,950244,23476
"29787","Ocbimv22035726m.g","KQ422521",263260,271106,7846
"29788","Ocbimv22030110m.g","KQ420892",123097,124939,1842
"29789","Ocbimv22015697m.g","LGKD01620721",134,310,176
"29790","Ocbimv22036190m.g","KQ422673",1,878,877
"29791","Ocbimv22038357m.g","KQ423290",76474,80674,4200
"29792","Ocbimv22000689m.g","KQ424055",609409,609948,539
"29793","Ocbimv22005886m.g","KQ417281",670904,674028,3124
"29794","Ocbimv22027408m.g","KQ420269",8056,9452,1396
"29795","Ocbimv22021213m.g","KQ419013",122148,133725,11577
"29796","Ocbimv22005111m.g","KQ415813",238446,249741,11295
"29797","Ocbimv22001524m.g","KQ416941",124015,124538,523
"29798","Ocbimv22012641m.g","KQ428192",124967,128661,3694
"29799","Ocbimv22027359m.g","KQ420265",101040,104551,3511
"29800","Ocbimv22004084m.g","KQ417133",678965,687354,8389
"29801","Ocbimv22037997m.g","KQ416719",224917,228906,3989
"29802","Ocbimv22002928m.g","KQ417050",14491,150619,136128
"29803","Ocbimv22034690m.g","KQ416547",77508,77714,206
"29804","Ocbimv22018269m.g","KQ418589",2240,14079,11839
"29805","Ocbimv22004394m.g","KQ425294",50,1102,1052
"29806","Ocbimv22014458m.g","KQ428938",76932,100029,23097
"29807","Ocbimv22033721m.g","KQ416495",25098,26346,1248
"29808","Ocbimv22017283m.g","KQ418476",10270,10635,365
"29809","Ocbimv22013545m.g","KQ415918",30297,84386,54089
"29810","Ocbimv22029840m.g","KQ420828",1297864,1329305,31441
"29811","Ocbimv22030606m.g","KQ416359",327149,330255,3106
"29812","Ocbimv22021519m.g","KQ419065",48084,159013,110929
"29813","Ocbimv22021846m.g","KQ415687",1170461,1174935,4474
"29814","Ocbimv22023524m.g","KQ416090",109949,110545,596
"29815","Ocbimv22005418m.g","KQ415816",17786,143270,125484
"29816","Ocbimv22028154m.g","KQ420439",193519,196417,2898
"29817","Ocbimv22033995m.g","KQ416504",35149,40733,5584
"29818","Ocbimv22013743m.g","KQ428640",44849,47668,2819
"29819","Ocbimv22000927m.g","KQ424119",11245,12382,1137
"29820","Ocbimv22002795m.g","KQ417037",154686,155434,748
"29821","Ocbimv22004939m.g","KQ425476",42861,44422,1561
"29822","Ocbimv22005417m.g","KQ415816",10678,11987,1309
"29823","Ocbimv22004088m.g","KQ417134",37349,37915,566
"29824","Ocbimv22020544m.g","KQ418922",1422370,1451237,28867
"29825","Ocbimv22027051m.g","KQ420169",1132127,1132591,464
"29826","Ocbimv22020906m.g","KQ418974",309891,310395,504
"29827","Ocbimv22037615m.g","KQ416704",549205,549525,320
"29828","Ocbimv22022491m.g","KQ419232",197113,234109,36996
"29829","Ocbimv22017556m.g","KQ415978",293745,293952,207
"29830","Ocbimv22035366m.g","KQ416583",129184,153310,24126
"29831","Ocbimv22018564m.g","KQ418637",169531,182357,12826
"29832","Ocbimv22010428m.g","KQ427380",108430,116595,8165
"29833","Ocbimv22008552m.g","KQ426687",28608,44990,16382
"29834","Ocbimv22011986m.g","KQ417851",224027,230885,6858
"29835","Ocbimv22032344m.g","KQ421523",1249076,1251351,2275
"29836","Ocbimv22002655m.g","KQ417023",1621663,1621998,335
"29837","Ocbimv22024105m.g","KQ419534",96884,116725,19841
"29838","Ocbimv22020641m.g","KQ418945",818110,824843,6733
"29839","Ocbimv22019522m.g","KQ418781",77207,78127,920
"29840","Ocbimv22020898m.g","KQ418974",228321,229634,1313
"29841","Ocbimv22005875m.g","KQ417280",370539,377014,6475
"29842","Ocbimv22000604m.g","KQ424015",431520,438925,7405
"29843","Ocbimv22009937m.g","KQ417623",680940,681095,155
"29844","Ocbimv22010288m.g","KQ417665",565550,566740,1190
"29845","Ocbimv22037748m.g","KQ416708",487631,508402,20771
"29846","Ocbimv22016733m.g","KQ429984",80816,81188,372
"29847","Ocbimv22026102m.g","KQ419989",413228,414392,1164
"29848","Ocbimv22023926m.g","KQ419500",737131,740576,3445
"29849","Ocbimv22001414m.g","KQ424302",164169,189708,25539
"29850","Ocbimv22008520m.g","KQ417506",842563,902788,60225
"29851","Ocbimv22021663m.g","KQ416049",258134,289226,31092
"29852","Ocbimv22025792m.g","KQ416167",170733,171041,308
"29853","Ocbimv22000088m.g","KQ416839",85865,94518,8653
"29854","Ocbimv22035373m.g","KQ416583",239069,271782,32713
"29855","Ocbimv22022480m.g","KQ419230",197350,197625,275
"29856","Ocbimv22001968m.g","KQ424505",99669,100161,492
"29857","Ocbimv22037893m.g","KQ423149",213806,214156,350
"29858","Ocbimv22005726m.g","KQ425730",15886,17016,1130
"29859","Ocbimv22020567m.g","KQ418926",134868,135836,968
"29860","Ocbimv22021543m.g","KQ432221",2399,11794,9395
"29861","Ocbimv22019030m.g","KQ418711",915607,920521,4914
"29862","Ocbimv22000332m.g","KQ423926",58259,119839,61580
"29863","Ocbimv22023218m.g","KQ419376",170323,170559,236
"29864","Ocbimv22037061m.g","KQ422913",66253,80047,13794
"29865","Ocbimv22015063m.g","KQ418194",1140289,1173367,33078
"29866","Ocbimv22002606m.g","KQ417023",16295,51770,35475
"29867","Ocbimv22036509m.g","KQ422783",26258,32447,6189
"29868","Ocbimv22019514m.g","KQ431182",43719,48146,4427
"29869","Ocbimv22024914m.g","LGKD01311498",11,349,338
"29870","Ocbimv22018384m.g","KQ418612",276659,276868,209
"29871","Ocbimv22035986m.g","KQ422621",287025,297474,10449
"29872","Ocbimv22027659m.g","KQ420334",2874,26517,23643
"29873","Ocbimv22023321m.g","KQ419393",24540,26181,1641
"29874","Ocbimv22012083m.g","KQ415900",90623,90859,236
"29875","Ocbimv22007258m.g","KQ417395",6069,6916,847
"29876","Ocbimv22010520m.g","KQ417686",607329,607517,188
"29877","Ocbimv22039975m.g","LGKD01487204",27,824,797
"29878","Ocbimv22036460m.g","KQ422771",52314,59794,7480
"29879","Ocbimv22025393m.g","KQ419788",130006,204716,74710
"29880","Ocbimv22029277m.g","KQ420696",380109,388270,8161
"29881","Ocbimv22032409m.g","KQ421532",215393,218228,2835
"29882","Ocbimv22017472m.g","KQ430312",13070,20108,7038
"29883","Ocbimv22036321m.g","KQ415755",26239,31003,4764
"29884","Ocbimv22011449m.g","KQ427751",41171,41881,710
"29885","Ocbimv22037708m.g","KQ423104",57021,58505,1484
"29886","Ocbimv22025104m.g","KQ419694",53401,54185,784
"29887","Ocbimv22032048m.g","KQ415660",724644,725438,794
"29888","Ocbimv22008584m.g","KQ417510",304205,307591,3386
"29889","Ocbimv22026503m.g","KQ420059",620260,620855,595
"29890","Ocbimv22031430m.g","KQ421241",520271,549953,29682
"29891","Ocbimv22016729m.g","KQ429984",22768,32455,9687
"29892","Ocbimv22038577m.g","KQ416752",41608,62785,21177
"29893","Ocbimv22033373m.g","KQ421802",20618,21181,563
"29894","Ocbimv22014491m.g","KQ428965",66180,66674,494
"29895","Ocbimv22010233m.g","KQ427324",8127,53944,45817
"29896","Ocbimv22025660m.g","KQ419878",66420,78701,12281
"29897","Ocbimv22008115m.g","KQ415851",11932,12135,203
"29898","Ocbimv22025436m.g","KQ419801",38161,39188,1027
"29899","Ocbimv22029267m.g","KQ420696",113452,255991,142539
"29900","Ocbimv22026602m.g","KQ420078",264743,290652,25909
"29901","Ocbimv22038886m.g","KQ416771",13677,13931,254
"29902","Ocbimv22010627m.g","KQ415669",1727662,1763984,36322
"29903","Ocbimv22004927m.g","KQ425474",466,27896,27430
"29904","Ocbimv22002403m.g","KQ424657",323706,373684,49978
"29905","Ocbimv22009107m.g","KQ426881",12401,15678,3277
"29906","Ocbimv22002408m.g","KQ424658",226571,227071,500
"29907","Ocbimv22037433m.g","KQ416694",3155140,3180468,25328
"29908","Ocbimv22022464m.g","KQ419223",322921,345630,22709
"29909","Ocbimv22039546m.g","KQ416802",203347,203955,608
"29910","Ocbimv22030022m.g","KQ420885",88281,88895,614
"29911","Ocbimv22024512m.g","LGKD01699232",3,173,170
"29912","Ocbimv22030729m.g","KQ421079",440986,441327,341
"29913","Ocbimv22009649m.g","KQ427059",478964,480164,1200
"29914","Ocbimv22033198m.g","KQ416471",47098,52055,4957
"29915","Ocbimv22000536m.g","KQ423989",175766,186949,11183
"29916","Ocbimv22015368m.g","KQ418232",164475,165266,791
"29917","Ocbimv22000263m.g","KQ423910",67726,68535,809
"29918","Ocbimv22033899m.g","KQ421906",59877,73176,13299
"29919","Ocbimv22010316m.g","KQ427354",1832,11401,9569
"29920","Ocbimv22008203m.g","KQ426577",4790,7483,2693
"29921","Ocbimv22032892m.g","KQ421676",308516,330367,21851
"29922","Ocbimv22021718m.g","KQ419091",369458,369640,182
"29923","Ocbimv22007962m.g","KQ426505",178902,205248,26346
"29924","Ocbimv22032633m.g","KQ421620",626314,628073,1759
"29925","Ocbimv22018815m.g","KQ418683",72992,93392,20400
"29926","Ocbimv22002828m.g","KQ417040",137838,139139,1301
"29927","Ocbimv22032052m.g","KQ421415",19457,20262,805
"29928","Ocbimv22008272m.g","KQ417492",601016,602179,1163
"29929","Ocbimv22039495m.g","KQ423677",191625,226906,35281
"29930","Ocbimv22032880m.g","KQ421672",53541,53825,284
"29931","Ocbimv22022890m.g","KQ419319",2236,3140,904
"29932","Ocbimv22036495m.g","KQ422777",176767,178571,1804
"29933","Ocbimv22021002m.g","KQ431922",87881,100757,12876
"29934","Ocbimv22013388m.g","KQ418018",892795,894067,1272
"29935","Ocbimv22009977m.g","KQ417629",338016,338336,320
"29936","Ocbimv22026211m.g","KQ420017",332926,339060,6134
"29937","Ocbimv22024285m.g","KQ416121",543732,544106,374
"29938","Ocbimv22026120m.g","KQ419991",6357,7726,1369
"29939","Ocbimv22032749m.g","KQ421655",4172,5269,1097
"29940","Ocbimv22003882m.g","KQ425134",399516,399740,224
"29941","Ocbimv22020916m.g","KQ418974",1278091,1278723,632
"29942","Ocbimv22003133m.g","KQ424892",3599,4120,521
"29943","Ocbimv22013974m.g","KQ428716",10046,25423,15377
"29944","Ocbimv22005057m.g","KQ425509",30351,45668,15317
"29945","Ocbimv22014055m.g","KQ428738",71150,71323,173
"29946","Ocbimv22036206m.g","KQ422677",482345,527172,44827
"29947","Ocbimv22005570m.g","KQ425655",57326,77218,19892
"29948","Ocbimv22022277m.g","KQ419192",356508,425283,68775
"29949","Ocbimv22009866m.g","KQ417620",1903479,1961052,57573
"29950","Ocbimv22029259m.g","KQ420694",132042,132530,488
"29951","Ocbimv22023642m.g","KQ419448",284623,286256,1633
"29952","Ocbimv22028298m.g","KQ420463",264656,265012,356
"29953","Ocbimv22039437m.g","KQ423666",4336,26688,22352
"29954","Ocbimv22031884m.g","KQ421371",523707,574738,51031
"29955","Ocbimv22001996m.g","KQ416979",1122562,1122770,208
"29956","Ocbimv22024771m.g","KQ419625",203268,204028,760
"29957","Ocbimv22022818m.g","KQ433029",111397,123707,12310
"29958","Ocbimv22001016m.g","KQ424157",135036,166632,31596
"29959","Ocbimv22023902m.g","KQ419497",28840,48657,19817
"29960","Ocbimv22029837m.g","KQ420828",1246210,1268134,21924
"29961","Ocbimv22013759m.g","KQ418059",18670,19834,1164
"29962","Ocbimv22006587m.g","KQ426026",388336,388736,400
"29963","Ocbimv22035062m.g","KQ422263",193388,195107,1719
"29964","Ocbimv22038144m.g","KQ423217",682734,682922,188
"29965","Ocbimv22007183m.g","KQ426226",33931,50316,16385
"29966","Ocbimv22019734m.g","KQ418807",47583,77429,29846
"29967","Ocbimv22001010m.g","KQ424147",559021,559185,164
"29968","Ocbimv22026045m.g","KQ419973",150582,151314,732
"29969","Ocbimv22024658m.g","KQ419607",585271,593627,8356
"29970","Ocbimv22019481m.g","KQ416011",729373,734379,5006
"29971","Ocbimv22008801m.g","KQ426774",143175,143333,158
"29972","Ocbimv22018989m.g","KQ418708",400788,401444,656
"29973","Ocbimv22039827m.g","KQ423773",6309,6689,380
"29974","Ocbimv22019115m.g","KQ418718",50447,70697,20250
"29975","Ocbimv22013017m.g","KQ417972",433959,449171,15212
"29976","Ocbimv22002882m.g","KQ424814",60052,62617,2565
"29977","Ocbimv22038574m.g","KQ423406",10073,23977,13904
"29978","Ocbimv22010514m.g","KQ427415",619,1885,1266
"29979","Ocbimv22036885m.g","KQ416665",4858,56716,51858
"29980","Ocbimv22024919m.g","KQ419657",540214,540552,338
"29981","Ocbimv22037796m.g","KQ423136",36653,37948,1295
"29982","Ocbimv22001911m.g","KQ424469",240555,240893,338
"29983","Ocbimv22018131m.g","KQ418575",184168,186248,2080
"29984","Ocbimv22027471m.g","KQ416225",85213,88895,3682
"29985","Ocbimv22008028m.g","KQ417471",66581,66811,230
"29986","Ocbimv22028502m.g","KQ416259",447745,652511,204766
"29987","Ocbimv22026736m.g","KQ416198",330819,331324,505
"29988","Ocbimv22002442m.g","KQ424659",61896,62607,711
"29989","Ocbimv22015508m.g","KQ415945",5058,10102,5044
"29990","Ocbimv22035415m.g","KQ415749",527926,529288,1362
"29991","Ocbimv22023140m.g","KQ416081",199952,200362,410
"29992","Ocbimv22031323m.g","KQ421218",166589,166861,272
"29993","Ocbimv22022067m.g","KQ419156",231076,231480,404
"29994","Ocbimv22029947m.g","KQ416325",354899,369596,14697
"29995","Ocbimv22037833m.g","KQ423139",315223,316031,808
"29996","Ocbimv22003384m.g","KQ425000",9514,43642,34128
"29997","Ocbimv22033568m.g","KQ415731",80597,81341,744
"29998","Ocbimv22023676m.g","KQ419458",209804,210209,405
"29999","Ocbimv22010733m.g","KQ417706",453701,454204,503
"30000","Ocbimv22024394m.g","KQ415693",395375,418840,23465
"30001","Ocbimv22007824m.g","KQ426466",10348,58949,48601
"30002","Ocbimv22037618m.g","KQ423078",70715,71062,347
"30003","Ocbimv22013577m.g","KQ418038",345053,345579,526
"30004","Ocbimv22005843m.g","KQ417280",152255,153362,1107
"30005","Ocbimv22037183m.g","KQ416680",779395,779616,221
"30006","Ocbimv22006679m.g","KQ417343",28492,89182,60690
"30007","Ocbimv22023650m.g","KQ419452",105053,105208,155
"30008","Ocbimv22026623m.g","KQ420080",522166,523562,1396
"30009","Ocbimv22000140m.g","KQ423868",147414,180270,32856
"30010","Ocbimv22010801m.g","KQ417715",192507,199043,6536
"30011","Ocbimv22020561m.g","KQ418926",8395,14872,6477
"30012","Ocbimv22008218m.g","KQ426583",39598,52231,12633
"30013","Ocbimv22039809m.g","KQ423762",16620,42342,25722
"30014","Ocbimv22016851m.g","KQ418413",77652,77872,220
"30015","Ocbimv22007297m.g","KQ417401",161670,162725,1055
"30016","Ocbimv22016862m.g","KQ418413",254956,264957,10001
"30017","Ocbimv22028584m.g","KQ416262",21888,22073,185
"30018","Ocbimv22014430m.g","KQ428915",19497,39817,20320
"30019","Ocbimv22025517m.g","KQ419831",122018,122641,623
"30020","Ocbimv22029838m.g","KQ420828",1271310,1282920,11610
"30021","Ocbimv22016727m.g","KQ429984",3681,5083,1402
"30022","Ocbimv22029765m.g","KQ420820",444550,491421,46871
"30023","Ocbimv22028488m.g","KQ420505",82071,82253,182
"30024","Ocbimv22035324m.g","KQ422351",690576,695015,4439
"30025","Ocbimv22005284m.g","KQ425570",2166,2700,534
"30026","Ocbimv22022549m.g","KQ432840",36095,36358,263
"30027","Ocbimv22008378m.g","KQ426620",36862,37950,1088
"30028","Ocbimv22029263m.g","KQ420695",448649,449314,665
"30029","Ocbimv22027619m.g","KQ420314",928,20962,20034
"30030","Ocbimv22014494m.g","KQ418142",66306,119235,52929
"30031","Ocbimv22025818m.g","KQ419909",138584,184881,46297
"30032","Ocbimv22038593m.g","KQ423414",61165,61488,323
"30033","Ocbimv22024528m.g","LGKD01699441",9,353,344
"30034","Ocbimv22033694m.g","KQ416491",366074,386400,20326
"30035","Ocbimv22005296m.g","KQ425571",225186,254296,29110
"30036","Ocbimv22025951m.g","KQ419933",62904,99922,37018
"30037","Ocbimv22001543m.g","KQ424353",134017,138595,4578
"30038","Ocbimv22027237m.g","KQ416215",242872,249958,7086
"30039","Ocbimv22019742m.g","LGKD01653492",79,171,92
"30040","Ocbimv22012845m.g","KQ417945",575287,595786,20499
"30041","Ocbimv22001144m.g","KQ424206",53141,60215,7074
"30042","Ocbimv22010002m.g","KQ427202",309885,310088,203
"30043","Ocbimv22011226m.g","KQ417763",716435,716812,377
"30044","Ocbimv22027024m.g","KQ420166",15524,45969,30445
"30045","Ocbimv22035171m.g","KQ422294",3530,3844,314
"30046","Ocbimv22038419m.g","KQ416740",105986,106297,311
"30047","Ocbimv22006833m.g","KQ417358",211642,236485,24843
"30048","Ocbimv22006547m.g","KQ426003",26080,46120,20040
"30049","Ocbimv22007187m.g","KQ426231",45889,70167,24278
"30050","Ocbimv22001291m.g","KQ416918",1349833,1350745,912
"30051","Ocbimv22025360m.g","KQ419781",183304,199798,16494
"30052","Ocbimv22006288m.g","KQ417312",25746,35949,10203
"30053","Ocbimv22035685m.g","KQ422516",465849,466960,1111
"30054","Ocbimv22017131m.g","KQ418453",62414,82469,20055
"30055","Ocbimv22011516m.g","KQ417796",756618,766332,9714
"30056","Ocbimv22006738m.g","KQ417345",384069,417659,33590
"30057","Ocbimv22035296m.g","KQ422351",109713,119956,10243
"30058","Ocbimv22015274m.g","KQ415941",15669,29974,14305
"30059","Ocbimv22027323m.g","KQ420260",382114,382504,390
"30060","Ocbimv22023564m.g","KQ419432",202443,204092,1649
"30061","Ocbimv22028185m.g","KQ420442",9031,11956,2925
"30062","Ocbimv22033057m.g","KQ421721",604789,634048,29259
"30063","Ocbimv22032059m.g","KQ421415",142872,152397,9525
"30064","Ocbimv22001311m.g","KQ424264",340404,345910,5506
"30065","Ocbimv22013308m.g","KQ418009",525631,525852,221
"30066","Ocbimv22025962m.g","KQ419936",56760,189203,132443
"30067","Ocbimv22006166m.g","KQ417300",1814867,1815142,275
"30068","Ocbimv22026572m.g","KQ416193",521387,522563,1176
"30069","Ocbimv22012303m.g","KQ428115",254412,256516,2104
"30070","Ocbimv22020532m.g","KQ418922",810745,812549,1804
"30071","Ocbimv22008559m.g","KQ426699",39298,50564,11266
"30072","Ocbimv22024638m.g","KQ419605",406180,407028,848
"30073","Ocbimv22026259m.g","KQ420022",207056,261915,54859
"30074","Ocbimv22014136m.g","KQ428771",12815,12979,164
"30075","Ocbimv22006427m.g","KQ425918",24572,24907,335
"30076","Ocbimv22006760m.g","KQ417347",1094665,1095072,407
"30077","Ocbimv22039501m.g","KQ423680",86457,88741,2284
"30078","Ocbimv22014315m.g","KQ428863",30810,98311,67501
"30079","Ocbimv22018553m.g","KQ430743",38502,38732,230
"30080","Ocbimv22024424m.g","KQ419577",448575,457769,9194
"30081","Ocbimv22006417m.g","KQ425907",116,301,185
"30082","Ocbimv22002002m.g","KQ416979",1492579,1498167,5588
"30083","Ocbimv22020054m.g","KQ431437",484,2639,2155
"30084","Ocbimv22014840m.g","KQ415935",103080,104080,1000
"30085","Ocbimv22010467m.g","LGKD01579890",7,159,152
"30086","Ocbimv22018929m.g","KQ418698",94574,97087,2513
"30087","Ocbimv22005895m.g","KQ415825",57210,57674,464
"30088","Ocbimv22028577m.g","KQ420525",128313,178856,50543
"30089","Ocbimv22037502m.g","KQ416698",325789,328884,3095
"30090","Ocbimv22015807m.g","KQ418295",84471,93976,9505
"30091","Ocbimv22021902m.g","KQ419126",40478,41827,1349
"30092","Ocbimv22019296m.g","KQ431079",53474,54047,573
"30093","Ocbimv22038471m.g","KQ423358",25799,37911,12112
"30094","Ocbimv22023867m.g","KQ419490",29307,30208,901
"30095","Ocbimv22013926m.g","KQ428714",55662,56052,390
"30096","Ocbimv22002784m.g","KQ424779",617376,617558,182
"30097","Ocbimv22000750m.g","KQ416878",310627,312114,1487
"30098","Ocbimv22020984m.g","KQ431915",61710,62940,1230
"30099","Ocbimv22033537m.g","KQ421825",4541,14459,9918
"30100","Ocbimv22008665m.g","KQ417519",28445,28783,338
"30101","Ocbimv22013047m.g","KQ428356",111,697,586
"30102","Ocbimv22018423m.g","LGKD01036454",34,195,161
"30103","Ocbimv22006617m.g","KQ417337",49761,57833,8072
"30104","Ocbimv22030742m.g","KQ416368",1009085,1044461,35376
"30105","Ocbimv22021009m.g","KQ431926",9952,10302,350
"30106","Ocbimv22000605m.g","KQ424015",444999,446848,1849
"30107","Ocbimv22002671m.g","KQ424735",1860,80440,78580
"30108","Ocbimv22019441m.g","KQ418767",337151,338515,1364
"30109","Ocbimv22018355m.g","KQ418610",88931,95207,6276
"30110","Ocbimv22015088m.g","KQ418194",1938728,1940711,1983
"30111","Ocbimv22020597m.g","KQ431746",91691,114958,23267
"30112","Ocbimv22015796m.g","KQ429581",2519,14148,11629
"30113","Ocbimv22008553m.g","KQ426687",52203,119369,67166
"30114","Ocbimv22012927m.g","KQ417955",74792,79027,4235
"30115","Ocbimv22023338m.g","KQ419395",73464,79313,5849
"30116","Ocbimv22001572m.g","KQ424361",161951,162994,1043
"30117","Ocbimv22019740m.g","KQ418810",149759,150599,840
"30118","Ocbimv22025497m.g","KQ416157",48032,57479,9447
"30119","Ocbimv22034215m.g","KQ422009",353217,353556,339
"30120","Ocbimv22019116m.g","KQ418718",60927,61580,653
"30121","Ocbimv22020946m.g","KQ418982",293097,293633,536
"30122","Ocbimv22002946m.g","KQ424851",649092,649321,229
"30123","Ocbimv22028792m.g","KQ416272",346705,355530,8825
"30124","Ocbimv22004837m.g","KQ417209",152984,156716,3732
"30125","Ocbimv22028957m.g","KQ420612",38619,39479,860
"30126","Ocbimv22014753m.g","KQ418175",523448,524710,1262
"30127","Ocbimv22036192m.g","KQ416624",143035,144113,1078
"30128","Ocbimv22013846m.g","KQ418068",45756,46150,394
"30129","Ocbimv22028406m.g","KQ416257",1186139,1192341,6202
"30130","Ocbimv22010037m.g","KQ427222",30049,30363,314
"30131","Ocbimv22034129m.g","KQ421984",138000,141869,3869
"30132","Ocbimv22033676m.g","KQ421858",304261,313806,9545
"30133","Ocbimv22030119m.g","LGKD01375770",1,479,478
"30134","Ocbimv22027154m.g","KQ420206",25574,33182,7608
"30135","Ocbimv22003381m.g","KQ424999",161659,164390,2731
"30136","Ocbimv22030722m.g","KQ421079",83198,83575,377
"30137","Ocbimv22036181m.g","KQ422667",46391,49289,2898
"30138","Ocbimv22009447m.g","KQ426997",159705,197299,37594
"30139","Ocbimv22002726m.g","KQ424762",71992,73014,1022
"30140","Ocbimv22020359m.g","KQ418900",283367,303472,20105
"30141","Ocbimv22006030m.g","KQ425782",1878,3494,1616
"30142","Ocbimv22033654m.g","KQ421858",146177,172404,26227
"30143","Ocbimv22032098m.g","KQ421445",65498,65764,266
"30144","Ocbimv22035116m.g","KQ416574",308533,308763,230
"30145","Ocbimv22039092m.g","KQ423546",142603,142824,221
"30146","Ocbimv22035204m.g","LGKD01437385",1,480,479
"30147","Ocbimv22037805m.g","KQ423138",2813,3214,401
"30148","Ocbimv22033520m.g","KQ421824",1344,2644,1300
"30149","Ocbimv22028350m.g","KQ420477",180304,180899,595
"30150","Ocbimv22003739m.g","KQ425078",29314,69579,40265
"30151","Ocbimv22009788m.g","KQ427132",423321,424080,759
"30152","Ocbimv22002548m.g","KQ424681",151596,153750,2154
"30153","Ocbimv22012582m.g","KQ417917",1730218,1730529,311
"30154","Ocbimv22006073m.g","KQ425807",87355,87561,206
"30155","Ocbimv22014105m.g","KQ428760",251110,258616,7506
"30156","Ocbimv22020610m.g","KQ418938",467985,471642,3657
"30157","Ocbimv22012313m.g","KQ415907",168961,169336,375
"30158","Ocbimv22018730m.g","KQ418664",72,31317,31245
"30159","Ocbimv22014738m.g","KQ429055",104762,104929,167
"30160","Ocbimv22034319m.g","KQ422015",1522047,1522379,332
"30161","Ocbimv22028008m.g","KQ416243",942113,942334,221
"30162","Ocbimv22038976m.g","KQ423497",21648,24405,2757
"30163","Ocbimv22031193m.g","KQ421196",8043,22667,14624
"30164","Ocbimv22036934m.g","KQ416666",872961,874466,1505
"30165","Ocbimv22038477m.g","KQ416745",301775,325937,24162
"30166","Ocbimv22030137m.g","KQ420908",74744,74989,245
"30167","Ocbimv22039460m.g","KQ423672",5617,107138,101521
"30168","Ocbimv22035103m.g","KQ416572",705575,706580,1005
"30169","Ocbimv22025830m.g","KQ419909",374823,387135,12312
"30170","Ocbimv22009203m.g","KQ417573",787901,788089,188
"30171","Ocbimv22017181m.g","KQ418462",278844,445722,166878
"30172","Ocbimv22015373m.g","KQ415674",297443,299482,2039
"30173","Ocbimv22029933m.g","KQ416325",144,488,344
"30174","Ocbimv22030851m.g","KQ416373",61735,62361,626
"30175","Ocbimv22004458m.g","KQ417164",65853,77452,11599
"30176","Ocbimv22036260m.g","KQ416628",18496,22586,4090
"30177","Ocbimv22030542m.g","KQ421018",145670,160836,15166
"30178","Ocbimv22007766m.g","KQ415847",1000601,1005711,5110
"30179","Ocbimv22001422m.g","KQ424303",25617,27313,1696
"30180","Ocbimv22031044m.g","KQ421147",6997,7604,607
"30181","Ocbimv22035553m.g","KQ422436",68978,69946,968
"30182","Ocbimv22014104m.g","KQ428760",209635,239826,30191
"30183","Ocbimv22001173m.g","KQ424212",112604,121633,9029
"30184","Ocbimv22014713m.g","KQ418169",127994,167296,39302
"30185","Ocbimv22012463m.g","KQ428165",172742,203007,30265
"30186","Ocbimv22016811m.g","KQ430038",32596,34493,1897
"30187","Ocbimv22006123m.g","KQ417300",129355,141859,12504
"30188","Ocbimv22018485m.g","LGKD01643500",1148,1414,266
"30189","Ocbimv22032085m.g","KQ421430",204203,219418,15215
"30190","Ocbimv22009956m.g","KQ417626",3907,67712,63805
"30191","Ocbimv22039147m.g","KQ423550",3769,18832,15063
"30192","Ocbimv22006295m.g","KQ425863",9412,25529,16117
"30193","Ocbimv22003500m.g","KQ417089",305234,305494,260
"30194","Ocbimv22028111m.g","KQ416249",743961,744746,785
"30195","Ocbimv22038325m.g","KQ423283",34873,38019,3146
"30196","Ocbimv22029592m.g","KQ420779",364425,381106,16681
"30197","Ocbimv22033053m.g","KQ421721",572283,572483,200
"30198","Ocbimv22033046m.g","KQ421721",274180,296557,22377
"30199","Ocbimv22000469m.g","KQ416862",17323,51910,34587
"30200","Ocbimv22002089m.g","KQ424537",148055,150987,2932
"30201","Ocbimv22005190m.g","KQ425538",179058,179297,239
"30202","Ocbimv22015162m.g","KQ429177",70954,71331,377
"30203","Ocbimv22021803m.g","KQ432325",6979,22069,15090
"30204","Ocbimv22010780m.g","KQ427521",1496,28940,27444
"30205","Ocbimv22023326m.g","KQ419394",13247,23746,10499
"30206","Ocbimv22010034m.g","KQ417632",31034,31183,149
"30207","Ocbimv22023865m.g","KQ419490",16813,17745,932
"30208","Ocbimv22008669m.g","KQ417519",755219,755596,377
"30209","Ocbimv22009234m.g","KQ426937",83,634,551
"30210","Ocbimv22038798m.g","KQ423465",128289,143647,15358
"30211","Ocbimv22021973m.g","KQ432483",4703,5560,857
"30212","Ocbimv22023828m.g","KQ416099",28252,30348,2096
"30213","Ocbimv22016483m.g","KQ429892",27026,27229,203
"30214","Ocbimv22010771m.g","KQ427511",112724,114175,1451
"30215","Ocbimv22025628m.g","KQ419863",46678,69599,22921
"30216","Ocbimv22019309m.g","KQ418747",538319,538726,407
"30217","Ocbimv22024283m.g","KQ416121",415453,415701,248
"30218","Ocbimv22001550m.g","KQ424353",696934,697296,362
"30219","Ocbimv22015360m.g","KQ429294",13735,14686,951
"30220","Ocbimv22005846m.g","KQ417280",170166,176768,6602
"30221","Ocbimv22034843m.g","KQ422191",83503,90986,7483
"30222","Ocbimv22002991m.g","KQ424859",114859,117285,2426
"30223","Ocbimv22031564m.g","KQ421279",32007,44321,12314
"30224","Ocbimv22011925m.g","KQ427949",398253,442778,44525
"30225","Ocbimv22018600m.g","KQ418644",705431,756241,50810
"30226","Ocbimv22007613m.g","KQ417438",101086,112609,11523
"30227","Ocbimv22028831m.g","KQ420591",92,43993,43901
"30228","Ocbimv22039670m.g","KQ416813",175096,177480,2384
"30229","Ocbimv22027859m.g","KQ420381",16318,17097,779
"30230","Ocbimv22017742m.g","KQ418537",142857,143579,722
"30231","Ocbimv22002030m.g","LGKD01508226",1,281,280
"30232","Ocbimv22035807m.g","KQ422556",436037,465334,29297
"30233","Ocbimv22012014m.g","LGKD01591683",181,605,424
"30234","Ocbimv22007768m.g","KQ426453",50904,51641,737
"30235","Ocbimv22006025m.g","KQ425781",23480,41538,18058
"30236","Ocbimv22019168m.g","KQ418726",317919,357751,39832
"30237","Ocbimv22012484m.g","KQ417917",73951,77127,3176
"30238","Ocbimv22036578m.g","KQ422794",157045,163931,6886
"30239","Ocbimv22008290m.g","KQ426610",302989,306876,3887
"30240","Ocbimv22016178m.g","KQ418323",154932,156291,1359
"30241","Ocbimv22028172m.g","KQ420439",615635,632515,16880
"30242","Ocbimv22003624m.g","KQ417095",85185,117115,31930
"30243","Ocbimv22031961m.g","KQ421389",548894,585479,36585
"30244","Ocbimv22026589m.g","KQ415699",57034,57591,557
"30245","Ocbimv22002513m.g","KQ417012",73016,150454,77438
"30246","Ocbimv22034333m.g","KQ422016",202444,204327,1883
"30247","Ocbimv22033575m.g","KQ421836",505451,506309,858
"30248","Ocbimv22029761m.g","KQ420820",254980,271968,16988
"30249","Ocbimv22038234m.g","KQ423235",171050,171844,794
"30250","Ocbimv22007332m.g","KQ417405",48656,50199,1543
"30251","Ocbimv22018775m.g","KQ418671",101604,107570,5966
"30252","Ocbimv22036598m.g","KQ422799",19105,33259,14154
"30253","Ocbimv22011318m.g","KQ417780",434663,435019,356
"30254","Ocbimv22003031m.g","KQ417055",1313216,1315747,2531
"30255","Ocbimv22015772m.g","KQ429551",18339,19580,1241
"30256","Ocbimv22007504m.g","KQ417417",172570,187784,15214
"30257","Ocbimv22029862m.g","KQ420828",1852245,1853162,917
"30258","Ocbimv22027627m.g","KQ420320",44157,44878,721
"30259","Ocbimv22018902m.g","KQ430924",116451,146670,30219
"30260","Ocbimv22039303m.g","KQ423610",8263,9646,1383
"30261","Ocbimv22009780m.g","KQ417613",1175374,1175550,176
"30262","Ocbimv22012706m.g","KQ428204",17533,21250,3717
"30263","Ocbimv22015659m.g","KQ418273",200587,205425,4838
"30264","Ocbimv22035479m.g","KQ422401",57583,107236,49653
"30265","Ocbimv22013363m.g","KQ428462",177147,178208,1061
"30266","Ocbimv22002637m.g","KQ417023",1172679,1221677,48998
"30267","Ocbimv22004126m.g","KQ425212",24157,69835,45678
"30268","Ocbimv22031563m.g","KQ421278",56,253,197
"30269","Ocbimv22005635m.g","KQ425692",213017,226986,13969
"30270","Ocbimv22029701m.g","KQ420810",20582,84679,64097
"30271","Ocbimv22026880m.g","KQ420132",1035772,1043669,7897
"30272","Ocbimv22017058m.g","KQ430145",16659,16931,272
"30273","Ocbimv22036026m.g","KQ422633",247720,247887,167
"30274","Ocbimv22031622m.g","KQ415725",181834,183841,2007
"30275","Ocbimv22025110m.g","KQ419694",146380,184753,38373
"30276","Ocbimv22008077m.g","KQ426561",70559,76706,6147
"30277","Ocbimv22016476m.g","KQ415966",397913,398131,218
"30278","Ocbimv22038480m.g","KQ416745",444023,444175,152
"30279","Ocbimv22011526m.g","KQ427769",46310,47732,1422
"30280","Ocbimv22037562m.g","KQ416701",207074,228080,21006
"30281","Ocbimv22029490m.g","KQ420761",330287,335692,5405
"30282","Ocbimv22016155m.g","LGKD01624782",1,1155,1154
"30283","Ocbimv22028649m.g","KQ420545",66147,74874,8727
"30284","Ocbimv22009801m.g","KQ417617",247103,247333,230
"30285","Ocbimv22011190m.g","KQ415884",118847,119140,293
"30286","Ocbimv22033647m.g","KQ421856",108983,114820,5837
"30287","Ocbimv22007393m.g","KQ426321",89762,90250,488
"30288","Ocbimv22001486m.g","KQ424321",16086,16511,425
"30289","Ocbimv22015535m.g","KQ429401",51754,106208,54454
"30290","Ocbimv22028323m.g","KQ420475",155511,159696,4185
"30291","Ocbimv22017194m.g","KQ430193",69197,91334,22137
"30292","Ocbimv22011682m.g","KQ427848",130893,133159,2266
"30293","Ocbimv22003687m.g","KQ425066",98687,144111,45424
"30294","Ocbimv22012024m.g","KQ427973",211470,213561,2091
"30295","Ocbimv22030155m.g","KQ420911",36271,64968,28697
"30296","Ocbimv22032587m.g","KQ421602",166663,173493,6830
"30297","Ocbimv22009240m.g","KQ417578",144363,202221,57858
"30298","Ocbimv22017021m.g","KQ430123",162639,213349,50710
"30299","Ocbimv22012944m.g","KQ428307",102470,103880,1410
"30300","Ocbimv22028724m.g","KQ416270",631781,633698,1917
"30301","Ocbimv22033001m.g","LGKD01412339",162,455,293
"30302","Ocbimv22018631m.g","LGKD01644554",9,1796,1787
"30303","Ocbimv22027341m.g","KQ420261",1201111,1211500,10389
"30304","Ocbimv22011542m.g","KQ427775",130774,156098,25324
"30305","Ocbimv22032932m.g","KQ421685",198635,198826,191
"30306","Ocbimv22006394m.g","KQ417318",288613,292731,4118
"30307","Ocbimv22002195m.g","KQ416995",104969,110809,5840
"30308","Ocbimv22017876m.g","KQ418552",676607,739882,63275
"30309","Ocbimv22016403m.g","KQ418345",63135,124530,61395
"30310","Ocbimv22010522m.g","KQ417687",274162,276005,1843
"30311","Ocbimv22033868m.g","KQ421896",347876,354253,6377
"30312","Ocbimv22006383m.g","KQ417316",359998,360315,317
"30313","Ocbimv22007135m.g","KQ417381",189771,190195,424
"30314","Ocbimv22033920m.g","KQ421906",562792,599313,36521
"30315","Ocbimv22016085m.g","KQ429703",17295,17658,363
"30316","Ocbimv22007436m.g","KQ426344",67408,68139,731
"30317","Ocbimv22036452m.g","KQ422768",134352,135588,1236
"30318","Ocbimv22028635m.g","KQ415707",8512,9779,1267
"30319","Ocbimv22037672m.g","KQ416705",2967958,2968185,227
"30320","Ocbimv22001271m.g","KQ424245",57859,63857,5998
"30321","Ocbimv22019564m.g","KQ418784",4115,4438,323
"30322","Ocbimv22036690m.g","KQ422839",63853,81908,18055
"30323","Ocbimv22019414m.g","KQ431117",2992,3315,323
"30324","Ocbimv22037662m.g","KQ416705",1443775,1444017,242
"30325","Ocbimv22010512m.g","KQ427407",17755,18243,488
"30326","Ocbimv22039318m.g","KQ416788",88316,99146,10830
"30327","Ocbimv22038375m.g","KQ416738",158497,167328,8831
"30328","Ocbimv22026248m.g","KQ416187",172562,174346,1784
"30329","Ocbimv22000690m.g","KQ424055",659962,660394,432
"30330","Ocbimv22021230m.g","LGKD01666490",104,283,179
"30331","Ocbimv22018924m.g","KQ430924",405401,437864,32463
"30332","Ocbimv22036699m.g","KQ416653",283996,322733,38737
"30333","Ocbimv22004494m.g","KQ417173",225608,227443,1835
"30334","Ocbimv22012332m.g","KQ415907",550319,555979,5660
"30335","Ocbimv22025082m.g","KQ416137",417138,418024,886
"30336","Ocbimv22007216m.g","KQ426253",14735,19308,4573
"30337","Ocbimv22033681m.g","KQ416490",51023,51280,257
"30338","Ocbimv22037462m.g","KQ415759",26519,26944,425
"30339","Ocbimv22012912m.g","KQ417953",81211,81462,251
"30340","Ocbimv22013093m.g","KQ417981",223110,223776,666
"30341","Ocbimv22015847m.g","KQ429586",142730,143266,536
"30342","Ocbimv22035752m.g","KQ422523",39212,47868,8656
"30343","Ocbimv22037679m.g","KQ423100",16665,17308,643
"30344","Ocbimv22010046m.g","KQ427227",114612,115455,843
"30345","Ocbimv22022947m.g","KQ419328",100902,101249,347
"30346","Ocbimv22021080m.g","KQ418998",2108417,2110595,2178
"30347","Ocbimv22034550m.g","KQ416536",934207,937136,2929
"30348","Ocbimv22033495m.g","KQ421821",334365,350579,16214
"30349","Ocbimv22028183m.g","KQ420442",19,6990,6971
"30350","Ocbimv22021378m.g","KQ432103",68616,70580,1964
"30351","Ocbimv22006094m.g","KQ417294",667341,669320,1979
"30352","Ocbimv22034066m.g","KQ416508",869951,872568,2617
"30353","Ocbimv22006825m.g","KQ417358",25142,38054,12912
"30354","Ocbimv22036720m.g","KQ416655",61468,80688,19220
"30355","Ocbimv22009521m.g","KQ415865",761734,763048,1314
"30356","Ocbimv22030105m.g","KQ420892",87942,105393,17451
"30357","Ocbimv22038016m.g","KQ416719",481050,481662,612
"30358","Ocbimv22030493m.g","KQ421003",365,955,590
"30359","Ocbimv22015883m.g","KQ429605",43303,49929,6626
"30360","Ocbimv22038614m.g","KQ423415",83558,85792,2234
"30361","Ocbimv22039047m.g","KQ423520",111988,113630,1642
"30362","Ocbimv22001602m.g","KQ424367",210552,215606,5054
"30363","Ocbimv22039726m.g","KQ423737",4461,5314,853
"30364","Ocbimv22034916m.g","KQ415742",309133,309627,494
"30365","Ocbimv22024621m.g","LGKD01699968",119,2088,1969
"30366","Ocbimv22002066m.g","KQ424530",828541,830485,1944
"30367","Ocbimv22037175m.g","KQ422952",10185,10599,414
"30368","Ocbimv22007967m.g","KQ417466",899696,924242,24546
"30369","Ocbimv22029909m.g","KQ416322",84867,85085,218
"30370","Ocbimv22004934m.g","KQ417214",38941,41547,2606
"30371","Ocbimv22039518m.g","KQ416801",15050,35922,20872
"30372","Ocbimv22035511m.g","KQ422415",175764,176297,533
"30373","Ocbimv22008118m.g","KQ426568",56302,67620,11318
"30374","Ocbimv22007128m.g","KQ417381",83198,86847,3649
"30375","Ocbimv22013458m.g","KQ418025",1253,1938,685
"30376","Ocbimv22005740m.g","KQ425732",202559,212639,10080
"30377","Ocbimv22034026m.g","KQ421948",17489,34821,17332
"30378","Ocbimv22024677m.g","KQ419614",168578,169980,1402
"30379","Ocbimv22003282m.g","KQ424936",40213,52109,11896
"30380","Ocbimv22030974m.g","KQ416379",726170,729538,3368
"30381","Ocbimv22015733m.g","KQ429530",13490,96816,83326
"30382","Ocbimv22004618m.g","LGKD01146092",375,524,149
"30383","Ocbimv22027904m.g","KQ416239",514515,546412,31897
"30384","Ocbimv22000470m.g","KQ416862",40706,41228,522
"30385","Ocbimv22009904m.g","KQ417622",552720,553799,1079
"30386","Ocbimv22011987m.g","KQ417851",236160,237360,1200
"30387","Ocbimv22005580m.g","KQ425655",321673,364687,43014
"30388","Ocbimv22012763m.g","KQ417937",78614,79204,590
"30389","Ocbimv22009989m.g","KQ427199",61190,61513,323
"30390","Ocbimv22012562m.g","KQ417917",1243547,1267067,23520
"30391","Ocbimv22013727m.g","KQ428622",821,47476,46655
"30392","Ocbimv22037049m.g","KQ422909",1095570,1095980,410
"30393","Ocbimv22019446m.g","KQ418767",458900,459171,271
"30394","Ocbimv22010118m.g","KQ427264",349,1012,663
"30395","Ocbimv22019972m.g","KQ418839",580483,586236,5753
"30396","Ocbimv22023199m.g","KQ419368",746102,782289,36187
"30397","Ocbimv22018581m.g","KQ418642",129562,159731,30169
"30398","Ocbimv22025295m.g","KQ419763",132523,144686,12163
"30399","Ocbimv22003476m.g","KQ425015",680111,719833,39722
"30400","Ocbimv22029266m.g","KQ420696",92950,112737,19787
"30401","Ocbimv22021307m.g","KQ419027",118133,118762,629
"30402","Ocbimv22014973m.g","KQ418188",507394,585567,78173
"30403","Ocbimv22011581m.g","KQ417806",399855,422356,22501
"30404","Ocbimv22022588m.g","KQ416072",1358815,1361135,2320
"30405","Ocbimv22007452m.g","KQ415842",752155,752448,293
"30406","Ocbimv22000832m.g","KQ415780",136036,136329,293
"30407","Ocbimv22038862m.g","KQ416769",176238,177519,1281
"30408","Ocbimv22029157m.g","KQ420671",19021,19293,272
"30409","Ocbimv22003254m.g","LGKD01519656",255,588,333
"30410","Ocbimv22031165m.g","KQ421185",244417,244701,284
"30411","Ocbimv22001907m.g","KQ424469",93447,94119,672
"30412","Ocbimv22019922m.g","KQ431376",314808,316650,1842
"30413","Ocbimv22014294m.g","KQ418115",259923,260177,254
"30414","Ocbimv22010421m.g","KQ427379",72982,73318,336
"30415","Ocbimv22036879m.g","LGKD01455379",3736,4296,560
"30416","Ocbimv22022047m.g","KQ419152",149314,157512,8198
"30417","Ocbimv22011074m.g","KQ427619",74731,77344,2613
"30418","Ocbimv22014815m.g","KQ429096",358736,372121,13385
"30419","Ocbimv22014169m.g","KQ418097",235270,238467,3197
"30420","Ocbimv22004668m.g","KQ425412",212853,213200,347
"30421","Ocbimv22005137m.g","KQ415813",1332653,1333801,1148
"30422","Ocbimv22020466m.g","KQ431711",9466,56455,46989
"30423","Ocbimv22020232m.g","KQ431549",10107,12215,2108
"30424","Ocbimv22001443m.g","KQ416933",315672,327606,11934
"30425","Ocbimv22016482m.g","KQ429891",95216,117162,21946
"30426","Ocbimv22013198m.g","KQ415914",120550,120774,224
"30427","Ocbimv22007704m.g","KQ426423",130007,146878,16871
"30428","Ocbimv22032117m.g","KQ421453",29940,31547,1607
"30429","Ocbimv22020750m.g","KQ431824",100680,105823,5143
"30430","Ocbimv22004483m.g","KQ425336",3522,13896,10374
"30431","Ocbimv22007520m.g","KQ417420",238871,240093,1222
"30432","Ocbimv22030538m.g","KQ421018",43604,57799,14195
"30433","Ocbimv22014572m.g","KQ428993",20638,20868,230
"30434","Ocbimv22027933m.g","KQ420404",729494,730467,973
"30435","Ocbimv22013930m.g","KQ418072",34713,44929,10216
"30436","Ocbimv22004284m.g","KQ425258",86814,88052,1238
"30437","Ocbimv22028141m.g","KQ416251",1424154,1424651,497
"30438","Ocbimv22007649m.g","KQ426409",1011,14059,13048
"30439","Ocbimv22017738m.g","KQ418535",301368,308829,7461
"30440","Ocbimv22003055m.g","KQ424867",115930,116537,607
"30441","Ocbimv22038658m.g","KQ423432",54708,75371,20663
"30442","Ocbimv22005455m.g","KQ417253",43266,49101,5835
"30443","Ocbimv22000547m.g","KQ423995",190106,190560,454
"30444","Ocbimv22029312m.g","KQ420707",85471,117499,32028
"30445","Ocbimv22019472m.g","KQ416011",226356,292367,66011
"30446","Ocbimv22015979m.g","KQ415949",1085854,1087200,1346
"30447","Ocbimv22025891m.g","KQ416175",609813,611989,2176
"30448","Ocbimv22020972m.g","KQ431898",2249,45698,43449
"30449","Ocbimv22034735m.g","KQ422138",343365,350241,6876
"30450","Ocbimv22022391m.g","KQ419215",82197,98300,16103
"30451","Ocbimv22004222m.g","KQ425237",6788,11167,4379
"30452","Ocbimv22015971m.g","KQ415949",95460,98164,2704
"30453","Ocbimv22011222m.g","KQ417763",330710,390967,60257
"30454","Ocbimv22032116m.g","KQ421451",306931,327366,20435
"30455","Ocbimv22027480m.g","KQ416225",266626,267129,503
"30456","Ocbimv22008079m.g","KQ426561",85653,85949,296
"30457","Ocbimv22023172m.g","KQ419366",405026,412022,6996
"30458","Ocbimv22020046m.g","KQ431412",79409,79591,182
"30459","Ocbimv22031920m.g","KQ416413",1155,60055,58900
"30460","Ocbimv22023555m.g","KQ419432",95588,97782,2194
"30461","Ocbimv22008810m.g","KQ426774",201883,203430,1547
"30462","Ocbimv22021197m.g","KQ416040",506121,506530,409
"30463","Ocbimv22002287m.g","KQ417001",143821,214369,70548
"30464","Ocbimv22000052m.g","KQ423834",163973,188187,24214
"30465","Ocbimv22009408m.g","KQ417591",808176,816336,8160
"30466","Ocbimv22013459m.g","KQ418025",23123,59443,36320
"30467","Ocbimv22015477m.g","KQ418259",110066,110659,593
"30468","Ocbimv22001676m.g","KQ416953",194493,194915,422
"30469","Ocbimv22009021m.g","KQ426844",12664,13647,983
"30470","Ocbimv22025314m.g","KQ419767",75394,77634,2240
"30471","Ocbimv22001119m.g","KQ424186",73272,73547,275
"30472","Ocbimv22039857m.g","KQ423780",734438,895880,161442
"30473","Ocbimv22024452m.g","KQ416123",69676,81192,11516
"30474","Ocbimv22010465m.g","KQ427401",44640,46694,2054
"30475","Ocbimv22001197m.g","KQ424224",219615,219794,179
"30476","Ocbimv22014944m.g","KQ429139",443291,457206,13915
"30477","Ocbimv22037689m.g","KQ423101",57564,58571,1007
"30478","Ocbimv22010071m.g","LGKD01576491",2,202,200
"30479","Ocbimv22002155m.g","KQ416990",203924,231612,27688
"30480","Ocbimv22030546m.g","KQ421018",233258,233980,722
"30481","Ocbimv22020611m.g","KQ418938",600806,602650,1844
"30482","Ocbimv22032434m.g","KQ421540",249,13827,13578
"30483","Ocbimv22033499m.g","KQ421821",388928,396824,7896
"30484","Ocbimv22038840m.g","KQ416768",341166,356583,15417
"30485","Ocbimv22017134m.g","KQ418453",107288,116801,9513
"30486","Ocbimv22000129m.g","KQ416841",1140574,1140870,296
"30487","Ocbimv22001339m.g","KQ416921",12572,51457,38885
"30488","Ocbimv22037436m.g","KQ423023",91647,91913,266
"30489","Ocbimv22022073m.g","KQ419158",46803,47104,301
"30490","Ocbimv22038258m.g","KQ423251",38497,39022,525
"30491","Ocbimv22005845m.g","KQ417280",156339,160290,3951
"30492","Ocbimv22036091m.g","KQ416616",2183072,2185564,2492
"30493","Ocbimv22010943m.g","KQ417725",506671,508831,2160
"30494","Ocbimv22035139m.g","KQ422289",11994,12263,269
"30495","Ocbimv22019412m.g","LGKD01258973",8,172,164
"30496","Ocbimv22009790m.g","KQ427132",429655,434987,5332
"30497","Ocbimv22020910m.g","KQ418974",655882,656220,338
"30498","Ocbimv22004832m.g","KQ417209",130657,133046,2389
"30499","Ocbimv22010213m.g","KQ427311",17822,62795,44973
"30500","Ocbimv22027665m.g","KQ420334",133061,164052,30991
"30501","Ocbimv22016064m.g","KQ415952",284225,294489,10264
"30502","Ocbimv22009603m.g","KQ427052",30924,34420,3496
"30503","Ocbimv22006097m.g","KQ417295",294518,296085,1567
"30504","Ocbimv22002238m.g","KQ416999",74988,86171,11183
"30505","Ocbimv22039758m.g","KQ423738",95510,100379,4869
"30506","Ocbimv22017543m.g","KQ430345",130302,139261,8959
"30507","Ocbimv22009625m.g","KQ427057",263493,263678,185
"30508","Ocbimv22035337m.g","KQ416581",275911,296286,20375
"30509","Ocbimv22011954m.g","KQ417847",1276465,1276647,182
"30510","Ocbimv22029153m.g","KQ420669",32658,74062,41404
"30511","Ocbimv22030825m.g","KQ421100",12082,20455,8373
"30512","Ocbimv22025052m.g","KQ416136",903507,1002110,98603
"30513","Ocbimv22016221m.g","KQ418328",587264,616945,29681
"30514","Ocbimv22010745m.g","KQ427491",54248,54541,293
"30515","Ocbimv22037301m.g","KQ422997",442322,444237,1915
"30516","Ocbimv22031372m.g","KQ416393",336328,336492,164
"30517","Ocbimv22031753m.g","KQ421338",139184,167564,28380
"30518","Ocbimv22008730m.g","KQ417528",183015,186780,3765
"30519","Ocbimv22013397m.g","KQ428481",1927,18061,16134
"30520","Ocbimv22006150m.g","KQ417300",861925,862545,620
"30521","Ocbimv22007096m.g","KQ417377",1097528,1098047,519
"30522","Ocbimv22006519m.g","KQ425980",38237,39370,1133
"30523","Ocbimv22016888m.g","KQ418419",636,1527,891
"30524","Ocbimv22021708m.g","KQ419088",137611,139066,1455
"30525","Ocbimv22009571m.g","KQ427028",397127,402764,5637
"30526","Ocbimv22035830m.g","KQ422567",40095,40771,676
"30527","Ocbimv22026655m.g","KQ420085",661030,661978,948
"30528","Ocbimv22021876m.g","KQ432369",10361,25608,15247
"30529","Ocbimv22009053m.g","KQ415859",791871,792710,839
"30530","Ocbimv22027368m.g","KQ420267",218573,265854,47281
"30531","Ocbimv22034952m.g","KQ422223",622894,652741,29847
"30532","Ocbimv22006562m.g","KQ417336",143478,195797,52319
"30533","Ocbimv22032401m.g","KQ421531",136416,155461,19045
"30534","Ocbimv22036537m.g","KQ422787",125374,125544,170
"30535","Ocbimv22014015m.g","KQ418077",5118,5552,434
"30536","Ocbimv22017218m.g","KQ418469",4144,29344,25200
"30537","Ocbimv22039126m.g","KQ416779",913451,914836,1385
"30538","Ocbimv22039949m.g","KQ423808",191571,203077,11506
"30539","Ocbimv22016542m.g","KQ418367",176528,198241,21713
"30540","Ocbimv22006420m.g","KQ425914",15501,15701,200
"30541","Ocbimv22018520m.g","KQ415994",573041,574638,1597
"30542","Ocbimv22006662m.g","KQ417342",6825,9300,2475
"30543","Ocbimv22006271m.g","KQ417309",14755,23352,8597
"30544","Ocbimv22024578m.g","KQ419601",373313,373828,515
"30545","Ocbimv22032589m.g","KQ421602",294257,294598,341
"30546","Ocbimv22003156m.g","KQ417062",11693,25887,14194
"30547","Ocbimv22026796m.g","KQ420117",1320488,1322648,2160
"30548","Ocbimv22018200m.g","KQ415990",1296773,1344026,47253
"30549","Ocbimv22007579m.g","KQ417431",133003,136803,3800
"30550","Ocbimv22030322m.g","KQ420950",66586,71546,4960
"30551","Ocbimv22011147m.g","KQ427654",93175,103286,10111
"30552","Ocbimv22037627m.g","KQ415761",535243,535890,647
"30553","Ocbimv22018157m.g","KQ418580",207420,207629,209
"30554","Ocbimv22005365m.g","KQ425596",369141,369437,296
"30555","Ocbimv22017425m.g","KQ418495",280067,296760,16693
"30556","Ocbimv22030560m.g","KQ421022",165599,182900,17301
"30557","Ocbimv22037716m.g","KQ423112",1,2036,2035
"30558","Ocbimv22020484m.g","KQ418919",387169,406931,19762
"30559","Ocbimv22024567m.g","KQ419597",28220,28396,176
"30560","Ocbimv22036847m.g","KQ422876",34117,36398,2281
"30561","Ocbimv22034229m.g","KQ416526",139570,206070,66500
"30562","Ocbimv22037948m.g","KQ423179",14050,14859,809
"30563","Ocbimv22034328m.g","KQ422016",95582,96487,905
"30564","Ocbimv22002719m.g","KQ424760",79618,115467,35849
"30565","Ocbimv22015436m.g","KQ418245",194508,198467,3959
"30566","Ocbimv22011773m.g","KQ415891",379010,397276,18266
"30567","Ocbimv22004049m.g","KQ425190",129026,132480,3454
"30568","Ocbimv22010043m.g","KQ417634",362042,382018,19976
"30569","Ocbimv22009479m.g","KQ417596",1395109,1399079,3970
"30570","Ocbimv22032219m.g","KQ421483",12867,15400,2533
"30571","Ocbimv22000118m.g","KQ416841",365731,366659,928
"30572","Ocbimv22017665m.g","KQ418525",261581,262335,754
"30573","Ocbimv22007917m.g","KQ417459",424786,506737,81951
"30574","Ocbimv22022472m.g","KQ416069",690969,691268,299
"30575","Ocbimv22016610m.g","KQ418370",178909,184666,5757
"30576","Ocbimv22002755m.g","KQ424774",20309,20533,224
"30577","Ocbimv22025409m.g","KQ419790",108372,108782,410
"30578","Ocbimv22038766m.g","KQ416765",326162,328619,2457
"30579","Ocbimv22038980m.g","KQ423499",7264,52224,44960
"30580","Ocbimv22023466m.g","KQ419414",434072,435716,1644
"30581","Ocbimv22034899m.g","KQ422210",50,21429,21379
"30582","Ocbimv22033663m.g","KQ421858",251002,255771,4769
"30583","Ocbimv22039614m.g","KQ423717",168583,168921,338
"30584","Ocbimv22030282m.g","KQ420938",17580,18545,965
"30585","Ocbimv22034918m.g","KQ415742",382213,382898,685
"30586","Ocbimv22008958m.g","KQ426820",36135,36908,773
"30587","Ocbimv22007211m.g","KQ417394",99268,112049,12781
"30588","Ocbimv22038597m.g","KQ423414",125815,126033,218
"30589","Ocbimv22023389m.g","KQ419399",164,821,657
"30590","Ocbimv22027248m.g","KQ420228",258358,260210,1852
"30591","Ocbimv22020491m.g","KQ418919",507305,511591,4286
"30592","Ocbimv22024384m.g","KQ433978",12140,17376,5236
"30593","Ocbimv22032910m.g","KQ421684",30059,31293,1234
"30594","Ocbimv22013330m.g","KQ418012",305934,306828,894
"30595","Ocbimv22026896m.g","KQ420138",329001,333127,4126
"30596","Ocbimv22039173m.g","KQ423560",18601,19559,958
"30597","Ocbimv22031272m.g","KQ416392",732,2900,2168
"30598","Ocbimv22038987m.g","KQ423499",158533,159811,1278
"30599","Ocbimv22020235m.g","KQ418874",25451,27404,1953
"30600","Ocbimv22018692m.g","KQ418653",339356,339796,440
"30601","Ocbimv22028270m.g","KQ415659",1912365,1916868,4503
"30602","Ocbimv22026780m.g","KQ420113",124277,146583,22306
"30603","Ocbimv22031677m.g","KQ421308",284479,325146,40667
"30604","Ocbimv22008779m.g","KQ426774",43292,46055,2763
"30605","Ocbimv22027087m.g","KQ420176",155714,169699,13985
"30606","Ocbimv22018219m.g","KQ415990",1925098,1950690,25592
"30607","Ocbimv22010066m.g","KQ417640",149171,150070,899
"30608","Ocbimv22029665m.g","KQ420799",42254,43674,1420
"30609","Ocbimv22025720m.g","KQ419887",1170650,1171189,539
"30610","Ocbimv22035201m.g","KQ422304",144,419,275
"30611","Ocbimv22014119m.g","KQ418092",89776,130324,40548
"30612","Ocbimv22000891m.g","KQ424104",10061,11634,1573
"30613","Ocbimv22027699m.g","KQ420346",111117,165581,54464
"30614","Ocbimv22026521m.g","KQ415698",15932,164088,148156
"30615","Ocbimv22023583m.g","KQ433487",1,35583,35582
"30616","Ocbimv22027092m.g","KQ420180",56569,78233,21664
"30617","Ocbimv22031097m.g","KQ421163",975457,975927,470
"30618","Ocbimv22034040m.g","KQ416508",434742,435717,975
"30619","Ocbimv22009727m.g","LGKD01573141",1,225,224
"30620","Ocbimv22004868m.g","LGKD01147920",2,480,478
"30621","Ocbimv22032894m.g","LGKD01410074",345,1130,785
"30622","Ocbimv22020063m.g","KQ418849",4605,40900,36295
"30623","Ocbimv22008835m.g","KQ417537",64366,83058,18692
"30624","Ocbimv22013858m.g","KQ415921",329799,342665,12866
"30625","Ocbimv22016094m.g","KQ429706",2,536,534
"30626","Ocbimv22023215m.g","KQ433266",6997,8085,1088
"30627","Ocbimv22004561m.g","KQ425361",225929,277845,51916
"30628","Ocbimv22019999m.g","KQ418840",1816469,1833556,17087
"30629","Ocbimv22017340m.g","KQ418483",189790,193908,4118
"30630","Ocbimv22011621m.g","KQ427818",41833,42020,187
"30631","Ocbimv22009541m.g","KQ415865",1043866,1064172,20306
"30632","Ocbimv22014808m.g","KQ429094",4603,10753,6150
"30633","Ocbimv22023525m.g","KQ419425",101001,101545,544
"30634","Ocbimv22039658m.g","KQ423719",17009,52389,35380
"30635","Ocbimv22012205m.g","LGKD01593660",3,543,540
"30636","Ocbimv22016014m.g","KQ418310",215524,216144,620
"30637","Ocbimv22017116m.g","KQ418451",213823,214476,653
"30638","Ocbimv22005729m.g","KQ425731",36410,78707,42297
"30639","Ocbimv22008099m.g","KQ426567",101719,109107,7388
"30640","Ocbimv22030755m.g","KQ421083",558636,559901,1265
"30641","Ocbimv22007968m.g","KQ417466",1545938,1595818,49880
"30642","Ocbimv22000203m.g","KQ423898",46146,50013,3867
"30643","Ocbimv22003006m.g","KQ424863",333297,335699,2402
"30644","Ocbimv22019805m.g","KQ431321",18726,33605,14879
"30645","Ocbimv22022296m.g","KQ419192",845108,845398,290
"30646","Ocbimv22027130m.g","KQ420195",68234,69196,962
"30647","Ocbimv22004228m.g","KQ417143",67748,67963,215
"30648","Ocbimv22003580m.g","KQ417092",262177,271792,9615
"30649","Ocbimv22017178m.g","KQ418460",103781,104523,742
"30650","Ocbimv22009251m.g","KQ417578",561119,561846,727
"30651","Ocbimv22009438m.g","KQ426995",63959,70707,6748
"30652","Ocbimv22015426m.g","KQ429329",273,3274,3001
"30653","Ocbimv22008972m.g","KQ417544",417597,432109,14512
"30654","Ocbimv22039111m.g","KQ416779",556181,556351,170
"30655","Ocbimv22026369m.g","KQ416188",113423,113809,386
"30656","Ocbimv22001832m.g","KQ424439",104703,105104,401
"30657","Ocbimv22002673m.g","KQ424735",5452,5688,236
"30658","Ocbimv22037966m.g","KQ416716",425109,426201,1092
"30659","Ocbimv22018554m.g","KQ418635",30266,32079,1813
"30660","Ocbimv22002773m.g","KQ417034",153528,155162,1634
"30661","Ocbimv22029087m.g","KQ420643",1162,28392,27230
"30662","Ocbimv22008680m.g","KQ426727",226363,259658,33295
"30663","Ocbimv22004817m.g","KQ417208",308315,309739,1424
"30664","Ocbimv22037696m.g","KQ423101",98950,103475,4525
"30665","Ocbimv22011234m.g","KQ417764",22835,32187,9352
"30666","Ocbimv22010218m.g","KQ427311",149581,149964,383
"30667","Ocbimv22020199m.g","KQ418873",288649,328409,39760
"30668","Ocbimv22025111m.g","KQ419695",84031,149932,65901
"30669","Ocbimv22007059m.g","KQ417373",157620,158463,843
"30670","Ocbimv22024931m.g","KQ419659",31400,87206,55806
"30671","Ocbimv22030144m.g","KQ420909",48870,49052,182
"30672","Ocbimv22035233m.g","KQ422335",5998,18335,12337
"30673","Ocbimv22019108m.g","LGKD01647928",28,328,300
"30674","Ocbimv22038782m.g","KQ423461",225581,225739,158
"30675","Ocbimv22007939m.g","KQ426499",71754,79720,7966
"30676","Ocbimv22026381m.g","KQ416188",402935,408725,5790
"30677","Ocbimv22001945m.g","KQ416975",122025,167666,45641
"30678","Ocbimv22031530m.g","KQ421265",473438,488209,14771
"30679","Ocbimv22025310m.g","KQ419766",224927,225588,661
"30680","Ocbimv22039825m.g","KQ423771",54083,54661,578
"30681","Ocbimv22034190m.g","KQ421998",34549,34734,185
"30682","Ocbimv22038770m.g","KQ416765",491619,495069,3450
"30683","Ocbimv22018251m.g","KQ418587",293233,295127,1894
"30684","Ocbimv22012991m.g","KQ417969",8422,13006,4584
"30685","Ocbimv22016405m.g","KQ429842",11513,12100,587
"30686","Ocbimv22039752m.g","KQ416821",117625,147260,29635
"30687","Ocbimv22036143m.g","KQ422653",173964,174592,628
"30688","Ocbimv22031632m.g","KQ421305",93890,138492,44602
"30689","Ocbimv22020689m.g","KQ418954",159438,160234,796
"30690","Ocbimv22015303m.g","KQ418217",64341,66613,2272
"30691","Ocbimv22021295m.g","KQ419026",171216,173009,1793
"30692","Ocbimv22023779m.g","KQ416096",1287344,1315592,28248
"30693","Ocbimv22020366m.g","KQ418900",421375,462181,40806
"30694","Ocbimv22039256m.g","KQ423598",14576,16381,1805
"30695","Ocbimv22018871m.g","KQ418693",479882,518937,39055
"30696","Ocbimv22007299m.g","KQ426286",40620,60383,19763
"30697","Ocbimv22008061m.g","KQ426556",133515,134238,723
"30698","Ocbimv22010180m.g","KQ417653",586972,587458,486
"30699","Ocbimv22031086m.g","KQ421157",3607,3969,362
"30700","Ocbimv22011429m.g","KQ427746",107529,129635,22106
"30701","Ocbimv22032978m.g","KQ421706",82789,90381,7592
"30702","Ocbimv22027622m.g","KQ420314",89966,107424,17458
"30703","Ocbimv22023486m.g","KQ416088",307675,309123,1448
"30704","Ocbimv22039371m.g","KQ423634",65030,92190,27160
"30705","Ocbimv22038282m.g","KQ423259",644532,685486,40954
"30706","Ocbimv22029162m.g","KQ420672",195557,227027,31470
"30707","Ocbimv22003183m.g","KQ424903",49949,58108,8159
"30708","Ocbimv22005040m.g","KQ417226",45202,104621,59419
"30709","Ocbimv22024489m.g","KQ419588",314871,350688,35817
"30710","Ocbimv22025019m.g","KQ416136",171581,172077,496
"30711","Ocbimv22018763m.g","KQ418671",9136,12375,3239
"30712","Ocbimv22009857m.g","KQ417620",1276781,1306705,29924
"30713","Ocbimv22031367m.g","KQ421224",118469,124236,5767
"30714","Ocbimv22024982m.g","KQ419670",479962,491654,11692
"30715","Ocbimv22011875m.g","KQ417844",734085,734261,176
"30716","Ocbimv22034637m.g","KQ416542",41393,43423,2030
"30717","Ocbimv22039245m.g","KQ423592",12948,13311,363
"30718","Ocbimv22020735m.g","KQ418957",533421,571340,37919
"30719","Ocbimv22010203m.g","KQ417655",455695,456036,341
"30720","Ocbimv22004390m.g","KQ425290",14078,15516,1438
"30721","Ocbimv22002774m.g","KQ417034",156401,181451,25050
"30722","Ocbimv22030526m.g","KQ421010",230405,230968,563
"30723","Ocbimv22018395m.g","KQ430684",66346,67290,944
"30724","Ocbimv22009138m.g","KQ415861",180589,224875,44286
"30725","Ocbimv22014445m.g","KQ428931",5528,6376,848
"30726","Ocbimv22019672m.g","KQ418794",31128,31481,353
"30727","Ocbimv22022157m.g","KQ419177",1958,18800,16842
"30728","Ocbimv22028778m.g","KQ420580",40505,42604,2099
"30729","Ocbimv22026987m.g","KQ420159",7963,8394,431
"30730","Ocbimv22017862m.g","KQ418552",395560,399405,3845
"30731","Ocbimv22015267m.g","KQ418216",700683,761443,60760
"30732","Ocbimv22000895m.g","KQ424106",143842,144400,558
"30733","Ocbimv22008472m.g","KQ415854",578807,676831,98024
"30734","Ocbimv22012370m.g","KQ428137",35784,36417,633
"30735","Ocbimv22025439m.g","KQ419801",118511,119859,1348
"30736","Ocbimv22025331m.g","KQ419775",198834,210868,12034
"30737","Ocbimv22016618m.g","KQ418370",293946,296060,2114
"30738","Ocbimv22038495m.g","KQ423378",220,15839,15619
"30739","Ocbimv22028547m.g","KQ416260",525413,557594,32181
"30740","Ocbimv22035146m.g","KQ422290",238920,239258,338
"30741","Ocbimv22014813m.g","KQ429096",347578,348382,804
"30742","Ocbimv22015381m.g","KQ429305",2632,4602,1970
"30743","Ocbimv22000802m.g","KQ424072",252096,252560,464
"30744","Ocbimv22016364m.g","KQ415962",589175,613250,24075
"30745","Ocbimv22033753m.g","KQ421864",214355,221301,6946
"30746","Ocbimv22028169m.g","KQ420439",343603,344403,800
"30747","Ocbimv22029565m.g","KQ420776",747201,751252,4051
"30748","Ocbimv22009950m.g","KQ427173",212925,218146,5221
"30749","Ocbimv22018759m.g","KQ418668",27540,28013,473
"30750","Ocbimv22026553m.g","KQ416192",217071,260941,43870
"30751","Ocbimv22019088m.g","KQ430963",17957,29545,11588
"30752","Ocbimv22034446m.g","KQ422045",161096,213004,51908
"30753","Ocbimv22015839m.g","KQ418295",309296,316570,7274
"30754","Ocbimv22038323m.g","KQ416736",301085,301330,245
"30755","Ocbimv22034930m.g","KQ416562",4170,9065,4895
"30756","Ocbimv22000898m.g","KQ415781",16408,20503,4095
"30757","Ocbimv22028326m.g","KQ420475",301864,322025,20161
"30758","Ocbimv22015974m.g","KQ415949",293305,300206,6901
"30759","Ocbimv22015836m.g","KQ418295",273857,290004,16147
"30760","Ocbimv22036200m.g","KQ416625",575401,575838,437
"30761","Ocbimv22015282m.g","KQ415941",98445,98708,263
"30762","Ocbimv22034917m.g","KQ415742",336525,374312,37787
"30763","Ocbimv22024598m.g","KQ419601",1124338,1202421,78083
"30764","Ocbimv22012950m.g","KQ417960",289848,290618,770
"30765","Ocbimv22005521m.g","KQ425644",29552,31265,1713
"30766","Ocbimv22024915m.g","KQ419657",35198,35431,233
"30767","Ocbimv22023517m.g","KQ433432",7881,8930,1049
"30768","Ocbimv22010907m.g","KQ427566",123548,132752,9204
"30769","Ocbimv22036125m.g","KQ422647",174735,175094,359
"30770","Ocbimv22037434m.g","KQ423023",7495,59768,52273
"30771","Ocbimv22026434m.g","KQ420051",19,255,236
"30772","Ocbimv22029045m.g","KQ416282",18374,21451,3077
"30773","Ocbimv22030103m.g","KQ420892",54644,60161,5517
"30774","Ocbimv22026026m.g","KQ419958",47359,53725,6366
"30775","Ocbimv22032395m.g","KQ421531",58808,82816,24008
"30776","Ocbimv22024148m.g","KQ416113",1158,2474,1316
"30777","Ocbimv22000104m.g","KQ423861",13455,57398,43943
"30778","Ocbimv22024477m.g","KQ416124",191028,191965,937
"30779","Ocbimv22036660m.g","KQ422819",386441,389348,2907
"30780","Ocbimv22030967m.g","KQ416379",80876,81139,263
"30781","Ocbimv22007312m.g","KQ426287",284791,288188,3397
"30782","Ocbimv22017229m.g","KQ418469",491194,520717,29523
"30783","Ocbimv22033036m.g","KQ416466",154815,156245,1430
"30784","Ocbimv22008157m.g","KQ417481",1082995,1084063,1068
"30785","Ocbimv22011354m.g","KQ417791",89590,89931,341
"30786","Ocbimv22019014m.g","KQ418711",166628,229853,63225
"30787","Ocbimv22038175m.g","KQ423226",15980,57246,41266
"30788","Ocbimv22007445m.g","KQ417416",87084,99358,12274
"30789","Ocbimv22008156m.g","KQ417481",1078654,1079991,1337
"30790","Ocbimv22022253m.g","KQ419190",9113,9379,266
"30791","Ocbimv22017014m.g","KQ430123",23471,131957,108486
"30792","Ocbimv22016693m.g","KQ418385",486716,486987,271
"30793","Ocbimv22024093m.g","KQ419533",448122,450076,1954
"30794","Ocbimv22010665m.g","KQ427464",626234,635559,9325
"30795","Ocbimv22011057m.g","KQ417741",799532,799708,176
"30796","Ocbimv22004085m.g","KQ417133",696350,722419,26069
"30797","Ocbimv22010344m.g","KQ427359",85083,85787,704
"30798","Ocbimv22018424m.g","KQ418617",3577,4486,909
"30799","Ocbimv22031608m.g","KQ421295",13,2110,2097
"30800","Ocbimv22018282m.g","KQ418590",578802,580435,1633
"30801","Ocbimv22025260m.g","KQ419750",254586,256230,1644
"30802","Ocbimv22002114m.g","KQ424547",13449,14411,962
"30803","Ocbimv22020832m.g","KQ418970",1660584,1691519,30935
"30804","Ocbimv22034850m.g","KQ422194",101987,108530,6543
"30805","Ocbimv22021757m.g","KQ419094",363712,371948,8236
"30806","Ocbimv22014211m.g","KQ418101",65789,94713,28924
"30807","Ocbimv22034873m.g","KQ416561",14445,21965,7520
"30808","Ocbimv22038121m.g","KQ423217",153572,155945,2373
"30809","Ocbimv22029581m.g","KQ420777",309641,334278,24637
"30810","Ocbimv22022557m.g","LGKD01679787",66,464,398
"30811","Ocbimv22000903m.g","KQ415781",97449,98711,1262
"30812","Ocbimv22022033m.g","KQ419149",379336,380112,776
"30813","Ocbimv22010596m.g","KQ427456",29192,32956,3764
"30814","Ocbimv22012948m.g","KQ417960",156673,157014,341
"30815","Ocbimv22020604m.g","KQ431760",1617,2172,555
"30816","Ocbimv22009239m.g","KQ417578",8664,124414,115750
"30817","Ocbimv22038269m.g","KQ416733",344066,344305,239
"30818","Ocbimv22001465m.g","KQ424307",6221,6643,422
"30819","Ocbimv22009462m.g","KQ427011",89129,92089,2960
"30820","Ocbimv22021389m.g","KQ432116",21672,28289,6617
"30821","Ocbimv22004190m.g","KQ425220",485553,495315,9762
"30822","Ocbimv22007463m.g","LGKD01556019",65,211,146
"30823","Ocbimv22006922m.g","KQ426144",1146,14644,13498
"30824","Ocbimv22025856m.g","KQ419916",28985,30102,1117
"30825","Ocbimv22025521m.g","KQ419831",273045,273511,466
"30826","Ocbimv22036974m.g","KQ416666",2474545,2513845,39300
"30827","Ocbimv22019549m.g","KQ418783",475834,486609,10775
"30828","Ocbimv22035268m.g","KQ422349",10238,13922,3684
"30829","Ocbimv22004723m.g","KQ425427",158676,160360,1684
"30830","Ocbimv22014895m.g","KQ429131",451058,451345,287
"30831","Ocbimv22035008m.g","KQ422245",150434,181985,31551
"30832","Ocbimv22039592m.g","LGKD01484180",13,258,245
"30833","Ocbimv22001897m.g","KQ424463",15654,16215,561
"30834","Ocbimv22019719m.g","LGKD01653149",1,483,482
"30835","Ocbimv22016957m.g","KQ418429",247041,274637,27596
"30836","Ocbimv22036383m.g","KQ422736",318353,318556,203
"30837","Ocbimv22038625m.g","KQ423422",629976,633122,3146
"30838","Ocbimv22006300m.g","KQ425863",99939,100244,305
"30839","Ocbimv22020792m.g","KQ418966",27,4389,4362
"30840","Ocbimv22007469m.g","KQ426356",1248,13906,12658
"30841","Ocbimv22030756m.g","KQ421084",54,443,389
"30842","Ocbimv22001846m.g","LGKD01505972",52,249,197
"30843","Ocbimv22033903m.g","KQ421906",112950,138494,25544
"30844","Ocbimv22020615m.g","KQ418940",287907,288068,161
"30845","Ocbimv22039564m.g","KQ416803",170953,201368,30415
"30846","Ocbimv22037139m.g","KQ422938",116785,117228,443
"30847","Ocbimv22006061m.g","KQ417293",252239,256694,4455
"30848","Ocbimv22019575m.g","KQ431207",12927,14384,1457
"30849","Ocbimv22020485m.g","KQ418919",417217,446038,28821
"30850","Ocbimv22001100m.g","KQ424181",8657,22339,13682
"30851","Ocbimv22032799m.g","KQ421658",644847,658336,13489
"30852","Ocbimv22010988m.g","KQ417731",227541,239500,11959
"30853","Ocbimv22029166m.g","KQ420672",342785,373340,30555
"30854","Ocbimv22038686m.g","KQ423444",18629,23485,4856
"30855","Ocbimv22028364m.g","KQ420477",435831,440420,4589
"30856","Ocbimv22013069m.g","KQ428362",10110,27314,17204
"30857","Ocbimv22007536m.g","KQ426370",18062,18337,275
"30858","Ocbimv22003361m.g","KQ417084",711707,711919,212
"30859","Ocbimv22005279m.g","KQ417238",564152,564565,413
"30860","Ocbimv22032842m.g","KQ421665",30264,36065,5801
"30861","Ocbimv22020108m.g","KQ418855",267737,268765,1028
"30862","Ocbimv22032784m.g","KQ421658",340953,341716,763
"30863","Ocbimv22032516m.g","KQ421572",161509,227021,65512
"30864","Ocbimv22022529m.g","KQ419241",367217,397108,29891
"30865","Ocbimv22039715m.g","KQ416816",67685,68992,1307
"30866","Ocbimv22025198m.g","KQ419727",505347,512254,6907
"30867","Ocbimv22029531m.g","KQ420774",304800,309003,4203
"30868","Ocbimv22030335m.g","KQ420951",17662,32919,15257
"30869","Ocbimv22017823m.g","KQ418551",75375,89004,13629
"30870","Ocbimv22001821m.g","KQ416966",505363,518691,13328
"30871","Ocbimv22012489m.g","KQ417917",135531,141904,6373
"30872","Ocbimv22026595m.g","KQ416194",382320,384255,1935
"30873","Ocbimv22000471m.g","KQ416862",56185,56367,182
"30874","Ocbimv22003442m.g","KQ417087",1156808,1196054,39246
"30875","Ocbimv22039896m.g","KQ416834",166771,188210,21439
"30876","Ocbimv22022142m.g","KQ419175",634320,651488,17168
"30877","Ocbimv22034148m.g","KQ421987",124825,149357,24532
"30878","Ocbimv22029567m.g","KQ420776",776450,794557,18107
"30879","Ocbimv22023454m.g","KQ419414",341129,341449,320
"30880","Ocbimv22009550m.g","KQ415865",1593445,1602159,8714
"30881","Ocbimv22028142m.g","KQ416251",1439039,1454827,15788
"30882","Ocbimv22005253m.g","KQ417236",6321,10022,3701
"30883","Ocbimv22035822m.g","KQ416602",54441,54590,149
"30884","Ocbimv22015983m.g","KQ418304",270608,270769,161
"30885","Ocbimv22028052m.g","KQ420424",1404,2131,727
"30886","Ocbimv22008555m.g","KQ417509",161301,161553,252
"30887","Ocbimv22009062m.g","KQ417556",313042,329307,16265
"30888","Ocbimv22035982m.g","KQ422621",240202,246387,6185
"30889","Ocbimv22027438m.g","KQ420277",72680,78333,5653
"30890","Ocbimv22039045m.g","KQ415769",579314,582003,2689
"30891","Ocbimv22037117m.g","KQ416673",140833,141372,539
"30892","Ocbimv22029680m.g","KQ420800",11569,18206,6637
"30893","Ocbimv22021720m.g","KQ419091",432279,437896,5617
"30894","Ocbimv22006786m.g","KQ426105",13276,14254,978
"30895","Ocbimv22019461m.g","KQ418770",210286,219064,8778
"30896","Ocbimv22033811m.g","KQ421878",326443,327272,829
"30897","Ocbimv22027111m.g","KQ420185",272708,273853,1145
"30898","Ocbimv22033739m.g","KQ421864",55980,61183,5203
"30899","Ocbimv22026428m.g","KQ420047",428445,428997,552
"30900","Ocbimv22011661m.g","KQ427837",4589,11520,6931
"30901","Ocbimv22027867m.g","KQ416236",16288,155036,138748
"30902","Ocbimv22005439m.g","KQ417252",333983,334659,676
"30903","Ocbimv22012373m.g","KQ417906",20589,51772,31183
"30904","Ocbimv22012602m.g","KQ417921",10727,24311,13584
"30905","Ocbimv22029311m.g","KQ420707",56150,72312,16162
"30906","Ocbimv22005813m.g","KQ417280",4626,9025,4399
"30907","Ocbimv22037652m.g","KQ416705",683158,683418,260
"30908","Ocbimv22018456m.g","KQ415992",627615,628267,652
"30909","Ocbimv22038529m.g","LGKD01472820",5,169,164
"30910","Ocbimv22031801m.g","KQ421353",24505,26128,1623
"30911","Ocbimv22026495m.g","KQ420059",129804,208829,79025
"30912","Ocbimv22038415m.g","KQ423329",74704,83857,9153
"30913","Ocbimv22025918m.g","KQ419927",656745,657053,308
"30914","Ocbimv22013119m.g","KQ417983",48774,49022,248
"30915","Ocbimv22035575m.g","KQ422439",53141,64452,11311
"30916","Ocbimv22014981m.g","KQ418190",136046,174455,38409
"30917","Ocbimv22032536m.g","KQ421579",16331,17972,1641
"30918","Ocbimv22035471m.g","KQ422393",45436,51595,6159
"30919","Ocbimv22017845m.g","KQ418552",130980,136087,5107
"30920","Ocbimv22000610m.g","KQ424022",23214,23558,344
"30921","Ocbimv22002959m.g","KQ417051",589142,589797,655
"30922","Ocbimv22039873m.g","KQ416832",230617,239895,9278
"30923","Ocbimv22007069m.g","KQ417374",383546,384048,502
"30924","Ocbimv22019710m.g","KQ418804",690568,690904,336
"30925","Ocbimv22013283m.g","KQ418007",202346,203578,1232
"30926","Ocbimv22037641m.g","KQ423086",1439,1591,152
"30927","Ocbimv22009757m.g","KQ427112",11421,11579,158
"30928","Ocbimv22031990m.g","KQ421403",19493,142754,123261
"30929","Ocbimv22004879m.g","KQ417211",447917,486411,38494
"30930","Ocbimv22012880m.g","KQ428261",131584,134767,3183
"30931","Ocbimv22031639m.g","KQ421305",267399,270714,3315
"30932","Ocbimv22018043m.g","KQ430535",1626,44631,43005
"30933","Ocbimv22014745m.g","KQ418175",190966,193468,2502
"30934","Ocbimv22007652m.g","KQ426409",64121,72452,8331
"30935","Ocbimv22024347m.g","KQ419574",316335,342566,26231
"30936","Ocbimv22018650m.g","KQ418649",560548,604347,43799
"30937","Ocbimv22034963m.g","KQ422230",75643,77109,1466
"30938","Ocbimv22019975m.g","KQ418839",638209,672288,34079
"30939","Ocbimv22011805m.g","KQ415893",176134,195778,19644
"30940","Ocbimv22034509m.g","KQ422063",179882,201778,21896
"30941","Ocbimv22036550m.g","KQ416644",735958,749699,13741
"30942","Ocbimv22015057m.g","KQ418194",908892,910214,1322
"30943","Ocbimv22002862m.g","KQ424808",61786,62271,485
"30944","Ocbimv22004174m.g","KQ425220",258518,275003,16485
"30945","Ocbimv22023600m.g","KQ416092",93862,107549,13687
"30946","Ocbimv22033392m.g","KQ416479",707943,814715,106772
"30947","Ocbimv22025904m.g","KQ419921",53413,54665,1252
"30948","Ocbimv22027102m.g","KQ420181",1068425,1068865,440
"30949","Ocbimv22006757m.g","KQ417347",573134,573710,576
"30950","Ocbimv22018074m.g","KQ430556",9639,9839,200
"30951","Ocbimv22010741m.g","LGKD01581967",3,425,422
"30952","Ocbimv22024028m.g","KQ419523",75146,75392,246
"30953","Ocbimv22018786m.g","KQ430870",15586,15874,288
"30954","Ocbimv22036070m.g","KQ416616",921177,921345,168
"30955","Ocbimv22007793m.g","KQ426456",519263,547755,28492
"30956","Ocbimv22021406m.g","KQ416044",55477,57212,1735
"30957","Ocbimv22020237m.g","KQ431554",5529,9765,4236
"30958","Ocbimv22027579m.g","KQ420308",74832,78150,3318
"30959","Ocbimv22011814m.g","KQ415893",517910,518966,1056
"30960","Ocbimv22007772m.g","KQ426456",49599,50000,401
"30961","Ocbimv22031571m.g","KQ421281",617226,802300,185074
"30962","Ocbimv22035671m.g","KQ422500",140320,142708,2388
"30963","Ocbimv22029766m.g","KQ420820",460262,460477,215
"30964","Ocbimv22011795m.g","KQ427906",69984,71821,1837
"30965","Ocbimv22033172m.g","KQ416469",207083,208591,1508
"30966","Ocbimv22001246m.g","KQ424238",117973,118347,374
"30967","Ocbimv22039497m.g","KQ416800",79368,107237,27869
"30968","Ocbimv22000130m.g","KQ416841",1351126,1351332,206
"30969","Ocbimv22008405m.g","KQ426632",27243,28460,1217
"30970","Ocbimv22039832m.g","KQ423774",75460,77225,1765
"30971","Ocbimv22026752m.g","KQ420109",37331,38242,911
"30972","Ocbimv22035287m.g","KQ422349",198721,200073,1352
"30973","Ocbimv22001490m.g","KQ424322",98473,98643,170
"30974","Ocbimv22009712m.g","KQ427096",124591,125148,557
"30975","Ocbimv22027206m.g","KQ420218",11852,25140,13288
"30976","Ocbimv22015964m.g","KQ429629",144103,198945,54842
"30977","Ocbimv22026694m.g","KQ416197",104198,131673,27475
"30978","Ocbimv22039242m.g","KQ423591",292376,293072,696
"30979","Ocbimv22014426m.g","KQ418133",272632,273560,928
"30980","Ocbimv22020836m.g","KQ418970",2056810,2059179,2369
"30981","Ocbimv22006923m.g","KQ426144",23163,30637,7474
"30982","Ocbimv22013103m.g","KQ417982",19834,76366,56532
"30983","Ocbimv22038676m.g","KQ416760",205245,206670,1425
"30984","Ocbimv22020106m.g","KQ418855",179403,258569,79166
"30985","Ocbimv22027274m.g","KQ420241",90439,94142,3703
"30986","Ocbimv22024625m.g","LGKD01308576",1,162,161
"30987","Ocbimv22023009m.g","KQ419338",178350,179717,1367
"30988","Ocbimv22037489m.g","KQ416697",967759,967935,176
"30989","Ocbimv22019413m.g","LGKD01650512",186,335,149
"30990","Ocbimv22003660m.g","KQ425063",42354,59841,17487
"30991","Ocbimv22007086m.g","KQ417377",562392,565012,2620
"30992","Ocbimv22038194m.g","KQ423231",281007,313074,32067
"30993","Ocbimv22036599m.g","KQ422799",21277,24829,3552
"30994","Ocbimv22003438m.g","KQ417087",1103341,1111706,8365
"30995","Ocbimv22003884m.g","KQ425134",589778,590559,781
"30996","Ocbimv22022016m.g","KQ432511",50373,51005,632
"30997","Ocbimv22003388m.g","KQ425000",95226,102345,7119
"30998","Ocbimv22020803m.g","LGKD01663507",212,445,233
"30999","Ocbimv22023240m.g","KQ433284",72358,72582,224
"31000","Ocbimv22003093m.g","KQ424880",76769,76942,173
"31001","Ocbimv22035245m.g","KQ422341",233,59350,59117
"31002","Ocbimv22028744m.g","KQ420571",297549,297764,215
"31003","Ocbimv22010974m.g","KQ427574",67321,67599,278
"31004","Ocbimv22032762m.g","KQ421655",344734,345343,609
"31005","Ocbimv22010886m.g","KQ417722",388258,389219,961
"31006","Ocbimv22009287m.g","KQ417579",239397,239831,434
"31007","Ocbimv22006286m.g","KQ425853",11624,12612,988
"31008","Ocbimv22037439m.g","KQ423024",43839,44024,185
"31009","Ocbimv22001052m.g","KQ424168",84340,165757,81417
"31010","Ocbimv22008490m.g","KQ417505",168210,173169,4959
"31011","Ocbimv22014324m.g","KQ428867",10192,12085,1893
"31012","Ocbimv22011189m.g","KQ427669",157098,157334,236
"31013","Ocbimv22000539m.g","LGKD01492588",1,461,460
"31014","Ocbimv22029919m.g","KQ420845",319410,319580,170
"31015","Ocbimv22033194m.g","KQ416471",240,26451,26211
"31016","Ocbimv22009449m.g","KQ426998",18503,19980,1477
"31017","Ocbimv22001056m.g","KQ424168",270971,271877,906
"31018","Ocbimv22026011m.g","KQ419957",688,4567,3879
"31019","Ocbimv22036890m.g","KQ422891",30050,30953,903
"31020","Ocbimv22010719m.g","KQ427478",62136,133666,71530
"31021","Ocbimv22033583m.g","KQ421838",151199,166605,15406
"31022","Ocbimv22014678m.g","KQ418168",254806,259353,4547
"31023","Ocbimv22009045m.g","KQ415859",636446,661280,24834
"31024","Ocbimv22012183m.g","KQ417884",55360,55905,545
"31025","Ocbimv22012723m.g","KQ417930",2990,18796,15806
"31026","Ocbimv22037172m.g","KQ422952",5221,17812,12591
"31027","Ocbimv22019704m.g","KQ418804",49022,49450,428
"31028","Ocbimv22006706m.g","KQ426075",449688,468002,18314
"31029","Ocbimv22019073m.g","KQ418715",40636,42260,1624
"31030","Ocbimv22033656m.g","KQ421858",187679,226182,38503
"31031","Ocbimv22037099m.g","KQ422921",6970,8004,1034
"31032","Ocbimv22010082m.g","KQ417641",151042,184596,33554
"31033","Ocbimv22031908m.g","KQ421376",596888,598334,1446
"31034","Ocbimv22036819m.g","KQ416659",2445,85139,82694
"31035","Ocbimv22027966m.g","KQ416242",205358,215616,10258
"31036","Ocbimv22021777m.g","KQ419099",27517,27777,260
"31037","Ocbimv22010051m.g","KQ417635",20697,21720,1023
"31038","Ocbimv22013374m.g","KQ418018",395536,396062,526
"31039","Ocbimv22024107m.g","KQ419534",132140,156675,24535
"31040","Ocbimv22015604m.g","KQ415946",1026902,1028654,1752
"31041","Ocbimv22015495m.g","KQ418263",487569,488279,710
"31042","Ocbimv22010291m.g","KQ417665",1173848,1174216,368
"31043","Ocbimv22029625m.g","KQ420787",869713,885962,16249
"31044","Ocbimv22025284m.g","KQ419759",521744,568682,46938
"31045","Ocbimv22010761m.g","KQ417713",977529,979519,1990
"31046","Ocbimv22006362m.g","KQ425894",73199,83021,9822
"31047","Ocbimv22009922m.g","KQ417623",38206,62242,24036
"31048","Ocbimv22029714m.g","KQ420813",480941,482411,1470
"31049","Ocbimv22012404m.g","KQ428150",29665,88544,58879
"31050","Ocbimv22002431m.g","KQ417009",1636695,1636967,272
"31051","Ocbimv22007752m.g","KQ415847",717189,722723,5534
"31052","Ocbimv22009697m.g","KQ427086",847,1655,808
"31053","Ocbimv22029381m.g","KQ416301",189101,189412,311
"31054","Ocbimv22033402m.g","KQ421804",15171,15533,362
"31055","Ocbimv22020038m.g","KQ418844",85613,88858,3245
"31056","Ocbimv22033966m.g","KQ421930",80147,133395,53248
"31057","Ocbimv22002652m.g","KQ417023",1536053,1621092,85039
"31058","Ocbimv22011149m.g","KQ427654",137646,140251,2605
"31059","Ocbimv22016638m.g","KQ418371",239686,265046,25360
"31060","Ocbimv22018183m.g","LGKD01641502",92,530,438
"31061","Ocbimv22038666m.g","KQ423432",260372,292462,32090
"31062","Ocbimv22033736m.g","KQ416495",654151,659006,4855
"31063","Ocbimv22038500m.g","KQ423382",149677,151399,1722
"31064","Ocbimv22021870m.g","KQ419115",19787,20560,773
"31065","Ocbimv22019866m.g","KQ431339",9138,9314,176
"31066","Ocbimv22011586m.g","KQ417807",113539,116785,3246
"31067","Ocbimv22009176m.g","KQ415862",662426,663927,1501
"31068","Ocbimv22007081m.g","KQ417377",442402,442899,497
"31069","Ocbimv22009983m.g","KQ417629",424114,459955,35841
"31070","Ocbimv22008415m.g","KQ426634",222771,224080,1309
"31071","Ocbimv22019942m.g","KQ418838",247146,247493,347
"31072","Ocbimv22002554m.g","KQ417016",95590,96069,479
"31073","Ocbimv22018629m.g","KQ430776",4562,4807,245
"31074","Ocbimv22001654m.g","KQ416951",319147,374814,55667
"31075","Ocbimv22005927m.g","KQ417284",499556,510347,10791
"31076","Ocbimv22039890m.g","KQ416834",2139,26871,24732
"31077","Ocbimv22011031m.g","KQ427604",52567,76256,23689
"31078","Ocbimv22037823m.g","KQ423139",172322,173282,960
"31079","Ocbimv22039543m.g","KQ423702",26967,37000,10033
"31080","Ocbimv22012480m.g","KQ428177",11562,33226,21664
"31081","Ocbimv22034821m.g","KQ422187",183433,260149,76716
"31082","Ocbimv22001831m.g","KQ424439",83591,97670,14079
"31083","Ocbimv22023797m.g","KQ433635",2458,30241,27783
"31084","Ocbimv22011373m.g","KQ417791",229096,229883,787
"31085","Ocbimv22037236m.g","KQ422973",24792,25516,724
"31086","Ocbimv22001683m.g","KQ424384",3051,3298,247
"31087","Ocbimv22031687m.g","KQ421308",655589,665273,9684
"31088","Ocbimv22036913m.g","KQ422894",406294,408008,1714
"31089","Ocbimv22001798m.g","KQ424422",3867,4064,197
"31090","Ocbimv22003525m.g","KQ425021",324008,354295,30287
"31091","Ocbimv22028065m.g","KQ420424",166324,171092,4768
"31092","Ocbimv22002903m.g","KQ424815",178635,179309,674
"31093","Ocbimv22006244m.g","KQ417305",362284,414628,52344
"31094","Ocbimv22007836m.g","KQ417455",1712,7663,5951
"31095","Ocbimv22009585m.g","KQ427030",14181,29814,15633
"31096","Ocbimv22018662m.g","KQ418651",329471,329752,281
"31097","Ocbimv22016112m.g","KQ418320",66959,81117,14158
"31098","Ocbimv22024286m.g","KQ416121",762840,763639,799
"31099","Ocbimv22026612m.g","KQ420080",123766,146732,22966
"31100","Ocbimv22036105m.g","KQ422642",40003,40200,197
"31101","Ocbimv22007331m.g","KQ417405",627,2197,1570
"31102","Ocbimv22018152m.g","LGKD01248098",93,350,257
"31103","Ocbimv22037836m.g","KQ423139",366841,422104,55263
"31104","Ocbimv22021669m.g","KQ416049",404406,405226,820
"31105","Ocbimv22031713m.g","KQ421325",96535,100467,3932
"31106","Ocbimv22020715m.g","KQ416032",628174,631041,2867
"31107","Ocbimv22014929m.g","KQ418187",759644,765187,5543
"31108","Ocbimv22019231m.g","KQ418737",39476,40412,936
"31109","Ocbimv22030998m.g","KQ421143",45977,54246,8269
"31110","Ocbimv22029968m.g","KQ420863",247131,261093,13962
"31111","Ocbimv22029728m.g","KQ420813",807045,817551,10506
"31112","Ocbimv22034519m.g","KQ422068",79753,81356,1603
"31113","Ocbimv22034383m.g","KQ422024",43079,84500,41421
"31114","Ocbimv22022738m.g","KQ416074",576533,577528,995
"31115","Ocbimv22017511m.g","KQ430326",109032,116471,7439
"31116","Ocbimv22002270m.g","KQ424601",35231,36400,1169
"31117","Ocbimv22004333m.g","KQ417149",492248,514083,21835
"31118","Ocbimv22029529m.g","KQ420774",290532,293544,3012
"31119","Ocbimv22005628m.g","KQ425692",26267,45047,18780
"31120","Ocbimv22031574m.g","KQ421282",722,1021,299
"31121","Ocbimv22008565m.g","KQ426704",29464,58595,29131
"31122","Ocbimv22031468m.g","KQ416399",312042,323858,11816
"31123","Ocbimv22024340m.g","KQ419574",197759,198399,640
"31124","Ocbimv22024690m.g","KQ419615",515608,530512,14904
"31125","Ocbimv22012749m.g","KQ417935",96669,97073,404
"31126","Ocbimv22023913m.g","KQ433699",164119,165059,940
"31127","Ocbimv22035736m.g","KQ422521",361810,362839,1029
"31128","Ocbimv22033909m.g","KQ421906",270193,290782,20589
"31129","Ocbimv22035621m.g","KQ422477",337,1544,1207
"31130","Ocbimv22030840m.g","KQ421110",95397,97849,2452
"31131","Ocbimv22013486m.g","KQ415916",293159,299808,6649
"31132","Ocbimv22024273m.g","KQ419562",98983,136273,37290
"31133","Ocbimv22021350m.g","KQ416042",1445517,1479910,34393
"31134","Ocbimv22023809m.g","KQ419478",593262,593798,536
"31135","Ocbimv22013471m.g","KQ428524",133230,134271,1041
"31136","Ocbimv22031346m.g","KQ421219",334666,336180,1514
"31137","Ocbimv22003327m.g","KQ417081",18909,66453,47544
"31138","Ocbimv22021779m.g","KQ432315",19225,94630,75405
"31139","Ocbimv22025766m.g","KQ416166",733936,736749,2813
"31140","Ocbimv22027694m.g","KQ416231",78729,83336,4607
"31141","Ocbimv22032735m.g","KQ416449",373322,395349,22027
"31142","Ocbimv22039568m.g","KQ423703",219125,283351,64226
"31143","Ocbimv22010167m.g","KQ427290",265754,284801,19047
"31144","Ocbimv22020408m.g","KQ418908",425990,430034,4044
"31145","Ocbimv22015966m.g","KQ429631",1700,2014,314
"31146","Ocbimv22039527m.g","KQ423690",155963,158379,2416
"31147","Ocbimv22012981m.g","KQ428324",2052,2372,320
"31148","Ocbimv22000772m.g","KQ416879",447032,450775,3743
"31149","Ocbimv22022896m.g","KQ433114",1757,30141,28384
"31150","Ocbimv22004539m.g","KQ417177",14262,51196,36934
"31151","Ocbimv22039596m.g","KQ416807",79655,82891,3236
"31152","Ocbimv22022379m.g","KQ419212",116121,116895,774
"31153","Ocbimv22021680m.g","KQ416051",283968,342263,58295
"31154","Ocbimv22039644m.g","KQ423718",30303,31237,934
"31155","Ocbimv22016622m.g","KQ415967",155509,155796,287
"31156","Ocbimv22020238m.g","KQ431554",13846,14646,800
"31157","Ocbimv22008403m.g","KQ426631",1531,12094,10563
"31158","Ocbimv22019429m.g","KQ418764",1100,1586,486
"31159","Ocbimv22031857m.g","KQ421360",37228,40676,3448
"31160","Ocbimv22025152m.g","KQ419712",256719,258612,1893
"31161","Ocbimv22037932m.g","KQ423169",166669,232612,65943
"31162","Ocbimv22012500m.g","KQ417917",258235,273286,15051
"31163","Ocbimv22015054m.g","KQ418194",726558,727170,612
"31164","Ocbimv22007019m.g","KQ417370",510992,511522,530
"31165","Ocbimv22029757m.g","KQ420820",20540,20767,227
"31166","Ocbimv22025829m.g","KQ419909",372216,373532,1316
"31167","Ocbimv22025263m.g","KQ419751",125968,141285,15317
"31168","Ocbimv22029870m.g","KQ420828",1959816,1965105,5289
"31169","Ocbimv22008402m.g","KQ426629",179713,230947,51234
"31170","Ocbimv22032896m.g","KQ421678",114870,122179,7309
"31171","Ocbimv22017217m.g","KQ418468",317347,318405,1058
"31172","Ocbimv22029370m.g","KQ420731",71090,71269,179
"31173","Ocbimv22039706m.g","KQ416815",51873,89344,37471
"31174","Ocbimv22018794m.g","KQ430878",30718,31122,404
"31175","Ocbimv22006879m.g","KQ426130",305926,369278,63352
"31176","Ocbimv22014157m.g","KQ418096",32801,32971,170
"31177","Ocbimv22004609m.g","KQ417183",183542,183835,293
"31178","Ocbimv22035824m.g","KQ416602",187065,188454,1389
"31179","Ocbimv22007009m.g","KQ417370",326623,334710,8087
"31180","Ocbimv22039048m.g","KQ423522",118771,119289,518
"31181","Ocbimv22031200m.g","KQ421200",40534,63812,23278
"31182","Ocbimv22004955m.g","KQ417216",214938,221607,6669
"31183","Ocbimv22030944m.g","KQ421127",23902,25684,1782
"31184","Ocbimv22019774m.g","KQ418812",141796,200919,59123
"31185","Ocbimv22033812m.g","KQ421879",179616,179786,170
"31186","Ocbimv22039784m.g","KQ416822",174425,184097,9672
"31187","Ocbimv22033207m.g","KQ421752",172293,205056,32763
"31188","Ocbimv22031512m.g","KQ421263",708950,709387,437
"31189","Ocbimv22005330m.g","KQ417243",278,3626,3348
"31190","Ocbimv22030339m.g","KQ420956",47,1842,1795
"31191","Ocbimv22020444m.g","LGKD01660515",220,1005,785
"31192","Ocbimv22001754m.g","KQ416961",26432,27038,606
"31193","Ocbimv22001475m.g","KQ424315",602,1237,635
"31194","Ocbimv22016125m.g","KQ418320",598866,625196,26330
"31195","Ocbimv22030925m.g","KQ421117",1932706,1957738,25032
"31196","Ocbimv22032973m.g","KQ421705",164534,167732,3198
"31197","Ocbimv22032830m.g","KQ421664",1123571,1125045,1474
"31198","Ocbimv22021430m.g","KQ432150",847,1978,1131
"31199","Ocbimv22010744m.g","KQ427491",30856,33287,2431
"31200","Ocbimv22024039m.g","KQ416109",1816044,1817922,1878
"31201","Ocbimv22000211m.g","KQ423900",50218,51631,1413
"31202","Ocbimv22016189m.g","KQ429735",2541,5906,3365
"31203","Ocbimv22022723m.g","KQ416074",12529,15341,2812
"31204","Ocbimv22012578m.g","KQ417917",1669437,1673727,4290
"31205","Ocbimv22012815m.g","KQ417942",1340297,1383900,43603
"31206","Ocbimv22015879m.g","KQ429602",253497,254754,1257
"31207","Ocbimv22005997m.g","KQ425779",180305,257109,76804
"31208","Ocbimv22001129m.g","KQ424197",8268,14094,5826
"31209","Ocbimv22027927m.g","KQ420404",552435,552824,389
"31210","Ocbimv22027830m.g","KQ420375",1253940,1289806,35866
"31211","Ocbimv22005390m.g","KQ417249",1265878,1323574,57696
"31212","Ocbimv22038468m.g","KQ423354",282402,282764,362
"31213","Ocbimv22020711m.g","KQ416032",435108,453587,18479
"31214","Ocbimv22008107m.g","KQ426567",178978,183556,4578
"31215","Ocbimv22006270m.g","LGKD01543685",423,791,368
"31216","Ocbimv22001347m.g","KQ416923",245878,249142,3264
"31217","Ocbimv22027383m.g","KQ420268",505885,507671,1786
"31218","Ocbimv22024229m.g","KQ433872",10166,10871,705
"31219","Ocbimv22038439m.g","KQ423338",264008,274908,10900
"31220","Ocbimv22018452m.g","KQ415992",603408,623103,19695
"31221","Ocbimv22021673m.g","LGKD01670070",66,263,197
"31222","Ocbimv22008261m.g","KQ417492",265964,266621,657
"31223","Ocbimv22009760m.g","KQ417611",381137,433587,52450
"31224","Ocbimv22022750m.g","KQ416074",1015637,1074128,58491
"31225","Ocbimv22006512m.g","KQ425968",1068,2134,1066
"31226","Ocbimv22002821m.g","KQ424797",24318,26903,2585
"31227","Ocbimv22032767m.g","KQ421655",721105,721902,797
"31228","Ocbimv22000490m.g","KQ416864",502729,503097,368
"31229","Ocbimv22014856m.g","KQ418182",78572,81939,3367
"31230","Ocbimv22013850m.g","KQ418068",100086,109124,9038
"31231","Ocbimv22033367m.g","KQ421800",117434,118907,1473
"31232","Ocbimv22005630m.g","KQ425692",46070,55962,9892
"31233","Ocbimv22024937m.g","KQ419660",120470,123159,2689
"31234","Ocbimv22002413m.g","KQ417009",97630,97929,299
"31235","Ocbimv22007455m.g","KQ426347",155849,166896,11047
"31236","Ocbimv22000825m.g","KQ424081",315929,321807,5878
"31237","Ocbimv22014762m.g","LGKD01612470",38,247,209
"31238","Ocbimv22004912m.g","KQ417213",661747,670248,8501
"31239","Ocbimv22015520m.g","KQ415945",815262,816949,1687
"31240","Ocbimv22001652m.g","KQ416951",246793,247774,981
"31241","Ocbimv22026598m.g","KQ420078",140159,144500,4341
"31242","Ocbimv22021309m.g","KQ419027",122513,122851,338
"31243","Ocbimv22001598m.g","KQ424367",171202,171605,403
"31244","Ocbimv22029046m.g","KQ416282",22542,23484,942
"31245","Ocbimv22001686m.g","KQ424386",65514,67516,2002
"31246","Ocbimv22006298m.g","KQ425863",42295,47686,5391
"31247","Ocbimv22011194m.g","KQ415884",503310,503591,281
"31248","Ocbimv22020124m.g","KQ431474",1241,7289,6048
"31249","Ocbimv22008753m.g","KQ426760",46356,130507,84151
"31250","Ocbimv22029155m.g","KQ420670",67409,67669,260
"31251","Ocbimv22027435m.g","KQ420275",665976,666945,969
"31252","Ocbimv22002406m.g","KQ424658",146071,173959,27888
"31253","Ocbimv22024977m.g","KQ419670",397446,431254,33808
"31254","Ocbimv22024403m.g","KQ415693",734569,735740,1171
"31255","Ocbimv22037906m.g","KQ423162",36924,63113,26189
"31256","Ocbimv22024082m.g","KQ419533",321680,344940,23260
"31257","Ocbimv22016951m.g","KQ430103",10572,10787,215
"31258","Ocbimv22038382m.g","KQ416738",810491,833086,22595
"31259","Ocbimv22007144m.g","KQ426210",18050,18337,287
"31260","Ocbimv22031707m.g","KQ421325",7209,18102,10893
"31261","Ocbimv22031986m.g","KQ421396",109069,110350,1281
"31262","Ocbimv22025217m.g","KQ419738",182316,188710,6394
"31263","Ocbimv22026455m.g","KQ420053",42532,43219,687
"31264","Ocbimv22027738m.g","KQ416232",36133,36934,801
"31265","Ocbimv22035841m.g","KQ416604",105067,106818,1751
"31266","Ocbimv22038413m.g","KQ423329",33470,42606,9136
"31267","Ocbimv22016367m.g","KQ415962",739000,739725,725
"31268","Ocbimv22008235m.g","KQ426596",299320,300507,1187
"31269","Ocbimv22016753m.g","KQ429998",37281,111882,74601
"31270","Ocbimv22026079m.g","KQ419989",73575,102886,29311
"31271","Ocbimv22005961m.g","KQ417285",1671719,1671877,158
"31272","Ocbimv22015468m.g","KQ429368",71073,95889,24816
"31273","Ocbimv22015234m.g","KQ415940",116614,116829,215
"31274","Ocbimv22013092m.g","KQ417981",36719,36868,149
"31275","Ocbimv22015912m.g","KQ418303",158160,201019,42859
"31276","Ocbimv22022587m.g","KQ416072",1034869,1035042,173
"31277","Ocbimv22000421m.g","KQ423958",356167,360192,4025
"31278","Ocbimv22008187m.g","KQ417482",190679,219375,28696
"31279","Ocbimv22030727m.g","KQ421079",267891,268166,275
"31280","Ocbimv22032062m.g","KQ416416",198120,198407,287
"31281","Ocbimv22017345m.g","KQ418483",315973,320647,4674
"31282","Ocbimv22026141m.g","KQ420001",17151,33730,16579
"31283","Ocbimv22032001m.g","KQ421409",836792,837802,1010
"31284","Ocbimv22009975m.g","KQ417629",236148,237030,882
"31285","Ocbimv22003004m.g","KQ424863",313566,318258,4692
"31286","Ocbimv22017057m.g","KQ418446",37141,98658,61517
"31287","Ocbimv22039211m.g","KQ423576",380581,381833,1252
"31288","Ocbimv22037336m.g","KQ423004",10992,11729,737
"31289","Ocbimv22021698m.g","KQ432284",176585,206840,30255
"31290","Ocbimv22033165m.g","KQ421737",1534819,1735836,201017
"31291","Ocbimv22013877m.g","KQ428701",5823,6766,943
"31292","Ocbimv22016600m.g","KQ429929",4548,31884,27336
"31293","Ocbimv22003495m.g","KQ417089",75216,75461,245
"31294","Ocbimv22036146m.g","KQ422658",241162,251548,10386
"31295","Ocbimv22031073m.g","KQ416384",57556,58065,509
"31296","Ocbimv22030414m.g","KQ416347",30678,31475,797
"31297","Ocbimv22003994m.g","LGKD01526780",236,577,341
"31298","Ocbimv22028526m.g","KQ420517",216398,221610,5212
"31299","Ocbimv22020227m.g","KQ431542",108,24180,24072
"31300","Ocbimv22011224m.g","KQ417763",429144,443203,14059
"31301","Ocbimv22031983m.g","KQ416415",549509,550432,923
"31302","Ocbimv22025658m.g","KQ419878",13889,31343,17454
"31303","Ocbimv22016839m.g","KQ418411",36160,47230,11070
"31304","Ocbimv22030477m.g","KQ420992",308370,329404,21034
"31305","Ocbimv22029724m.g","KQ420813",646874,661738,14864
"31306","Ocbimv22034670m.g","KQ416546",107945,108869,924
"31307","Ocbimv22016858m.g","KQ418413",168110,211898,43788
"31308","Ocbimv22025245m.g","KQ419743",470532,470681,149
"31309","Ocbimv22021980m.g","KQ419141",141962,166422,24460
"31310","Ocbimv22023137m.g","KQ416081",29071,29946,875
"31311","Ocbimv22012511m.g","KQ417917",365406,379016,13610
"31312","Ocbimv22028089m.g","KQ420428",262752,262976,224
"31313","Ocbimv22005779m.g","KQ415823",274078,289390,15312
"31314","Ocbimv22019462m.g","KQ418770",231980,267806,35826
"31315","Ocbimv22005925m.g","KQ417284",485702,488538,2836
"31316","Ocbimv22013559m.g","KQ418038",25763,33784,8021
"31317","Ocbimv22039817m.g","KQ423766",170515,178091,7576
"31318","Ocbimv22016731m.g","KQ429984",46978,57162,10184
"31319","Ocbimv22002427m.g","KQ417009",1333096,1334066,970
"31320","Ocbimv22036542m.g","KQ422788",324931,325107,176
"31321","Ocbimv22037347m.g","KQ423009",329023,329476,453
"31322","Ocbimv22030603m.g","KQ416359",22494,22851,357
"31323","Ocbimv22034220m.g","KQ416524",1241,5797,4556
"31324","Ocbimv22000535m.g","KQ423989",162663,163010,347
"31325","Ocbimv22001997m.g","KQ416979",1123028,1156289,33261
"31326","Ocbimv22023334m.g","KQ419395",39373,64606,25233
"31327","Ocbimv22037240m.g","KQ422973",33186,34784,1598
"31328","Ocbimv22006194m.g","KQ417301",166023,173906,7883
"31329","Ocbimv22024867m.g","KQ419643",418228,418515,287
"31330","Ocbimv22027481m.g","KQ416225",295112,295921,809
"31331","Ocbimv22031177m.g","KQ415722",3612,5999,2387
"31332","Ocbimv22013601m.g","KQ418039",60422,92925,32503
"31333","Ocbimv22009407m.g","KQ417591",789626,803233,13607
"31334","Ocbimv22029595m.g","KQ420779",421076,441861,20785
"31335","Ocbimv22015657m.g","KQ418273",31487,31651,164
"31336","Ocbimv22012327m.g","KQ415907",467547,513316,45769
"31337","Ocbimv22012321m.g","KQ415907",365612,376754,11142
"31338","Ocbimv22003635m.g","LGKD01523045",1,342,341
"31339","Ocbimv22036731m.g","KQ416655",283370,338661,55291
"31340","Ocbimv22032809m.g","KQ416450",251387,252035,648
"31341","Ocbimv22035565m.g","KQ422438",78097,79904,1807
"31342","Ocbimv22008666m.g","KQ417519",466011,466463,452
"31343","Ocbimv22011876m.g","KQ417844",741150,742252,1102
"31344","Ocbimv22004487m.g","KQ417173",10557,10831,274
"31345","Ocbimv22001023m.g","KQ424157",293807,306677,12870
"31346","Ocbimv22003331m.g","KQ417081",207891,214715,6824
"31347","Ocbimv22033671m.g","KQ421858",282322,283095,773
"31348","Ocbimv22004890m.g","KQ425464",58960,69312,10352
"31349","Ocbimv22032826m.g","KQ421664",392416,393039,623
"31350","Ocbimv22003166m.g","KQ417062",64933,66196,1263
"31351","Ocbimv22016594m.g","KQ418368",842016,894826,52810
"31352","Ocbimv22018400m.g","KQ430684",210839,229047,18208
"31353","Ocbimv22004331m.g","KQ417149",452425,471338,18913
"31354","Ocbimv22024746m.g","KQ419623",54020,68962,14942
"31355","Ocbimv22034762m.g","KQ422161",58772,59026,254
"31356","Ocbimv22026070m.g","KQ419982",593946,594149,203
"31357","Ocbimv22038714m.g","KQ423448",50299,68174,17875
"31358","Ocbimv22033960m.g","KQ421920",238678,238962,284
"31359","Ocbimv22008465m.g","KQ415854",467653,474797,7144
"31360","Ocbimv22000848m.g","KQ424093",321987,324138,2151
"31361","Ocbimv22011912m.g","KQ427949",157160,157707,547
"31362","Ocbimv22039822m.g","KQ423766",646786,693776,46990
"31363","Ocbimv22036248m.g","KQ416627",315258,324807,9549
"31364","Ocbimv22027096m.g","KQ420181",181293,181442,149
"31365","Ocbimv22027876m.g","KQ420386",105804,106184,380
"31366","Ocbimv22035603m.g","KQ422458",102080,123268,21188
"31367","Ocbimv22038953m.g","KQ423493",906347,911336,4989
"31368","Ocbimv22012101m.g","KQ428036",69483,71448,1965
"31369","Ocbimv22004051m.g","KQ425190",149637,149908,271
"31370","Ocbimv22017110m.g","KQ418450",143746,144039,293
"31371","Ocbimv22019106m.g","KQ430964",340162,340445,283
"31372","Ocbimv22010947m.g","KQ417726",119300,121281,1981
"31373","Ocbimv22008805m.g","KQ426774",171616,177020,5404
"31374","Ocbimv22036136m.g","KQ416620",165355,183494,18139
"31375","Ocbimv22008055m.g","LGKD01560495",14,229,215
"31376","Ocbimv22015450m.g","LGKD01618610",49,405,356
"31377","Ocbimv22012899m.g","KQ417950",19916,21675,1759
"31378","Ocbimv22033823m.g","KQ421891",85711,138748,53037
"31379","Ocbimv22033294m.g","KQ421766",65493,69662,4169
"31380","Ocbimv22004524m.g","KQ415805",1023269,1023529,260
"31381","Ocbimv22007647m.g","KQ417439",215036,233808,18772
"31382","Ocbimv22019908m.g","KQ418834",58261,104554,46293
"31383","Ocbimv22014020m.g","KQ418079",292730,294604,1874
"31384","Ocbimv22031417m.g","KQ421236",26046,49385,23339
"31385","Ocbimv22032841m.g","KQ421665",26282,29484,3202
"31386","Ocbimv22005996m.g","KQ425779",51218,170106,118888
"31387","Ocbimv22007231m.g","KQ426258",20485,21172,687
"31388","Ocbimv22010876m.g","KQ417721",1309926,1312565,2639
"31389","Ocbimv22015851m.g","KQ418296",222767,223282,515
"31390","Ocbimv22025908m.g","KQ419922",13425,13574,149
"31391","Ocbimv22008811m.g","KQ426774",206818,214000,7182
"31392","Ocbimv22029609m.g","KQ420782",18035,38391,20356
"31393","Ocbimv22031511m.g","KQ421263",671403,775923,104520
"31394","Ocbimv22026514m.g","KQ416190",167848,174183,6335
"31395","Ocbimv22035998m.g","KQ422629",556146,600166,44020
"31396","Ocbimv22034831m.g","KQ422188",131304,131822,518
"31397","Ocbimv22027578m.g","KQ420308",71226,72544,1318
"31398","Ocbimv22039763m.g","KQ423740",48004,48336,332
"31399","Ocbimv22028214m.g","KQ420444",413360,437480,24120
"31400","Ocbimv22028458m.g","KQ416258",67269,67661,392
"31401","Ocbimv22025426m.g","KQ419797",21784,22041,257
"31402","Ocbimv22022804m.g","KQ419300",608739,617306,8567
"31403","Ocbimv22023790m.g","KQ419476",228794,358152,129358
"31404","Ocbimv22002676m.g","KQ424735",188460,191825,3365
"31405","Ocbimv22003967m.g","KQ425161",40309,56048,15739
"31406","Ocbimv22034279m.g","KQ422015",755419,762460,7041
"31407","Ocbimv22019576m.g","KQ418788",90238,90760,522
"31408","Ocbimv22002565m.g","KQ415793",1727687,1730132,2445
"31409","Ocbimv22023527m.g","KQ419425",430588,439850,9262
"31410","Ocbimv22025043m.g","KQ416136",626233,626726,493
"31411","Ocbimv22028989m.g","KQ420622",215301,227738,12437
"31412","Ocbimv22029143m.g","KQ420662",1125787,1127541,1754
"31413","Ocbimv22030972m.g","KQ416379",694465,723614,29149
"31414","Ocbimv22017508m.g","KQ430326",61251,65597,4346
"31415","Ocbimv22009027m.g","KQ426847",15539,18904,3365
"31416","Ocbimv22023789m.g","KQ419476",195010,195204,194
"31417","Ocbimv22000274m.g","KQ423910",366365,396915,30550
"31418","Ocbimv22011862m.g","LGKD01591000",1847,2230,383
"31419","Ocbimv22019861m.g","KQ418823",25328,38151,12823
"31420","Ocbimv22030723m.g","KQ421079",95972,96226,254
"31421","Ocbimv22038129m.g","KQ423217",287619,327016,39397
"31422","Ocbimv22039113m.g","KQ416779",658955,659110,155
"31423","Ocbimv22014933m.g","KQ429139",77446,90957,13511
"31424","Ocbimv22036397m.g","KQ416639",60623,66691,6068
"31425","Ocbimv22019574m.g","KQ431207",1815,2810,995
"31426","Ocbimv22000381m.g","KQ423941",473495,473860,365
"31427","Ocbimv22000035m.g","KQ423831",132373,133924,1551
"31428","Ocbimv22024907m.g","KQ416131",707988,708158,170
"31429","Ocbimv22022432m.g","KQ419216",119334,124919,5585
"31430","Ocbimv22025803m.g","KQ419907",21012,65587,44575
"31431","Ocbimv22010080m.g","KQ417641",103378,126570,23192
"31432","Ocbimv22022609m.g","LGKD01680825",17,385,368
"31433","Ocbimv22030101m.g","KQ420892",11158,38331,27173
"31434","Ocbimv22017421m.g","KQ430291",19299,24705,5406
"31435","Ocbimv22008579m.g","KQ417510",276086,276966,880
"31436","Ocbimv22009664m.g","KQ427059",801270,805023,3753
"31437","Ocbimv22039319m.g","KQ416788",100690,110717,10027
"31438","Ocbimv22009848m.g","KQ417620",770899,786689,15790
"31439","Ocbimv22034049m.g","KQ416508",517712,535110,17398
"31440","Ocbimv22004383m.g","LGKD01529752",1,222,221
"31441","Ocbimv22027747m.g","KQ420357",38606,44449,5843
"31442","Ocbimv22033990m.g","KQ415734",59633,60519,886
"31443","Ocbimv22001781m.g","KQ424414",52925,60218,7293
"31444","Ocbimv22029856m.g","KQ420828",1755484,1755826,342
"31445","Ocbimv22005170m.g","KQ425537",309943,362407,52464
"31446","Ocbimv22011240m.g","KQ417766",452974,454676,1702
"31447","Ocbimv22024078m.g","KQ419533",150869,151354,485
"31448","Ocbimv22017341m.g","KQ418483",246979,268162,21183
"31449","Ocbimv22011675m.g","KQ417816",198679,281476,82797
"31450","Ocbimv22009962m.g","LGKD01574763",1019,2425,1406
"31451","Ocbimv22028788m.g","KQ416272",251262,253750,2488
"31452","Ocbimv22021891m.g","KQ419122",23987,24631,644
"31453","Ocbimv22014284m.g","KQ418113",93190,93420,230
"31454","Ocbimv22036150m.g","KQ422659",144206,145379,1173
"31455","Ocbimv22038421m.g","KQ423334",20756,28232,7476
"31456","Ocbimv22002333m.g","KQ424632",46751,47014,263
"31457","Ocbimv22027381m.g","KQ420268",441619,442585,966
"31458","Ocbimv22027423m.g","KQ420272",172655,172876,221
"31459","Ocbimv22030181m.g","KQ420917",23962,25068,1106
"31460","Ocbimv22037164m.g","KQ422946",4122,7663,3541
"31461","Ocbimv22009136m.g","KQ415861",5799,56952,51153
"31462","Ocbimv22020009m.g","KQ418841",30572,35912,5340
"31463","Ocbimv22013195m.g","KQ428421",24914,25201,287
"31464","Ocbimv22014095m.g","KQ418088",157569,157874,305
"31465","Ocbimv22027108m.g","KQ420185",199864,200157,293
"31466","Ocbimv22010009m.g","KQ427204",241642,241916,274
"31467","Ocbimv22019909m.g","KQ418834",105621,105956,335
"31468","Ocbimv22003160m.g","KQ417062",45211,47167,1956
"31469","Ocbimv22039305m.g","KQ423610",36506,36784,278
"31470","Ocbimv22025851m.g","KQ419912",142396,203489,61093
"31471","Ocbimv22027617m.g","KQ420313",774433,775632,1199
"31472","Ocbimv22024701m.g","KQ419616",270057,293799,23742
"31473","Ocbimv22013318m.g","KQ418010",37240,37810,570
"31474","Ocbimv22033515m.g","KQ421823",317736,318474,738
"31475","Ocbimv22034732m.g","KQ422135",84751,94714,9963
"31476","Ocbimv22006538m.g","KQ425992",248768,248956,188
"31477","Ocbimv22017657m.g","KQ418525",96748,110818,14070
"31478","Ocbimv22012827m.g","KQ428255",14284,57470,43186
"31479","Ocbimv22019910m.g","KQ418834",114827,128673,13846
"31480","Ocbimv22008640m.g","KQ417515",133796,134191,395
"31481","Ocbimv22029261m.g","KQ420695",351626,351808,182
"31482","Ocbimv22025453m.g","KQ419807",47323,75860,28537
"31483","Ocbimv22002224m.g","KQ416996",168144,168661,517
"31484","Ocbimv22033067m.g","KQ421721",828155,833662,5507
"31485","Ocbimv22007554m.g","KQ417424",9196,9855,659
"31486","Ocbimv22012097m.g","KQ428036",22431,46435,24004
"31487","Ocbimv22009877m.g","KQ417621",295012,295530,518
"31488","Ocbimv22039970m.g","KQ415773",119307,119525,218
"31489","Ocbimv22022530m.g","KQ419241",401336,426461,25125
"31490","Ocbimv22018325m.g","KQ430653",32409,32720,311
"31491","Ocbimv22017522m.g","KQ418504",185917,189035,3118
"31492","Ocbimv22016832m.g","KQ430050",332549,333119,570
"31493","Ocbimv22004503m.g","KQ417173",1897179,1897394,215
"31494","Ocbimv22020938m.g","KQ418980",191441,192344,903
"31495","Ocbimv22010834m.g","KQ427538",27515,27963,448
"31496","Ocbimv22008927m.g","KQ417540",258381,258794,413
"31497","Ocbimv22001299m.g","KQ424262",169408,169572,164
"31498","Ocbimv22007563m.g","KQ417429",75733,105566,29833
"31499","Ocbimv22002496m.g","KQ424672",70076,70398,322
"31500","Ocbimv22031265m.g","KQ416391",116763,116978,215
"31501","Ocbimv22036645m.g","KQ422818",119219,119545,326
"31502","Ocbimv22002257m.g","KQ424585",159006,160044,1038
"31503","Ocbimv22034163m.g","KQ416516",305964,306775,811
"31504","Ocbimv22034210m.g","KQ422009",88116,89499,1383
"31505","Ocbimv22011036m.g","KQ417740",64272,71245,6973
"31506","Ocbimv22023690m.g","LGKD01691825",153,362,209
"31507","Ocbimv22037107m.g","KQ422923",191805,241481,49676
"31508","Ocbimv22000225m.g","LGKD01490022",14,178,164
"31509","Ocbimv22039711m.g","KQ416815",1097573,1097815,242
"31510","Ocbimv22018286m.g","KQ430627",23753,24340,587
"31511","Ocbimv22025997m.g","KQ419951",62910,63299,389
"31512","Ocbimv22013466m.g","KQ418025",127466,180620,53154
"31513","Ocbimv22002159m.g","KQ424563",974,36856,35882
"31514","Ocbimv22005752m.g","KQ415822",52912,59376,6464
"31515","Ocbimv22016788m.g","KQ430029",74927,96802,21875
"31516","Ocbimv22019471m.g","KQ416011",94484,96295,1811
"31517","Ocbimv22010509m.g","KQ417683",33133,38193,5060
"31518","Ocbimv22028881m.g","KQ420600",279521,279871,350
"31519","Ocbimv22037473m.g","KQ423042",62817,64629,1812
"31520","Ocbimv22023348m.g","KQ419395",134504,136066,1562
"31521","Ocbimv22002640m.g","KQ417023",1248744,1277733,28989
"31522","Ocbimv22032431m.g","KQ421533",822504,825165,2661
"31523","Ocbimv22006686m.g","KQ417343",278839,279349,510
"31524","Ocbimv22012009m.g","KQ415896",425831,426566,735
"31525","Ocbimv22031395m.g","KQ416395",158140,159247,1107
"31526","Ocbimv22004464m.g","KQ425323",5630,6814,1184
"31527","Ocbimv22002409m.g","KQ424658",272898,273224,326
"31528","Ocbimv22028456m.g","KQ420494",357,42411,42054
"31529","Ocbimv22026872m.g","KQ420132",838480,871851,33371
"31530","Ocbimv22037791m.g","KQ416712",71188,119388,48200
"31531","Ocbimv22029485m.g","KQ416308",920210,928692,8482
"31532","Ocbimv22004999m.g","KQ415811",232004,242964,10960
"31533","Ocbimv22024839m.g","KQ419639",246808,247455,647
"31534","Ocbimv22023392m.g","KQ419401",2570,11373,8803
"31535","Ocbimv22029331m.g","KQ416298",252734,253945,1211
"31536","Ocbimv22029014m.g","KQ416279",770887,808642,37755
"31537","Ocbimv22033524m.g","KQ421824",93637,118876,25239
"31538","Ocbimv22018499m.g","KQ418629",13760,15906,2146
"31539","Ocbimv22033862m.g","KQ421896",266331,273892,7561
"31540","Ocbimv22001499m.g","KQ424337",64,360,296
"31541","Ocbimv22002462m.g","KQ424661",70706,70981,275
"31542","Ocbimv22030392m.g","KQ420970",210193,213450,3257
"31543","Ocbimv22039938m.g","KQ423801",182072,202114,20042
"31544","Ocbimv22025806m.g","KQ419907",76667,87322,10655
"31545","Ocbimv22018677m.g","KQ415684",359961,393538,33577
"31546","Ocbimv22008368m.g","KQ417498",755783,756556,773
"31547","Ocbimv22001688m.g","KQ424386",76688,77571,883
"31548","Ocbimv22012543m.g","KQ417917",885152,885370,218
"31549","Ocbimv22012990m.g","KQ417968",23272,23753,481
"31550","Ocbimv22006755m.g","KQ417347",440029,440555,526
"31551","Ocbimv22033453m.g","KQ421816",662159,711986,49827
"31552","Ocbimv22031766m.g","KQ416405",241928,243387,1459
"31553","Ocbimv22030360m.g","KQ420963",36201,39362,3161
"31554","Ocbimv22018757m.g","KQ416000",280294,282293,1999
"31555","Ocbimv22001703m.g","KQ424387",429702,430577,875
"31556","Ocbimv22035990m.g","KQ422628",80504,134790,54286
"31557","Ocbimv22036419m.g","KQ416641",493559,546085,52526
"31558","Ocbimv22019888m.g","KQ418832",436257,582537,146280
"31559","Ocbimv22009595m.g","KQ427040",101892,127911,26019
"31560","Ocbimv22017850m.g","KQ418552",190510,200522,10012
"31561","Ocbimv22025164m.g","KQ416141",75489,119852,44363
"31562","Ocbimv22028955m.g","KQ416277",123997,132195,8198
"31563","Ocbimv22023135m.g","KQ419354",300222,309701,9479
"31564","Ocbimv22022975m.g","KQ419332",27484,27882,398
"31565","Ocbimv22007567m.g","KQ417429",198292,201041,2749
"31566","Ocbimv22008711m.g","KQ426740",417094,446082,28988
"31567","Ocbimv22001048m.g","KQ424160",130336,159220,28884
"31568","Ocbimv22001457m.g","KQ416933",784900,827411,42511
"31569","Ocbimv22028842m.g","KQ420592",194480,196983,2503
"31570","Ocbimv22022099m.g","KQ419162",205428,205616,188
"31571","Ocbimv22016705m.g","KQ429970",188047,188876,829
"31572","Ocbimv22028046m.g","KQ416244",203906,206086,2180
"31573","Ocbimv22018981m.g","KQ418706",24308,25276,968
"31574","Ocbimv22005305m.g","KQ425573",62544,77283,14739
"31575","Ocbimv22036459m.g","KQ422771",45032,51738,6706
"31576","Ocbimv22036576m.g","KQ422794",141793,147991,6198
"31577","Ocbimv22026946m.g","KQ420146",396468,491451,94983
"31578","Ocbimv22038200m.g","KQ416731",207548,207853,305
"31579","Ocbimv22032553m.g","KQ421583",12524,13201,677
"31580","Ocbimv22024852m.g","KQ419640",165316,173714,8398
"31581","Ocbimv22024993m.g","KQ419672",393206,393713,507
"31582","Ocbimv22003322m.g","KQ417080",153962,154573,611
"31583","Ocbimv22032752m.g","KQ421655",25600,36826,11226
"31584","Ocbimv22011482m.g","KQ417795",182177,215647,33470
"31585","Ocbimv22033723m.g","KQ416495",126429,201340,74911
"31586","Ocbimv22018165m.g","KQ418581",1349,7147,5798
"31587","Ocbimv22010277m.g","KQ427344",94623,97604,2981
"31588","Ocbimv22018972m.g","KQ430934",119084,119417,333
"31589","Ocbimv22008145m.g","KQ417481",519797,533905,14108
"31590","Ocbimv22026831m.g","KQ420126",109557,112784,3227
"31591","Ocbimv22014328m.g","KQ428877",362,20761,20399
"31592","Ocbimv22021431m.g","KQ419049",1693,10187,8494
"31593","Ocbimv22007744m.g","KQ415847",525944,526588,644
"31594","Ocbimv22030475m.g","KQ420992",295735,309025,13290
"31595","Ocbimv22032193m.g","KQ421476",186871,187616,745
"31596","Ocbimv22002691m.g","KQ424742",168396,168605,209
"31597","Ocbimv22007477m.g","KQ415843",3978,4133,155
"31598","Ocbimv22039109m.g","KQ416779",534912,536144,1232
"31599","Ocbimv22017671m.g","KQ418525",379859,381283,1424
"31600","Ocbimv22039611m.g","KQ423717",91936,92175,239
"31601","Ocbimv22027173m.g","KQ420208",335555,336090,535
"31602","Ocbimv22001485m.g","KQ424318",221390,222002,612
"31603","Ocbimv22010513m.g","LGKD01580069",3,263,260
"31604","Ocbimv22001079m.g","KQ424173",152999,154603,1604
"31605","Ocbimv22013779m.g","KQ428661",133732,145265,11533
"31606","Ocbimv22014248m.g","KQ418106",142336,143405,1069
"31607","Ocbimv22012434m.g","KQ417911",488166,544585,56419
"31608","Ocbimv22007464m.g","KQ426354",36001,54673,18672
"31609","Ocbimv22031844m.g","KQ421356",869399,884344,14945
"31610","Ocbimv22014565m.g","KQ428991",325,1152,827
"31611","Ocbimv22039819m.g","KQ423766",445592,449498,3906
"31612","Ocbimv22013501m.g","KQ418031",848863,865585,16722
"31613","Ocbimv22030415m.g","KQ420973",47352,47795,443
"31614","Ocbimv22019727m.g","KQ431280",141163,146033,4870
"31615","Ocbimv22003752m.g","KQ417105",750354,751135,781
"31616","Ocbimv22001799m.g","KQ424422",19037,33312,14275
"31617","Ocbimv22013444m.g","KQ428508",73798,74642,844
"31618","Ocbimv22011393m.g","KQ417791",935299,941965,6666
"31619","Ocbimv22022260m.g","KQ419190",519565,519732,167
"31620","Ocbimv22029688m.g","KQ420805",22187,65068,42881
"31621","Ocbimv22029563m.g","KQ420776",667269,679330,12061
"31622","Ocbimv22032419m.g","KQ421533",409775,421567,11792
"31623","Ocbimv22026164m.g","KQ416186",60717,62121,1404
"31624","Ocbimv22015821m.g","KQ418295",152785,177610,24825
"31625","Ocbimv22021184m.g","KQ416040",19292,21245,1953
"31626","Ocbimv22028772m.g","KQ420579",629553,698820,69267
"31627","Ocbimv22002595m.g","KQ424714",6434,49080,42646
"31628","Ocbimv22023538m.g","KQ433448",31827,32233,406
"31629","Ocbimv22027497m.g","KQ416226",146062,146312,250
"31630","Ocbimv22006160m.g","KQ417300",1143766,1148382,4616
"31631","Ocbimv22031243m.g","KQ421206",262126,278878,16752
"31632","Ocbimv22010434m.g","KQ427385",42416,126597,84181
"31633","Ocbimv22017601m.g","KQ415979",131330,190569,59239
"31634","Ocbimv22024779m.g","KQ419629",400985,401980,995
"31635","Ocbimv22039824m.g","KQ423768",11525,11824,299
"31636","Ocbimv22034353m.g","KQ422018",14286,16416,2130
"31637","Ocbimv22037270m.g","KQ422987",54891,82755,27864
"31638","Ocbimv22027227m.g","KQ420222",536873,538287,1414
"31639","Ocbimv22009168m.g","KQ415862",58129,58407,278
"31640","Ocbimv22021265m.g","KQ419022",53859,205798,151939
"31641","Ocbimv22028470m.g","KQ420499",19098,106681,87583
"31642","Ocbimv22014085m.g","KQ415924",231367,234604,3237
"31643","Ocbimv22021857m.g","KQ415687",1476191,1525536,49345
"31644","Ocbimv22007282m.g","KQ417398",111679,114198,2519
"31645","Ocbimv22014717m.g","KQ429040",282952,283290,338
"31646","Ocbimv22034479m.g","KQ422055",46573,49018,2445
"31647","Ocbimv22027873m.g","KQ416236",266310,266537,227
"31648","Ocbimv22038552m.g","KQ423398",59725,65237,5512
"31649","Ocbimv22022506m.g","KQ419236",1,1486,1485
"31650","Ocbimv22025317m.g","KQ419773",51511,129643,78132
"31651","Ocbimv22014947m.g","KQ429139",469935,471818,1883
"31652","Ocbimv22022424m.g","KQ419216",51606,60364,8758
"31653","Ocbimv22011637m.g","KQ427828",18271,19089,818
"31654","Ocbimv22015197m.g","KQ418205",214872,232733,17861
"31655","Ocbimv22013355m.g","KQ428462",6152,6581,429
"31656","Ocbimv22030307m.g","KQ420942",310814,312847,2033
"31657","Ocbimv22022503m.g","KQ432800",24596,25960,1364
"31658","Ocbimv22016666m.g","KQ418376",278676,301190,22514
"31659","Ocbimv22031951m.g","KQ421389",118617,156313,37696
"31660","Ocbimv22018128m.g","KQ430573",4708,5175,467
"31661","Ocbimv22026854m.g","KQ420130",832953,852912,19959
"31662","Ocbimv22038949m.g","KQ423493",747084,839625,92541
"31663","Ocbimv22030780m.g","KQ421086",134629,166782,32153
"31664","Ocbimv22030143m.g","KQ420909",46514,47310,796
"31665","Ocbimv22022796m.g","KQ416075",119744,127768,8024
"31666","Ocbimv22018366m.g","KQ418610",137666,139314,1648
"31667","Ocbimv22014653m.g","KQ429026",328985,331097,2112
"31668","Ocbimv22016861m.g","KQ418413",223230,250744,27514
"31669","Ocbimv22011120m.g","LGKD01585095",1,157,156
"31670","Ocbimv22027252m.g","KQ420230",76282,123069,46787
"31671","Ocbimv22001651m.g","KQ416951",120058,122245,2187
"31672","Ocbimv22032284m.g","KQ416427",14947,15198,251
"31673","Ocbimv22015746m.g","KQ418289",29323,54188,24865
"31674","Ocbimv22024821m.g","KQ419631",860956,889424,28468
"31675","Ocbimv22006558m.g","KQ417336",17770,20857,3087
"31676","Ocbimv22002573m.g","KQ415794",73928,104695,30767
"31677","Ocbimv22000711m.g","KQ416877",471973,473487,1514
"31678","Ocbimv22027446m.g","KQ420279",183687,202951,19264
"31679","Ocbimv22022174m.g","KQ419180",528377,536035,7658
"31680","Ocbimv22004380m.g","KQ425284",1234,44836,43602
"31681","Ocbimv22001793m.g","KQ424420",197783,204381,6598
"31682","Ocbimv22010358m.g","KQ427364",109635,150905,41270
"31683","Ocbimv22016684m.g","KQ415968",1922,40299,38377
"31684","Ocbimv22003828m.g","KQ417116",271716,272018,302
"31685","Ocbimv22005251m.g","KQ425554",24687,46535,21848
"31686","Ocbimv22024311m.g","KQ419564",210746,218027,7281
"31687","Ocbimv22033318m.g","KQ421770",33788,57021,23233
"31688","Ocbimv22036140m.g","KQ416620",211302,276523,65221
"31689","Ocbimv22007601m.g","KQ415844",35401,35693,292
"31690","Ocbimv22017900m.g","KQ418555",1681009,1692402,11393
"31691","Ocbimv22037638m.g","KQ423084",213702,214745,1043
"31692","Ocbimv22034317m.g","KQ422015",1464666,1465160,494
"31693","Ocbimv22009481m.g","KQ427014",290887,292325,1438
"31694","Ocbimv22029374m.g","KQ420733",100371,100544,173
"31695","Ocbimv22039902m.g","KQ416834",213526,289095,75569
"31696","Ocbimv22001131m.g","KQ424197",15905,16961,1056
"31697","Ocbimv22022885m.g","KQ419318",488972,497057,8085
"31698","Ocbimv22027885m.g","KQ420388",88459,88659,200
"31699","Ocbimv22018964m.g","KQ418702",727399,784946,57547
"31700","Ocbimv22011199m.g","KQ427674",13390,13770,380
"31701","Ocbimv22008150m.g","KQ417481",573047,597582,24535
"31702","Ocbimv22015411m.g","KQ429325",148994,181282,32288
"31703","Ocbimv22017620m.g","LGKD01637021",81,251,170
"31704","Ocbimv22025343m.g","KQ416150",106599,109622,3023
"31705","Ocbimv22035215m.g","KQ422314",72176,76449,4273
"31706","Ocbimv22007965m.g","KQ417464",260462,268243,7781
"31707","Ocbimv22039332m.g","KQ416788",385682,388102,2420
"31708","Ocbimv22029135m.g","KQ420662",223351,224815,1464
"31709","Ocbimv22035794m.g","KQ422550",200512,200691,179
"31710","Ocbimv22018059m.g","KQ418561",155832,156125,293
"31711","Ocbimv22014386m.g","KQ418125",58764,62750,3986
"31712","Ocbimv22039626m.g","KQ416810",920147,927322,7175
"31713","Ocbimv22010139m.g","KQ427275",340354,340740,386
"31714","Ocbimv22025536m.g","KQ419832",17173,18810,1637
"31715","Ocbimv22011353m.g","KQ417791",65039,65326,287
"31716","Ocbimv22009628m.g","KQ427059",6409,8002,1593
"31717","Ocbimv22018697m.g","LGKD01645059",1,189,188
"31718","Ocbimv22034497m.g","KQ422062",283657,300640,16983
"31719","Ocbimv22028327m.g","KQ420475",322067,322825,758
"31720","Ocbimv22026551m.g","KQ416192",147820,160054,12234
"31721","Ocbimv22005575m.g","KQ425655",217398,252067,34669
"31722","Ocbimv22020490m.g","KQ418919",501440,505512,4072
"31723","Ocbimv22015404m.g","KQ418240",98313,110646,12333
"31724","Ocbimv22025287m.g","KQ419760",3480,18354,14874
"31725","Ocbimv22032756m.g","KQ421655",136186,157102,20916
"31726","Ocbimv22019831m.g","KQ431332",512402,512795,393
"31727","Ocbimv22027593m.g","KQ420313",228346,237827,9481
"31728","Ocbimv22024396m.g","KQ415693",449945,450184,239
"31729","Ocbimv22033550m.g","KQ421829",36882,37067,185
"31730","Ocbimv22023445m.g","LGKD01688869",416,619,203
"31731","Ocbimv22020797m.g","KQ431857",60779,65806,5027
"31732","Ocbimv22012989m.g","KQ417968",15531,16304,773
"31733","Ocbimv22026989m.g","KQ420159",125412,186314,60902
"31734","Ocbimv22032272m.g","KQ421507",229502,254501,24999
"31735","Ocbimv22019329m.g","KQ431096",60516,70402,9886
"31736","Ocbimv22016309m.g","KQ418338",236401,247621,11220
"31737","Ocbimv22014800m.g","KQ429084",53266,69686,16420
"31738","Ocbimv22013773m.g","KQ428661",16637,46892,30255
"31739","Ocbimv22033773m.g","LGKD01083668",2,175,173
"31740","Ocbimv22026071m.g","LGKD01327357",3609,5811,2202
"31741","Ocbimv22016503m.g","KQ418363",152144,153476,1332
"31742","Ocbimv22039651m.g","KQ416811",204889,207402,2513
"31743","Ocbimv22000776m.g","KQ416881",11200,12022,822
"31744","Ocbimv22032063m.g","KQ421417",5420,8341,2921
"31745","Ocbimv22002263m.g","KQ424594",16648,33317,16669
"31746","Ocbimv22002292m.g","KQ417001",448812,540336,91524
"31747","Ocbimv22016745m.g","KQ429989",115656,149004,33348
"31748","Ocbimv22001716m.g","KQ424391",51361,51624,263
"31749","Ocbimv22037722m.g","KQ423122",462,1720,1258
"31750","Ocbimv22008731m.g","KQ417528",220085,220264,179
"31751","Ocbimv22001325m.g","KQ415784",526813,527166,353
"31752","Ocbimv22008703m.g","KQ426740",314827,314997,170
"31753","Ocbimv22014650m.g","KQ429026",109060,109341,281
"31754","Ocbimv22038522m.g","KQ423384",274895,318756,43861
"31755","Ocbimv22019398m.g","KQ416010",413615,421578,7963
"31756","Ocbimv22035250m.g","KQ422341",148960,184864,35904
"31757","Ocbimv22008701m.g","KQ426738",139062,139628,566
"31758","Ocbimv22006832m.g","KQ417358",160443,189463,29020
"31759","Ocbimv22003689m.g","KQ425066",184565,210379,25814
"31760","Ocbimv22015568m.g","KQ418267",575043,576148,1105
"31761","Ocbimv22034998m.g","KQ422238",1750,2226,476
"31762","Ocbimv22033117m.g","KQ421731",188171,270623,82452
"31763","Ocbimv22036623m.g","KQ416651",880608,880775,167
"31764","Ocbimv22003698m.g","KQ417101",136216,136584,368
"31765","Ocbimv22017466m.g","KQ418498",729493,764716,35223
"31766","Ocbimv22030186m.g","KQ420917",249246,249966,720
"31767","Ocbimv22008536m.g","KQ426670",46766,68343,21577
"31768","Ocbimv22028468m.g","KQ420496",165596,165914,318
"31769","Ocbimv22038087m.g","KQ423213",220440,228923,8483
"31770","Ocbimv22034495m.g","KQ422062",211745,212847,1102
"31771","Ocbimv22033636m.g","KQ421854",196388,197720,1332
"31772","Ocbimv22015105m.g","KQ418194",2783984,2784626,642
"31773","Ocbimv22027043m.g","KQ416209",180545,185473,4928
"31774","Ocbimv22012621m.g","KQ417921",969643,971218,1575
"31775","Ocbimv22000674m.g","KQ424049",94984,95331,347
"31776","Ocbimv22016978m.g","KQ418431",433758,491249,57491
"31777","Ocbimv22011313m.g","KQ417780",285692,285883,191
"31778","Ocbimv22016401m.g","KQ418344",5623,47258,41635
"31779","Ocbimv22028068m.g","KQ420424",274359,274706,347
"31780","Ocbimv22002085m.g","KQ424537",127076,127354,278
"31781","Ocbimv22000062m.g","KQ423839",219254,220716,1462
"31782","Ocbimv22016274m.g","KQ429784",217895,315312,97417
"31783","Ocbimv22024319m.g","KQ419566",422136,422823,687
"31784","Ocbimv22015641m.g","KQ418271",157056,157639,583
"31785","Ocbimv22000528m.g","KQ423988",76,20250,20174
"31786","Ocbimv22002288m.g","KQ417001",214677,264204,49527
"31787","Ocbimv22014731m.g","KQ418173",7870,52481,44611
"31788","Ocbimv22030856m.g","KQ416373",469901,524592,54691
"31789","Ocbimv22012342m.g","KQ415907",973682,993885,20203
"31790","Ocbimv22029183m.g","KQ420672",661002,674597,13595
"31791","Ocbimv22007717m.g","KQ417446",139340,149004,9664
"31792","Ocbimv22002305m.g","KQ424627",165312,172694,7382
"31793","Ocbimv22010783m.g","KQ427521",180515,194065,13550
"31794","Ocbimv22029208m.g","KQ416291",324859,325089,230
"31795","Ocbimv22028378m.g","KQ416257",195076,197317,2241
"31796","Ocbimv22028152m.g","KQ420439",68658,79349,10691
"31797","Ocbimv22024073m.g","KQ419533",6795,7720,925
"31798","Ocbimv22030611m.g","KQ416359",1016408,1016659,251
"31799","Ocbimv22021675m.g","KQ416051",48077,48268,191
"31800","Ocbimv22034665m.g","KQ422110",387420,387686,266
"31801","Ocbimv22017188m.g","KQ418463",20310,20507,197
"31802","Ocbimv22000966m.g","KQ424136",21552,22946,1394
"31803","Ocbimv22039524m.g","KQ423686",269326,269580,254
"31804","Ocbimv22016222m.g","KQ418328",619869,651121,31252
"31805","Ocbimv22006199m.g","KQ417303",34750,35580,830
"31806","Ocbimv22007020m.g","KQ417370",513749,519881,6132
"31807","Ocbimv22000526m.g","KQ416865",170081,183112,13031
"31808","Ocbimv22034008m.g","KQ421945",64660,64908,248
"31809","Ocbimv22025645m.g","KQ419874",240668,241108,440
"31810","Ocbimv22035260m.g","KQ416580",38119,40513,2394
"31811","Ocbimv22003864m.g","KQ417118",192409,194872,2463
"31812","Ocbimv22027031m.g","KQ420166",503365,504972,1607
"31813","Ocbimv22035114m.g","KQ422282",48617,49009,392
"31814","Ocbimv22038527m.g","KQ423384",383121,386396,3275
"31815","Ocbimv22018463m.g","KQ418619",40089,41011,922
"31816","Ocbimv22003069m.g","KQ424877",118614,121898,3284
"31817","Ocbimv22038979m.g","KQ423497",46380,48794,2414
"31818","Ocbimv22012454m.g","KQ428165",91095,92713,1618
"31819","Ocbimv22026291m.g","KQ420023",234433,265077,30644
"31820","Ocbimv22011080m.g","KQ417746",171316,172154,838
"31821","Ocbimv22025674m.g","KQ419885",3477,14519,11042
"31822","Ocbimv22032414m.g","KQ421532",310186,383834,73648
"31823","Ocbimv22024280m.g","KQ416121",109325,109585,260
"31824","Ocbimv22009966m.g","KQ427188",29,949,920
"31825","Ocbimv22022511m.g","KQ419238",21455,40409,18954
"31826","Ocbimv22006223m.g","KQ425846",92439,92767,328
"31827","Ocbimv22022616m.g","KQ432913",4177,6189,2012
"31828","Ocbimv22017210m.g","KQ430210",25176,36636,11460
"31829","Ocbimv22039628m.g","KQ416810",967989,982445,14456
"31830","Ocbimv22029605m.g","KQ420780",92748,97030,4282
"31831","Ocbimv22009752m.g","KQ427110",43426,43692,266
"31832","Ocbimv22032715m.g","KQ421642",207,7526,7319
"31833","Ocbimv22005981m.g","KQ417288",290585,293409,2824
"31834","Ocbimv22023620m.g","KQ419445",72219,95553,23334
"31835","Ocbimv22017606m.g","KQ430378",17815,18471,656
"31836","Ocbimv22033454m.g","KQ421816",735314,748065,12751
"31837","Ocbimv22039081m.g","KQ423541",12517,17470,4953
"31838","Ocbimv22024695m.g","KQ419615",569652,621907,52255
"31839","Ocbimv22003470m.g","KQ425015",547278,588034,40756
"31840","Ocbimv22009403m.g","KQ417591",355472,356199,727
"31841","Ocbimv22023713m.g","KQ419463",12574,27803,15229
"31842","Ocbimv22021808m.g","LGKD01671348",528,827,299
"31843","Ocbimv22028626m.g","KQ420536",15597,29100,13503
"31844","Ocbimv22016284m.g","KQ429791",12163,13215,1052
"31845","Ocbimv22018622m.g","KQ418644",1037637,1067608,29971
"31846","Ocbimv22035531m.g","KQ422422",576834,577028,194
"31847","Ocbimv22009069m.g","KQ426856",53760,91592,37832
"31848","Ocbimv22022586m.g","KQ416072",661050,661373,323
"31849","Ocbimv22038962m.g","KQ423493",1038157,1119063,80906
"31850","Ocbimv22007361m.g","KQ417408",115055,115807,752
"31851","Ocbimv22004547m.g","KQ417180",196319,196597,278
"31852","Ocbimv22010154m.g","KQ427290",9836,20443,10607
"31853","Ocbimv22007879m.g","KQ426479",49,1861,1812
"31854","Ocbimv22032020m.g","KQ421411",36014,74571,38557
"31855","Ocbimv22031169m.g","KQ421187",266073,268261,2188
"31856","Ocbimv22012272m.g","KQ428094",1425,7096,5671
"31857","Ocbimv22025137m.g","KQ419705",69668,69823,155
"31858","Ocbimv22035937m.g","KQ422615",87473,87688,215
"31859","Ocbimv22021365m.g","KQ432092",36423,36792,369
"31860","Ocbimv22015999m.g","KQ429647",104300,115717,11417
"31861","Ocbimv22010485m.g","KQ417681",1023292,1113449,90157
"31862","Ocbimv22018877m.g","KQ418693",605544,606139,595
"31863","Ocbimv22035806m.g","KQ422556",415967,433391,17424
"31864","Ocbimv22020050m.g","KQ431421",9482,9829,347
"31865","Ocbimv22018296m.g","KQ418598",327823,330404,2581
"31866","Ocbimv22007313m.g","KQ426287",290942,293088,2146
"31867","Ocbimv22022387m.g","KQ419213",60049,60445,396
"31868","Ocbimv22027725m.g","KQ420349",2399,16320,13921
"31869","Ocbimv22009146m.g","KQ415861",283961,286606,2645
"31870","Ocbimv22025646m.g","KQ419876",4638,7732,3094
"31871","Ocbimv22014768m.g","KQ418176",688526,700487,11961
"31872","Ocbimv22014389m.g","KQ418125",198929,232060,33131
"31873","Ocbimv22008497m.g","KQ417506",258594,259351,757
"31874","Ocbimv22006297m.g","KQ425863",27963,40104,12141
"31875","Ocbimv22028181m.g","KQ420441",97917,98285,368
"31876","Ocbimv22010737m.g","KQ427487",71840,73606,1766
"31877","Ocbimv22014787m.g","LGKD01612644",3,227,224
"31878","Ocbimv22004921m.g","KQ425468",25881,27430,1549
"31879","Ocbimv22027650m.g","KQ420330",229443,229628,185
"31880","Ocbimv22008699m.g","KQ426738",118198,122549,4351
"31881","Ocbimv22002244m.g","KQ416999",850091,897604,47513
"31882","Ocbimv22026166m.g","KQ420009",69180,74032,4852
"31883","Ocbimv22036325m.g","KQ415755",126005,127615,1610
"31884","Ocbimv22037271m.g","KQ422987",100307,100967,660
"31885","Ocbimv22028281m.g","KQ420458",22918,33402,10484
"31886","Ocbimv22003561m.g","KQ417090",1816511,1822768,6257
"31887","Ocbimv22025129m.g","KQ419698",152293,153844,1551
"31888","Ocbimv22002295m.g","KQ424622",7204,7615,411
"31889","Ocbimv22025837m.g","KQ416171",418569,418754,185
"31890","Ocbimv22032703m.g","KQ421638",114111,114479,368
"31891","Ocbimv22034951m.g","KQ422223",495015,497139,2124
"31892","Ocbimv22010393m.g","KQ427372",42476,43130,654
"31893","Ocbimv22037765m.g","KQ423129",88066,88392,326
"31894","Ocbimv22026979m.g","KQ420157",127027,156614,29587
"31895","Ocbimv22019237m.g","KQ418738",1199,1453,254
"31896","Ocbimv22022878m.g","KQ419318",331610,333206,1596
"31897","Ocbimv22021749m.g","KQ419094",206828,252703,45875
"31898","Ocbimv22038191m.g","KQ423231",238512,245302,6790
"31899","Ocbimv22025230m.g","KQ419742",77901,79537,1636
"31900","Ocbimv22000508m.g","KQ415777",432611,432760,149
"31901","Ocbimv22015089m.g","KQ418194",2081376,2081807,431
"31902","Ocbimv22024585m.g","KQ419601",731530,749853,18323
"31903","Ocbimv22032141m.g","KQ421460",151113,151607,494
"31904","Ocbimv22013469m.g","KQ428524",63220,63658,438
"31905","Ocbimv22003794m.g","KQ417112",1063311,1075945,12634
"31906","Ocbimv22012519m.g","KQ417917",507133,528094,20961
"31907","Ocbimv22028571m.g","KQ420524",213450,219674,6224
"31908","Ocbimv22034412m.g","KQ422033",38327,62634,24307
"31909","Ocbimv22028073m.g","KQ416246",60981,64597,3616
"31910","Ocbimv22003717m.g","KQ425069",193331,200574,7243
"31911","Ocbimv22032296m.g","KQ421516",3141,5029,1888
"31912","Ocbimv22022603m.g","KQ419270",10280,21524,11244
"31913","Ocbimv22029309m.g","KQ420706",10210,39663,29453
"31914","Ocbimv22038222m.g","KQ416731",666619,666942,323
"31915","Ocbimv22001181m.g","KQ424217",113616,113864,248
"31916","Ocbimv22021178m.g","KQ415686",631634,632359,725
"31917","Ocbimv22014138m.g","KQ428774",65328,65504,176
"31918","Ocbimv22015514m.g","KQ415945",729676,750198,20522
"31919","Ocbimv22007758m.g","KQ415847",826041,826488,447
"31920","Ocbimv22007164m.g","KQ417386",920363,921210,847
"31921","Ocbimv22001096m.g","KQ424179",1377,2625,1248
"31922","Ocbimv22012320m.g","KQ415907",347417,350771,3354
"31923","Ocbimv22034084m.g","KQ421961",312362,316835,4473
"31924","Ocbimv22038986m.g","KQ423499",153289,153793,504
"31925","Ocbimv22034255m.g","KQ422015",119015,162257,43242
"31926","Ocbimv22005313m.g","KQ425580",24444,45108,20664
"31927","Ocbimv22012472m.g","KQ417913",42784,43440,656
"31928","Ocbimv22027689m.g","KQ420342",33451,33690,239
"31929","Ocbimv22034341m.g","KQ422016",278042,278667,625
"31930","Ocbimv22003721m.g","KQ425075",170329,190653,20324
"31931","Ocbimv22036274m.g","KQ416628",783154,783393,239
"31932","Ocbimv22010982m.g","KQ417731",122283,138948,16665
"31933","Ocbimv22031111m.g","KQ416385",1411985,1412347,362
"31934","Ocbimv22024070m.g","KQ419532",28382,29332,950
"31935","Ocbimv22007743m.g","KQ415847",318636,328906,10270
"31936","Ocbimv22025944m.g","KQ419931",172026,172385,359
"31937","Ocbimv22006647m.g","KQ426052",10345,12913,2568
"31938","Ocbimv22006721m.g","KQ415834",201620,202485,865
"31939","Ocbimv22027903m.g","KQ416239",511188,511490,302
"31940","Ocbimv22009192m.g","KQ417569",237,710,473
"31941","Ocbimv22010721m.g","KQ427478",138986,176525,37539
"31942","Ocbimv22028619m.g","KQ416264",748283,755868,7585
"31943","Ocbimv22020977m.g","LGKD01664116",83,265,182
"31944","Ocbimv22011457m.g","KQ427753",44767,49193,4426
"31945","Ocbimv22017843m.g","KQ418552",70579,123807,53228
"31946","Ocbimv22001306m.g","KQ424264",279551,279913,362
"31947","Ocbimv22034069m.g","KQ416508",900362,920773,20411
"31948","Ocbimv22027669m.g","KQ416230",123294,126963,3669
"31949","Ocbimv22026871m.g","KQ420132",805981,828566,22585
"31950","Ocbimv22009305m.g","KQ417581",188245,243327,55082
"31951","Ocbimv22023306m.g","KQ416087",652361,663219,10858
"31952","Ocbimv22015098m.g","KQ418194",2466253,2468118,1865
"31953","Ocbimv22000246m.g","KQ423905",86001,88522,2521
"31954","Ocbimv22016106m.g","KQ429708",309152,310936,1784
"31955","Ocbimv22036812m.g","KQ416658",1111374,1111748,374
"31956","Ocbimv22002897m.g","KQ424814",553459,560657,7198
"31957","Ocbimv22027302m.g","KQ420250",11712,11948,236
"31958","Ocbimv22000039m.g","KQ423831",342022,342279,257
"31959","Ocbimv22035586m.g","KQ422447",785878,786765,887
"31960","Ocbimv22001643m.g","KQ416950",1736036,1854050,118014
"31961","Ocbimv22028914m.g","KQ416274",1916979,1936325,19346
"31962","Ocbimv22011815m.g","KQ415893",519705,519941,236
"31963","Ocbimv22027329m.g","KQ420260",1096030,1096236,206
"31964","Ocbimv22039340m.g","KQ416790",71915,74547,2632
"31965","Ocbimv22005682m.g","KQ417272",268439,269005,566
"31966","Ocbimv22018086m.g","KQ418571",303264,309249,5985
"31967","Ocbimv22034462m.g","KQ422050",264684,268898,4214
"31968","Ocbimv22021093m.g","KQ431983",29164,30283,1119
"31969","Ocbimv22017151m.g","LGKD01633276",968,1984,1016
"31970","Ocbimv22035795m.g","KQ422554",14941,15360,419
"31971","Ocbimv22017686m.g","KQ430417",63606,64684,1078
"31972","Ocbimv22015512m.g","KQ415945",580421,580930,509
"31973","Ocbimv22007163m.g","KQ417386",744699,746930,2231
"31974","Ocbimv22017809m.g","KQ418549",245433,245708,275
"31975","Ocbimv22013923m.g","KQ428714",25746,55105,29359
"31976","Ocbimv22031195m.g","KQ421196",26346,40747,14401
"31977","Ocbimv22020516m.g","KQ418921",901731,901964,233
"31978","Ocbimv22007491m.g","KQ415843",191708,202296,10588
"31979","Ocbimv22008347m.g","KQ417497",1921078,1921714,636
"31980","Ocbimv22039686m.g","KQ416813",2071153,2071459,306
"31981","Ocbimv22009507m.g","KQ415865",610683,629797,19114
"31982","Ocbimv22021355m.g","KQ416042",1914982,1921446,6464
"31983","Ocbimv22024127m.g","KQ419537",256598,256936,338
"31984","Ocbimv22001026m.g","KQ424157",377913,396957,19044
"31985","Ocbimv22008822m.g","KQ426775",34136,70844,36708
"31986","Ocbimv22025558m.g","KQ419838",420589,421578,989
"31987","Ocbimv22034535m.g","KQ416536",162750,172345,9595
"31988","Ocbimv22030344m.g","KQ420958",259673,261703,2030
"31989","Ocbimv22033249m.g","KQ421758",1394837,1395558,721
"31990","Ocbimv22005242m.g","KQ417234",253724,254536,812
"31991","Ocbimv22033230m.g","KQ421758",506417,508042,1625
"31992","Ocbimv22000781m.g","KQ416881",168149,262595,94446
"31993","Ocbimv22008274m.g","KQ417492",726382,727008,626
"31994","Ocbimv22003718m.g","KQ425070",6,515,509
"31995","Ocbimv22000425m.g","KQ423959",44332,60726,16394
"31996","Ocbimv22015306m.g","KQ418217",99626,105400,5774
"31997","Ocbimv22010031m.g","KQ415869",625380,626740,1360
"31998","Ocbimv22033255m.g","KQ421758",1467937,1478765,10828
"31999","Ocbimv22029019m.g","KQ420625",137602,137796,194
"32000","Ocbimv22001450m.g","KQ416933",638318,640682,2364
"32001","Ocbimv22001984m.g","KQ415787",1070787,1072366,1579
"32002","Ocbimv22011953m.g","KQ417847",1244056,1281663,37607
"32003","Ocbimv22009196m.g","KQ417572",85015,85392,377
"32004","Ocbimv22005814m.g","KQ417280",13540,16898,3358
"32005","Ocbimv22031627m.g","KQ421305",41850,42899,1049
"32006","Ocbimv22033375m.g","KQ416478",35670,52511,16841
"32007","Ocbimv22038403m.g","KQ416739",198,4972,4774
"32008","Ocbimv22005440m.g","KQ417252",594257,594577,320
"32009","Ocbimv22007912m.g","KQ417459",296154,303854,7700
"32010","Ocbimv22021920m.g","KQ419132",382057,382413,356
"32011","Ocbimv22002341m.g","KQ415791",393587,425228,31641
"32012","Ocbimv22011104m.g","KQ417748",99547,100637,1090
"32013","Ocbimv22033167m.g","KQ421738",674,1512,838
"32014","Ocbimv22022294m.g","KQ419192",823777,824862,1085
"32015","Ocbimv22009913m.g","KQ427153",86770,87336,566
"32016","Ocbimv22013278m.g","KQ428432",69648,73371,3723
"32017","Ocbimv22021182m.g","KQ419012",6589,30746,24157
"32018","Ocbimv22005411m.g","KQ417249",2571907,2582995,11088
"32019","Ocbimv22028566m.g","KQ420522",237392,237571,179
"32020","Ocbimv22009677m.g","KQ417601",337393,338910,1517
"32021","Ocbimv22035068m.g","LGKD01436048",1,195,194
"32022","Ocbimv22012544m.g","KQ417917",908257,925064,16807
"32023","Ocbimv22001466m.g","KQ424308",14482,16444,1962
"32024","Ocbimv22024072m.g","KQ419532",66419,77595,11176
"32025","Ocbimv22011407m.g","KQ417791",1140265,1149216,8951
"32026","Ocbimv22020316m.g","KQ418890",41720,41884,164
"32027","Ocbimv22023937m.g","KQ419503",3279,6913,3634
"32028","Ocbimv22013296m.g","KQ418007",643789,645182,1393
"32029","Ocbimv22025593m.g","KQ419857",245151,262283,17132
"32030","Ocbimv22002349m.g","KQ424640",76725,79653,2928
"32031","Ocbimv22038289m.g","KQ423260",351123,366770,15647
"32032","Ocbimv22000694m.g","KQ424055",677148,698688,21540
"32033","Ocbimv22035595m.g","KQ416594",60082,76685,16603
"32034","Ocbimv22012569m.g","KQ417917",1435205,1436872,1667
"32035","Ocbimv22037895m.g","KQ416714",5542,6694,1152
"32036","Ocbimv22028593m.g","KQ416263",37050,37250,200
"32037","Ocbimv22011833m.g","KQ415893",1283492,1283686,194
"32038","Ocbimv22021262m.g","KQ432063",110564,112727,2163
"32039","Ocbimv22023840m.g","KQ419485",248693,248914,221
"32040","Ocbimv22014817m.g","KQ429096",398435,403149,4714
"32041","Ocbimv22001720m.g","KQ416957",9650,10204,554
"32042","Ocbimv22015749m.g","KQ418289",94384,95496,1112
"32043","Ocbimv22038630m.g","KQ423423",119122,121966,2844
"32044","Ocbimv22034196m.g","KQ422001",186568,187287,719
"32045","Ocbimv22026286m.g","KQ420023",167798,168505,707
"32046","Ocbimv22003012m.g","KQ417054",219005,219225,220
"32047","Ocbimv22022948m.g","KQ419329",91522,93339,1817
"32048","Ocbimv22024506m.g","KQ419590",813979,814581,602
"32049","Ocbimv22024114m.g","KQ433802",1,1568,1567
"32050","Ocbimv22038428m.g","KQ423336",343745,344032,287
"32051","Ocbimv22003731m.g","KQ425076",307060,307749,689
"32052","Ocbimv22014150m.g","KQ428779",419,2938,2519
"32053","Ocbimv22031190m.g","KQ416390",593240,622172,28932
"32054","Ocbimv22026311m.g","KQ420023",566850,567200,350
"32055","Ocbimv22024715m.g","KQ419621",340177,340371,194
"32056","Ocbimv22033141m.g","KQ421736",13991,14763,772
"32057","Ocbimv22032222m.g","KQ421487",25029,25217,188
"32058","Ocbimv22033310m.g","KQ421769",112145,117531,5386
"32059","Ocbimv22005805m.g","KQ415823",1179842,1193020,13178
"32060","Ocbimv22005631m.g","KQ425692",57390,63652,6262
"32061","Ocbimv22022146m.g","KQ419176",132063,132230,167
"32062","Ocbimv22006404m.g","KQ417318",535772,553966,18194
"32063","Ocbimv22015938m.g","KQ418303",1314330,1316928,2598
"32064","Ocbimv22017446m.g","LGKD01635551",4,300,296
"32065","Ocbimv22005239m.g","KQ425549",67594,68637,1043
"32066","Ocbimv22010814m.g","KQ427527",528,10160,9632
"32067","Ocbimv22005100m.g","KQ417228",923934,924224,290
"32068","Ocbimv22015421m.g","KQ418241",546691,547362,671
"32069","Ocbimv22014179m.g","KQ418098",90948,92065,1117
"32070","Ocbimv22024228m.g","KQ433872",690,4245,3555
"32071","Ocbimv22006370m.g","KQ425894",172189,202435,30246
"32072","Ocbimv22010979m.g","KQ417730",159855,161461,1606
"32073","Ocbimv22013107m.g","KQ417982",191694,255663,63969
"32074","Ocbimv22029601m.g","KQ420779",488455,513302,24847
"32075","Ocbimv22005107m.g","KQ415813",152735,169895,17160
"32076","Ocbimv22002004m.g","KQ416979",1512813,1523827,11014
"32077","Ocbimv22013052m.g","KQ417977",152041,157415,5374
"32078","Ocbimv22031795m.g","KQ416408",117126,144789,27663
"32079","Ocbimv22017594m.g","KQ430374",57627,58722,1095
"32080","Ocbimv22025174m.g","KQ416141",853172,853726,554
"32081","Ocbimv22039406m.g","KQ423651",891930,892169,239
"32082","Ocbimv22028363m.g","KQ420477",423802,433174,9372
"32083","Ocbimv22022263m.g","KQ416064",2281505,2283901,2396
"32084","Ocbimv22012364m.g","KQ428130",225785,238262,12477
"32085","Ocbimv22039010m.g","KQ416777",233599,253486,19887
"32086","Ocbimv22024886m.g","KQ419647",62622,250068,187446
"32087","Ocbimv22036343m.g","KQ422717",158422,240846,82424
"32088","Ocbimv22009880m.g","KQ417621",335146,342145,6999
"32089","Ocbimv22005978m.g","KQ417288",164861,274907,110046
"32090","Ocbimv22012308m.g","KQ415907",20561,53706,33145
"32091","Ocbimv22032010m.g","KQ421409",1033165,1033563,398
"32092","Ocbimv22027678m.g","KQ420335",3545,48573,45028
"32093","Ocbimv22012214m.g","KQ415904",400296,402456,2160
"32094","Ocbimv22012561m.g","KQ417917",1223973,1224131,158
"32095","Ocbimv22002330m.g","KQ424629",226471,234304,7833
"32096","Ocbimv22011684m.g","KQ417819",53637,65832,12195
"32097","Ocbimv22039907m.g","KQ416834",346239,349318,3079
"32098","Ocbimv22020450m.g","LGKD01267754",9,284,275
"32099","Ocbimv22008341m.g","KQ417497",1671785,1672693,908
"32100","Ocbimv22016419m.g","LGKD01627413",207,545,338
"32101","Ocbimv22039471m.g","KQ423675",132021,148724,16703
"32102","Ocbimv22010705m.g","KQ417704",93302,95188,1886
"32103","Ocbimv22025911m.g","KQ419925",234103,236949,2846
"32104","Ocbimv22016730m.g","KQ429984",34462,44938,10476
"32105","Ocbimv22004899m.g","KQ417213",280845,306224,25379
"32106","Ocbimv22005325m.g","KQ417240",482655,496564,13909
"32107","Ocbimv22037787m.g","KQ416711",300228,324561,24333
"32108","Ocbimv22009026m.g","KQ426847",9034,10833,1799
"32109","Ocbimv22025920m.g","KQ419927",1084175,1084651,476
"32110","Ocbimv22004465m.g","KQ425323",6230,6426,196
"32111","Ocbimv22008308m.g","KQ417496",309758,317922,8164
"32112","Ocbimv22001896m.g","KQ424463",3356,8516,5160
"32113","Ocbimv22028981m.g","KQ420621",93129,121890,28761
"32114","Ocbimv22025356m.g","KQ419781",53470,75601,22131
"32115","Ocbimv22005923m.g","KQ417284",459743,460270,527
"32116","Ocbimv22029845m.g","KQ420828",1354626,1373576,18950
"32117","Ocbimv22018122m.g","KQ430572",488933,494475,5542
"32118","Ocbimv22034096m.g","KQ421974",51111,52858,1747
"32119","Ocbimv22031361m.g","KQ421221",539726,539878,152
"32120","Ocbimv22000701m.g","KQ416877",233195,285281,52086
"32121","Ocbimv22010772m.g","KQ427511",141820,144087,2267
"32122","Ocbimv22025873m.g","KQ419917",564248,565121,873
"32123","Ocbimv22028745m.g","KQ420572",72998,73249,251
"32124","Ocbimv22013633m.g","KQ418040",270541,323129,52588
"32125","Ocbimv22022465m.g","KQ419223",347492,354048,6556
"32126","Ocbimv22011333m.g","KQ427712",17486,17662,176
"32127","Ocbimv22021615m.g","KQ432252",219856,242516,22660
"32128","Ocbimv22010976m.g","KQ427579",14310,23499,9189
"32129","Ocbimv22021055m.g","KQ431974",32,13079,13047
"32130","Ocbimv22039056m.g","KQ423531",147254,194901,47647
"32131","Ocbimv22033150m.g","KQ421737",185169,186574,1405
"32132","Ocbimv22036410m.g","KQ416641",153755,168931,15176
"32133","Ocbimv22000544m.g","KQ423995",102220,103972,1752
"32134","Ocbimv22038210m.g","KQ416731",604396,606817,2421
"32135","Ocbimv22027288m.g","KQ420243",225883,226461,578
"32136","Ocbimv22030316m.g","KQ420945",46197,66833,20636
"32137","Ocbimv22028814m.g","KQ416272",559348,628142,68794
"32138","Ocbimv22035845m.g","KQ422575",19283,57845,38562
"32139","Ocbimv22008467m.g","KQ415854",489629,489969,340
"32140","Ocbimv22033321m.g","KQ421772",345366,346738,1372
"32141","Ocbimv22007061m.g","KQ417374",6070,6342,272
"32142","Ocbimv22020452m.g","KQ416029",25268,25735,467
"32143","Ocbimv22016673m.g","KQ418378",159262,159717,455
"32144","Ocbimv22013169m.g","KQ417996",284322,295976,11654
"32145","Ocbimv22025013m.g","KQ416136",894,25975,25081
"32146","Ocbimv22039891m.g","KQ416834",44393,81506,37113
"32147","Ocbimv22013495m.g","KQ418031",291829,339568,47739
"32148","Ocbimv22030351m.g","KQ416345",378913,379281,368
"32149","Ocbimv22008245m.g","KQ426602",43356,51466,8110
"32150","Ocbimv22027599m.g","KQ420313",366629,383534,16905
"32151","Ocbimv22018669m.g","KQ418652",164240,164725,485
"32152","Ocbimv22001853m.g","KQ424450",486428,486655,227
"32153","Ocbimv22020443m.g","LGKD01660513",35,214,179
"32154","Ocbimv22009612m.g","LGKD01572067",10740,13843,3103
"32155","Ocbimv22006405m.g","KQ417318",543488,544470,982
"32156","Ocbimv22036402m.g","KQ422750",30567,32057,1490
"32157","Ocbimv22004325m.g","KQ417148",2209,3705,1496
"32158","Ocbimv22007212m.g","KQ426251",679,1068,389
"32159","Ocbimv22004991m.g","KQ417223",87385,187303,99918
"32160","Ocbimv22025050m.g","KQ416136",823368,824856,1488
"32161","Ocbimv22005896m.g","KQ415825",99272,117192,17920
"32162","Ocbimv22032479m.g","KQ416432",14016,16987,2971
"32163","Ocbimv22015033m.g","KQ418194",587886,588125,239
"32164","Ocbimv22004203m.g","KQ425223",58218,62213,3995
"32165","Ocbimv22036786m.g","KQ416657",181225,182369,1144
"32166","Ocbimv22017138m.g","KQ418453",194208,267635,73427
"32167","Ocbimv22026177m.g","KQ420011",59948,84458,24510
"32168","Ocbimv22005736m.g","KQ425732",162176,162394,218
"32169","Ocbimv22031479m.g","KQ421258",125543,133291,7748
"32170","Ocbimv22023995m.g","KQ419514",1147630,1278935,131305
"32171","Ocbimv22013157m.g","KQ428392",4037,5397,1360
"32172","Ocbimv22015284m.g","KQ415941",223527,224012,485
"32173","Ocbimv22008747m.g","KQ426758",325720,326043,323
"32174","Ocbimv22028317m.g","KQ420471",200842,206776,5934
"32175","Ocbimv22032827m.g","KQ421664",674025,677872,3847
"32176","Ocbimv22028843m.g","KQ420592",542027,542395,368
"32177","Ocbimv22023682m.g","KQ419458",370716,398802,28086
"32178","Ocbimv22021105m.g","LGKD01665597",62,358,296
"32179","Ocbimv22017080m.g","KQ430161",1766,3282,1516
"32180","Ocbimv22001301m.g","KQ424264",2022,2117,95
"32181","Ocbimv22039798m.g","KQ416825",430763,431743,980
"32182","Ocbimv22033431m.g","KQ421810",164249,179032,14783
"32183","Ocbimv22016958m.g","KQ430109",43121,93930,50809
"32184","Ocbimv22029108m.g","KQ420653",3433,4133,700
"32185","Ocbimv22023153m.g","KQ433242",28640,137852,109212
"32186","Ocbimv22031823m.g","KQ421356",77701,105385,27684
"32187","Ocbimv22026060m.g","LGKD01055259",52,306,254
"32188","Ocbimv22012546m.g","KQ417917",949027,951199,2172
"32189","Ocbimv22013485m.g","KQ415916",281904,285380,3476
"32190","Ocbimv22003796m.g","KQ425101",59020,59677,657
"32191","Ocbimv22030553m.g","KQ421022",15810,42770,26960
"32192","Ocbimv22019859m.g","KQ418823",19087,20520,1433
"32193","Ocbimv22036355m.g","KQ422719",9065,25868,16803
"32194","Ocbimv22038866m.g","KQ416769",691463,691858,395
"32195","Ocbimv22007590m.g","KQ417435",10405,30467,20062
"32196","Ocbimv22037876m.g","KQ423141",190285,190440,155
"32197","Ocbimv22033866m.g","KQ421896",317396,322828,5432
"32198","Ocbimv22018561m.g","KQ418637",71127,103358,32231
"32199","Ocbimv22004493m.g","KQ417173",223616,224352,736
"32200","Ocbimv22002629m.g","KQ417023",887238,895237,7999
"32201","Ocbimv22027190m.g","KQ420215",26371,30856,4485
"32202","Ocbimv22001860m.g","KQ416971",331011,331437,426
"32203","Ocbimv22038307m.g","KQ423275",89594,90767,1173
"32204","Ocbimv22008760m.g","KQ426760",269979,317524,47545
"32205","Ocbimv22010694m.g","KQ417703",395587,402166,6579
"32206","Ocbimv22031679m.g","KQ421308",444989,445316,327
"32207","Ocbimv22001727m.g","KQ416957",46866,47776,910
"32208","Ocbimv22000652m.g","KQ424033",19574,29035,9461
"32209","Ocbimv22008720m.g","KQ415858",1346237,1346755,518
"32210","Ocbimv22015695m.g","KQ418277",232559,233017,458
"32211","Ocbimv22010361m.g","KQ417674",7754,30527,22773
"32212","Ocbimv22007657m.g","KQ426411",8018,8699,681
"32213","Ocbimv22002530m.g","KQ424677",73354,75080,1726
"32214","Ocbimv22038551m.g","KQ423398",58644,59491,847
"32215","Ocbimv22038381m.g","KQ416738",762296,774669,12373
"32216","Ocbimv22008340m.g","KQ417497",1554466,1556254,1788
"32217","Ocbimv22021008m.g","KQ431922",177656,189825,12169
"32218","Ocbimv22016869m.g","LGKD01631214",102,499,397
"32219","Ocbimv22019967m.g","KQ418839",440568,502691,62123
"32220","Ocbimv22011115m.g","KQ427644",299537,303179,3642
"32221","Ocbimv22014358m.g","KQ428878",5746,24351,18605
"32222","Ocbimv22020269m.g","KQ418881",149444,158647,9203
"32223","Ocbimv22005150m.g","KQ425531",6041,16757,10716
"32224","Ocbimv22030285m.g","KQ420939",129556,134814,5258
"32225","Ocbimv22025887m.g","KQ416175",472328,489565,17237
"32226","Ocbimv22028090m.g","KQ416248",46124,48151,2027
"32227","Ocbimv22039019m.g","KQ423511",4512,15596,11084
"32228","Ocbimv22033756m.g","KQ421865",14033,26533,12500
"32229","Ocbimv22033794m.g","KQ421871",498751,518205,19454
"32230","Ocbimv22037282m.g","KQ422989",96592,118821,22229
"32231","Ocbimv22034627m.g","KQ415738",148147,148428,281
"32232","Ocbimv22025308m.g","KQ419766",74877,75163,286
"32233","Ocbimv22014896m.g","KQ429131",457660,497257,39597
"32234","Ocbimv22002851m.g","KQ424803",219721,243658,23937
"32235","Ocbimv22035006m.g","KQ422245",33330,81323,47993
"32236","Ocbimv22038180m.g","KQ423229",499585,499809,224
"32237","Ocbimv22005049m.g","KQ425506",15979,22550,6571
"32238","Ocbimv22028231m.g","KQ416253",42242,42454,212
"32239","Ocbimv22021453m.g","KQ419052",27655,27888,233
"32240","Ocbimv22038182m.g","KQ423231",71655,94600,22945
"32241","Ocbimv22031945m.g","KQ421388",1999,3679,1680
"32242","Ocbimv22030662m.g","KQ421053",119300,122054,2754
"32243","Ocbimv22030761m.g","KQ421084",9636,11917,2281
"32244","Ocbimv22014101m.g","KQ428760",63741,64205,464
"32245","Ocbimv22035015m.g","KQ422246",145607,158691,13084
"32246","Ocbimv22022777m.g","KQ433008",8336,53556,45220
"32247","Ocbimv22023718m.g","KQ416094",327815,328342,527
"32248","Ocbimv22029341m.g","KQ420711",929375,950900,21525
"32249","Ocbimv22016759m.g","KQ418393",148372,149328,956
"32250","Ocbimv22028125m.g","KQ416251",153659,186699,33040
"32251","Ocbimv22010466m.g","KQ427401",70485,72712,2227
"32252","Ocbimv22014117m.g","KQ418091",96413,131604,35191
"32253","Ocbimv22020587m.g","LGKD01661244",160,716,556
"32254","Ocbimv22000967m.g","KQ424136",24027,26002,1975
"32255","Ocbimv22004304m.g","KQ417147",278978,279574,596
"32256","Ocbimv22018543m.g","KQ415995",218759,221431,2672
"32257","Ocbimv22007664m.g","KQ417440",20740,33282,12542
"32258","Ocbimv22014712m.g","KQ418169",87890,110517,22627
"32259","Ocbimv22021929m.g","KQ419133",285084,306730,21646
"32260","Ocbimv22027829m.g","KQ420375",1234819,1234998,179
"32261","Ocbimv22011846m.g","KQ427920",10697,50938,40241
"32262","Ocbimv22037069m.g","KQ416671",132598,133460,862
"32263","Ocbimv22019843m.g","KQ418821",613850,615031,1181
"32264","Ocbimv22021662m.g","KQ416049",253824,254970,1146
"32265","Ocbimv22009711m.g","KQ427096",123743,124082,339
"32266","Ocbimv22037119m.g","KQ416673",377744,377896,152
"32267","Ocbimv22006444m.g","KQ417320",85277,105466,20189
"32268","Ocbimv22032367m.g","KQ421524",63618,66143,2525
"32269","Ocbimv22036636m.g","KQ416651",1648951,1679134,30183
"32270","Ocbimv22038733m.g","KQ416764",119516,143383,23867
"32271","Ocbimv22031493m.g","KQ421261",357540,422848,65308
"32272","Ocbimv22006329m.g","KQ425878",11206,47663,36457
"32273","Ocbimv22020027m.g","KQ418843",166214,188848,22634
"32274","Ocbimv22035168m.g","KQ415662",153697,154062,365
"32275","Ocbimv22012118m.g","LGKD01198379",27,221,194
"32276","Ocbimv22023708m.g","KQ419461",92899,93126,227
"32277","Ocbimv22011472m.g","KQ417793",224090,271150,47060
"32278","Ocbimv22011570m.g","KQ427785",103773,109886,6113
"32279","Ocbimv22029060m.g","KQ420639",297657,297821,164
"32280","Ocbimv22003558m.g","KQ417090",1805014,1811949,6935
"32281","Ocbimv22012073m.g","KQ428000",86133,87312,1179
"32282","Ocbimv22038022m.g","KQ416719",792919,816855,23936
"32283","Ocbimv22028638m.g","KQ415707",110773,111043,270
"32284","Ocbimv22002976m.g","KQ417051",2336010,2336165,155
"32285","Ocbimv22038838m.g","KQ416768",298624,299106,482
"32286","Ocbimv22009464m.g","LGKD01570927",106,219,113
"32287","Ocbimv22004054m.g","KQ425191",3557,3772,215
"32288","Ocbimv22005034m.g","KQ417225",19109,26847,7738
"32289","Ocbimv22026482m.g","KQ420055",777764,782667,4903
"32290","Ocbimv22010341m.g","KQ415875",278841,281489,2648
"32291","Ocbimv22029659m.g","KQ416315",348172,348339,167
"32292","Ocbimv22021922m.g","KQ419133",2856,4996,2140
"32293","Ocbimv22019788m.g","KQ431313",1488,2204,716
"32294","Ocbimv22033027m.g","KQ421720",119575,120132,557
"32295","Ocbimv22035751m.g","KQ422523",8516,11266,2750
"32296","Ocbimv22016865m.g","KQ418413",392036,407173,15137
"32297","Ocbimv22039279m.g","KQ416787",109690,126991,17301
"32298","Ocbimv22019469m.g","KQ418771",181005,193599,12594
"32299","Ocbimv22013020m.g","KQ417974",208285,211260,2975
"32300","Ocbimv22039180m.g","KQ415772",248639,248845,206
"32301","Ocbimv22011230m.g","KQ417763",924330,925937,1607
"32302","Ocbimv22028986m.g","KQ420622",8364,8669,305
"32303","Ocbimv22014581m.g","KQ428994",155770,156962,1192
"32304","Ocbimv22008649m.g","KQ417518",235519,249583,14064
"32305","Ocbimv22023510m.g","KQ419420",192850,196194,3344
"32306","Ocbimv22000648m.g","KQ416872",545660,546039,379
"32307","Ocbimv22031461m.g","KQ416399",199503,202109,2606
"32308","Ocbimv22031212m.g","KQ421200",278127,293346,15219
"32309","Ocbimv22005750m.g","KQ425733",169672,173266,3594
"32310","Ocbimv22012825m.g","KQ428255",172,2006,1834
"32311","Ocbimv22024980m.g","KQ419670",464997,465963,966
"32312","Ocbimv22005162m.g","KQ425537",32790,33680,890
"32313","Ocbimv22033096m.g","KQ421725",59857,62404,2547
"32314","Ocbimv22031206m.g","KQ421200",154318,176591,22273
"32315","Ocbimv22022398m.g","KQ419215",273497,287076,13579
"32316","Ocbimv22027153m.g","KQ420204",539756,540004,248
"32317","Ocbimv22003872m.g","KQ417118",382494,389638,7144
"32318","Ocbimv22005238m.g","KQ425549",14379,51101,36722
"32319","Ocbimv22028113m.g","KQ416250",85067,87202,2135
"32320","Ocbimv22014893m.g","KQ429131",214552,215720,1168
"32321","Ocbimv22034390m.g","KQ422028",45530,45871,341
"32322","Ocbimv22020463m.g","LGKD01660916",406,567,161
"32323","Ocbimv22027936m.g","KQ420404",1183429,1183883,454
"32324","Ocbimv22006222m.g","KQ425846",87891,88514,623
"32325","Ocbimv22036525m.g","KQ422783",138601,139011,410
"32326","Ocbimv22035198m.g","KQ422300",146527,180039,33512
"32327","Ocbimv22009199m.g","KQ417573",379225,382314,3089
"32328","Ocbimv22019302m.g","KQ418745",270577,293373,22796
"32329","Ocbimv22039855m.g","KQ423780",638526,672752,34226
"32330","Ocbimv22000066m.g","KQ423841",7791,10649,2858
"32331","Ocbimv22027896m.g","KQ420393",83366,83668,302
"32332","Ocbimv22027231m.g","KQ420223",75581,76734,1153
"32333","Ocbimv22013291m.g","KQ418007",475857,476105,248
"32334","Ocbimv22000492m.g","KQ416864",666553,667413,860
"32335","Ocbimv22032270m.g","KQ421507",180461,182999,2538
"32336","Ocbimv22025064m.g","LGKD01313034",237,500,263
"32337","Ocbimv22016472m.g","KQ415966",195665,196107,442
"32338","Ocbimv22001803m.g","KQ424425",434671,434994,323
"32339","Ocbimv22026389m.g","KQ420035",137873,151418,13545
"32340","Ocbimv22032041m.g","KQ421413",28,5898,5870
"32341","Ocbimv22003342m.g","KQ424982",58780,59199,419
"32342","Ocbimv22000869m.g","KQ424096",543294,544291,997
"32343","Ocbimv22019795m.g","KQ431315",19705,19876,171
"32344","Ocbimv22024287m.g","KQ416121",902468,902677,209
"32345","Ocbimv22019763m.g","KQ418811",897012,899271,2259
"32346","Ocbimv22023962m.g","KQ419508",318844,318996,152
"32347","Ocbimv22025993m.g","KQ416179",16724,67823,51099
"32348","Ocbimv22032258m.g","KQ421506",8371,26422,18051
"32349","Ocbimv22028493m.g","KQ420512",30561,31240,679
"32350","Ocbimv22014161m.g","KQ418096",388699,389145,446
"32351","Ocbimv22024153m.g","KQ419541",52583,53770,1187
"32352","Ocbimv22010528m.g","KQ417687",1117573,1117977,404
"32353","Ocbimv22022846m.g","KQ433054",78298,78650,352
"32354","Ocbimv22035901m.g","KQ422595",400967,403860,2893
"32355","Ocbimv22005262m.g","LGKD01536245",19,312,293
"32356","Ocbimv22018572m.g","KQ430766",30529,31929,1400
"32357","Ocbimv22025758m.g","KQ416166",468693,473092,4399
"32358","Ocbimv22003250m.g","KQ417068",952186,952816,630
"32359","Ocbimv22012107m.g","KQ417874",288490,317802,29312
"32360","Ocbimv22004697m.g","KQ417198",297682,298455,773
"32361","Ocbimv22006986m.g","KQ417370",42572,48860,6288
"32362","Ocbimv22034324m.g","KQ422016",60950,62350,1400
"32363","Ocbimv22023885m.g","KQ419491",178634,208065,29431
"32364","Ocbimv22036052m.g","KQ416615",11045,18396,7351
"32365","Ocbimv22039394m.g","KQ416793",1609,3472,1863
"32366","Ocbimv22001002m.g","KQ424146",265527,267492,1965
"32367","Ocbimv22010170m.g","KQ427298",38940,88082,49142
"32368","Ocbimv22032304m.g","KQ421521",109414,109677,263
"32369","Ocbimv22002929m.g","KQ417050",178937,191703,12766
"32370","Ocbimv22018789m.g","KQ430875",50681,67477,16796
"32371","Ocbimv22012363m.g","KQ428130",217548,218921,1373
"32372","Ocbimv22036098m.g","KQ422641",93641,94021,380
"32373","Ocbimv22013053m.g","KQ417977",158969,169391,10422
"32374","Ocbimv22037144m.g","KQ416676",44895,45176,281
"32375","Ocbimv22004706m.g","KQ425422",45535,46605,1070
"32376","Ocbimv22003593m.g","KQ417094",227514,230349,2835
"32377","Ocbimv22001097m.g","KQ424180",16682,16894,212
"32378","Ocbimv22006553m.g","KQ426013",6844,7146,302
"32379","Ocbimv22029036m.g","KQ420630",274229,276665,2436
"32380","Ocbimv22010231m.g","KQ427322",145738,146166,428
"32381","Ocbimv22010519m.g","KQ427417",73522,73986,464
"32382","Ocbimv22024656m.g","KQ419607",373935,479644,105709
"32383","Ocbimv22021644m.g","KQ419081",58372,58764,392
"32384","Ocbimv22007565m.g","KQ417429",135451,164766,29315
"32385","Ocbimv22016009m.g","KQ418310",50990,52354,1364
"32386","Ocbimv22031232m.g","KQ421203",121883,152331,30448
"32387","Ocbimv22000365m.g","KQ423941",133852,169706,35854
"32388","Ocbimv22020740m.g","KQ418958",67395,68198,803
"32389","Ocbimv22031475m.g","KQ416399",378015,379958,1943
"32390","Ocbimv22023234m.g","KQ419378",122734,123134,400
"32391","Ocbimv22038620m.g","LGKD01474036",198,488,290
"32392","Ocbimv22021571m.g","KQ419079",73682,74053,371
"32393","Ocbimv22008554m.g","KQ417509",51851,53256,1405
"32394","Ocbimv22037792m.g","KQ416712",158199,159707,1508
"32395","Ocbimv22036843m.g","KQ422875",3861,9515,5654
"32396","Ocbimv22023333m.g","KQ419395",20326,30015,9689
"32397","Ocbimv22032442m.g","KQ416431",445,40350,39905
"32398","Ocbimv22029914m.g","LGKD01374071",42,446,404
"32399","Ocbimv22039313m.g","KQ416788",43623,44085,462
"32400","Ocbimv22000718m.g","KQ416877",522227,523270,1043
"32401","Ocbimv22016344m.g","KQ429822",97129,150427,53298
"32402","Ocbimv22026611m.g","KQ420080",80845,120267,39422
"32403","Ocbimv22006445m.g","KQ417320",103823,104228,405
"32404","Ocbimv22015240m.g","KQ415940",1404388,1453412,49024
"32405","Ocbimv22002896m.g","KQ424814",545060,549492,4432
"32406","Ocbimv22035218m.g","KQ422315",308,27771,27463
"32407","Ocbimv22008280m.g","KQ417493",256854,258139,1285
"32408","Ocbimv22010883m.g","KQ417722",305794,306024,230
"32409","Ocbimv22001167m.g","KQ424208",78512,78883,371
"32410","Ocbimv22014998m.g","KQ418193",659673,660377,704
"32411","Ocbimv22008158m.g","KQ417481",1109311,1109511,200
"32412","Ocbimv22000283m.g","KQ423912",9365,10100,735
"32413","Ocbimv22025724m.g","KQ419887",1343518,1346119,2601
"32414","Ocbimv22005542m.g","KQ425649",181259,220072,38813
"32415","Ocbimv22018530m.g","KQ418633",298581,299622,1041
"32416","Ocbimv22000766m.g","KQ416879",243254,248062,4808
"32417","Ocbimv22005062m.g","KQ425510",72433,95651,23218
"32418","Ocbimv22019410m.g","KQ418760",547146,551082,3936
"32419","Ocbimv22011919m.g","KQ427949",330667,331281,614
"32420","Ocbimv22019511m.g","KQ418778",8654,9560,906
"32421","Ocbimv22021338m.g","KQ419033",91692,93342,1650
"32422","Ocbimv22009036m.g","KQ415859",44604,44858,254
"32423","Ocbimv22003426m.g","KQ417087",617790,618305,515
"32424","Ocbimv22011992m.g","KQ417851",664212,685417,21205
"32425","Ocbimv22025970m.g","KQ419938",10153,35877,25724
"32426","Ocbimv22011923m.g","KQ427949",347269,363774,16505
"32427","Ocbimv22019521m.g","KQ418781",74723,77181,2458
"32428","Ocbimv22030814m.g","KQ421092",220209,245471,25262
"32429","Ocbimv22010621m.g","KQ415669",1478793,1508282,29489
"32430","Ocbimv22019794m.g","KQ431315",2637,6732,4095
"32431","Ocbimv22023807m.g","KQ419478",498533,530463,31930
"32432","Ocbimv22005840m.g","KQ417280",137226,138416,1190
"32433","Ocbimv22002572m.g","KQ415794",35439,37314,1875
"32434","Ocbimv22029587m.g","KQ420779",278264,289046,10782
"32435","Ocbimv22006801m.g","KQ417350",50686,60539,9853
"32436","Ocbimv22004060m.g","KQ425191",137993,150867,12874
"32437","Ocbimv22005823m.g","KQ417280",63717,65072,1355
"32438","Ocbimv22022213m.g","KQ416062",36324,40969,4645
"32439","Ocbimv22029090m.g","KQ420643",63036,92050,29014
"32440","Ocbimv22015496m.g","KQ418263",598474,600160,1686
"32441","Ocbimv22010477m.g","KQ417681",599044,599235,191
"32442","Ocbimv22028845m.g","KQ420593",5577,6134,557
"32443","Ocbimv22023830m.g","KQ416099",59955,61221,1266
"32444","Ocbimv22006419m.g","KQ425910",1795,2100,305
"32445","Ocbimv22021971m.g","LGKD01673384",1,572,571
"32446","Ocbimv22008879m.g","KQ426791",599600,599932,332
"32447","Ocbimv22038334m.g","KQ423286",5720,78068,72348
"32448","Ocbimv22009315m.g","KQ417582",926361,926839,478
"32449","Ocbimv22006542m.g","KQ425992",366979,393466,26487
"32450","Ocbimv22003082m.g","KQ424877",383058,393455,10397
"32451","Ocbimv22032550m.g","KQ416437",280019,281618,1599
"32452","Ocbimv22009808m.g","KQ427140",84350,85088,738
"32453","Ocbimv22031113m.g","KQ416385",1456860,1457162,302
"32454","Ocbimv22025795m.g","KQ419905",157121,166259,9138
"32455","Ocbimv22007048m.g","KQ417371",193116,193553,437
"32456","Ocbimv22006276m.g","KQ425850",98334,98627,293
"32457","Ocbimv22009198m.g","KQ417572",250126,251741,1615
"32458","Ocbimv22008513m.g","KQ417506",825403,923775,98372
"32459","Ocbimv22038947m.g","KQ423493",618678,641012,22334
"32460","Ocbimv22026182m.g","KQ420011",130499,130726,227
"32461","Ocbimv22003059m.g","KQ424867",329590,329778,188
"32462","Ocbimv22007640m.g","KQ417439",11630,37954,26324
"32463","Ocbimv22014939m.g","KQ429139",356912,371937,15025
"32464","Ocbimv22023743m.g","KQ419470",605834,648730,42896
"32465","Ocbimv22029588m.g","KQ420779",293044,302224,9180
"32466","Ocbimv22025302m.g","KQ419763",191158,225354,34196
"32467","Ocbimv22003355m.g","KQ424993",211179,212157,978
"32468","Ocbimv22016954m.g","KQ418429",79145,126243,47098
"32469","Ocbimv22020953m.g","KQ418982",613488,613730,242
"32470","Ocbimv22005867m.g","KQ417280",329890,333633,3743
"32471","Ocbimv22035675m.g","KQ422501",384691,440146,55455
"32472","Ocbimv22008611m.g","KQ417510",839851,850279,10428
"32473","Ocbimv22033963m.g","KQ421925",85175,85396,221
"32474","Ocbimv22016498m.g","KQ418361",52288,52811,523
"32475","Ocbimv22007401m.g","LGKD01555286",8,196,188
"32476","Ocbimv22027351m.g","KQ416222",231841,233701,1860
"32477","Ocbimv22012503m.g","KQ417917",285816,297151,11335
"32478","Ocbimv22019952m.g","KQ431382",10332,10896,564
"32479","Ocbimv22004940m.g","KQ417215",319557,473876,154319
"32480","Ocbimv22019101m.g","KQ430964",207644,207922,278
"32481","Ocbimv22002889m.g","KQ424814",433357,489054,55697
"32482","Ocbimv22010319m.g","KQ427354",22515,94320,71805
"32483","Ocbimv22000494m.g","KQ415777",53359,54055,696
"32484","Ocbimv22015453m.g","KQ429354",47351,50102,2751
"32485","Ocbimv22002485m.g","KQ424671",112365,113995,1630
"32486","Ocbimv22020448m.g","KQ416028",71859,129387,57528
"32487","Ocbimv22008796m.g","KQ426774",121828,123337,1509
"32488","Ocbimv22003860m.g","KQ425133",16891,21129,4238
"32489","Ocbimv22024842m.g","KQ419640",51873,58604,6731
"32490","Ocbimv22008676m.g","KQ417519",1520443,1520667,224
"32491","Ocbimv22001733m.g","KQ424397",71190,79151,7961
"32492","Ocbimv22009605m.g","KQ427052",41756,42384,628
"32493","Ocbimv22022708m.g","KQ432975",112777,122119,9342
"32494","Ocbimv22019097m.g","KQ416007",11101,13808,2707
"32495","Ocbimv22004808m.g","KQ417208",165815,171271,5456
"32496","Ocbimv22028958m.g","KQ420615",83963,126847,42884
"32497","Ocbimv22010657m.g","KQ427464",282392,429454,147062
"32498","Ocbimv22013908m.g","KQ418071",59371,59879,508
"32499","Ocbimv22002249m.g","KQ424585",7635,8258,623
"32500","Ocbimv22034903m.g","KQ422211",63351,109267,45916
"32501","Ocbimv22020886m.g","KQ431871",37672,38007,335
"32502","Ocbimv22027199m.g","KQ420217",150412,152637,2225
"32503","Ocbimv22007749m.g","KQ415847",639488,654186,14698
"32504","Ocbimv22032941m.g","KQ421688",75753,76002,249
"32505","Ocbimv22015699m.g","KQ418278",1216,1380,164
"32506","Ocbimv22022169m.g","KQ419180",425874,487165,61291
"32507","Ocbimv22012988m.g","KQ417968",2684,3634,950
"32508","Ocbimv22016911m.g","KQ418422",569097,569720,623
"32509","Ocbimv22036471m.g","KQ416642",54966,56365,1399
"32510","Ocbimv22019145m.g","KQ431010",1200,4209,3009
"32511","Ocbimv22012184m.g","KQ417884",280655,280882,227
"32512","Ocbimv22022351m.g","KQ419203",48997,49368,371
"32513","Ocbimv22025793m.g","KQ416167",335724,336011,287
"32514","Ocbimv22023413m.g","KQ433358",6204,6494,290
"32515","Ocbimv22016213m.g","KQ418328",167260,167433,173
"32516","Ocbimv22024670m.g","KQ419607",838775,870237,31462
"32517","Ocbimv22018850m.g","KQ430904",34187,45835,11648
"32518","Ocbimv22003820m.g","KQ425121",302299,329356,27057
"32519","Ocbimv22027236m.g","KQ416215",209117,212949,3832
"32520","Ocbimv22015210m.g","KQ429207",25366,27829,2463
"32521","Ocbimv22033977m.g","KQ421934",95067,95929,862
"32522","Ocbimv22019896m.g","KQ418832",634824,637554,2730
"32523","Ocbimv22008748m.g","KQ426760",3790,22742,18952
"32524","Ocbimv22018921m.g","KQ430924",355221,389772,34551
"32525","Ocbimv22030253m.g","KQ420928",453354,453560,206
"32526","Ocbimv22009512m.g","KQ415865",698726,716850,18124
"32527","Ocbimv22037482m.g","KQ416697",458414,458941,527
"32528","Ocbimv22029624m.g","KQ420787",864385,866813,2428
"32529","Ocbimv22028680m.g","KQ420554",51826,53491,1665
"32530","Ocbimv22032294m.g","KQ421514",483244,483780,536
"32531","Ocbimv22016007m.g","KQ418310",8075,9437,1362
"32532","Ocbimv22039745m.g","KQ416818",80152,84255,4103
"32533","Ocbimv22015158m.g","KQ429174",33765,34846,1081
"32534","Ocbimv22035290m.g","KQ422349",222415,226343,3928
"32535","Ocbimv22009803m.g","KQ417617",280903,282462,1559
"32536","Ocbimv22003880m.g","KQ425134",97801,98064,263
"32537","Ocbimv22024938m.g","KQ419660",125398,136286,10888
"32538","Ocbimv22009300m.g","KQ417581",94056,95918,1862
"32539","Ocbimv22026128m.g","KQ419991",240312,241994,1682
"32540","Ocbimv22020686m.g","KQ418954",25726,115047,89321
"32541","Ocbimv22000561m.g","KQ416867",1557,2230,673
"32542","Ocbimv22004924m.g","KQ425470",199670,202109,2439
"32543","Ocbimv22016117m.g","KQ418320",307966,308136,170
"32544","Ocbimv22002811m.g","KQ417037",499746,514409,14663
"32545","Ocbimv22000341m.g","KQ416854",596256,598517,2261
"32546","Ocbimv22019907m.g","KQ418834",45398,48076,2678
"32547","Ocbimv22032121m.g","KQ421453",275584,275754,170
"32548","Ocbimv22033252m.g","KQ421758",1411755,1412560,805
"32549","Ocbimv22022505m.g","KQ432802",7032,7280,248
"32550","Ocbimv22034893m.g","KQ422208",432953,468387,35434
"32551","Ocbimv22028203m.g","KQ420444",193736,209809,16073
"32552","Ocbimv22027040m.g","KQ416209",59935,66689,6754
"32553","Ocbimv22035676m.g","KQ422502",9988,30463,20475
"32554","Ocbimv22004822m.g","KQ425443",73771,73983,212
"32555","Ocbimv22026033m.g","KQ419959",103108,111180,8072
"32556","Ocbimv22015805m.g","KQ418295",73441,83868,10427
"32557","Ocbimv22002502m.g","KQ417011",163404,171870,8466
"32558","Ocbimv22029395m.g","KQ420741",108766,109074,308
"32559","Ocbimv22038586m.g","KQ423412",128731,130468,1737
"32560","Ocbimv22029635m.g","KQ420791",1936,2121,185
"32561","Ocbimv22012412m.g","KQ417911",37224,77982,40758
"32562","Ocbimv22030201m.g","KQ420924",71082,81491,10409
"32563","Ocbimv22008001m.g","KQ415849",26612,36682,10070
"32564","Ocbimv22023023m.g","KQ416080",426504,427015,511
"32565","Ocbimv22034660m.g","KQ416544",314337,323961,9624
"32566","Ocbimv22019895m.g","KQ418832",617535,634558,17023
"32567","Ocbimv22025272m.g","KQ419754",451032,460644,9612
"32568","Ocbimv22028276m.g","KQ415659",2271127,2271495,368
"32569","Ocbimv22021237m.g","KQ419018",282705,282920,215
"32570","Ocbimv22037033m.g","KQ422909",434208,463464,29256
"32571","Ocbimv22027062m.g","KQ420172",24988,26714,1726
"32572","Ocbimv22014387m.g","KQ418125",107965,120648,12683
"32573","Ocbimv22020525m.g","KQ418922",164991,172745,7754
"32574","Ocbimv22023511m.g","KQ419420",256043,256988,945
"32575","Ocbimv22030540m.g","KQ421018",88626,97221,8595
"32576","Ocbimv22007335m.g","KQ426300",3048,7286,4238
"32577","Ocbimv22027271m.g","KQ420240",619193,634398,15205
"32578","Ocbimv22035955m.g","KQ416612",1629680,1656678,26998
"32579","Ocbimv22004349m.g","KQ425271",26824,27192,368
"32580","Ocbimv22021528m.g","KQ419071",47412,63205,15793
"32581","Ocbimv22011762m.g","KQ417830",314831,315064,233
"32582","Ocbimv22013011m.g","KQ417972",189531,203072,13541
"32583","Ocbimv22024034m.g","KQ416109",501533,501760,227
"32584","Ocbimv22006064m.g","KQ417293",383308,384090,782
"32585","Ocbimv22025834m.g","KQ416171",40479,77771,37292
"32586","Ocbimv22024138m.g","KQ419538",700219,700550,331
"32587","Ocbimv22023257m.g","KQ419380",608280,608573,293
"32588","Ocbimv22014960m.g","KQ418188",53379,82030,28651
"32589","Ocbimv22024198m.g","KQ419548",12664,13517,853
"32590","Ocbimv22013500m.g","KQ418031",827173,846865,19692
"32591","Ocbimv22033994m.g","KQ416504",29793,32526,2733
"32592","Ocbimv22019320m.g","KQ418749",210482,252535,42053
"32593","Ocbimv22038261m.g","KQ423251",94978,148212,53234
"32594","Ocbimv22003873m.g","KQ417118",399368,414388,15020
"32595","Ocbimv22029056m.g","KQ420639",70457,71056,599
"32596","Ocbimv22038852m.g","KQ415768",305400,305768,368
"32597","Ocbimv22020749m.g","KQ431824",64629,92592,27963
"32598","Ocbimv22008383m.g","KQ417499",173044,173418,374
"32599","Ocbimv22025949m.g","KQ419933",13001,13617,616
"32600","Ocbimv22020154m.g","KQ418863",337874,338029,155
"32601","Ocbimv22001579m.g","KQ424363",250642,251820,1178
"32602","Ocbimv22022555m.g","LGKD01679629",49,366,317
"32603","Ocbimv22013133m.g","KQ417985",594316,594666,350
"32604","Ocbimv22026962m.g","KQ420154",164561,165188,627
"32605","Ocbimv22007973m.g","KQ417466",1972166,1973696,1530
"32606","Ocbimv22004136m.g","KQ425217",9959,10399,440
"32607","Ocbimv22032338m.g","KQ421523",818710,819108,398
"32608","Ocbimv22017484m.g","KQ418500",183747,184760,1013
"32609","Ocbimv22036461m.g","KQ422771",63372,73636,10264
"32610","Ocbimv22039031m.g","KQ423516",4375,20152,15777
"32611","Ocbimv22030188m.g","KQ420919",110271,111123,852
"32612","Ocbimv22002377m.g","KQ415792",653353,655729,2376
"32613","Ocbimv22032626m.g","KQ421612",87080,99683,12603
"32614","Ocbimv22000413m.g","KQ423958",262772,265119,2347
"32615","Ocbimv22015200m.g","KQ418205",264054,297335,33281
"32616","Ocbimv22017124m.g","KQ418453",3920,23030,19110
"32617","Ocbimv22031631m.g","KQ421305",92096,93761,1665
"32618","Ocbimv22014868m.g","LGKD01613691",160,321,161
"32619","Ocbimv22002625m.g","KQ417023",781546,795825,14279
"32620","Ocbimv22025518m.g","KQ419831",173882,174506,624
"32621","Ocbimv22016416m.g","KQ418350",190878,215040,24162
"32622","Ocbimv22016619m.g","KQ418370",334900,335112,212
"32623","Ocbimv22039664m.g","KQ423723",200891,201073,182
"32624","Ocbimv22013004m.g","KQ417972",12629,53600,40971
"32625","Ocbimv22004076m.g","KQ417133",602812,606210,3398
"32626","Ocbimv22021477m.g","LGKD01668565",73,240,167
"32627","Ocbimv22017395m.g","KQ418489",350088,363965,13877
"32628","Ocbimv22017379m.g","KQ418487",148264,153028,4764
"32629","Ocbimv22032983m.g","KQ416463",61659,99300,37641
"32630","Ocbimv22035493m.g","KQ422411",51846,65724,13878
"32631","Ocbimv22033612m.g","KQ421847",79362,80163,801
"32632","Ocbimv22033470m.g","KQ416482",24948,27961,3013
"32633","Ocbimv22037746m.g","KQ416708",411044,428477,17433
"32634","Ocbimv22027709m.g","KQ420347",60048,141294,81246
"32635","Ocbimv22027372m.g","KQ420267",423412,433512,10100
"32636","Ocbimv22017871m.g","KQ418552",574012,593625,19613
"32637","Ocbimv22029678m.g","KQ420799",368261,369487,1226
"32638","Ocbimv22017898m.g","KQ418555",1625302,1625696,394
"32639","Ocbimv22036577m.g","KQ422794",148697,154765,6068
"32640","Ocbimv22002729m.g","KQ417030",543758,544066,308
"32641","Ocbimv22033362m.g","LGKD01416432",8,229,221
"32642","Ocbimv22037406m.g","KQ416694",2047338,2051624,4286
"32643","Ocbimv22017239m.g","KQ418469",574097,596538,22441
"32644","Ocbimv22034597m.g","KQ422083",165766,166680,914
"32645","Ocbimv22012106m.g","KQ417874",238840,239016,176
"32646","Ocbimv22025515m.g","KQ419829",163018,163188,170
"32647","Ocbimv22038505m.g","KQ423383",8488,9385,897
"32648","Ocbimv22024033m.g","KQ419524",135426,141990,6564
"32649","Ocbimv22031537m.g","KQ421269",31313,43463,12150
"32650","Ocbimv22008323m.g","KQ417497",362668,421255,58587
"32651","Ocbimv22007783m.g","KQ426456",225612,240703,15091
"32652","Ocbimv22032551m.g","KQ416437",323426,324741,1315
"32653","Ocbimv22018541m.g","KQ415995",172229,207341,35112
"32654","Ocbimv22017660m.g","KQ418525",157807,171503,13696
"32655","Ocbimv22016691m.g","KQ418384",53369,53641,272
"32656","Ocbimv22001805m.g","KQ424425",562107,574827,12720
"32657","Ocbimv22000624m.g","KQ416870",77423,84286,6863
"32658","Ocbimv22037739m.g","KQ416708",325751,357811,32060
"32659","Ocbimv22033463m.g","KQ421819",204738,208379,3641
"32660","Ocbimv22001383m.g","KQ416929",962073,962438,365
"32661","Ocbimv22022653m.g","KQ419277",193869,194577,708
"32662","Ocbimv22036365m.g","KQ422726",8659,10435,1776
"32663","Ocbimv22017243m.g","KQ418469",638655,639100,445
"32664","Ocbimv22031203m.g","KQ421200",90756,92033,1277
"32665","Ocbimv22034165m.g","KQ421992",6477,6719,242
"32666","Ocbimv22029240m.g","KQ420690",301226,310906,9680
"32667","Ocbimv22032303m.g","KQ416428",14365,28319,13954
"32668","Ocbimv22019566m.g","KQ418784",44375,49965,5590
"32669","Ocbimv22012465m.g","KQ428165",205666,207821,2155
"32670","Ocbimv22038339m.g","KQ415764",501484,501687,203
"32671","Ocbimv22021859m.g","KQ432359",5751,16711,10960
"32672","Ocbimv22028669m.g","KQ420549",73256,85505,12249
"32673","Ocbimv22038936m.g","KQ416772",544797,547218,2421
"32674","Ocbimv22024117m.g","KQ433805",9039,17723,8684
"32675","Ocbimv22005031m.g","KQ417224",327787,329045,1258
"32676","Ocbimv22028001m.g","KQ420415",583097,591921,8824
"32677","Ocbimv22036615m.g","KQ416649",470865,474884,4019
"32678","Ocbimv22032370m.g","KQ416430",13116,14608,1492
"32679","Ocbimv22012968m.g","KQ428314",649,83605,82956
"32680","Ocbimv22030639m.g","KQ421039",458785,461108,2323
"32681","Ocbimv22008311m.g","KQ426613",70056,70403,347
"32682","Ocbimv22009702m.g","KQ427095",30150,42460,12310
"32683","Ocbimv22027666m.g","KQ420334",180129,259809,79680
"32684","Ocbimv22028092m.g","KQ416248",323610,323846,236
"32685","Ocbimv22027801m.g","KQ416233",558000,560697,2697
"32686","Ocbimv22001082m.g","KQ424173",176594,177862,1268
"32687","Ocbimv22012281m.g","KQ428101",66851,73864,7013
"32688","Ocbimv22009976m.g","KQ417629",284207,332339,48132
"32689","Ocbimv22036478m.g","KQ416642",508993,509304,311
"32690","Ocbimv22016845m.g","KQ418413",46447,46784,337
"32691","Ocbimv22027049m.g","KQ420169",631464,631742,278
"32692","Ocbimv22011899m.g","LGKD01591161",3,191,188
"32693","Ocbimv22037367m.g","KQ423019",17241,18859,1618
"32694","Ocbimv22035410m.g","KQ422367",384206,388777,4571
"32695","Ocbimv22017282m.g","KQ430235",26596,27743,1147
"32696","Ocbimv22017810m.g","KQ418549",540161,540352,191
"32697","Ocbimv22027079m.g","KQ420176",937,8978,8041
"32698","Ocbimv22036215m.g","KQ422680",308350,323843,15493
"32699","Ocbimv22018283m.g","KQ430620",236,4082,3846
"32700","Ocbimv22028160m.g","KQ420439",243362,256642,13280
"32701","Ocbimv22012213m.g","KQ415904",397780,398064,284
"32702","Ocbimv22037611m.g","KQ423077",967948,969496,1548
"32703","Ocbimv22036574m.g","KQ422794",112377,113096,719
"32704","Ocbimv22015389m.g","KQ429317",33,844,811
"32705","Ocbimv22011603m.g","KQ417809",48143,49564,1421
"32706","Ocbimv22010169m.g","KQ415871",43584,45771,2187
"32707","Ocbimv22029594m.g","KQ420779",415314,419749,4435
"32708","Ocbimv22026517m.g","KQ416190",503121,543828,40707
"32709","Ocbimv22001746m.g","KQ424400",16281,33445,17164
"32710","Ocbimv22026174m.g","KQ420009",309184,309540,356
"32711","Ocbimv22034134m.g","KQ421984",176574,185159,8585
"32712","Ocbimv22005633m.g","KQ425692",114983,136504,21521
"32713","Ocbimv22020560m.g","KQ418926",3188,3781,593
"32714","Ocbimv22022691m.g","KQ419281",564604,574038,9434
"32715","Ocbimv22010408m.g","KQ417676",642509,642676,167
"32716","Ocbimv22031385m.g","KQ421226",76834,77129,295
"32717","Ocbimv22000601m.g","KQ424015",416320,422454,6134
"32718","Ocbimv22009436m.g","KQ426995",35963,44985,9022
"32719","Ocbimv22022656m.g","KQ419278",71749,72339,590
"32720","Ocbimv22018841m.g","KQ416003",626501,685248,58747
"32721","Ocbimv22029590m.g","KQ420779",328206,329192,986
"32722","Ocbimv22008294m.g","KQ426610",419784,421235,1451
"32723","Ocbimv22015802m.g","KQ418294",4404,5447,1043
"32724","Ocbimv22015256m.g","KQ418216",375930,395954,20024
"32725","Ocbimv22018405m.g","KQ430684",647337,694171,46834
"32726","Ocbimv22031732m.g","KQ421332",740999,752028,11029
"32727","Ocbimv22000435m.g","KQ423963",159031,160515,1484
"32728","Ocbimv22009163m.g","KQ417567",80134,82773,2639
"32729","Ocbimv22034120m.g","KQ421982",26741,27393,652
"32730","Ocbimv22023919m.g","KQ419500",393584,393895,311
"32731","Ocbimv22018738m.g","KQ430840",7073,7384,311
"32732","Ocbimv22035140m.g","KQ422289",42713,42964,251
"32733","Ocbimv22001290m.g","KQ416918",1094706,1095246,540
"32734","Ocbimv22031480m.g","KQ421258",130718,131008,290
"32735","Ocbimv22026209m.g","KQ420017",237712,237960,248
"32736","Ocbimv22020885m.g","KQ431871",7742,12477,4735
"32737","Ocbimv22011604m.g","KQ427796",55340,57604,2264
"32738","Ocbimv22029144m.g","KQ420662",1160279,1174416,14137
"32739","Ocbimv22001463m.g","KQ416934",314561,348078,33517
"32740","Ocbimv22003362m.g","KQ417085",151818,156160,4342
"32741","Ocbimv22021905m.g","KQ419128",2868,52509,49641
"32742","Ocbimv22031993m.g","KQ421405",53879,55891,2012
"32743","Ocbimv22010400m.g","KQ417676",350075,351376,1301
"32744","Ocbimv22032757m.g","KQ421655",196946,197671,725
"32745","Ocbimv22024293m.g","KQ416121",1405618,1406226,608
"32746","Ocbimv22038259m.g","KQ423251",48853,62904,14051
"32747","Ocbimv22020559m.g","KQ418925",6560,7340,780
"32748","Ocbimv22026059m.g","KQ415697",1824093,1824257,164
"32749","Ocbimv22007821m.g","KQ417454",69228,69800,572
"32750","Ocbimv22026947m.g","KQ420146",429792,429965,173
"32751","Ocbimv22035688m.g","KQ422516",500171,520151,19980
"32752","Ocbimv22014884m.g","KQ415936",375865,405374,29509
"32753","Ocbimv22013418m.g","KQ418021",197690,198935,1245
"32754","Ocbimv22035033m.g","KQ422253",2081,10148,8067
"32755","Ocbimv22014539m.g","KQ428981",67596,68849,1253
"32756","Ocbimv22025538m.g","KQ419832",29672,33001,3329
"32757","Ocbimv22036775m.g","KQ422859",32986,33396,410
"32758","Ocbimv22029829m.g","KQ420828",1001553,1013758,12205
"32759","Ocbimv22036545m.g","KQ416644",8396,62310,53914
"32760","Ocbimv22018772m.g","KQ418671",74420,78555,4135
"32761","Ocbimv22033156m.g","KQ421737",346319,430221,83902
"32762","Ocbimv22030102m.g","KQ420892",52246,53508,1262
"32763","Ocbimv22002556m.g","KQ424691",667,960,293
"32764","Ocbimv22023163m.g","KQ419366",94092,109776,15684
"32765","Ocbimv22030235m.g","KQ420927",39015,62737,23722
"32766","Ocbimv22004956m.g","KQ417216",227924,238407,10483
"32767","Ocbimv22031158m.g","KQ421181",762908,763162,254
"32768","Ocbimv22002080m.g","KQ424537",62478,74031,11553
"32769","Ocbimv22015183m.g","KQ418204",3159,4841,1682
"32770","Ocbimv22025719m.g","KQ419887",1169025,1170190,1165
"32771","Ocbimv22038149m.g","KQ423220",16619,16786,167
"32772","Ocbimv22010204m.g","KQ417655",456459,456704,245
"32773","Ocbimv22012837m.g","KQ417945",217074,217496,422
"32774","Ocbimv22023917m.g","KQ419500",390140,390517,377
"32775","Ocbimv22003567m.g","KQ417091",26559,26765,206
"32776","Ocbimv22013513m.g","KQ418031",1087492,1108224,20732
"32777","Ocbimv22039361m.g","KQ423631",189359,199807,10448
"32778","Ocbimv22023998m.g","KQ419515",597404,597568,164
"32779","Ocbimv22012665m.g","KQ417924",466129,493529,27400
"32780","Ocbimv22005048m.g","KQ425506",3546,9706,6160
"32781","Ocbimv22033262m.g","KQ421758",1709817,1711336,1519
"32782","Ocbimv22001333m.g","KQ424269",173869,174672,803
"32783","Ocbimv22010630m.g","KQ415669",2885569,2886093,524
"32784","Ocbimv22026498m.g","KQ420059",305822,308808,2986
"32785","Ocbimv22000056m.g","KQ423836",128247,128909,662
"32786","Ocbimv22015645m.g","KQ418271",332487,337542,5055
"32787","Ocbimv22032683m.g","KQ416444",191180,194669,3489
"32788","Ocbimv22029156m.g","KQ420670",70078,70428,350
"32789","Ocbimv22030274m.g","KQ415716",1194257,1194529,272
"32790","Ocbimv22036088m.g","KQ416616",2015893,2016099,206
"32791","Ocbimv22009268m.g","KQ417578",1353032,1365699,12667
"32792","Ocbimv22004974m.g","KQ425492",94724,139280,44556
"32793","Ocbimv22010731m.g","KQ417706",365546,447076,81530
"32794","Ocbimv22022576m.g","KQ432875",65993,67166,1173
"32795","Ocbimv22004183m.g","KQ425220",320673,324101,3428
"32796","Ocbimv22000041m.g","KQ423834",56318,76973,20655
"32797","Ocbimv22027648m.g","KQ420329",362377,378408,16031
"32798","Ocbimv22005302m.g","KQ417239",50073,118568,68495
"32799","Ocbimv22023639m.g","KQ419448",223263,266888,43625
"32800","Ocbimv22032445m.g","KQ416431",156615,157343,728
"32801","Ocbimv22027971m.g","KQ420410",127292,127738,446
"32802","Ocbimv22017551m.g","KQ415978",125625,134189,8564
"32803","Ocbimv22014601m.g","KQ428999",25691,47351,21660
"32804","Ocbimv22021339m.g","KQ419033",111704,115634,3930
"32805","Ocbimv22025850m.g","KQ419912",106435,138504,32069
"32806","Ocbimv22010882m.g","KQ417722",294505,295335,830
"32807","Ocbimv22001420m.g","KQ416932",177888,240035,62147
"32808","Ocbimv22022983m.g","KQ419333",284964,350112,65148
"32809","Ocbimv22003999m.g","KQ425175",1479,2274,795
"32810","Ocbimv22022663m.g","KQ419279",38024,58613,20589
"32811","Ocbimv22024250m.g","KQ433889",2202,2552,350
"32812","Ocbimv22019031m.g","KQ418711",930817,982202,51385
"32813","Ocbimv22009537m.g","KQ415865",990920,992424,1504
"32814","Ocbimv22014526m.g","KQ415932",1268682,1269180,498
"32815","Ocbimv22016426m.g","KQ418351",94058,96824,2766
"32816","Ocbimv22027944m.g","KQ420406",79482,80092,610
"32817","Ocbimv22020376m.g","KQ418900",581770,591838,10068
"32818","Ocbimv22028844m.g","KQ420592",609508,610185,677
"32819","Ocbimv22026453m.g","KQ420052",266600,269474,2874
"32820","Ocbimv22001031m.g","KQ424157",553372,605328,51956
"32821","Ocbimv22035424m.g","KQ416585",465088,466451,1363
"32822","Ocbimv22027293m.g","KQ416218",156975,178775,21800
"32823","Ocbimv22035185m.g","KQ422296",162743,163072,329
"32824","Ocbimv22018539m.g","KQ415995",146157,148018,1861
"32825","Ocbimv22031585m.g","KQ416401",286473,286677,204
"32826","Ocbimv22012548m.g","KQ417917",999180,999833,653
"32827","Ocbimv22029582m.g","KQ420778",116969,118433,1464
"32828","Ocbimv22035241m.g","KQ422340",1275,3216,1941
"32829","Ocbimv22018501m.g","KQ418631",163938,263347,99409
"32830","Ocbimv22035863m.g","KQ422586",167588,167935,347
"32831","Ocbimv22027451m.g","KQ420287",89539,89907,368
"32832","Ocbimv22013186m.g","KQ428420",67848,74270,6422
"32833","Ocbimv22025703m.g","KQ419887",216666,217742,1076
"32834","Ocbimv22002285m.g","KQ417001",39623,60316,20693
"32835","Ocbimv22001640m.g","KQ416950",1453993,1454145,152
"32836","Ocbimv22000133m.g","KQ416841",1736942,1737160,218
"32837","Ocbimv22028542m.g","KQ416260",212822,214413,1591
"32838","Ocbimv22026263m.g","KQ420022",434584,435133,549
"32839","Ocbimv22005878m.g","KQ417280",401198,402400,1202
"32840","Ocbimv22029689m.g","KQ420805",76136,79997,3861
"32841","Ocbimv22007735m.g","KQ426444",1,304,303
"32842","Ocbimv22019944m.g","KQ418838",401394,419185,17791
"32843","Ocbimv22036713m.g","KQ416654",347380,368807,21427
"32844","Ocbimv22031593m.g","KQ421286",19715,20107,392
"32845","Ocbimv22038605m.g","KQ416754",115469,148757,33288
"32846","Ocbimv22024269m.g","LGKD01697544",82,297,215
"32847","Ocbimv22005037m.g","KQ417225",69840,70147,307
"32848","Ocbimv22019058m.g","KQ430958",6841,7119,278
"32849","Ocbimv22004842m.g","KQ417209",227520,292545,65025
"32850","Ocbimv22006850m.g","KQ417358",337978,350218,12240
"32851","Ocbimv22002782m.g","KQ424779",549749,549994,245
"32852","Ocbimv22032029m.g","KQ421411",264693,320594,55901
"32853","Ocbimv22004677m.g","KQ415808",14056,32904,18848
"32854","Ocbimv22034804m.g","KQ422178",88507,88932,425
"32855","Ocbimv22014599m.g","KQ428999",267,3322,3055
"32856","Ocbimv22028031m.g","KQ416244",56244,58532,2288
"32857","Ocbimv22033338m.g","KQ421784",228020,233128,5108
"32858","Ocbimv22020163m.g","KQ418863",517969,527471,9502
"32859","Ocbimv22026419m.g","KQ420047",304498,339473,34975
"32860","Ocbimv22029859m.g","KQ420828",1799616,1821694,22078
"32861","Ocbimv22012134m.g","KQ415902",214439,225177,10738
"32862","Ocbimv22010612m.g","KQ415669",544400,545628,1228
"32863","Ocbimv22008978m.g","KQ426822",79,1383,1304
"32864","Ocbimv22014247m.g","KQ418106",51690,55100,3410
"32865","Ocbimv22037938m.g","KQ423173",51074,51384,310
"32866","Ocbimv22019122m.g","KQ430983",156331,156739,408
"32867","Ocbimv22032289m.g","KQ421514",102234,291246,189012
"32868","Ocbimv22014641m.g","KQ418160",574638,574901,263
"32869","Ocbimv22014209m.g","KQ418101",56962,58021,1059
"32870","Ocbimv22020011m.g","LGKD01655600",103,489,386
"32871","Ocbimv22003268m.g","KQ424932",209950,263990,54040
"32872","Ocbimv22034452m.g","KQ416533",62183,63406,1223
"32873","Ocbimv22021877m.g","KQ419117",146355,147552,1197
"32874","Ocbimv22000450m.g","KQ423968",169614,177119,7505
"32875","Ocbimv22009143m.g","KQ415861",225652,251569,25917
"32876","Ocbimv22015259m.g","KQ418216",454083,455029,946
"32877","Ocbimv22020609m.g","KQ418937",28595,29170,575
"32878","Ocbimv22001124m.g","KQ424191",3962,4264,302
"32879","Ocbimv22039914m.g","KQ423795",21214,27060,5846
"32880","Ocbimv22011799m.g","KQ427909",61,466,405
"32881","Ocbimv22001297m.g","KQ424257",84326,103485,19159
"32882","Ocbimv22038751m.g","KQ416765",87008,87274,266
"32883","Ocbimv22017073m.g","KQ418448",115623,122584,6961
"32884","Ocbimv22039009m.g","KQ416777",209466,218215,8749
"32885","Ocbimv22036476m.g","KQ416642",137729,175448,37719
"32886","Ocbimv22011384m.g","KQ417791",631771,641731,9960
"32887","Ocbimv22009925m.g","KQ417623",69331,70108,777
"32888","Ocbimv22037548m.g","KQ423058",1172048,1172359,311
"32889","Ocbimv22002194m.g","KQ416995",41571,42029,458
"32890","Ocbimv22026961m.g","KQ420154",153365,153697,332
"32891","Ocbimv22002447m.g","KQ424659",126048,127403,1355
"32892","Ocbimv22008103m.g","KQ426567",145672,146392,720
"32893","Ocbimv22031393m.g","KQ416395",72010,74167,2157
"32894","Ocbimv22004431m.g","KQ425304",39626,42490,2864
"32895","Ocbimv22026232m.g","KQ420017",919779,922184,2405
"32896","Ocbimv22012858m.g","KQ417945",831804,872570,40766
"32897","Ocbimv22011567m.g","KQ427784",6455,31225,24770
"32898","Ocbimv22011094m.g","KQ417747",343810,348060,4250
"32899","Ocbimv22009344m.g","KQ417584",406007,406348,341
"32900","Ocbimv22039207m.g","KQ423576",138172,188705,50533
"32901","Ocbimv22002197m.g","KQ416995",123561,143281,19720
"32902","Ocbimv22012166m.g","KQ428057",12506,17513,5007
"32903","Ocbimv22001308m.g","KQ424264",311329,322776,11447
"32904","Ocbimv22026023m.g","KQ419957",314689,315541,852
"32905","Ocbimv22006582m.g","KQ426026",207067,207957,890
"32906","Ocbimv22000322m.g","KQ423923",17006,99753,82747
"32907","Ocbimv22009733m.g","KQ417608",351577,434844,83267
"32908","Ocbimv22032256m.g","KQ421505",284396,286140,1744
"32909","Ocbimv22018674m.g","KQ415684",311264,316825,5561
"32910","Ocbimv22017201m.g","LGKD01633933",37,378,341
"32911","Ocbimv22029130m.g","KQ420661",190084,206290,16206
"32912","Ocbimv22033363m.g","KQ416477",378510,378779,269
"32913","Ocbimv22022340m.g","KQ419201",143615,161073,17458
"32914","Ocbimv22032213m.g","KQ416425",864916,948510,83594
"32915","Ocbimv22032837m.g","KQ421664",1363473,1366499,3026
"32916","Ocbimv22008352m.g","KQ417497",2070339,2070661,322
"32917","Ocbimv22035625m.g","KQ422481",5498,116946,111448
"32918","Ocbimv22026470m.g","KQ420054",264,3581,3317
"32919","Ocbimv22024084m.g","KQ419533",354570,383262,28692
"32920","Ocbimv22016057m.g","KQ415952",19612,25154,5542
"32921","Ocbimv22020137m.g","KQ418859",360805,406397,45592
"32922","Ocbimv22036937m.g","KQ416666",946027,964012,17985
"32923","Ocbimv22033088m.g","KQ421725",7232,21570,14338
"32924","Ocbimv22037009m.g","KQ422903",551533,585928,34395
"32925","Ocbimv22006353m.g","KQ417315",105943,107493,1550
"32926","Ocbimv22000681m.g","KQ424055",207324,278878,71554
"32927","Ocbimv22032915m.g","KQ421684",81220,81839,619
"32928","Ocbimv22022592m.g","KQ419269",1609,3741,2132
"32929","Ocbimv22007229m.g","KQ426253",109399,111355,1956
"32930","Ocbimv22036462m.g","KQ422771",84588,89061,4473
"32931","Ocbimv22009185m.g","KQ426911",220542,269336,48794
"32932","Ocbimv22020116m.g","KQ418856",344837,345229,392
"32933","Ocbimv22003671m.g","KQ417100",462318,463984,1666
"32934","Ocbimv22023134m.g","KQ419354",227056,241538,14482
"32935","Ocbimv22031887m.g","KQ421372",323524,323819,295
"32936","Ocbimv22005762m.g","KQ417276",485461,557779,72318
"32937","Ocbimv22019366m.g","KQ416009",365236,365610,374
"32938","Ocbimv22017514m.g","KQ430328",50203,50845,642
"32939","Ocbimv22002470m.g","KQ415666",68049,73692,5643
"32940","Ocbimv22000069m.g","KQ423846",108091,131151,23060
"32941","Ocbimv22019958m.g","KQ418839",74145,102226,28081
"32942","Ocbimv22022091m.g","KQ432556",274212,294679,20467
"32943","Ocbimv22033173m.g","KQ416469",219323,220259,936
"32944","Ocbimv22015870m.g","KQ429595",7199,7432,233
"32945","Ocbimv22039807m.g","KQ416826",91951,92205,254
"32946","Ocbimv22017743m.g","KQ418537",144772,144972,200
"32947","Ocbimv22001406m.g","KQ424300",159699,161206,1507
"32948","Ocbimv22038800m.g","KQ423465",164475,187283,22808
"32949","Ocbimv22026375m.g","KQ416188",271480,271777,297
"32950","Ocbimv22000836m.g","KQ424088",21795,36290,14495
"32951","Ocbimv22005632m.g","KQ425692",66011,108347,42336
"32952","Ocbimv22020759m.g","KQ418961",1781,62437,60656
"32953","Ocbimv22008935m.g","KQ417541",27657,31011,3354
"32954","Ocbimv22033733m.g","KQ416495",399881,412765,12884
"32955","Ocbimv22003286m.g","KQ424936",148100,160329,12229
"32956","Ocbimv22011436m.g","KQ427746",307423,343840,36417
"32957","Ocbimv22034888m.g","KQ422208",308062,309430,1368
"32958","Ocbimv22033008m.g","KQ421716",127041,127550,509
"32959","Ocbimv22001580m.g","KQ424363",321672,350157,28485
"32960","Ocbimv22025236m.g","KQ419743",181651,234113,52462
"32961","Ocbimv22027785m.g","KQ416233",133701,146946,13245
"32962","Ocbimv22004309m.g","KQ417147",554522,554746,224
"32963","Ocbimv22006231m.g","KQ425847",255661,259001,3340
"32964","Ocbimv22001029m.g","KQ424157",461681,514747,53066
"32965","Ocbimv22038459m.g","KQ416743",39841,41201,1360
"32966","Ocbimv22033699m.g","KQ416491",494886,511901,17015
"32967","Ocbimv22007441m.g","KQ417414",266682,273873,7191
"32968","Ocbimv22019592m.g","KQ418789",214660,219941,5281
"32969","Ocbimv22000857m.g","KQ424096",36731,44885,8154
"32970","Ocbimv22011654m.g","KQ427833",191388,191702,314
"32971","Ocbimv22033855m.g","KQ421896",134941,144046,9105
"32972","Ocbimv22011146m.g","KQ427654",58882,83117,24235
"32973","Ocbimv22039192m.g","KQ416784",557703,611726,54023
"32974","Ocbimv22001893m.g","KQ415786",138796,139011,215
"32975","Ocbimv22003706m.g","KQ417101",329356,340692,11336
"32976","Ocbimv22036351m.g","KQ422717",239748,266171,26423
"32977","Ocbimv22020746m.g","KQ431819",242101,244446,2345
"32978","Ocbimv22000498m.g","KQ415777",121636,121899,263
"32979","Ocbimv22024629m.g","KQ419605",241200,252429,11229
"32980","Ocbimv22011468m.g","KQ417793",155529,189483,33954
"32981","Ocbimv22018215m.g","KQ415990",1836873,1844532,7659
"32982","Ocbimv22015417m.g","KQ418241",311451,351071,39620
"32983","Ocbimv22039638m.g","KQ416810",1260875,1270951,10076
"32984","Ocbimv22009361m.g","KQ426965",8171,10104,1933
"32985","Ocbimv22012289m.g","KQ428101",174089,175870,1781
"32986","Ocbimv22014831m.g","KQ429096",576157,595670,19513
"32987","Ocbimv22002221m.g","KQ424575",259038,259385,347
"32988","Ocbimv22012700m.g","KQ417928",289980,290896,916
"32989","Ocbimv22022370m.g","KQ419208",86234,86467,233
"32990","Ocbimv22018510m.g","KQ415994",5528,6687,1159
"32991","Ocbimv22033412m.g","KQ421806",423,21006,20583
"32992","Ocbimv22004376m.g","KQ415803",700758,735322,34564
"32993","Ocbimv22024804m.g","KQ419631",229967,238129,8162
"32994","Ocbimv22002984m.g","KQ424855",142313,142953,640
"32995","Ocbimv22035801m.g","KQ422556",295103,324489,29386
"32996","Ocbimv22030906m.g","KQ421117",1535686,1544173,8487
"32997","Ocbimv22037704m.g","KQ423103",44814,64203,19389
"32998","Ocbimv22007831m.g","KQ426466",160795,174730,13935
"32999","Ocbimv22002517m.g","KQ417012",275291,275572,281
"33000","Ocbimv22019130m.g","KQ418719",34513,37197,2684
"33001","Ocbimv22027164m.g","KQ416211",111368,111716,348
"33002","Ocbimv22009670m.g","LGKD01572483",75,281,206
"33003","Ocbimv22000383m.g","KQ423941",514795,539120,24325
"33004","Ocbimv22032890m.g","KQ421676",210796,211202,406
"33005","Ocbimv22013866m.g","KQ428700",5203,5520,317
"33006","Ocbimv22032503m.g","KQ421564",182376,187877,5501
"33007","Ocbimv22035177m.g","KQ422295",100879,124713,23834
"33008","Ocbimv22005231m.g","KQ425547",327,5869,5542
"33009","Ocbimv22009691m.g","KQ417604",160227,160376,149
"33010","Ocbimv22009213m.g","KQ417574",2002121,2002900,779
"33011","Ocbimv22037686m.g","KQ423101",22437,31198,8761
"33012","Ocbimv22019501m.g","KQ416013",134569,135189,620
"33013","Ocbimv22012351m.g","LGKD01594761",33,557,524
"33014","Ocbimv22010558m.g","KQ417691",337454,363275,25821
"33015","Ocbimv22039389m.g","KQ423638",185262,186473,1211
"33016","Ocbimv22038898m.g","KQ416771",662505,663719,1214
"33017","Ocbimv22014793m.g","KQ429073",35875,37392,1517
"33018","Ocbimv22001519m.g","KQ424342",103327,103548,221
"33019","Ocbimv22021793m.g","KQ419103",204399,205719,1320
"33020","Ocbimv22037385m.g","KQ416694",1053644,1054145,501
"33021","Ocbimv22011991m.g","KQ417851",570546,582030,11484
"33022","Ocbimv22036924m.g","KQ422894",519607,549075,29468
"33023","Ocbimv22031220m.g","KQ421201",19064,26665,7601
"33024","Ocbimv22011536m.g","KQ427773",34744,39055,4311
"33025","Ocbimv22004055m.g","KQ425191",55423,81846,26423
"33026","Ocbimv22006365m.g","KQ425894",86912,117820,30908
"33027","Ocbimv22039683m.g","KQ416813",1892438,1892647,209
"33028","Ocbimv22008074m.g","KQ426561",22870,23034,164
"33029","Ocbimv22039435m.g","KQ423664",19231,21552,2321
"33030","Ocbimv22000363m.g","KQ423941",57832,102363,44531
"33031","Ocbimv22010073m.g","KQ427251",10701,44425,33724
"33032","Ocbimv22035442m.g","KQ422383",2094,3030,936
"33033","Ocbimv22004621m.g","KQ415807",8151,8642,491
"33034","Ocbimv22035554m.g","KQ422436",71062,72677,1615
"33035","Ocbimv22030252m.g","KQ420928",352671,353348,677
"33036","Ocbimv22039215m.g","KQ423581",230589,230870,281
"33037","Ocbimv22012958m.g","KQ428311",77856,148923,71067
"33038","Ocbimv22015609m.g","KQ418269",239,9210,8971
"33039","Ocbimv22015427m.g","KQ429329",3546,4034,488
"33040","Ocbimv22003029m.g","KQ417055",1228940,1257617,28677
"33041","Ocbimv22029326m.g","KQ416297",159953,219245,59292
"33042","Ocbimv22010641m.g","KQ427464",1902,55927,54025
"33043","Ocbimv22028374m.g","KQ420479",30,560,530
"33044","Ocbimv22018865m.g","KQ418693",359300,360899,1599
"33045","Ocbimv22039909m.g","KQ416834",358494,372201,13707
"33046","Ocbimv22024927m.g","KQ419658",18545,28743,10198
"33047","Ocbimv22021596m.g","KQ432245",53663,54619,956
"33048","Ocbimv22012914m.g","KQ417953",201215,226754,25539
"33049","Ocbimv22014097m.g","KQ428755",56,9428,9372
"33050","Ocbimv22001242m.g","KQ424238",78951,107333,28382
"33051","Ocbimv22025105m.g","KQ419694",71180,94950,23770
"33052","Ocbimv22015191m.g","KQ418204",47736,48975,1239
"33053","Ocbimv22036341m.g","KQ422717",50448,152431,101983
"33054","Ocbimv22038709m.g","KQ416761",376472,376687,215
"33055","Ocbimv22035173m.g","KQ422295",799,1699,900
"33056","Ocbimv22024456m.g","KQ416123",169693,170284,591
"33057","Ocbimv22034468m.g","KQ422050",759051,763921,4870
"33058","Ocbimv22032286m.g","KQ421514",15291,101494,86203
"33059","Ocbimv22028895m.g","KQ416274",608273,630168,21895
"33060","Ocbimv22003619m.g","KQ425044",147444,147613,169
"33061","Ocbimv22036534m.g","KQ422787",24080,77210,53130
"33062","Ocbimv22006294m.g","KQ425861",86048,86227,179
"33063","Ocbimv22015997m.g","KQ429647",36873,49433,12560
"33064","Ocbimv22019830m.g","KQ431332",435858,436639,781
"33065","Ocbimv22016942m.g","KQ430102",41455,56659,15204
"33066","Ocbimv22011201m.g","KQ427678",3436,9437,6001
"33067","Ocbimv22004128m.g","KQ425213",98701,99690,989
"33068","Ocbimv22023119m.g","KQ419350",902299,905385,3086
"33069","Ocbimv22035891m.g","KQ422595",196605,218034,21429
"33070","Ocbimv22003913m.g","KQ417122",131233,131903,670
"33071","Ocbimv22007604m.g","KQ415844",163188,171232,8044
"33072","Ocbimv22006672m.g","KQ415833",21763,30392,8629
"33073","Ocbimv22018088m.g","KQ418571",327704,328738,1034
"33074","Ocbimv22030266m.g","KQ416339",258113,258358,245
"33075","Ocbimv22032740m.g","KQ421650",76506,92096,15590
"33076","Ocbimv22010711m.g","KQ427473",7878,33103,25225
"33077","Ocbimv22013656m.g","KQ428583",101800,152035,50235
"33078","Ocbimv22010343m.g","KQ427359",43048,45194,2146
"33079","Ocbimv22013602m.g","KQ418039",108094,129916,21822
"33080","Ocbimv22011575m.g","KQ417806",169172,169405,233
"33081","Ocbimv22027968m.g","KQ420410",34585,35119,534
"33082","Ocbimv22037961m.g","KQ416716",22622,33715,11093
"33083","Ocbimv22034460m.g","KQ422048",56713,67626,10913
"33084","Ocbimv22004003m.g","KQ417131",12614,16789,4175
"33085","Ocbimv22015156m.g","KQ418200",636260,672284,36024
"33086","Ocbimv22024177m.g","KQ419545",1,2323,2322
"33087","Ocbimv22020454m.g","KQ416029",50091,55746,5655
"33088","Ocbimv22038445m.g","KQ423341",39211,40026,815
"33089","Ocbimv22038127m.g","KQ423217",221899,226817,4918
"33090","Ocbimv22020528m.g","KQ418922",398596,405781,7185
"33091","Ocbimv22020640m.g","KQ418945",806640,813197,6557
"33092","Ocbimv22020392m.g","KQ431646",85367,85705,338
"33093","Ocbimv22012098m.g","KQ428036",49404,62828,13424
"33094","Ocbimv22033678m.g","KQ421858",318697,325506,6809
"33095","Ocbimv22018645m.g","KQ418649",475984,476763,779
"33096","Ocbimv22006438m.g","KQ417319",33937,34801,864
"33097","Ocbimv22011588m.g","KQ417807",128016,135392,7376
"33098","Ocbimv22014796m.g","KQ429075",60662,67805,7143
"33099","Ocbimv22008398m.g","KQ426629",142243,143937,1694
"33100","Ocbimv22017180m.g","KQ418462",251014,252703,1689
"33101","Ocbimv22020626m.g","KQ418943",161281,205074,43793
"33102","Ocbimv22002785m.g","KQ424779",803226,805545,2319
"33103","Ocbimv22002090m.g","KQ424537",157792,181284,23492
"33104","Ocbimv22011756m.g","KQ427892",28200,51599,23399
"33105","Ocbimv22008174m.g","KQ417481",1651163,1709719,58556
"33106","Ocbimv22003576m.g","KQ417092",202216,206963,4747
"33107","Ocbimv22035242m.g","KQ422340",48905,68309,19404
"33108","Ocbimv22034523m.g","KQ422068",90679,91674,995
"33109","Ocbimv22018174m.g","LGKD01641401",2,256,254
"33110","Ocbimv22021120m.g","KQ416039",13338,14907,1569
"33111","Ocbimv22014972m.g","KQ418188",447783,448698,915
"33112","Ocbimv22015942m.g","KQ418303",1447731,1447934,203
"33113","Ocbimv22036504m.g","KQ422781",196595,196816,221
"33114","Ocbimv22011154m.g","KQ427654",165190,173179,7989
"33115","Ocbimv22005693m.g","KQ417274",32858,33663,805
"33116","Ocbimv22021797m.g","KQ419103",506819,506989,170
"33117","Ocbimv22039278m.g","KQ416787",92213,101692,9479
"33118","Ocbimv22038017m.g","KQ416719",490465,497437,6972
"33119","Ocbimv22037323m.g","KQ423001",398462,400256,1794
"33120","Ocbimv22020325m.g","KQ418892",401533,401883,350
"33121","Ocbimv22025994m.g","KQ416179",71494,72356,862
"33122","Ocbimv22006096m.g","KQ425815",5409,6151,742
"33123","Ocbimv22003379m.g","KQ424999",142324,147695,5371
"33124","Ocbimv22010970m.g","KQ417729",541112,568997,27885
"33125","Ocbimv22006823m.g","KQ417358",14224,22104,7880
"33126","Ocbimv22025673m.g","KQ419885",21,586,565
"33127","Ocbimv22006549m.g","KQ426003",119620,175797,56177
"33128","Ocbimv22002842m.g","KQ424801",131472,135593,4121
"33129","Ocbimv22011228m.g","KQ417763",783681,784366,685
"33130","Ocbimv22018899m.g","KQ430924",89723,116440,26717
"33131","Ocbimv22022729m.g","KQ416074",358798,361293,2495
"33132","Ocbimv22003599m.g","KQ425041",221278,234696,13418
"33133","Ocbimv22029229m.g","KQ416294",282693,316185,33492
"33134","Ocbimv22033256m.g","KQ421758",1483135,1495972,12837
"33135","Ocbimv22013735m.g","KQ428628",3039,5261,2222
"33136","Ocbimv22003096m.g","KQ415796",128347,130807,2460
"33137","Ocbimv22009549m.g","KQ415865",1586771,1587844,1073
"33138","Ocbimv22029602m.g","KQ420779",518081,542865,24784
"33139","Ocbimv22029863m.g","KQ420828",1858909,1872198,13289
"33140","Ocbimv22028790m.g","KQ416272",333581,333772,191
"33141","Ocbimv22027584m.g","KQ420311",4469,57119,52650
"33142","Ocbimv22018477m.g","KQ418623",48766,49641,875
"33143","Ocbimv22025864m.g","KQ419916",207219,210705,3486
"33144","Ocbimv22013620m.g","KQ418039",660384,660872,488
"33145","Ocbimv22033849m.g","KQ421894",168831,169328,497
"33146","Ocbimv22017904m.g","KQ430515",162296,162838,542
"33147","Ocbimv22024571m.g","KQ434066",47,436,389
"33148","Ocbimv22027621m.g","KQ420314",77083,77578,495
"33149","Ocbimv22030798m.g","KQ416370",319817,320177,360
"33150","Ocbimv22025648m.g","KQ419876",23804,23980,176
"33151","Ocbimv22001552m.g","KQ424354",44479,76229,31750
"33152","Ocbimv22022339m.g","KQ419201",127772,143588,15816
"33153","Ocbimv22014582m.g","KQ428994",178437,209637,31200
"33154","Ocbimv22029561m.g","KQ420776",595080,596284,1204
"33155","Ocbimv22027854m.g","KQ420377",136914,137932,1018
"33156","Ocbimv22023596m.g","KQ419439",93617,94315,698
"33157","Ocbimv22034527m.g","KQ422072",20577,21680,1103
"33158","Ocbimv22006808m.g","KQ417353",682,4058,3376
"33159","Ocbimv22036062m.g","KQ416616",265900,266148,248
"33160","Ocbimv22023532m.g","KQ419425",630741,647805,17064
"33161","Ocbimv22015324m.g","KQ429267",30016,48070,18054
"33162","Ocbimv22033826m.g","KQ421891",152108,198182,46074
"33163","Ocbimv22024248m.g","KQ433885",2841,5996,3155
"33164","Ocbimv22010693m.g","KQ417703",364447,364986,539
"33165","Ocbimv22018936m.g","KQ416004",60383,61376,993
"33166","Ocbimv22030832m.g","LGKD01385188",7,429,422
"33167","Ocbimv22037939m.g","KQ423174",54,65564,65510
"33168","Ocbimv22032114m.g","KQ421451",291905,293179,1274
"33169","Ocbimv22019440m.g","KQ418767",333585,336215,2630
"33170","Ocbimv22027045m.g","KQ416209",206447,214777,8330
"33171","Ocbimv22012108m.g","KQ417874",323780,324703,923
"33172","Ocbimv22023089m.g","KQ433206",42144,42583,439
"33173","Ocbimv22003602m.g","KQ425041",277496,277933,437
"33174","Ocbimv22038002m.g","KQ416719",246777,248063,1286
"33175","Ocbimv22028439m.g","KQ420488",114227,118357,4130
"33176","Ocbimv22003392m.g","KQ425003",31376,84586,53210
"33177","Ocbimv22016971m.g","KQ418431",64554,88679,24125
"33178","Ocbimv22037661m.g","KQ416705",1377596,1397186,19590
"33179","Ocbimv22005123m.g","KQ415813",680146,684132,3986
"33180","Ocbimv22035630m.g","KQ422481",200661,225880,25219
"33181","Ocbimv22004001m.g","KQ417131",2,1542,1540
"33182","Ocbimv22017273m.g","KQ418475",41406,41735,329
"33183","Ocbimv22013151m.g","KQ417989",598920,599852,932
"33184","Ocbimv22000715m.g","KQ416877",491764,497180,5416
"33185","Ocbimv22015682m.g","KQ429470",172541,190543,18002
"33186","Ocbimv22031640m.g","KQ421305",286682,297565,10883
"33187","Ocbimv22002732m.g","KQ417030",655103,657865,2762
"33188","Ocbimv22011268m.g","KQ417771",1311347,1331486,20139
"33189","Ocbimv22007304m.g","KQ426287",229694,238228,8534
"33190","Ocbimv22036613m.g","LGKD01453336",22,183,161
"33191","Ocbimv22022192m.g","LGKD01675901",224,538,314
"33192","Ocbimv22001813m.g","KQ424429",124398,125046,648
"33193","Ocbimv22016063m.g","KQ415952",255074,277619,22545
"33194","Ocbimv22037579m.g","KQ423074",14748,15480,732
"33195","Ocbimv22020961m.g","KQ418983",30001,53500,23499
"33196","Ocbimv22016514m.g","LGKD01234673",12,134,122
"33197","Ocbimv22036882m.g","KQ422889",470413,536613,66200
"33198","Ocbimv22035141m.g","KQ422290",895,25384,24489
"33199","Ocbimv22004614m.g","KQ417183",485012,496618,11606
"33200","Ocbimv22008568m.g","KQ417510",23445,27248,3803
"33201","Ocbimv22024561m.g","KQ434053",19481,58240,38759
"33202","Ocbimv22021544m.g","KQ432225",5958,7170,1212
"33203","Ocbimv22008030m.g","KQ426534",105702,105920,218
"33204","Ocbimv22039380m.g","KQ423637",77367,78256,889
"33205","Ocbimv22027437m.g","KQ420277",59439,62297,2858
"33206","Ocbimv22025204m.g","KQ419727",693996,695363,1367
"33207","Ocbimv22034510m.g","KQ422063",223472,225438,1966
"33208","Ocbimv22013911m.g","KQ418071",201016,201765,749
"33209","Ocbimv22034794m.g","KQ422176",199478,208768,9290
"33210","Ocbimv22014544m.g","KQ428981",153331,161475,8144
"33211","Ocbimv22037886m.g","KQ423143",135709,136056,347
"33212","Ocbimv22001551m.g","KQ424354",5251,31805,26554
"33213","Ocbimv22023151m.g","KQ419360",343351,343629,278
"33214","Ocbimv22031084m.g","KQ415720",132624,133061,437
"33215","Ocbimv22026848m.g","KQ420130",235666,235875,209
"33216","Ocbimv22009951m.g","KQ427174",9726,11545,1819
"33217","Ocbimv22027771m.g","KQ420365",330704,410804,80100
"33218","Ocbimv22000174m.g","KQ423881",9221,9496,275
"33219","Ocbimv22001123m.g","KQ424186",257875,284392,26517
"33220","Ocbimv22028060m.g","KQ420424",130642,132361,1719
"33221","Ocbimv22023705m.g","KQ416093",322929,323615,686
"33222","Ocbimv22015342m.g","KQ415942",41415,41615,200
"33223","Ocbimv22033897m.g","KQ416498",421033,429100,8067
"33224","Ocbimv22027524m.g","KQ420299",96334,97608,1274
"33225","Ocbimv22027147m.g","KQ420203",186916,188283,1367
"33226","Ocbimv22006069m.g","KQ425805",455877,456164,287
"33227","Ocbimv22006382m.g","KQ417316",313223,313486,263
"33228","Ocbimv22000741m.g","KQ416877",1248437,1249566,1129
"33229","Ocbimv22007926m.g","KQ417460",10803,43051,32248
"33230","Ocbimv22038543m.g","KQ423395",30428,74106,43678
"33231","Ocbimv22005732m.g","LGKD01541021",146,301,155
"33232","Ocbimv22035034m.g","KQ422253",5025,6044,1019
"33233","Ocbimv22022460m.g","KQ419223",26055,36309,10254
"33234","Ocbimv22019762m.g","KQ418811",819270,835014,15744
"33235","Ocbimv22012355m.g","KQ428130",51275,80701,29426
"33236","Ocbimv22014144m.g","KQ418094",112898,124735,11837
"33237","Ocbimv22016438m.g","KQ418355",158383,159515,1132
"33238","Ocbimv22024988m.g","KQ419672",172418,172666,248
"33239","Ocbimv22024756m.g","KQ419623",126284,127087,803
"33240","Ocbimv22039677m.g","KQ416813",1127548,1127973,425
"33241","Ocbimv22026583m.g","KQ420075",78639,79085,446
"33242","Ocbimv22017457m.g","KQ418498",252579,312505,59926
"33243","Ocbimv22001492m.g","KQ424324",39899,43605,3706
"33244","Ocbimv22027306m.g","KQ416221",83466,83744,278
"33245","Ocbimv22008530m.g","KQ426666",165917,166462,545
"33246","Ocbimv22000423m.g","KQ423959",3882,20301,16419
"33247","Ocbimv22018058m.g","KQ430541",169564,231108,61544
"33248","Ocbimv22036958m.g","KQ416666",1797832,1798057,225
"33249","Ocbimv22008599m.g","KQ417510",511069,553931,42862
"33250","Ocbimv22029003m.g","KQ416279",392968,576405,183437
"33251","Ocbimv22004783m.g","KQ425437",75778,77794,2016
"33252","Ocbimv22035358m.g","KQ416582",190719,192750,2031
"33253","Ocbimv22000849m.g","KQ424093",545057,591098,46041
"33254","Ocbimv22025007m.g","KQ419683",118707,119340,633
"33255","Ocbimv22035679m.g","KQ422515",31,1135,1104
"33256","Ocbimv22009648m.g","KQ427059",464315,465215,900
"33257","Ocbimv22007723m.g","KQ417446",313587,314073,486
"33258","Ocbimv22016194m.g","KQ429742",75903,87018,11115
"33259","Ocbimv22010049m.g","KQ427227",218610,242549,23939
"33260","Ocbimv22032621m.g","KQ416442",72165,139509,67344
"33261","Ocbimv22032291m.g","KQ421514",172470,173042,572
"33262","Ocbimv22024011m.g","LGKD01694795",130,691,561
"33263","Ocbimv22001917m.g","KQ424476",13483,14113,630
"33264","Ocbimv22025079m.g","KQ416137",351557,372458,20901
"33265","Ocbimv22003851m.g","KQ415798",96517,97676,1159
"33266","Ocbimv22005681m.g","KQ417272",263422,265236,1814
"33267","Ocbimv22025505m.g","KQ419825",43011,86921,43910
"33268","Ocbimv22011480m.g","KQ417795",89492,94191,4699
"33269","Ocbimv22012169m.g","KQ428057",29826,41336,11510
"33270","Ocbimv22008521m.g","KQ417506",861407,861730,323
"33271","Ocbimv22020794m.g","KQ418966",14179,18787,4608
"33272","Ocbimv22020915m.g","KQ418974",1228049,1228339,290
"33273","Ocbimv22028898m.g","KQ416274",783917,784249,332
"33274","Ocbimv22020566m.g","KQ418926",131129,132423,1294
"33275","Ocbimv22009498m.g","KQ415865",456254,461130,4876
"33276","Ocbimv22033033m.g","KQ421720",306451,309027,2576
"33277","Ocbimv22021540m.g","KQ419073",19275,20398,1123
"33278","Ocbimv22017741m.g","KQ430456",134,340,206
"33279","Ocbimv22026146m.g","KQ420004",143230,151839,8609
"33280","Ocbimv22024218m.g","KQ419550",173679,176395,2716
"33281","Ocbimv22032356m.g","KQ421523",1442002,1443882,1880
"33282","Ocbimv22009635m.g","KQ427059",133846,136100,2254
"33283","Ocbimv22015211m.g","KQ429207",37283,41297,4014
"33284","Ocbimv22030681m.g","KQ421059",206776,207141,365
"33285","Ocbimv22021228m.g","KQ419016",94878,95090,212
"33286","Ocbimv22031148m.g","KQ421176",8290,10293,2003
"33287","Ocbimv22012509m.g","KQ417917",351272,359152,7880
"33288","Ocbimv22010671m.g","KQ417701",199235,201059,1824
"33289","Ocbimv22014647m.g","KQ429021",3692,8637,4945
"33290","Ocbimv22011501m.g","KQ417796",420900,422802,1902
"33291","Ocbimv22019048m.g","KQ418711",1210968,1211530,562
"33292","Ocbimv22007605m.g","KQ426399",344,568,224
"33293","Ocbimv22026758m.g","KQ420109",299449,300093,644
"33294","Ocbimv22012630m.g","KQ417921",1348125,1348786,661
"33295","Ocbimv22009373m.g","KQ417588",249145,249294,149
"33296","Ocbimv22004715m.g","KQ417199",218863,219188,325
"33297","Ocbimv22012487m.g","KQ417917",103993,113910,9917
"33298","Ocbimv22017502m.g","KQ430326",20823,31774,10951
"33299","Ocbimv22021941m.g","KQ419136",248577,248858,281
"33300","Ocbimv22025569m.g","KQ419844",91402,99938,8536
"33301","Ocbimv22025278m.g","KQ419758",125886,126494,608
"33302","Ocbimv22028264m.g","KQ415659",1718132,1718389,257
"33303","Ocbimv22010525m.g","KQ417687",622765,623418,653
"33304","Ocbimv22001001m.g","KQ424146",162763,163326,563
"33305","Ocbimv22001662m.g","KQ416951",432066,450941,18875
"33306","Ocbimv22039589m.g","KQ416806",237721,237933,212
"33307","Ocbimv22001372m.g","KQ416927",19895,20672,777
"33308","Ocbimv22030202m.g","KQ420924",85230,109386,24156
"33309","Ocbimv22038292m.g","KQ423260",567532,569955,2423
"33310","Ocbimv22006022m.g","LGKD01542108",6,119,113
"33311","Ocbimv22010455m.g","KQ417678",120434,141286,20852
"33312","Ocbimv22035920m.g","KQ416609",60175,66146,5971
"33313","Ocbimv22023490m.g","KQ416088",561973,562158,185
"33314","Ocbimv22004603m.g","KQ417182",808555,811963,3408
"33315","Ocbimv22038992m.g","KQ423506",24558,55079,30521
"33316","Ocbimv22031725m.g","KQ421325",356995,357882,887
"33317","Ocbimv22012604m.g","KQ417921",33378,67542,34164
"33318","Ocbimv22031215m.g","KQ421200",325877,326569,692
"33319","Ocbimv22021427m.g","KQ416045",477690,478130,440
"33320","Ocbimv22018117m.g","KQ430572",414741,421894,7153
"33321","Ocbimv22001264m.g","KQ424244",317916,322844,4928
"33322","Ocbimv22031428m.g","KQ421241",479864,480374,510
"33323","Ocbimv22034907m.g","KQ422211",139282,141889,2607
"33324","Ocbimv22019994m.g","KQ418840",1660039,1674542,14503
"33325","Ocbimv22033751m.g","KQ421864",206419,211914,5495
"33326","Ocbimv22020710m.g","KQ416032",390738,391796,1058
"33327","Ocbimv22019787m.g","KQ431312",34332,35738,1406
"33328","Ocbimv22007239m.g","KQ426259",72773,74397,1624
"33329","Ocbimv22037962m.g","KQ416716",47745,51625,3880
"33330","Ocbimv22037634m.g","KQ423084",17027,18328,1301
"33331","Ocbimv22022350m.g","KQ419203",43294,46496,3202
"33332","Ocbimv22003644m.g","KQ417098",58099,62321,4222
"33333","Ocbimv22037231m.g","KQ416684",581552,585112,3560
"33334","Ocbimv22027732m.g","KQ420350",124690,149157,24467
"33335","Ocbimv22005850m.g","KQ417280",201948,202745,797
"33336","Ocbimv22015364m.g","KQ418230",133758,134123,365
"33337","Ocbimv22035266m.g","KQ422348",100639,166962,66323
"33338","Ocbimv22032546m.g","KQ421581",166047,166917,870
"33339","Ocbimv22008702m.g","KQ426738",223049,226000,2951
"33340","Ocbimv22003514m.g","KQ425021",167190,184369,17179
"33341","Ocbimv22021900m.g","LGKD01672262",3,716,713
"33342","Ocbimv22028676m.g","KQ420550",43132,101182,58050
"33343","Ocbimv22005465m.g","KQ425611",273450,302090,28640
"33344","Ocbimv22025526m.g","KQ419831",278420,330505,52085
"33345","Ocbimv22016242m.g","KQ429764",104957,109656,4699
"33346","Ocbimv22034403m.g","KQ422029",68871,75789,6918
"33347","Ocbimv22012705m.g","KQ428204",10478,16638,6160
"33348","Ocbimv22000228m.g","KQ423901",70351,71298,947
"33349","Ocbimv22010202m.g","KQ417655",432898,433161,263
"33350","Ocbimv22001690m.g","KQ416955",191895,251519,59624
"33351","Ocbimv22032199m.g","KQ421476",337778,388006,50228
"33352","Ocbimv22037565m.g","KQ423066",146300,150579,4279
"33353","Ocbimv22014412m.g","KQ418129",251573,287182,35609
"33354","Ocbimv22001407m.g","KQ424302",5031,23672,18641
"33355","Ocbimv22029882m.g","KQ420830",190,20139,19949
"33356","Ocbimv22038611m.g","KQ416754",428598,436319,7721
"33357","Ocbimv22036915m.g","KQ422894",416522,433421,16899
"33358","Ocbimv22023984m.g","KQ419513",230601,231103,502
"33359","Ocbimv22002524m.g","KQ417012",391668,417209,25541
"33360","Ocbimv22012075m.g","LGKD01592525",4,327,323
"33361","Ocbimv22006277m.g","KQ425850",112508,130226,17718
"33362","Ocbimv22038123m.g","KQ423217",169764,187811,18047
"33363","Ocbimv22033333m.g","KQ421781",4143,4475,332
"33364","Ocbimv22023146m.g","LGKD01295207",102,494,392
"33365","Ocbimv22021011m.g","KQ431933",34549,43204,8655
"33366","Ocbimv22019643m.g","KQ418789",596504,596689,185
"33367","Ocbimv22013424m.g","KQ428503",5070,26265,21195
"33368","Ocbimv22038345m.g","KQ416737",875715,898337,22622
"33369","Ocbimv22016228m.g","KQ429756",43605,43769,164
"33370","Ocbimv22019286m.g","KQ418741",196804,197734,930
"33371","Ocbimv22003546m.g","KQ417090",1664457,1667310,2853
"33372","Ocbimv22019674m.g","LGKD01652572",3,365,362
"33373","Ocbimv22001549m.g","KQ424353",534782,535030,248
"33374","Ocbimv22014503m.g","KQ418145",30043,74757,44714
"33375","Ocbimv22005506m.g","KQ425633",106503,108601,2098
"33376","Ocbimv22025535m.g","KQ419832",1959,12274,10315
"33377","Ocbimv22031282m.g","KQ421217",75658,92128,16470
"33378","Ocbimv22032138m.g","KQ421460",98088,105803,7715
"33379","Ocbimv22017186m.g","LGKD01633647",524,688,164
"33380","Ocbimv22019104m.g","KQ430964",310509,312144,1635
"33381","Ocbimv22021304m.g","KQ419026",768798,770562,1764
"33382","Ocbimv22029615m.g","KQ420783",27718,29553,1835
"33383","Ocbimv22008767m.g","KQ417531",163826,203373,39547
"33384","Ocbimv22023461m.g","KQ419414",367119,368663,1544
"33385","Ocbimv22001229m.g","KQ416917",481296,481751,455
"33386","Ocbimv22033229m.g","KQ421758",435165,435386,221
"33387","Ocbimv22019447m.g","LGKD01650855",31,129,98
"33388","Ocbimv22027533m.g","KQ420299",858965,867311,8346
"33389","Ocbimv22009772m.g","KQ417613",101698,102129,431
"33390","Ocbimv22026798m.g","KQ420117",1526772,1602403,75631
"33391","Ocbimv22019260m.g","KQ418739",220367,220636,269
"33392","Ocbimv22018379m.g","KQ430673",3,497,494
"33393","Ocbimv22028452m.g","KQ420490",319832,320083,251
"33394","Ocbimv22002504m.g","KQ417011",188439,188987,548
"33395","Ocbimv22013421m.g","KQ418021",448469,495806,47337
"33396","Ocbimv22009429m.g","KQ417591",1591750,1624201,32451
"33397","Ocbimv22011800m.g","KQ427910",10762,134624,123862
"33398","Ocbimv22023231m.g","KQ419378",20504,21567,1063
"33399","Ocbimv22028742m.g","KQ420569",40319,40522,203
"33400","Ocbimv22029950m.g","KQ420859",48926,49874,948
"33401","Ocbimv22036754m.g","KQ422849",186431,187205,774
"33402","Ocbimv22017855m.g","KQ418552",249100,251401,2301
"33403","Ocbimv22011583m.g","LGKD01588055",284,601,317
"33404","Ocbimv22030574m.g","KQ416357",40933,66827,25894
"33405","Ocbimv22011776m.g","KQ415891",558021,558437,416
"33406","Ocbimv22021829m.g","KQ415687",756803,765090,8287
"33407","Ocbimv22021033m.g","KQ431955",741,60296,59555
"33408","Ocbimv22003247m.g","KQ417068",718214,745750,27536
"33409","Ocbimv22035143m.g","KQ422290",65470,84997,19527
"33410","Ocbimv22022108m.g","LGKD01675364",3,536,533
"33411","Ocbimv22013451m.g","KQ428518",55516,63722,8206
"33412","Ocbimv22013961m.g","KQ418073",388958,392533,3575
"33413","Ocbimv22002756m.g","KQ424774",37728,37955,227
"33414","Ocbimv22010812m.g","KQ427524",47508,55623,8115
"33415","Ocbimv22026938m.g","KQ420146",888,141338,140450
"33416","Ocbimv22010910m.g","KQ417724",402135,402512,377
"33417","Ocbimv22030434m.g","KQ420985",104828,105082,254
"33418","Ocbimv22011158m.g","KQ417754",89603,157939,68336
"33419","Ocbimv22004342m.g","KQ425268",124686,142161,17475
"33420","Ocbimv22004198m.g","KQ425223",52437,53129,692
"33421","Ocbimv22014011m.g","KQ428720",27387,27883,496
"33422","Ocbimv22016005m.g","KQ429656",5454,57034,51580
"33423","Ocbimv22032135m.g","KQ421459",38298,98549,60251
"33424","Ocbimv22014671m.g","KQ418168",29236,41696,12460
"33425","Ocbimv22021508m.g","KQ419061",132813,133215,402
"33426","Ocbimv22008778m.g","KQ426774",16582,21609,5027
"33427","Ocbimv22015070m.g","KQ418194",1274268,1296055,21787
"33428","Ocbimv22012999m.g","KQ428335",2,2405,2403
"33429","Ocbimv22004534m.g","KQ415805",1927694,1928119,425
"33430","Ocbimv22022381m.g","KQ419212",393244,393870,626
"33431","Ocbimv22026906m.g","KQ420140",85082,85701,619
"33432","Ocbimv22003652m.g","KQ425062",96613,103102,6489
"33433","Ocbimv22028191m.g","KQ420442",51943,53645,1702
"33434","Ocbimv22036651m.g","KQ422819",142376,197763,55387
"33435","Ocbimv22028543m.g","KQ416260",395053,395409,356
"33436","Ocbimv22032252m.g","KQ421503",136791,158835,22044
"33437","Ocbimv22005151m.g","KQ425531",157773,158018,245
"33438","Ocbimv22022900m.g","KQ433121",19956,46814,26858
"33439","Ocbimv22028925m.g","KQ416274",2063079,2064322,1243
"33440","Ocbimv22017072m.g","KQ418448",64998,65300,302
"33441","Ocbimv22012407m.g","KQ428153",5670,7919,2249
"33442","Ocbimv22020513m.g","KQ418921",689945,690244,299
"33443","Ocbimv22013357m.g","KQ428462",46460,47349,889
"33444","Ocbimv22017554m.g","KQ415978",253361,274685,21324
"33445","Ocbimv22014072m.g","KQ418087",100605,100937,332
"33446","Ocbimv22017325m.g","KQ418483",63162,63350,188
"33447","Ocbimv22026327m.g","KQ420027",29127,40078,10951
"33448","Ocbimv22029745m.g","KQ420818",116964,120188,3224
"33449","Ocbimv22015605m.g","KQ429431",33726,43686,9960
"33450","Ocbimv22035012m.g","KQ422246",56592,57021,429
"33451","Ocbimv22036547m.g","KQ416644",631438,631827,389
"33452","Ocbimv22022873m.g","KQ419316",70720,71736,1016
"33453","Ocbimv22006490m.g","KQ425943",72543,72785,242
"33454","Ocbimv22017011m.g","LGKD01632228",4759,6489,1730
"33455","Ocbimv22035276m.g","KQ422349",81228,83555,2327
"33456","Ocbimv22001545m.g","KQ424353",159050,159589,539
"33457","Ocbimv22019039m.g","KQ418711",1038094,1044030,5936
"33458","Ocbimv22035949m.g","KQ416612",1443898,1466322,22424
"33459","Ocbimv22017625m.g","KQ430384",17459,23524,6065
"33460","Ocbimv22011924m.g","KQ427949",370660,379297,8637
"33461","Ocbimv22003309m.g","KQ424958",212995,213561,566
"33462","Ocbimv22001101m.g","KQ424182",117152,118119,967
"33463","Ocbimv22004343m.g","KQ425268",142299,145360,3061
"33464","Ocbimv22028594m.g","KQ416263",264073,264333,260
"33465","Ocbimv22015318m.g","KQ418220",34515,35708,1193
"33466","Ocbimv22023473m.g","KQ433417",37251,37949,698
"33467","Ocbimv22032220m.g","KQ421485",16874,18571,1697
"33468","Ocbimv22012814m.g","KQ417942",1295678,1295842,164
"33469","Ocbimv22024401m.g","KQ415693",586272,587970,1698
"33470","Ocbimv22031853m.g","KQ421358",66922,67110,188
"33471","Ocbimv22039007m.g","KQ416777",200978,206754,5776
"33472","Ocbimv22005591m.g","KQ425656",271514,297802,26288
"33473","Ocbimv22033032m.g","KQ421720",294293,295074,781
"33474","Ocbimv22000818m.g","KQ424081",138762,139529,767
"33475","Ocbimv22038338m.g","KQ415764",446992,447534,542
"33476","Ocbimv22005891m.g","KQ425750",3517,8158,4641
"33477","Ocbimv22012793m.g","KQ428240",128483,147948,19465
"33478","Ocbimv22024390m.g","KQ415693",334790,338574,3784
"33479","Ocbimv22024062m.g","KQ433779",4492,6354,1862
"33480","Ocbimv22026458m.g","KQ420053",309916,310616,700
"33481","Ocbimv22039573m.g","KQ423703",321973,340584,18611
"33482","Ocbimv22001426m.g","KQ416933",42653,52109,9456
"33483","Ocbimv22002198m.g","KQ416995",146633,161876,15243
"33484","Ocbimv22026673m.g","KQ416196",599792,603111,3319
"33485","Ocbimv22012891m.g","KQ417949",14844,58599,43755
"33486","Ocbimv22029043m.g","KQ416282",5801,7394,1593
"33487","Ocbimv22039447m.g","KQ423671",33167,33751,584
"33488","Ocbimv22024346m.g","KQ419574",312893,315297,2404
"33489","Ocbimv22020286m.g","KQ431584",61,33663,33602
"33490","Ocbimv22010056m.g","KQ427235",17583,22066,4483
"33491","Ocbimv22035326m.g","KQ422352",11530,12536,1006
"33492","Ocbimv22003427m.g","KQ417087",675582,675794,212
"33493","Ocbimv22010508m.g","KQ417683",20586,28568,7982
"33494","Ocbimv22022114m.g","LGKD01675493",3908,4541,633
"33495","Ocbimv22012018m.g","KQ427973",6947,28345,21398
"33496","Ocbimv22019689m.g","KQ431259",385,855,470
"33497","Ocbimv22002686m.g","KQ424738",136253,148134,11881
"33498","Ocbimv22021853m.g","KQ415687",1449199,1456121,6922
"33499","Ocbimv22008596m.g","KQ417510",489731,500014,10283
"33500","Ocbimv22034611m.g","KQ416539",372173,372340,167
"33501","Ocbimv22014455m.g","KQ428936",1683,10660,8977
"33502","Ocbimv22029018m.g","KQ420624",17332,17856,524
"33503","Ocbimv22023861m.g","KQ416102",525653,525901,248
"33504","Ocbimv22015378m.g","KQ418233",94168,94692,524
"33505","Ocbimv22012930m.g","KQ428299",1235,32285,31050
"33506","Ocbimv22022877m.g","KQ419318",313750,314088,338
"33507","Ocbimv22021605m.g","KQ432245",100466,100843,377
"33508","Ocbimv22039156m.g","KQ423555",268184,272049,3865
"33509","Ocbimv22007559m.g","KQ417427",1846,12649,10803
"33510","Ocbimv22011982m.g","KQ417850",79869,87887,8018
"33511","Ocbimv22035454m.g","KQ422387",372,13574,13202
"33512","Ocbimv22018133m.g","LGKD01641088",133,408,275
"33513","Ocbimv22005496m.g","KQ425623",1059,8539,7480
"33514","Ocbimv22030233m.g","KQ420925",43627,52788,9161
"33515","Ocbimv22038771m.g","KQ416765",507386,514014,6628
"33516","Ocbimv22032679m.g","KQ416444",166564,172230,5666
"33517","Ocbimv22026697m.g","KQ420095",26674,31077,4403
"33518","Ocbimv22004964m.g","KQ425487",302650,302847,197
"33519","Ocbimv22016042m.g","KQ418312",406997,512130,105133
"33520","Ocbimv22037308m.g","KQ422999",57081,57902,821
"33521","Ocbimv22011867m.g","KQ427941",86399,120952,34553
"33522","Ocbimv22039137m.g","KQ423548",67410,74000,6590
"33523","Ocbimv22012966m.g","KQ417963",138890,139560,670
"33524","Ocbimv22023849m.g","KQ433676",15221,26524,11303
"33525","Ocbimv22031749m.g","KQ421337",244788,296267,51479
"33526","Ocbimv22024622m.g","KQ434070",18404,47155,28751
"33527","Ocbimv22014911m.g","KQ418187",319590,321454,1864
"33528","Ocbimv22014309m.g","KQ428859",61243,69618,8375
"33529","Ocbimv22029769m.g","KQ420820",524963,525225,262
"33530","Ocbimv22005166m.g","KQ425537",150985,153265,2280
"33531","Ocbimv22023101m.g","KQ419349",15422,21006,5584
"33532","Ocbimv22005600m.g","KQ425671",14712,15110,398
"33533","Ocbimv22014257m.g","KQ418108",28267,46324,18057
"33534","Ocbimv22033437m.g","KQ421813",66199,68511,2312
"33535","Ocbimv22034578m.g","KQ422077",304596,356740,52144
"33536","Ocbimv22006106m.g","KQ417297",176406,176932,526
"33537","Ocbimv22001921m.g","KQ424478",598,7803,7205
"33538","Ocbimv22033456m.g","KQ421816",828601,841031,12430
"33539","Ocbimv22015460m.g","KQ429360",105593,106189,596
"33540","Ocbimv22006940m.g","KQ426160",26546,27505,959
"33541","Ocbimv22002251m.g","KQ424585",65491,66413,922
"33542","Ocbimv22002856m.g","KQ424805",79238,93415,14177
"33543","Ocbimv22022772m.g","KQ433003",2015,2221,206
"33544","Ocbimv22038694m.g","KQ423444",271485,279223,7738
"33545","Ocbimv22035702m.g","KQ416599",41797,62092,20295
"33546","Ocbimv22006703m.g","KQ426075",413742,421650,7908
"33547","Ocbimv22000256m.g","KQ423906",95232,102327,7095
"33548","Ocbimv22021899m.g","KQ419124",83724,84249,525
"33549","Ocbimv22031552m.g","KQ421273",601584,604165,2581
"33550","Ocbimv22001736m.g","KQ416958",141143,153784,12641
"33551","Ocbimv22007997m.g","KQ426525",126186,126671,485
"33552","Ocbimv22039360m.g","KQ423631",176922,185998,9076
"33553","Ocbimv22029151m.g","KQ416289",1590,2607,1017
"33554","Ocbimv22007551m.g","KQ426371",376582,385102,8520
"33555","Ocbimv22030794m.g","KQ416370",207813,271473,63660
"33556","Ocbimv22012620m.g","KQ417921",867390,870720,3330
"33557","Ocbimv22009778m.g","KQ417613",956796,959612,2816
"33558","Ocbimv22014212m.g","KQ418101",103706,117523,13817
"33559","Ocbimv22032732m.g","KQ416449",15765,16291,526
"33560","Ocbimv22012639m.g","KQ428192",90979,108199,17220
"33561","Ocbimv22030567m.g","KQ421022",553171,555480,2309
"33562","Ocbimv22035570m.g","KQ422438",234087,247898,13811
"33563","Ocbimv22020670m.g","KQ418949",78953,144397,65444
"33564","Ocbimv22002286m.g","KQ417001",74686,128751,54065
"33565","Ocbimv22013206m.g","KQ418002",135053,136492,1439
"33566","Ocbimv22034164m.g","KQ416516",329742,330249,507
"33567","Ocbimv22010309m.g","KQ427350",78484,99013,20529
"33568","Ocbimv22025167m.g","KQ416141",532182,535146,2964
"33569","Ocbimv22014820m.g","KQ429096",476932,477881,949
"33570","Ocbimv22012352m.g","KQ417904",392640,392873,233
"33571","Ocbimv22033274m.g","KQ421759",144956,145123,167
"33572","Ocbimv22001737m.g","KQ416958",156228,156563,335
"33573","Ocbimv22018633m.g","KQ430777",15852,18056,2204
"33574","Ocbimv22020707m.g","KQ416032",259796,260165,369
"33575","Ocbimv22026206m.g","KQ420017",8551,10333,1782
"33576","Ocbimv22013657m.g","KQ428583",167316,195539,28223
"33577","Ocbimv22026220m.g","KQ420017",547804,565033,17229
"33578","Ocbimv22002721m.g","KQ424760",118572,119113,541
"33579","Ocbimv22028393m.g","KQ416257",726414,726777,363
"33580","Ocbimv22011000m.g","KQ427586",43751,47594,3843
"33581","Ocbimv22027930m.g","KQ420404",651457,652278,821
"33582","Ocbimv22020965m.g","KQ418983",66870,67058,188
"33583","Ocbimv22016267m.g","KQ429784",99102,99936,834
"33584","Ocbimv22036626m.g","KQ416651",1368225,1389482,21257
"33585","Ocbimv22012004m.g","KQ415896",28388,28720,332
"33586","Ocbimv22036324m.g","KQ415755",93075,97277,4202
"33587","Ocbimv22031449m.g","KQ421252",2081,3947,1866
"33588","Ocbimv22034358m.g","KQ422019",324707,365959,41252
"33589","Ocbimv22020992m.g","KQ418990",7522,8945,1423
"33590","Ocbimv22032248m.g","KQ421501",28697,118654,89957
"33591","Ocbimv22009833m.g","KQ417620",511834,518090,6256
"33592","Ocbimv22021074m.g","KQ418998",545235,545909,674
"33593","Ocbimv22030412m.g","KQ420971",163892,188649,24757
"33594","Ocbimv22013676m.g","KQ418044",1301,1638,337
"33595","Ocbimv22007118m.g","KQ417381",26866,30852,3986
"33596","Ocbimv22015735m.g","KQ429530",114774,115257,483
"33597","Ocbimv22004747m.g","KQ425434",12410,12606,196
"33598","Ocbimv22012104m.g","KQ428041",105904,106245,341
"33599","Ocbimv22032458m.g","KQ421549",149454,164483,15029
"33600","Ocbimv22003856m.g","KQ425131",96586,114211,17625
"33601","Ocbimv22028821m.g","KQ420587",97113,98852,1739
"33602","Ocbimv22034176m.g","KQ416518",447610,449849,2239
"33603","Ocbimv22002875m.g","KQ417044",93191,102542,9351
"33604","Ocbimv22002184m.g","KQ424569",137304,164753,27449
"33605","Ocbimv22020256m.g","KQ431560",171165,258856,87691
"33606","Ocbimv22020004m.g","KQ418840",2012830,2014327,1497
"33607","Ocbimv22033517m.g","KQ421823",352742,366228,13486
"33608","Ocbimv22018830m.g","KQ418685",363006,363260,254
"33609","Ocbimv22000969m.g","KQ424136",56661,95137,38476
"33610","ENSRNA022756294","KQ418052",342,423,81
"33611","ENSRNA022756306","KQ418052",3771,3852,81
"33612","ENSRNA022756310","KQ418052",3183,3264,81
"33613","ENSRNA022756317","KQ418052",1682,1763,81
"33614","ENSRNA022756364","KQ425194",6139,6210,71
"33615","ENSRNA022756367","KQ425194",3311,3382,71
"33616","ENSRNA022756457","KQ426191",1451,1534,83
"33617","ENSRNA022756460","KQ426191",10130,10213,83
"33618","ENSRNA022756462","KQ426191",7890,7973,83
"33619","ENSRNA022756489","LGKD01655541",59,130,71
"33620","ENSRNA022756522","LGKD01116820",4166,4237,71
"33621","ENSRNA022756527","LGKD01116820",2124,2195,71
"33622","ENSRNA022756531","LGKD01668207",44,117,73
"33623","ENSRNA022756542","LGKD01650542",82,153,71
"33624","ENSRNA022756564","LGKD01443532",116,187,71
"33625","ENSRNA022756599","LGKD01643882",193,274,81
"33626","ENSRNA022756616","KQ429916",241,314,73
"33627","ENSRNA022756629","KQ426969",994,1065,71
"33628","ENSRNA022756669","LGKD01590690",184,256,72
"33629","ENSRNA022756740","LGKD01631662",99,170,71
"33630","ENSRNA022756749","LGKD01488286",14,108,94
"33631","ENSRNA022756757","KQ424347",60820,60893,73
"33632","ENSRNA022756763","KQ418261",10334,10415,81
"33633","ENSRNA022756774","KQ419030",20346,20417,71
"33634","ENSRNA022756780","KQ430847",352,423,71
"33635","ENSRNA022756786","KQ420521",34776,34848,72
"33636","ENSRNA022756790","KQ420521",41629,41701,72
"33637","ENSRNA022756791","KQ420521",40972,41044,72
"33638","ENSRNA022756793","KQ420521",42656,42728,72
"33639","ENSRNA022756795","KQ420521",47803,47875,72
"33640","ENSRNA022756796","KQ420521",50055,50127,72
"33641","ENSRNA022756803","LGKD01650450",242,314,72
"33642","ENSRNA022756809","LGKD01676384",196,269,73
"33643","ENSRNA022756813","KQ430730",19114,19195,81
"33644","ENSRNA022756847","KQ422659",21606,21677,71
"33645","ENSRNA022756853","KQ423893",13080,13152,72
"33646","ENSRNA022756872","KQ426686",43457,43538,81
"33647","ENSRNA022756874","KQ426686",39646,39727,81
"33648","ENSRNA022756876","LGKD01231925",59,142,83
"33649","ENSRNA022756911","KQ428821",72958,73031,73
"33650","ENSRNA022756932","KQ417888",22902,22973,71
"33651","ENSRNA022756936","KQ417567",234131,234204,73
"33652","ENSRNA022756939","KQ417567",232058,232131,73
"33653","ENSRNA022756945","KQ418069",139467,139548,81
"33654","ENSRNA022756949","KQ420554",45202,45273,71
"33655","ENSRNA022756962","KQ422870",261294,261366,72
"33656","ENSRNA022756983","KQ424775",154362,154435,73
"33657","ENSRNA022756993","KQ428981",31481,31552,71
"33658","ENSRNA022757012","KQ415795",41033,41104,71
"33659","ENSRNA022757079","KQ420892",198822,198895,73
"33660","ENSRNA022757090","KQ418852",206302,206373,71
"33661","ENSRNA022757116","KQ421960",210797,210870,73
"33662","ENSRNA022757118","KQ421960",200235,200308,73
"33663","ENSRNA022757120","KQ421960",190921,190994,73
"33664","ENSRNA022757129","KQ426792",206033,206125,92
"33665","ENSRNA022757131","KQ426792",204255,204347,92
"33666","ENSRNA022757134","KQ426792",210025,210117,92
"33667","ENSRNA022757137","KQ426792",215544,215636,92
"33668","ENSRNA022757140","KQ426792",213843,213935,92
"33669","ENSRNA022757141","KQ426792",212995,213087,92
"33670","ENSRNA022757144","KQ418026",250439,250511,72
"33671","ENSRNA022757149","KQ428192",60328,60401,73
"33672","ENSRNA022757156","KQ426287",11271,11342,71
"33673","ENSRNA022757163","KQ420505",335810,335881,71
"33674","ENSRNA022757193","KQ417746",283605,283696,91
"33675","ENSRNA022757195","KQ417746",286660,286751,91
"33676","ENSRNA022757198","KQ417746",284062,284153,91
"33677","ENSRNA022757200","KQ417746",295027,295118,91
"33678","ENSRNA022757203","KQ417746",295969,296060,91
"33679","ENSRNA022757205","KQ417746",326591,326683,92
"33680","ENSRNA022757206","KQ417746",275777,275869,92
"33681","ENSRNA022757209","KQ417746",282692,282786,94
"33682","ENSRNA022757218","KQ421318",130863,130934,71
"33683","ENSRNA022757225","KQ417813",169344,169415,71
"33684","ENSRNA022757229","KQ420471",157655,157726,71
"33685","ENSRNA022757248","KQ415812",104196,104267,71
"33686","ENSRNA022757253","KQ424575",273218,273291,73
"33687","ENSRNA022757256","KQ424575",276885,276958,73
"33688","ENSRNA022757259","KQ424575",276462,276535,73
"33689","ENSRNA022757260","KQ424575",277184,277257,73
"33690","ENSRNA022757263","KQ424575",274684,274757,73
"33691","ENSRNA022757266","KQ424575",289991,290064,73
"33692","ENSRNA022757269","KQ424575",274104,274177,73
"33693","ENSRNA022757296","KQ423298",27224,27295,71
"33694","ENSRNA022757301","KQ416964",195481,195562,81
"33695","ENSRNA022757305","KQ421742",153808,153880,72
"33696","ENSRNA022757314","KQ421232",1432,1505,73
"33697","ENSRNA022757369","KQ417902",163214,163287,73
"33698","ENSRNA022757374","KQ417762",197621,197692,71
"33699","ENSRNA022757387","KQ417343",304962,305033,71
"33700","ENSRNA022757424","KQ421605",188473,188554,81
"33701","ENSRNA022757446","KQ421144",81453,81541,88
"33702","ENSRNA022757456","KQ415762",285,356,71
"33703","ENSRNA022757475","KQ419781",183171,183242,71
"33704","ENSRNA022757481","KQ422986",21815,21887,72
"33705","ENSRNA022757502","KQ419334",82836,82909,73
"33706","ENSRNA022757506","KQ425255",330568,330640,72
"33707","ENSRNA022757519","KQ415703",3627,3699,72
"33708","ENSRNA022757523","KQ415703",6293,6365,72
"33709","ENSRNA022757528","KQ421187",1130,1202,72
"33710","ENSRNA022757535","KQ421187",1921,1993,72
"33711","ENSRNA022757537","KQ421187",6163,6235,72
"33712","ENSRNA022757549","KQ416995",202950,203022,72
"33713","ENSRNA022757557","KQ418295",9708,9779,71
"33714","ENSRNA022757567","KQ424913",92525,92597,72
"33715","ENSRNA022757569","KQ424913",93382,93454,72
"33716","ENSRNA022757573","KQ424913",91175,91248,73
"33717","ENSRNA022757595","KQ418525",150600,150720,120
"33718","ENSRNA022757599","KQ418525",155448,155567,119
"33719","ENSRNA022757622","KQ417208",428639,428710,71
"33720","ENSRNA022757630","KQ417208",420294,420365,71
"33721","ENSRNA022757634","KQ417208",416993,417064,71
"33722","ENSRNA022757642","KQ417208",255916,255987,71
"33723","ENSRNA022757662","KQ425062",592609,592680,71
"33724","ENSRNA022757665","KQ425062",596088,596159,71
"33725","ENSRNA022757667","KQ425062",599804,599875,71
"33726","ENSRNA022757669","KQ425062",597668,597739,71
"33727","ENSRNA022757672","KQ425062",602998,603069,71
"33728","ENSRNA022757675","KQ425062",588220,588291,71
"33729","ENSRNA022757680","KQ419478",483999,484096,97
"33730","ENSRNA022757691","KQ423531",222267,222340,73
"33731","ENSRNA022757694","KQ421121",277737,277808,71
"33732","ENSRNA022757703","KQ417063",5602,5674,72
"33733","ENSRNA022757705","KQ417063",10288,10360,72
"33734","ENSRNA022757708","KQ417063",11039,11111,72
"33735","ENSRNA022757711","KQ417063",13883,13955,72
"33736","ENSRNA022757713","KQ417063",12737,12809,72
"33737","ENSRNA022757716","KQ417063",15180,15252,72
"33738","ENSRNA022757719","KQ417063",16698,16770,72
"33739","ENSRNA022757727","KQ420078",249766,249839,73
"33740","ENSRNA022757731","KQ420078",248271,248344,73
"33741","ENSRNA022757735","KQ420078",245870,245943,73
"33742","ENSRNA022757743","KQ422050",737981,738089,108
"33743","ENSRNA022757747","KQ417604",772394,772477,83
"33744","ENSRNA022757749","KQ417604",221830,221913,83
"33745","ENSRNA022757756","KQ416305",212443,212514,71
"33746","ENSRNA022757767","KQ416040",316684,316755,71
"33747","ENSRNA022757773","KQ420022",145377,145448,71
"33748","ENSRNA022757778","KQ420016",101088,101159,71
"33749","ENSRNA022757795","KQ422889",27168,27239,71
"33750","ENSRNA022757819","KQ417118",374223,374295,72
"33751","ENSRNA022757850","KQ418071",502989,503097,108
"33752","ENSRNA022757858","KQ419324",583805,583876,71
"33753","ENSRNA022757867","KQ419326",743165,743238,73
"33754","ENSRNA022757879","KQ417621",711424,711495,71
"33755","ENSRNA022757888","KQ422351",264478,264549,71
"33756","ENSRNA022757891","KQ422351",265238,265309,71
"33757","ENSRNA022757893","KQ422351",262142,262213,71
"33758","ENSRNA022757895","KQ422351",258298,258369,71
"33759","ENSRNA022757904","KQ416205",638098,638179,81
"33760","ENSRNA022757906","KQ416771",494106,494187,81
"33761","ENSRNA022757909","KQ418365",687262,687334,72
"33762","ENSRNA022757920","KQ417910",618131,618202,71
"33763","ENSRNA022757929","KQ418838",543912,543983,71
"33764","ENSRNA022757931","KQ418838",545709,545780,71
"33765","ENSRNA022757932","KQ418838",539996,540067,71
"33766","ENSRNA022757941","KQ417911",917980,918051,71
"33767","ENSRNA022757946","KQ418087",148521,148604,83
"33768","ENSRNA022757956","KQ426791",4054,4127,73
"33769","ENSRNA022757959","KQ418296",271055,271126,71
"33770","ENSRNA022757963","KQ418296",259330,259401,71
"33771","ENSRNA022757978","KQ421376",1036467,1036538,71
"33772","ENSRNA022757981","KQ421376",1021826,1021938,112
"33773","ENSRNA022757992","KQ415773",84045,84137,92
"33774","ENSRNA022758006","KQ416444",629420,629493,73
"33775","ENSRNA022758013","KQ421906",696352,696423,71
"33776","ENSRNA022758016","KQ421906",695858,695929,71
"33777","ENSRNA022758040","KQ417510",19410,19491,81
"33778","ENSRNA022758058","KQ415694",271597,271680,83
"33779","ENSRNA022758076","KQ417917",422365,422436,71
"33780","ENSRNA022758080","KQ417917",421893,421965,72
"33781","ENSRNA022758101","KQ415761",268463,268536,73
"33782","ENSRNA022758103","KQ416702",94498,94571,73
"33783","ENSRNA022758106","KQ416702",95081,95154,73
"33784","ENSRNA022758112","KQ416002",1038465,1038536,71
"33785","ENSRNA022758116","KQ417591",1231985,1232056,71
"33786","ENSRNA022758120","KQ417681",20039,20122,83
"33787","ENSRNA022758123","KQ417681",18523,18606,83
"33788","ENSRNA022758126","KQ417681",19703,19776,73
"33789","ENSRNA022758128","KQ417681",17185,17268,83
"33790","ENSRNA022758132","KQ416359",1375275,1375345,70
"33791","ENSRNA022758134","KQ416260",1523513,1523585,72
"33792","ENSRNA022758136","KQ415893",94288,94359,71
"33793","ENSRNA022758137","KQ417055",1312888,1312960,72
"33794","ENSRNA022758138","KQ417055",1309824,1309896,72
"33795","ENSRNA022758139","KQ415865",1592154,1592235,81
"33796","ENSRNA022758140","KQ415865",1589548,1589629,81
"33797","ENSRNA022758170","KQ416694",2691928,2692009,81
"33798","ENSRNA022758173","KQ416694",2686572,2686653,81
"33799","ENSRNA022760969","KQ417578",385346,385534,188
"33800","ENSRNA022760970","KQ415949",562905,563081,176
"33801","ENSRNA022760971","KQ420828",1315113,1315210,97
"33802","ENSRNA022760972","KQ420828",1986605,1986710,105
"33803","ENSRNA022760973","KQ420828",1352984,1353089,105
"33804","ENSRNA022760974","KQ418840",496363,496496,133
"33805","ENSRNA022760975","KQ417021",654945,655048,103
"33806","ENSRNA022760976","KQ417068",714470,714576,106
"33807","ENSRNA022760977","KQ417068",68943,69167,224
"33808","ENSRNA022760978","KQ419514",904909,905002,93
"33809","ENSRNA022760979","KQ416705",585677,585782,105
"33810","ENSRNA022760980","KQ416694",2845557,2845663,106
"33811","ENSRNA022760981","KQ417300",2752509,2752622,113
"33812","ENSRNA022760982","KQ415697",1490068,1490243,175
"33813","ENSRNA022760983","KQ417105",1905257,1905423,166
"33814","ENSRNA022760984","KQ417105",1333673,1333778,105
"33815","ENSRNA022760985","KQ417105",413205,413323,118
"33816","ENSRNA022760987","KQ421009",1125823,1125941,118
"33817","ENSRNA022760988","KQ416666",877216,877314,98
"33818","ENSRNA022760989","KQ416666",115063,115160,97
"33819","ENSRNA022760990","KQ415858",1429529,1429754,225
"33820","ENSRNA022760991","KQ415659",2167213,2167332,119
"33821","ENSRNA022760992","KQ415659",2369428,2369533,105
"33822","ENSRNA022760993","KQ415659",2242809,2242916,107
"33823","ENSRNA022760994","KQ415659",1114405,1114523,118
"33824","ENSRNA022760995","KQ415659",131886,132076,190
"33825","ENSRNA022760996","KQ423780",150104,150222,118
"33826","ENSRNA022760997","KQ416854",505000,505091,91
"33827","ENSRNA022760998","KQ417051",1916340,1916458,118
"33828","ENSRNA022760999","KQ417051",1403898,1404017,119
"33829","ENSRNA022761000","KQ417051",1206113,1207289,1176
"33830","ENSRNA022761001","KQ416243",732045,732163,118
"33831","ENSRNA022761003","KQ418304",441642,441760,118
"33832","ENSRNA022761004","KQ419485",695559,695845,286
"33833","ENSRNA022761005","KQ419485",182089,182188,99
"33834","ENSRNA022761006","KQ416128",767391,767548,157
"33835","ENSRNA022761007","KQ417934",51570,51688,118
"33836","ENSRNA022761008","KQ417934",179886,180004,118
"33837","ENSRNA022761009","KQ418273",249942,250060,118
"33838","ENSRNA022761010","KQ422015",283773,283891,118
"33839","ENSRNA022761011","KQ415813",540172,540291,119
"33840","ENSRNA022761012","KQ417285",49980,50076,96
"33841","ENSRNA022761013","KQ417285",1084038,1084141,103
"33842","ENSRNA022761014","KQ416136",728894,729012,118
"33843","ENSRNA022761015","KQ417975",807714,807832,118
"33844","ENSRNA022761016","KQ421389",619479,619581,102
"33845","ENSRNA022761017","KQ417447",1063781,1063899,118
"33846","ENSRNA022761018","KQ417447",235802,235909,107
"33847","ENSRNA022761019","KQ417893",1310129,1310240,111
"33848","ENSRNA022761020","KQ417893",204683,204801,118
"33849","ENSRNA022761021","KQ424459",330953,331241,288
"33850","ENSRNA022761022","KQ416657",130763,130879,116
"33851","ENSRNA022761024","KQ415694",854650,854767,117
"33852","ENSRNA022761025","KQ415694",854770,854873,103
"33853","ENSRNA022761026","KQ425015",327056,327157,101
"33854","ENSRNA022761027","KQ425015",322302,322404,102
"33855","ENSRNA022761028","KQ425015",324592,324694,102
"33856","ENSRNA022761029","KQ425015",323835,323937,102
"33857","ENSRNA022761030","KQ425015",323211,323313,102
"33858","ENSRNA022761031","KQ425015",764843,764961,118
"33859","ENSRNA022761032","KQ417336",1352794,1352912,118
"33860","ENSRNA022761034","KQ416715",407190,407280,90
"33861","ENSRNA022761035","KQ416715",416047,416141,94
"33862","ENSRNA022761036","KQ416715",802670,802863,193
"33863","ENSRNA022761037","KQ418018",1295834,1295940,106
"33864","ENSRNA022761038","KQ420261",357551,357665,114
"33865","ENSRNA022761039","KQ417771",478283,478389,106
"33866","ENSRNA022761040","KQ417771",1266761,1266919,158
"33867","ENSRNA022761041","KQ417591",1438748,1438865,117
"33868","ENSRNA022761042","KQ418269",555635,555724,89
"33869","ENSRNA022761043","KQ422909",927470,927588,118
"33870","ENSRNA022761045","KQ416737",536389,536547,158
"33871","ENSRNA022761046","KQ418176",871393,871511,118
"33872","ENSRNA022761047","KQ417087",340909,341027,118
"33873","ENSRNA022761048","KQ415687",833063,833320,257
"33874","ENSRNA022761049","KQ415687",388925,389097,172
"33875","ENSRNA022761050","KQ417386",613099,613225,126
"33876","ENSRNA022761051","KQ417386",91499,91607,108
"33877","ENSRNA022761052","KQ416371",1153170,1153273,103
"33878","ENSRNA022761053","KQ415716",1125403,1125521,118
"33879","ENSRNA022761054","KQ415842",563628,563726,98
"33880","ENSRNA022761055","KQ416042",2043621,2044131,510
"33881","ENSRNA022761056","KQ417497",1784772,1784890,118
"33882","ENSRNA022761057","KQ417497",424779,424897,118
"33883","ENSRNA022761058","KQ415681",13760,13862,102
"33884","ENSRNA022761059","KQ415681",1545782,1545900,118
"33885","ENSRNA022761060","KQ415823",678651,678765,114
"33886","ENSRNA022761061","KQ420463",1162166,1162240,74
"33887","ENSRNA022761062","KQ419605",352827,353063,236
"33888","ENSRNA022761063","KQ421737",1564063,1564175,112
"33889","ENSRNA022761064","KQ417931",174305,174425,120
"33890","ENSRNA022761065","KQ415793",1598180,1598313,133
"33891","ENSRNA022761066","KQ415793",676705,676811,106
"33892","ENSRNA022761067","KQ415763",24024,24133,109
"33893","ENSRNA022761068","KQ415885",483790,483908,118
"33894","ENSRNA022761069","KQ416121",396009,396615,606
"33895","ENSRNA022761070","KQ416291",698450,698568,118
"33896","ENSRNA022761071","KQ416260",1196554,1196775,221
"33897","ENSRNA022761072","KQ417023",1104366,1104478,112
"33898","ENSRNA022761073","KQ416260",1445230,1445350,120
"33899","ENSRNA022761074","KQ417023",1496307,1496413,106
"33900","ENSRNA022761075","KQ415940",707721,707836,115
"33901","ENSRNA022761076","KQ421758",437336,437441,105
"33902","ENSRNA022761077","KQ421758",1635942,1636043,101
"33903","ENSRNA022761078","KQ420299",1569630,1569748,118
"33904","ENSRNA022761079","KQ421758",300858,301090,232
"33905","ENSRNA022761080","KQ415962",1535752,1535867,115
"33906","ENSRNA022761081","KQ415962",119687,119845,158
"33907","ENSRNA022761082","KQ416039",1236995,1237112,117
"33908","ENSRNA022761083","KQ416046",1494866,1494984,118
"33909","ENSRNA022761084","KQ416046",157662,157781,119
"33910","ENSRNA022761085","KQ415805",2235585,2235651,66
"33911","ENSRNA022761086","KQ415805",1985681,1985753,72
"33912","ENSRNA022761087","KQ416087",819594,819699,105
"33913","ENSRNA022761088","KQ417252",1736465,1736670,205
"33914","ENSRNA022761090","KQ416841",624795,624908,113
"33915","ENSRNA022761091","KQ416841",168674,168804,130
"33916","ENSRNA022761092","KQ415669",421415,421578,163
"33917","ENSRNA022761093","KQ415669",422783,422945,162
"33918","ENSRNA022761094","KQ417173",803139,803257,118
"33919","ENSRNA022761095","KQ417721",261106,261203,97
"33920","ENSRNA022761096","KQ418881",424642,424760,118
"33921","ENSRNA022761097","KQ418070",854966,855084,118
"33922","ENSRNA022761098","KQ419574",454056,454174,118
"33923","ENSRNA022761099","KQ416918",463569,463764,195
"33924","ENSRNA022761100","KQ417791",162472,162625,153
"33925","ENSRNA022761101","KQ420203",376090,376242,152
"33926","ENSRNA022761102","KQ416359",968920,969038,118
"33927","ENSRNA022761103","KQ416359",607574,607692,118
"33928","ENSRNA022761104","KQ416359",754986,755108,122
"33929","ENSRNA022761105","KQ419158",572558,572747,189
"33930","ENSRNA022761106","KQ419158",698148,698251,103
"33931","ENSRNA022761107","KQ416109",295714,295811,97
"33932","ENSRNA022761108","KQ416109",1053210,1053328,118
"33933","ENSRNA022761109","KQ419202",156673,156772,99
"33934","ENSRNA022761110","KQ416885",781506,781615,109
"33935","ENSRNA022761111","KQ421273",168923,169030,107
"33936","ENSRNA022761112","KQ419260",10549,10666,117
"33937","ENSRNA022761113","KQ421712",557068,557186,118
"33938","ENSRNA022761114","KQ420055",323476,323560,84
"33939","ENSRNA022761115","KQ419500",741889,741990,101
"33940","ENSRNA022761116","KQ416405",624683,624789,106
"33941","ENSRNA022761117","KQ416405",253053,253150,97
"33942","ENSRNA022761118","KQ416405",429776,429930,154
"33943","ENSRNA022761119","KQ418422",870565,870683,118
"33944","ENSRNA022761120","KQ418422",1002689,1002825,136
"33945","ENSRNA022761121","KQ419989",1016704,1016810,106
"33946","ENSRNA022761122","KQ417989",785347,785538,191
"33947","ENSRNA022761123","KQ421263",40375,40492,117
"33948","ENSRNA022761124","KQ418196",508528,508631,103
"33949","ENSRNA022761125","KQ417733",134202,134294,92
"33950","ENSRNA022761126","KQ420138",60202,60335,133
"33951","ENSRNA022761127","KQ416568",363312,363414,102
"33952","ENSRNA022761128","KQ416196",665650,666326,676
"33953","ENSRNA022761129","KQ416196",1045968,1046082,114
"33954","ENSRNA022761130","KQ416614",843194,843302,108
"33955","ENSRNA022761131","KQ417877",344923,345027,104
"33956","ENSRNA022761132","KQ418832",766994,767208,214
"33957","ENSRNA022761133","KQ416124",897381,897484,103
"33958","ENSRNA022761134","KQ418812",689002,689107,105
"33959","ENSRNA022761135","KQ418715",830519,830625,106
"33960","ENSRNA022761136","KQ415788",67191,67295,104
"33961","ENSRNA022761137","KQ415788",1020791,1020949,158
"33962","ENSRNA022761138","KQ416011",986826,986926,100
"33963","ENSRNA022761139","KQ416011",130153,130271,118
"33964","ENSRNA022761140","KQ421759",696045,696132,87
"33965","ENSRNA022761141","KQ416479",577813,577919,106
"33966","ENSRNA022761142","KQ418804",327938,328057,119
"33967","ENSRNA022761143","KQ416223",937704,937836,132
"33968","ENSRNA022761144","KQ425676",129648,129766,118
"33969","ENSRNA022761145","KQ417985",353600,354245,645
"33970","ENSRNA022761146","KQ417985",1059313,1059416,103
"33971","ENSRNA022761147","KQ415767",1268054,1268157,103
"33972","ENSRNA022761148","KQ415767",375813,375931,118
"33973","ENSRNA022761149","KQ419887",603146,603251,105
"33974","ENSRNA022761150","KQ416999",404812,404930,118
"33975","ENSRNA022761151","KQ417851",1060957,1061075,118
"33976","ENSRNA022761152","KQ415917",969625,969840,215
"33977","ENSRNA022761153","KQ417763",487488,487591,103
"33978","ENSRNA022761154","KQ419312",1002940,1003058,118
"33979","ENSRNA022761155","KQ421163",114945,115015,70
"33980","ENSRNA022761156","KQ418549",468459,468568,109
"33981","ENSRNA022761157","KQ417398",151970,152128,158
"33982","ENSRNA022761158","KQ417398",898185,898357,172
"33983","ENSRNA022761159","KQ417398",173377,173481,104
"33984","ENSRNA022761160","KQ418159",726656,726774,118
"33985","ENSRNA022761161","KQ418159",1097008,1097166,158
"33986","ENSRNA022761162","KQ416662",37461,37615,154
"33987","ENSRNA022761163","KQ417836",400660,400778,118
"33988","ENSRNA022761164","KQ421181",19970,20088,118
"33989","ENSRNA022761165","KQ419543",57941,58034,93
"33990","ENSRNA022761166","KQ418498",185518,185618,100
"33991","ENSRNA022761167","KQ418957",778640,778746,106
"33992","ENSRNA022761168","KQ418957",199237,199355,118
"33993","ENSRNA022761169","KQ418957",665594,665723,129
"33994","ENSRNA022761170","KQ419425",247896,248010,114
"33995","ENSRNA022761171","KQ423139",122298,122437,139
"33996","ENSRNA022761172","KQ426461",323855,323967,112
"33997","ENSRNA022761173","KQ416908",546431,546534,103
"33998","ENSRNA022761174","KQ422223",196863,196968,105
"33999","ENSRNA022761175","KQ422223",198630,198780,150
"34000","ENSRNA022761176","KQ415924",41711,41818,107
"34001","ENSRNA022761177","KQ418537",116283,116401,118
"34002","ENSRNA022761178","KQ418537",610765,610879,114
"34003","ENSRNA022761179","KQ418537",1028204,1028300,96
"34004","ENSRNA022761180","KQ421308",450588,450840,252
"34005","ENSRNA022761181","KQ416094",660977,661050,73
"34006","ENSRNA022761182","KQ416094",274864,274973,109
"34007","ENSRNA022761183","KQ415847",287024,287133,109
"34008","ENSRNA022761184","KQ415847",1017991,1018096,105
"34009","ENSRNA022761185","KQ418821",381437,381553,116
"34010","ENSRNA022761186","KQ418821",463146,463284,138
"34011","ENSRNA022761188","KQ415967",465101,465204,103
"34012","ENSRNA022761189","KQ415852",628150,628405,255
"34013","ENSRNA022761190","KQ416920",516828,516932,104
"34014","ENSRNA022761191","KQ416920",546384,546534,150
"34015","ENSRNA022761192","KQ418838",339375,339474,99
"34016","ENSRNA022761193","KQ416338",37392,37537,145
"34017","ENSRNA022761194","KQ417438",517720,517829,109
"34018","ENSRNA022761195","KQ415785",96030,96148,118
"34019","ENSRNA022761196","KQ418296",30445,30547,102
"34020","ENSRNA022761197","KQ426791",375101,375294,193
"34021","ENSRNA022761198","KQ417133",427074,427179,105
"34022","ENSRNA022761199","KQ424231",538782,538891,109
"34023","ENSRNA022761200","KQ424231",539465,539574,109
"34024","ENSRNA022761201","KQ419003",469454,469565,111
"34025","ENSRNA022761202","KQ416013",627754,627871,117
"34026","ENSRNA022761203","KQ416233",699136,699255,119
"34027","ENSRNA022761204","KQ416175",75855,75973,118
"34028","ENSRNA022761205","KQ416175",1045872,1045991,119
"34029","ENSRNA022761206","KQ415981",41224,41499,275
"34030","ENSRNA022761207","KQ415981",26700,26806,106
"34031","ENSRNA022761208","KQ415981",1038410,1038528,118
"34032","ENSRNA022761209","KQ421170",545597,545699,102
"34033","ENSRNA022761210","KQ420059",522191,522291,100
"34034","ENSRNA022761211","KQ419326",538047,538145,98
"34035","ENSRNA022761212","KQ421526",493281,493676,395
"34036","ENSRNA022761213","KQ419982",206657,206757,100
"34037","ENSRNA022761214","KQ416644",93299,93417,118
"34038","ENSRNA022761215","KQ417237",180880,180986,106
"34039","ENSRNA022761216","KQ417288",531472,531589,117
"34040","ENSRNA022761217","KQ417288",259967,260084,117
"34041","ENSRNA022761218","KQ417655",402076,402194,118
"34042","ENSRNA022761219","KQ423259",116482,116599,117
"34043","ENSRNA022761220","KQ423259",120137,120255,118
"34044","ENSRNA022761221","KQ417228",695409,695530,121
"34045","ENSRNA022761222","KQ416602",559910,560010,100
"34046","ENSRNA022761223","KQ417129",455911,456028,117
"34047","ENSRNA022761224","KQ416088",290569,290676,107
"34048","ENSRNA022761225","KQ416088",185044,185206,162
"34049","ENSRNA022761226","KQ422166",571794,571905,111
"34050","ENSRNA022761227","KQ418022",551730,551833,103
"34051","ENSRNA022761228","KQ418562",253599,253744,145
"34052","ENSRNA022761229","KQ416526",542020,542138,118
"34053","ENSRNA022761230","KQ418940",370843,370949,106
"34054","ENSRNA022761231","KQ418061",413499,413688,189
"34055","ENSRNA022761232","KQ418044",313409,313527,118
"34056","ENSRNA022761233","KQ424142",275692,276235,543
"34057","ENSRNA022761234","KQ417847",222551,222653,102
"34058","ENSRNA022761235","KQ417847",1032479,1032595,116
"34059","ENSRNA022761236","KQ417847",993556,993674,118
"34060","ENSRNA022761237","KQ419657",1338033,1338138,105
"34061","ENSRNA022761238","KQ419657",939894,939996,102
"34062","ENSRNA022761239","KQ415932",1144656,1145593,937
"34063","ENSRNA022761240","KQ416490",1486938,1487126,188
"34064","ENSRNA022761241","KQ416974",713703,713861,158
"34065","ENSRNA022761242","KQ416537",148954,149073,119
"34066","ENSRNA022761243","KQ416537",934514,934637,123
"34067","ENSRNA022761244","KQ418115",704525,704643,118
"34068","ENSRNA022761245","KQ416572",270746,271041,295
"34069","ENSRNA022761246","KQ421083",446192,446296,104
"34070","ENSRNA022761247","KQ421083",326578,326696,118
"34071","ENSRNA022761248","KQ417143",30477,30600,123
"34072","ENSRNA022761249","KQ416209",471597,471874,277
"34073","ENSRNA022761250","KQ420779",497606,497800,194
"34074","ENSRNA022761251","KQ422894",271928,272046,118
"34075","ENSRNA022761252","KQ422894",507089,507198,109
"34076","ENSRNA022761253","KQ430572",262035,262136,101
"34077","ENSRNA022761254","KQ417086",69140,69239,99
"34078","ENSRNA022761255","KQ415811",1363176,1363378,202
"34079","ENSRNA022761256","KQ415811",1363427,1363545,118
"34080","ENSRNA022761257","KQ416810",1552991,1553089,98
"34081","ENSRNA022761258","KQ416810",1381246,1381364,118
"34082","ENSRNA022761259","KQ415909",73834,74010,176
"34083","ENSRNA022761260","KQ419409",590223,591619,1396
"34084","ENSRNA022761261","KQ419409",288578,289124,546
"34085","ENSRNA022761262","KQ419409",43796,43914,118
"34086","ENSRNA022761263","KQ419031",362098,362216,118
"34087","ENSRNA022761264","KQ418059",311418,311536,118
"34088","ENSRNA022761265","KQ418543",270177,270295,118
"34089","ENSRNA022761266","KQ419743",518733,518833,100
"34090","ENSRNA022761267","KQ419743",62532,62625,93
"34091","ENSRNA022761268","KQ417284",279045,279218,173
"34092","ENSRNA022761269","KQ417284",173642,173761,119
"34093","ENSRNA022761270","KQ418908",398879,398997,118
"34094","ENSRNA022761271","KQ418908",133158,133276,118
"34095","ENSRNA022761272","KQ415876",459085,459203,118
"34096","ENSRNA022761273","KQ415876",709178,709296,118
"34097","ENSRNA022761274","KQ415684",817622,817740,118
"34098","ENSRNA022761275","KQ416340",768335,768452,117
"34099","ENSRNA022761276","KQ426326",127011,127121,110
"34100","ENSRNA022761277","KQ426326",494420,494538,118
"34101","ENSRNA022761279","KQ416336",197046,197147,101
"34102","ENSRNA022761280","KQ422997",769794,770046,252
"34103","ENSRNA022761281","KQ426596",80435,80561,126
"34104","ENSRNA022761282","KQ416585",423803,423921,118
"34105","ENSRNA022761283","KQ416585",448448,448540,92
"34106","ENSRNA022761284","KQ421478",85049,85161,112
"34107","ENSRNA022761285","KQ421523",1530738,1530853,115
"34108","ENSRNA022761286","KQ421523",468495,468595,100
"34109","ENSRNA022761287","KQ417050",239887,240005,118
"34110","ENSRNA022761288","KQ417995",573719,573834,115
"34111","ENSRNA022761289","KQ420166",819276,819425,149
"34112","ENSRNA022761290","KQ420166",262203,262321,118
"34113","ENSRNA022761291","KQ420166",511654,511769,115
"34114","ENSRNA022761292","KQ420579",6932,7050,118
"34115","ENSRNA022761293","KQ424486",326835,326953,118
"34116","ENSRNA022761294","KQ418120",379517,379635,118
"34117","ENSRNA022761295","KQ418120",607000,607084,84
"34118","ENSRNA022761296","KQ420275",121901,122019,118
"34119","ENSRNA022761297","KQ421241",497449,497552,103
"34120","ENSRNA022761298","KQ426135",47436,47536,100
"34121","ENSRNA022761299","KQ418869",161632,161768,136
"34122","ENSRNA022761300","KQ418140",79275,79393,118
"34123","ENSRNA022761301","KQ418140",650190,650300,110
"34124","ENSRNA022761302","KQ420148",428315,428417,102
"34125","ENSRNA022761303","KQ427059",721957,722048,91
"34126","ENSRNA022761304","KQ416069",73382,73502,120
"34127","ENSRNA022761305","KQ416069",696393,696511,118
"34128","ENSRNA022761306","KQ420217",626835,626998,163
"34129","ENSRNA022761307","KQ416818",191676,191780,104
"34130","ENSRNA022761308","KQ416779",203220,203491,271
"34131","ENSRNA022761309","KQ419786",93026,93144,118
"34132","ENSRNA022761310","KQ416487",330436,330553,117
"34133","ENSRNA022761311","KQ416487",93552,93937,385
"34134","ENSRNA022761312","KQ416581",485851,485961,110
"34135","ENSRNA022761313","KQ423827",552722,553117,395
"34136","ENSRNA022761314","KQ418216",764416,764525,109
"34137","ENSRNA022761315","KQ418216",1272222,1272331,109
"34138","ENSRNA022761316","KQ418216",336432,336548,116
"34139","ENSRNA022761317","KQ420181",1241981,1242088,107
"34140","ENSRNA022761318","KQ415837",181342,181447,105
"34141","ENSRNA022761319","KQ416072",629784,629886,102
"34142","ENSRNA022761320","KQ422077",526650,526764,114
"34143","ENSRNA022761321","KQ416102",234456,234570,114
"34144","ENSRNA022761322","KQ423675",572402,573211,809
"34145","ENSRNA022761323","KQ423675",288978,289115,137
"34146","ENSRNA022761324","KQ415875",275885,275989,104
"34147","ENSRNA022761325","KQ420414",53620,53738,118
"34148","ENSRNA022761326","KQ417495",128984,129102,118
"34149","ENSRNA022761327","KQ417495",30708,30847,139
"34150","ENSRNA022761328","KQ418536",120266,120385,119
"34151","ENSRNA022761329","KQ418536",306437,306730,293
"34152","ENSRNA022761330","KQ422187",661885,662046,161
"34153","ENSRNA022761332","KQ418322",63290,63392,102
"34154","ENSRNA022761333","KQ420961",493484,493602,118
"34155","ENSRNA022761334","KQ420260",1134943,1135046,103
"34156","ENSRNA022761335","KQ415660",1100498,1100656,158
"34157","ENSRNA022761336","KQ427644",49335,49452,117
"34158","ENSRNA022761337","KQ420157",430948,431066,118
"34159","ENSRNA022761338","KQ418003",223441,223559,118
"34160","ENSRNA022761339","KQ416505",512861,512998,137
"34161","ENSRNA022761340","KQ417374",337135,337174,39
"34162","ENSRNA022761341","KQ420016",675505,675647,142
"34163","ENSRNA022761342","KQ420016",237226,237381,155
"34164","ENSRNA022761343","KQ420016",691578,691695,117
"34165","ENSRNA022761344","KQ417748",325546,325664,118
"34166","ENSRNA022761346","KQ420194",45061,45165,104
"34167","ENSRNA022761347","KQ419478",82584,82702,118
"34168","ENSRNA022761348","KQ419478",527550,527662,112
"34169","ENSRNA022761349","KQ416578",681116,681217,101
"34170","ENSRNA022761350","KQ423703",570660,570764,104
"34171","ENSRNA022761352","KQ415859",670204,670310,106
"34172","ENSRNA022761354","KQ419727",205699,205805,106
"34173","ENSRNA022761355","KQ420605",191799,191917,118
"34174","ENSRNA022761356","KQ419358",590427,590535,108
"34175","ENSRNA022761357","KQ421212",217124,217243,119
"34176","ENSRNA022761358","KQ416239",470679,470877,198
"34177","ENSRNA022761359","KQ418856",38514,38633,119
"34178","ENSRNA022761360","KQ425256",186724,186828,104
"34179","ENSRNA022761361","KQ416193",295882,296168,286
"34180","ENSRNA022761362","KQ422598",522419,522519,100
"34181","ENSRNA022761363","KQ422021",465006,465124,118
"34182","ENSRNA022761364","KQ419615",343401,343519,118
"34183","ENSRNA022761365","KQ417305",403475,403639,164
"34184","ENSRNA022761366","KQ418739",132135,132252,117
"34185","ENSRNA022761367","KQ418587",857699,857816,117
"34186","ENSRNA022761368","KQ418587",166762,166855,93
"34187","ENSRNA022761369","KQ418587",488068,488138,70
"34188","ENSRNA022761370","KQ418571",853047,853146,99
"34189","ENSRNA022761371","KQ417213",575310,575545,235
"34190","ENSRNA022761372","KQ419861",327973,328091,118
"34191","ENSRNA022761373","KQ415869",590672,590788,116
"34192","ENSRNA022761374","KQ418839",811950,812067,117
"34193","ENSRNA022761375","KQ416279",177112,177229,117
"34194","ENSRNA022761376","KQ417324",879268,879315,47
"34195","ENSRNA022761377","KQ417324",368846,368964,118
"34196","ENSRNA022761378","KQ417324",649158,649217,59
"34197","ENSRNA022761379","KQ421853",302539,302639,100
"34198","ENSRNA022761380","KQ419631",57229,57336,107
"34199","ENSRNA022761381","KQ420525",463631,463928,297
"34200","ENSRNA022761382","KQ420525",221781,222085,304
"34201","ENSRNA022761383","KQ415863",529701,529807,106
"34202","ENSRNA022761384","KQ424425",437941,438036,95
"34203","ENSRNA022761385","KQ417923",466115,466323,208
"34204","ENSRNA022761386","KQ417724",760000,760095,95
"34205","ENSRNA022761387","KQ418320",75297,75383,86
"34206","ENSRNA022761388","KQ416772",501480,501598,118
"34207","ENSRNA022761389","KQ417780",489196,489314,118
"34208","ENSRNA022761390","KQ420714",116410,116664,254
"34209","ENSRNA022761391","KQ420714",482670,482788,118
"34210","ENSRNA022761392","KQ417703",110909,111027,118
"34211","ENSRNA022761393","KQ431376",220969,221087,118
"34212","ENSRNA022761394","KQ423536",467120,467248,128
"34213","ENSRNA022761395","KQ424538",68833,68951,118
"34214","ENSRNA022761396","KQ416254",74901,75085,184
"34215","ENSRNA022761397","KQ416376",83737,83835,98
"34216","ENSRNA022761398","KQ416654",124007,124110,103
"34217","ENSRNA022761399","KQ431068",89673,89791,118
"34218","ENSRNA022761400","KQ428735",102747,102866,119
"34219","ENSRNA022761401","KQ424657",42626,42744,118
"34220","ENSRNA022761402","KQ417878",286499,286601,102
"34221","ENSRNA022761403","KQ418949",511948,512064,116
"34222","ENSRNA022761404","KQ421879",308470,308576,106
"34223","ENSRNA022761405","KQ424627",272275,272381,106
"34224","ENSRNA022761406","KQ424627",308412,308502,90
"34225","ENSRNA022761407","KQ416430",75718,75818,100
"34226","ENSRNA022761408","KQ416430",315793,315910,117
"34227","ENSRNA022761409","KQ416117",362288,362380,92
"34228","ENSRNA022761410","KQ418892",233235,233338,103
"34229","ENSRNA022761411","KQ416966",104003,104141,138
"34230","ENSRNA022761412","KQ416966",887245,887360,115
"34231","ENSRNA022761413","KQ416966",655466,655567,101
"34232","ENSRNA022761414","KQ416579",598843,598961,118
"34233","ENSRNA022761415","KQ416579",60466,60584,118
"34234","ENSRNA022761416","KQ417370",94689,94866,177
"34235","ENSRNA022761417","KQ423422",496728,496846,118
"34236","ENSRNA022761418","KQ422993",54660,54760,100
"34237","ENSRNA022761419","KQ418131",305442,305560,118
"34238","ENSRNA022761420","KQ417693",426784,426922,138
"34239","ENSRNA022761421","KQ417693",197480,197569,89
"34240","ENSRNA022761422","KQ415979",202972,203090,118
"34241","ENSRNA022761423","KQ423231",163693,163886,193
"34242","ENSRNA022761424","KQ422136",381539,381656,117
"34243","ENSRNA022761425","KQ420031",14526,14680,154
"34244","ENSRNA022761426","KQ416249",353698,353798,100
"34245","ENSRNA022761427","KQ423464",861841,861959,118
"34246","ENSRNA022761428","KQ416617",872827,872945,118
"34247","ENSRNA022761429","KQ421356",657706,657824,118
"34248","ENSRNA022761430","KQ417487",9649,9767,118
"34249","ENSRNA022761431","KQ420313",247729,247848,119
"34250","ENSRNA022761432","KQ415781",594750,594933,183
"34251","ENSRNA022761433","KQ418012",175446,175639,193
"34252","ENSRNA022761434","KQ415936",75391,75491,100
"34253","ENSRNA022761435","KQ425104",93528,93687,159
"34254","ENSRNA022761436","KQ425104",93358,93461,103
"34255","ENSRNA022761437","KQ416847",102471,102589,118
"34256","ENSRNA022761438","KQ422233",315217,315406,189
"34257","ENSRNA022761439","KQ420656",119168,119271,103
"34258","ENSRNA022761440","KQ420656",15144,15262,118
"34259","ENSRNA022761441","KQ424219",360937,361099,162
"34260","ENSRNA022761442","KQ418420",202822,202927,105
"34261","ENSRNA022761443","KQ417110",180886,180981,95
"34262","ENSRNA022761444","KQ417316",220657,220775,118
"34263","ENSRNA022761445","KQ417972",56446,56563,117
"34264","ENSRNA022761446","KQ423531",84756,84873,117
"34265","ENSRNA022761447","KQ422556",162126,162300,174
"34266","ENSRNA022761448","KQ422556",284642,284760,118
"34267","ENSRNA022761449","KQ422556",102868,102974,106
"34268","ENSRNA022761450","KQ415987",419152,419558,406
"34269","ENSRNA022761451","KQ419078",300417,300535,118
"34270","ENSRNA022761452","KQ418129",344758,344857,99
"34271","ENSRNA022761453","KQ419013",197657,197907,250
"34272","ENSRNA022761454","KQ418796",376662,376761,99
"34273","ENSRNA022761455","KQ421121",190788,190891,103
"34274","ENSRNA022761456","KQ421121",191823,191923,100
"34275","ENSRNA022761457","KQ419020",386457,386566,109
"34276","ENSRNA022761458","KQ417333",88185,88230,45
"34277","ENSRNA022761459","KQ420346",161385,161499,114
"34278","ENSRNA022761460","KQ419515",722308,722426,118
"34279","ENSRNA022761461","KQ416263",530080,530174,94
"34280","ENSRNA022761462","KQ416263",744671,744778,107
"34281","ENSRNA022761463","KQ419208",117686,117916,230
"34282","ENSRNA022761464","KQ416677",712126,712427,301
"34283","ENSRNA022761465","KQ420595",271027,271145,118
"34284","ENSRNA022761466","KQ420595",402130,402248,118
"34285","ENSRNA022761467","KQ418312",275149,276228,1079
"34286","ENSRNA022761468","KQ417565",28716,28822,106
"34287","ENSRNA022761469","KQ417688",267095,267213,118
"34288","ENSRNA022761470","KQ416404",289658,289777,119
"34289","ENSRNA022761471","KQ422367",164316,164434,118
"34290","ENSRNA022761472","KQ421705",4125,4226,101
"34291","ENSRNA022761473","KQ415862",589210,589313,103
"34292","ENSRNA022761474","KQ415970",300806,300966,160
"34293","ENSRNA022761475","KQ424812",311009,311127,118
"34294","ENSRNA022761476","KQ421261",81555,81675,120
"34295","ENSRNA022761477","KQ423056",213491,213669,178
"34296","ENSRNA022761478","KQ421218",497499,497718,219
"34297","ENSRNA022761479","KQ417634",358944,359048,104
"34298","ENSRNA022761480","KQ416845",339324,339442,118
"34299","ENSRNA022761481","KQ423336",205937,206088,151
"34300","ENSRNA022761482","KQ421078",266232,266350,118
"34301","ENSRNA022761484","KQ424859",405027,405133,106
"34302","ENSRNA022761485","KQ425692",2101,2333,232
"34303","ENSRNA022761486","KQ425692",3256,3488,232
"34304","ENSRNA022761487","KQ425692",13447,13678,231
"34305","ENSRNA022761488","KQ418642",29653,29754,101
"34306","ENSRNA022761489","KQ416415",69711,69831,120
"34307","ENSRNA022761490","KQ421521",105287,105584,297
"34308","ENSRNA022761491","KQ421521",316285,316388,103
"34309","ENSRNA022761492","KQ422019",470282,470399,117
"34310","ENSRNA022761493","KQ421727",471388,471506,118
"34311","ENSRNA022761494","KQ425992",245593,245695,102
"34312","ENSRNA022761495","KQ415831",329915,330033,118
"34313","ENSRNA022761496","KQ418769",252968,253087,119
"34314","ENSRNA022761497","KQ419175",150229,150349,120
"34315","ENSRNA022761498","KQ420877",252338,252438,100
"34316","ENSRNA022761499","KQ419376",120142,120260,118
"34317","ENSRNA022761500","KQ422009",186872,186988,116
"34318","ENSRNA022761501","KQ420329",379528,379627,99
"34319","ENSRNA022761502","KQ417076",234968,235329,361
"34320","ENSRNA022761503","KQ422110",356228,356331,103
"34321","ENSRNA022761504","KQ420787",777726,777825,99
"34322","ENSRNA022761505","KQ425805",747239,747339,100
"34323","ENSRNA022761506","KQ425805",873303,873409,106
"34324","ENSRNA022761507","KQ416697",824013,824315,302
"34325","ENSRNA022761508","KQ416357",602112,602230,118
"34326","ENSRNA022761509","KQ416357",474953,475071,118
"34327","ENSRNA022761510","KQ417938",804629,804746,117
"34328","ENSRNA022761511","KQ418175",166486,166587,101
"34329","ENSRNA022761512","KQ418486",280853,280959,106
"34330","ENSRNA022761513","KQ418486",510070,510186,116
"34331","ENSRNA022761514","KQ418365",6775,6906,131
"34332","ENSRNA022761515","KQ418365",852690,852809,119
"34333","ENSRNA022761516","KQ417747",91723,91827,104
"34334","ENSRNA022761517","KQ416171",182237,182430,193
"34335","ENSRNA022761518","KQ417783",312264,312378,114
"34336","ENSRNA022761519","KQ419868",165334,165436,102
"34337","ENSRNA022761520","KQ423001",482491,482635,144
"34338","ENSRNA022761521","KQ424856",410536,410642,106
"34339","ENSRNA022761522","KQ420659",44195,44310,115
"34340","ENSRNA022761523","KQ417701",302701,302819,118
"34341","ENSRNA022761524","KQ427464",26802,26950,148
"34342","ENSRNA022761525","KQ416390",235108,235226,118
"34343","ENSRNA022761526","KQ416137",105746,105943,197
"34344","ENSRNA022761527","KQ418385",273607,273709,102
"34345","ENSRNA022761528","KQ416062",258025,258394,369
"34346","ENSRNA022761529","KQ424889",296378,296519,141
"34347","ENSRNA022761531","KQ417199",349115,349228,113
"34348","ENSRNA022761532","KQ420600",246332,246450,118
"34349","ENSRNA022761533","KQ419701",47323,47478,155
"34350","ENSRNA022761534","KQ421096",77159,77247,88
"34351","ENSRNA022761535","KQ421096",77159,77247,88
"34352","ENSRNA022761536","KQ425492",178809,178927,118
"34353","ENSRNA022761537","KQ420777",86869,86999,130
"34354","ENSRNA022761538","KQ423130",316544,316665,121
"34355","ENSRNA022761539","KQ421858",185222,185343,121
"34356","ENSRNA022761540","KQ416049",367865,367991,126
"34357","ENSRNA022761541","KQ416079",169197,169268,71
"34358","ENSRNA022761542","KQ417261",78688,78845,157
"34359","ENSRNA022761543","KQ417896",181973,182091,118
"34360","ENSRNA022761544","KQ418021",468278,468371,93
"34361","ENSRNA022761545","KQ421839",283471,283576,105
"34362","ENSRNA022761546","KQ418375",750493,750745,252
"34363","ENSRNA022761547","KQ421221",386035,386251,216
"34364","ENSRNA022761548","KQ421221",349505,349622,117
"34365","ENSRNA022761549","KQ419857",185111,185217,106
"34366","ENSRNA022761550","KQ419857",186596,186702,106
"34367","ENSRNA022761551","KQ419857",188249,188355,106
"34368","ENSRNA022761552","KQ419857",190200,190306,106
"34369","ENSRNA022761553","KQ419857",191419,191525,106
"34370","ENSRNA022761554","KQ419857",199136,199242,106
"34371","ENSRNA022761555","KQ419857",197445,197551,106
"34372","ENSRNA022761556","KQ419857",139359,139463,104
"34373","ENSRNA022761557","KQ419857",200322,200423,101
"34374","ENSRNA022761558","KQ419857",626372,626493,121
"34375","ENSRNA022761559","KQ422050",581192,581310,118
"34376","ENSRNA022761560","KQ429470",353450,353568,118
"34377","ENSRNA022761561","KQ418066",370927,371045,118
"34378","ENSRNA022761562","KQ417007",340044,340161,117
"34379","ENSRNA022761563","KQ417501",203269,203388,119
"34380","ENSRNA022761564","KQ420306",233140,233243,103
"34381","ENSRNA022761565","KQ422145",262876,262973,97
"34382","ENSRNA022761566","KQ417977",266943,267135,192
"34383","ENSRNA022761567","KQ417977",22197,22301,104
"34384","ENSRNA022761568","KQ417977",137317,137421,104
"34385","ENSRNA022761569","KQ416724",285495,285613,118
"34386","ENSRNA022761570","KQ416724",212885,212961,76
"34387","ENSRNA022761571","KQ417297",400155,400313,158
"34388","ENSRNA022761572","KQ415921",58716,58819,103
"34389","ENSRNA022761573","KQ420601",161673,161793,120
"34390","ENSRNA022761574","KQ432556",225772,225887,115
"34391","ENSRNA022761575","KQ421396",39959,40077,118
"34392","ENSRNA022761576","KQ418614",190759,190854,95
"34393","ENSRNA022761577","KQ426613",162654,162772,118
"34394","ENSRNA022761578","KQ425677",242008,242126,118
"34395","ENSRNA022761579","KQ418598",318935,319128,193
"34396","ENSRNA022761580","KQ422496",311405,311505,100
"34397","ENSRNA022761581","KQ417209",369097,369239,142
"34398","ENSRNA022761582","KQ417209",369444,369489,45
"34399","ENSRNA022761583","KQ422788",16302,16443,141
"34400","ENSRNA022761584","KQ418926",246222,246326,104
"34401","ENSRNA022761585","KQ418789",634028,634146,118
"34402","ENSRNA022761586","KQ416802",623089,623193,104
"34403","ENSRNA022761587","KQ417045",239809,239913,104
"34404","ENSRNA022761588","KQ419994",203177,203295,118
"34405","ENSRNA022761589","KQ417216",170498,170720,222
"34406","ENSRNA022761590","KQ432600",115883,116120,237
"34407","ENSRNA022761591","KQ425469",114966,115070,104
"34408","ENSRNA022761592","KQ422996",179533,179622,89
"34409","ENSRNA022761593","KQ416421",133524,133642,118
"34410","ENSRNA022761594","KQ416931",21628,21930,302
"34411","ENSRNA022761595","KQ416931",6206,6324,118
"34412","ENSRNA022761596","KQ423169",116723,116841,118
"34413","ENSRNA022761597","KQ419810",222097,222215,118
"34414","ENSRNA022761598","KQ420917",246373,246478,105
"34415","ENSRNA022761599","KQ420917",213494,213612,118
"34416","ENSRNA022761600","KQ416288",234493,234596,103
"34417","ENSRNA022761601","KQ426311",114851,114957,106
"34418","ENSRNA022761602","KQ418429",294087,294639,552
"34419","ENSRNA022761603","KQ425487",64810,64930,120
"34420","ENSRNA022761604","KQ421106",63319,63437,118
"34421","ENSRNA022761605","KQ422859",63340,63551,211
"34422","ENSRNA022761606","KQ422859",68930,69032,102
"34423","ENSRNA022761607","KQ419906",260107,260210,103
"34424","ENSRNA022761608","KQ418295",328212,328326,114
"34425","ENSRNA022761609","KQ415880",276746,276848,102
"34426","ENSRNA022761611","KQ422977",57171,57290,119
"34427","ENSRNA022761612","KQ417562",87357,87467,110
"34428","ENSRNA022761613","KQ423631",288575,288711,136
"34429","ENSRNA022761614","KQ423631",248318,248436,118
"34430","ENSRNA022761615","KQ420845",295920,296011,91
"34431","ENSRNA022761616","KQ419283",295237,295354,117
"34432","ENSRNA022761617","KQ421878",61111,61215,104
"34433","ENSRNA022761618","KQ420992",105355,105478,123
"34434","ENSRNA022761619","KQ419658",129771,129879,108
"34435","ENSRNA022761620","KQ416701",63639,63742,103
"34436","ENSRNA022761621","KQ416701",121039,121138,99
"34437","ENSRNA022761622","KQ416050",178478,179265,787
"34438","ENSRNA022761623","KQ423149",208730,208845,115
"34439","ENSRNA022761624","KQ428200",148436,148527,91
"34440","ENSRNA022761625","KQ425807",45247,45365,118
"34441","ENSRNA022761626","KQ416073",139142,139260,118
"34442","ENSRNA022761627","KQ426157",74203,74284,81
"34443","ENSRNA022761628","KQ427322",167236,167354,118
"34444","ENSRNA022761629","KQ420720",79624,79715,91
"34445","ENSRNA022761630","KQ417165",55604,55722,118
"34446","ENSRNA022761631","KQ418001",168602,168719,117
"34447","ENSRNA022761632","KQ422276",138038,138142,104
"34448","ENSRNA022761633","KQ416869",193212,193323,111
"34449","ENSRNA022761634","KQ424684",125125,125231,106
"34450","ENSRNA022761635","KQ424450",34809,34927,118
"34451","ENSRNA022761636","KQ417910",158440,158556,116
"34452","ENSRNA022761637","KQ420958",681338,681456,118
"34453","ENSRNA022761638","KQ417482",516738,516856,118
"34454","ENSRNA022761639","KQ427263",281978,282077,99
"34455","ENSRNA022761640","KQ427263",584909,585015,106
"34456","ENSRNA022761641","KQ427263",286682,286861,179
"34457","ENSRNA022761642","KQ418904",36826,36944,118
"34458","ENSRNA022761643","KQ418904",388624,388682,58
"34459","ENSRNA022761644","KQ418904",550020,550210,190
"34460","ENSRNA022761645","KQ423555",383605,383751,146
"34461","ENSRNA022761646","KQ418351",174522,174636,114
"34462","ENSRNA022761647","KQ416698",27731,27849,118
"34463","ENSRNA022761648","KQ415873",406355,406475,120
"34464","ENSRNA022761649","KQ418829",468863,469145,282
"34465","ENSRNA022761650","KQ419093",326992,327148,156
"34466","ENSRNA022761651","KQ417189",29947,30065,118
"34467","ENSRNA022761652","KQ420000",202732,202851,119
"34468","ENSRNA022761653","KQ419663",102986,103103,117
"34469","ENSRNA022761654","KQ426602",5976,6076,100
"34470","ENSRNA022761655","KQ421630",102490,102608,118
"34471","ENSRNA022761656","KQ419029",73315,73432,117
"34472","ENSRNA022761657","KQ426499",175675,175961,286
"34473","ENSRNA022761658","KQ432932",233833,233953,120
"34474","ENSRNA022761659","KQ417929",67021,67132,111
"34475","ENSRNA022761660","KQ422172",131118,131270,152
"34476","ENSRNA022761661","KQ429332",231626,231855,229
"34477","ENSRNA022761662","KQ424863",247033,247442,409
"34478","ENSRNA022761663","KQ422697",310830,310942,112
"34479","ENSRNA022761664","KQ424264",310011,310582,571
"34480","ENSRNA022761665","KQ418833",306038,306132,94
"34481","ENSRNA022761666","KQ420409",111741,111927,186
"34482","ENSRNA022761667","KQ418740",635153,635271,118
"34483","ENSRNA022761668","KQ418552",568196,568389,193
"34484","ENSRNA022761669","KQ418007",311068,311185,117
"34485","ENSRNA022761670","KQ419691",123768,123867,99
"34486","ENSRNA022761671","KQ419691",216909,217020,111
"34487","ENSRNA022761672","KQ419497",81251,81369,118
"34488","ENSRNA022761673","KQ429853",76897,77004,107
"34489","ENSRNA022761674","KQ421713",119793,120222,429
"34490","ENSRNA022761675","KQ423825",85191,85295,104
"34491","ENSRNA022761676","KQ423141",383728,383920,192
"34492","ENSRNA022761677","KQ420646",108267,108355,88
"34493","ENSRNA022761678","KQ420258",14493,14611,118
"34494","ENSRNA022761679","KQ417027",282345,282768,423
"34495","ENSRNA022761680","KQ422169",396335,396453,118
"34496","ENSRNA022761681","KQ422169",397566,397683,117
"34497","ENSRNA022761682","KQ420239",128086,128204,118
"34498","ENSRNA022761683","KQ420239",128899,129017,118
"34499","ENSRNA022761684","KQ419534",103111,103208,97
"34500","ENSRNA022761685","KQ423480",228011,228114,103
"34501","ENSRNA022761686","KQ424539",370230,370345,115
"34502","ENSRNA022761687","KQ425255",17580,17698,118
"34503","ENSRNA022761688","KQ418998",637360,637480,120
"34504","ENSRNA022761689","KQ418998",123431,123553,122
"34505","ENSRNA022761690","KQ418998",123631,123747,116
"34506","ENSRNA022761691","KQ416274",927772,927892,120
"34507","ENSRNA022761692","KQ417481",969464,969879,415
"34508","ENSRNA022761693","KQ417481",415350,415469,119
"34509","ENSRNA022761694","KQ426847",124231,124292,61
"34510","ENSRNA022761695","KQ422783",133956,134074,118
"34511","ENSRNA022761696","KQ418520",120932,121031,99
"34512","ENSRNA022761697","KQ424675",137672,137791,119
"34513","ENSRNA022761698","KQ422934",76769,76887,118
"34514","ENSRNA022761699","KQ423363",151117,151236,119
"34515","ENSRNA022761700","KQ423363",50617,50706,89
"34516","ENSRNA022761701","KQ418657",121140,121613,473
"34517","ENSRNA022761702","KQ423605",184896,184986,90
"34518","ENSRNA022761704","KQ417260",10875,11016,141
"34519","ENSRNA022761705","KQ416450",92713,92829,116
"34520","ENSRNA022761706","KQ421602",80452,80556,104
"34521","ENSRNA022761707","KQ417078",286331,286611,280
"34522","ENSRNA022761708","KQ433417",247321,247576,255
"34523","ENSRNA022761709","KQ418399",140353,140471,118
"34524","ENSRNA022761710","KQ416736",202332,202458,126
"34525","ENSRNA022761711","KQ418575",175813,175931,118
"34526","ENSRNA022761712","KQ425121",617301,617405,104
"34527","ENSRNA022761713","KQ421206",606183,606318,135
"34528","ENSRNA022761714","KQ419280",448580,448697,117
"34529","ENSRNA022761715","KQ420079",337252,337403,151
"34530","ENSRNA022761716","KQ420079",336747,336840,93
"34531","ENSRNA022761717","KQ420079",336912,337247,335
"34532","ENSRNA022761718","KQ419223",513293,513411,118
"34533","ENSRNA022761719","KQ419223",368634,368749,115
"34534","ENSRNA022761720","KQ419661",409811,409922,111
"34535","ENSRNA022761721","KQ417641",317955,318187,232
"34536","ENSRNA022761722","KQ416990",142926,143044,118
"34537","ENSRNA022761723","KQ419660",104984,105533,549
"34538","ENSRNA022761724","KQ419660",1903,2011,108
"34539","ENSRNA022761725","KQ416129",163313,163430,117
"34540","ENSRNA022761726","KQ416618",184187,184771,584
"34541","ENSRNA022761727","KQ416086",105465,105580,115
"34542","ENSRNA022761728","KQ418180",118076,118198,122
"34543","ENSRNA022761729","KQ420128",154146,154249,103
"34544","ENSRNA022761730","KQ417401",124208,124327,119
"34545","ENSRNA022761732","KQ421184",70949,71067,118
"34546","ENSRNA022761733","KQ421187",86228,86346,118
"34547","ENSRNA022761734","KQ417224",66163,66286,123
"34548","ENSRNA022761735","KQ422031",32428,32546,118
"34549","ENSRNA022761736","KQ421661",74528,74631,103
"34550","ENSRNA022761737","KQ424446",227262,227423,161
"34551","ENSRNA022761739","KQ421168",203665,203771,106
"34552","ENSRNA022761740","KQ428462",33213,33331,118
"34553","ENSRNA022761741","KQ416917",139887,140005,118
"34554","ENSRNA022761742","KQ416074",168615,168898,283
"34555","ENSRNA022761743","KQ415907",226202,226295,93
"34556","ENSRNA022761744","KQ417729",507952,508064,112
"34557","ENSRNA022761745","KQ417729",508085,508278,193
"34558","ENSRNA022761746","KQ421816",275932,276038,106
"34559","ENSRNA022761747","KQ421816",829891,829992,101
"34560","ENSRNA022761748","KQ421816",830131,830233,102
"34561","ENSRNA022761749","KQ420105",167573,167691,118
"34562","ENSRNA022761750","KQ423047",256243,256410,167
"34563","ENSRNA022761751","KQ426287",94252,94434,182
"34564","ENSRNA022761752","KQ417858",240750,240868,118
"34565","ENSRNA022761753","KQ416559",358419,358502,83
"34566","ENSRNA022761754","KQ420939",246267,246386,119
"34567","ENSRNA022761756","KQ418401",282570,282684,114
"34568","ENSRNA022761757","KQ425041",137040,137156,116
"34569","ENSRNA022761758","KQ418026",305942,306048,106
"34570","ENSRNA022761759","KQ419807",64775,64893,118
"34571","ENSRNA022761760","KQ416531",68529,68633,104
"34572","ENSRNA022761761","KQ423839",288320,288463,143
"34573","ENSRNA022761762","KQ428426",138283,138401,118
"34574","ENSRNA022761763","KQ417019",19056,19152,96
"34575","ENSRNA022761764","KQ424811",128555,128825,270
"34576","ENSRNA022761765","KQ424109",169874,170337,463
"34577","ENSRNA022761766","KQ425367",218844,218962,118
"34578","ENSRNA022761767","KQ421085",86206,86315,109
"34579","ENSRNA022761768","KQ426632",4035,4260,225
"34580","ENSRNA022761769","KQ426632",3888,4020,132
"34581","ENSRNA022761770","KQ430433",53953,54071,118
"34582","ENSRNA022761771","KQ421860",382714,382828,114
"34583","ENSRNA022761772","KQ417826",312919,313104,185
"34584","ENSRNA022761773","KQ417887",472201,472320,119
"34585","ENSRNA022761774","KQ417734",346786,346889,103
"34586","ENSRNA022761775","KQ418663",490448,490527,79
"34587","ENSRNA022761776","KQ418663",490448,490527,79
"34588","ENSRNA022761777","KQ418289",156719,156831,112
"34589","ENSRNA022761778","KQ415778",12074,12180,106
"34590","ENSRNA022761779","KQ417762",263659,263763,104
"34591","ENSRNA022761780","KQ417762",112818,112912,94
"34592","ENSRNA022761781","KQ418416",154147,154265,118
"34593","ENSRNA022761782","KQ418101",266142,266260,118
"34594","ENSRNA022761783","KQ416669",406,504,98
"34595","ENSRNA022761784","KQ416298",4542,4645,103
"34596","ENSRNA022761785","KQ416206",92606,92725,119
"34597","ENSRNA022761786","KQ425654",173125,173204,79
"34598","ENSRNA022761787","KQ425654",173125,173204,79
"34599","ENSRNA022761788","KQ421042",82588,82690,102
"34600","ENSRNA022761789","KQ423006",165179,165297,118
"34601","ENSRNA022761791","KQ424361",172996,173154,158
"34602","ENSRNA022761792","KQ418444",334427,334594,167
"34603","ENSRNA022761793","KQ417137",202084,202386,302
"34604","ENSRNA022761794","KQ417137",267660,267780,120
"34605","ENSRNA022761795","KQ423728",80664,80703,39
"34606","ENSRNA022761796","KQ421823",414170,414275,105
"34607","ENSRNA022761797","KQ420869",15375,15569,194
"34608","ENSRNA022761798","KQ428255",116129,116361,232
"34609","ENSRNA022761799","KQ422499",70505,70611,106
"34610","ENSRNA022761800","KQ432245",52746,52864,118
"34611","ENSRNA022761801","KQ421606",192596,192827,231
"34612","ENSRNA022761802","KQ433242",94765,95061,296
"34613","ENSRNA022761803","KQ426569",64368,64491,123
"34614","ENSRNA022761804","KQ424770",15905,16008,103
"34615","ENSRNA022761805","KQ419829",51635,51690,55
"34616","ENSRNA022761806","KQ419829",49648,49714,66
"34617","ENSRNA022761807","KQ419829",49549,49616,67
"34618","ENSRNA022761808","KQ419829",50803,50868,65
"34619","ENSRNA022761809","KQ419829",50494,50559,65
"34620","ENSRNA022761810","KQ419829",50289,50354,65
"34621","ENSRNA022761811","KQ419829",51008,51073,65
"34622","ENSRNA022761812","KQ422300",156669,156787,118
"34623","ENSRNA022761813","KQ417813",34867,34971,104
"34624","ENSRNA022761814","KQ417813",145444,145561,117
"34625","ENSRNA022761816","KQ416004",133122,133241,119
"34626","ENSRNA022761817","KQ420454",55771,55871,100
"34627","ENSRNA022761818","KQ423397",300942,301002,60
"34628","ENSRNA022761819","KQ421715",266901,267005,104
"34629","ENSRNA022761820","KQ421873",123052,123170,118
"34630","ENSRNA022761821","KQ420697",141439,141524,85
"34631","ENSRNA022761822","KQ418395",68771,68994,223
"34632","ENSRNA022761823","KQ419563",48570,48688,118
"34633","ENSRNA022761824","KQ424632",36733,36960,227
"34634","ENSRNA022761825","KQ422340",131179,131403,224
"34635","ENSRNA022761826","KQ422340",149085,149159,74
"34636","ENSRNA022761827","KQ417472",167580,167995,415
"34637","ENSRNA022761829","KQ428714",91203,91321,118
"34638","ENSRNA022761830","KQ419156",62726,62834,108
"34639","ENSRNA022761831","KQ423465",138301,138417,116
"34640","ENSRNA022761832","KQ418538",19155,19726,571
"34641","ENSRNA022761833","KQ419015",154238,154332,94
"34642","ENSRNA022761834","KQ417410",161429,161533,104
"34643","ENSRNA022761835","KQ423968",157987,158105,118
"34644","ENSRNA022761836","KQ423968",100169,100284,115
"34645","ENSRNA022761837","KQ421056",178615,178733,118
"34646","ENSRNA022761838","KQ420427",60983,61600,617
"34647","ENSRNA022761839","KQ419494",155633,155775,142
"34648","ENSRNA022761840","KQ419659",167884,167998,114
"34649","ENSRNA022761841","KQ431889",194155,194273,118
"34650","ENSRNA022761842","KQ420173",88051,88138,87
"34651","ENSRNA022761843","KQ420439",195585,195691,106
"34652","ENSRNA022761844","KQ420439",571068,571186,118
"34653","ENSRNA022761845","KQ416553",275618,275732,114
"34654","ENSRNA022761846","KQ415895",31894,32012,118
"34655","ENSRNA022761847","KQ417518",464065,464168,103
"34656","ENSRNA022761848","KQ421871",397692,397795,103
"34657","ENSRNA022761849","KQ418988",315476,315596,120
"34658","ENSRNA022761850","KQ419921",321057,321248,191
"34659","ENSRNA022761851","KQ423275",366352,366460,108
"34660","ENSRNA022761852","KQ418496",294945,295063,118
"34661","ENSRNA022761853","KQ423061",217115,217222,107
"34662","ENSRNA022761854","KQ423061",213489,213606,117
"34663","ENSRNA022761855","KQ418741",191526,191644,118
"34664","ENSRNA022761856","KQ418166",333471,333573,102
"34665","ENSRNA022761858","KQ416712",177838,177935,97
"34666","ENSRNA022761859","KQ421417",75632,75733,101
"34667","ENSRNA022761860","KQ422286",99164,99375,211
"34668","ENSRNA022761861","KQ422286",97589,97824,235
"34669","ENSRNA022761862","KQ422286",107753,107886,133
"34670","ENSRNA022761863","KQ427619",18927,19026,99
"34671","ENSRNA022761864","KQ427619",121654,121779,125
"34672","ENSRNA022761865","KQ419168",125464,125560,96
"34673","ENSRNA022761866","KQ418025",193976,194169,193
"34674","ENSRNA022761867","KQ426905",22935,23062,127
"34675","ENSRNA022761868","KQ418943",159002,159120,118
"34676","ENSRNA022761869","KQ418943",136966,137065,99
"34677","ENSRNA022761870","KQ419817",215826,216049,223
"34678","ENSRNA022761871","KQ423403",152465,152571,106
"34679","ENSRNA022761872","KQ426706",194041,194135,94
"34680","ENSRNA022761873","KQ416758",203043,203609,566
"34681","ENSRNA022761874","KQ424999",262996,263102,106
"34682","ENSRNA022761875","KQ421208",60278,60391,113
"34683","ENSRNA022761876","KQ420679",7877,7922,45
"34684","ENSRNA022761877","KQ419394",142000,142134,134
"34685","ENSRNA022761878","KQ428371",75461,75575,114
"34686","ENSRNA022761879","KQ417038",89211,89369,158
"34687","ENSRNA022761880","KQ419000",155870,155988,118
"34688","ENSRNA022761881","KQ421014",120079,120182,103
"34689","ENSRNA022761882","KQ421590",99012,99131,119
"34690","ENSRNA022761883","KQ422420",17832,17934,102
"34691","ENSRNA022761884","KQ424244",86241,86343,102
"34692","ENSRNA022761885","KQ424244",365687,365806,119
"34693","ENSRNA022761886","KQ423958",76656,76803,147
"34694","ENSRNA022761887","KQ425731",120186,120304,118
"34695","ENSRNA022761888","KQ419674",148840,148885,45
"34696","ENSRNA022761889","KQ420035",30967,31091,124
"34697","ENSRNA022761890","KQ424701",101521,101662,141
"34698","ENSRNA022761891","KQ422120",18776,18883,107
"34699","ENSRNA022761892","KQ426586",193665,193783,118
"34700","ENSRNA022761893","KQ426586",153805,153902,97
"34701","ENSRNA022761894","KQ423834",25783,25878,95
"34702","ENSRNA022761895","KQ415701",140608,140726,118
"34703","ENSRNA022761896","KQ427199",67903,68180,277
"34704","ENSRNA022761897","KQ425518",42394,42508,114
"34705","ENSRNA022761898","KQ415928",1194,1312,118
"34706","ENSRNA022761899","KQ419440",37316,37434,118
"34707","ENSRNA022761901","KQ427035",67838,67956,118
"34708","ENSRNA022761902","KQ416197",54500,54573,73
"34709","ENSRNA022761903","KQ428946",71160,71273,113
"34710","ENSRNA022761904","KQ424640",94890,95008,118
"34711","ENSRNA022761905","KQ422094",178727,178843,116
"34712","ENSRNA022761906","KQ422094",177466,177585,119
"34713","ENSRNA022761907","KQ418479",139522,139612,90
"34714","ENSRNA022761908","KQ419477",108370,108488,118
"34715","ENSRNA022761909","KQ416615",74364,74476,112
"34716","ENSRNA022761910","KQ429629",80502,80620,118
"34717","ENSRNA022761911","KQ418015",125736,125850,114
"34718","ENSRNA022761912","KQ417269",94619,94725,106
"34719","ENSRNA022761914","KQ422314",43950,44068,118
"34720","ENSRNA022761915","KQ429401",8702,8842,140
"34721","ENSRNA022761916","KQ423045",72627,72779,152
"34722","ENSRNA022761917","KQ421469",49859,49976,117
"34723","ENSRNA022761918","KQ416427",44926,45044,118
"34724","ENSRNA022761919","KQ433054",65586,65704,118
"34725","ENSRNA022761920","KQ427463",93987,94180,193
"34726","ENSRNA022761921","KQ426567",91992,92271,279
"34727","ENSRNA022761923","KQ425071",226401,226578,177
"34728","ENSRNA022761924","KQ429320",3564,3701,137
"34729","ENSRNA022761925","KQ422717",155965,156071,106
"34730","ENSRNA022761926","KQ422717",103397,103533,136
"34731","ENSRNA022761927","KQ426026",394774,394861,87
"34732","ENSRNA022761928","KQ421151",68400,68505,105
"34733","ENSRNA022761929","KQ419536",49539,49657,118
"34734","ENSRNA022761930","KQ427315",43297,43403,106
"34735","ENSRNA022761931","KQ419347",63217,63321,104
"34736","ENSRNA022761932","KQ421666",44435,44534,99
"34737","ENSRNA022761933","KQ423591",92740,92860,120
"34738","ENSRNA022761934","KQ425066",116843,116961,118
"34739","ENSRNA022761935","KQ425066",265707,265825,118
"34740","ENSRNA022761936","KQ416960",108698,109333,635
"34741","ENSRNA022761938","KQ417158",312647,312825,178
"34742","ENSRNA022761939","KQ417601",182793,182987,194
"34743","ENSRNA022761940","KQ419128",117422,117772,350
"34744","ENSRNA022761941","KQ427727",136739,136854,115
"34745","ENSRNA022761942","KQ423520",185827,185906,79
"34746","ENSRNA022761943","KQ417223",183652,183766,114
"34747","ENSRNA022761944","KQ420496",35669,35775,106
"34748","ENSRNA022761945","KQ428515",45643,45744,101
"34749","ENSRNA022761946","KQ422423",141732,141836,104
"34750","ENSRNA022761947","KQ423659",3111,3229,118
"34751","ENSRNA022761948","KQ418128",105332,105466,134
"34752","ENSRNA022761949","KQ423486",52206,52324,118
"34753","ENSRNA022761950","KQ431316",246751,246869,118
"34754","ENSRNA022761951","KQ431316",72302,72628,326
"34755","ENSRNA022761952","KQ416391",181550,181668,118
"34756","ENSRNA022761954","KQ428760",96642,96953,311
"34757","ENSRNA022761955","KQ416566",21807,21901,94
"34758","ENSRNA022761956","KQ420677",101976,102094,118
"34759","ENSRNA022761957","KQ420677",108398,108516,118
"34760","ENSRNA022761958","KQ420677",105178,105296,118
"34761","ENSRNA022761959","KQ420677",106768,106886,118
"34762","ENSRNA022761960","KQ420677",101238,101356,118
"34763","ENSRNA022761961","KQ420677",106119,106237,118
"34764","ENSRNA022761962","KQ420677",104514,104632,118
"34765","ENSRNA022761963","KQ420677",107732,107849,117
"34766","ENSRNA022761964","KQ420927",51265,51384,119
"34767","ENSRNA022761965","KQ429075",95859,95948,89
"34768","ENSRNA022761966","KQ428825",103403,103635,232
"34769","ENSRNA022761967","KQ428825",104845,105076,231
"34770","ENSRNA022761968","KQ425004",18313,18419,106
"34771","ENSRNA022761969","KQ420301",19601,19719,118
"34772","ENSRNA022761970","KQ420319",66334,66469,135
"34773","ENSRNA022761971","KQ421390",102312,102430,118
"34774","ENSRNA022761972","KQ418733",77389,77496,107
"34775","ENSRNA022761973","KQ422039",92619,92797,178
"34776","ENSRNA022761974","KQ426341",51999,52087,88
"34777","ENSRNA022761975","KQ417919",104549,104647,98
"34778","ENSRNA022761977","KQ419924",24311,24422,111
"34779","ENSRNA022761978","KQ420499",193232,193460,228
"34780","ENSRNA022761979","KQ417206",228553,228829,276
"34781","ENSRNA022761980","KQ427290",135444,135580,136
"34782","ENSRNA022761981","KQ415713",177928,178047,119
"34783","ENSRNA022761982","KQ421256",74360,74454,94
"34784","ENSRNA022761983","KQ420205",82324,82442,118
"34785","ENSRNA022761984","KQ419864",16034,16152,118
"34786","ENSRNA022761985","KQ423189",57628,57790,162
"34787","ENSRNA022761986","KQ423189",57812,57976,164
"34788","ENSRNA022761987","KQ425484",3033,3166,133
"34789","ENSRNA022761988","KQ427776",89443,89647,204
"34790","ENSRNA022761989","KQ424777",89269,89388,119
"34791","ENSRNA022761990","KQ429103",62545,62669,124
"34792","ENSRNA022761992","KQ429904",172167,172285,118
"34793","ENSRNA022761993","KQ417509",17275,17393,118
"34794","ENSRNA022761994","KQ423848",5841,6122,281
"34795","ENSRNA022761995","KQ423848",115487,115605,118
"34796","ENSRNA022761996","KQ423226",135416,135527,111
"34797","ENSRNA022761997","KQ418902",169830,169948,118
"34798","ENSRNA022761998","KQ420382",115215,115334,119
"34799","ENSRNA022761999","KQ421173",181221,181325,104
"34800","ENSRNA022762001","KQ421600",214715,214843,128
"34801","ENSRNA022762003","KQ417671",100182,100716,534
"34802","ENSRNA022762004","KQ433780",2939,3061,122
"34803","ENSRNA022762005","KQ433485",9,120,111
"34804","ENSRNA022762006","KQ433481",2698,2791,93
"34805","ENSRNA022762007","KQ417039",3962,4186,224
"34806","ENSRNA022762008","KQ417039",3963,4187,224
"34807","ENSRNA022762009","KQ431220",117395,117434,39
"34808","ENSRNA022762010","KQ431746",185934,186043,109
"34809","ENSRNA022762011","KQ422615",101693,101811,118
"34810","ENSRNA022762012","KQ423143",171541,171642,101
"34811","ENSRNA022762013","KQ420369",62925,63043,118
"34812","ENSRNA022762014","KQ420369",207869,207989,120
"34813","ENSRNA022762015","KQ422540",28876,28994,118
"34814","ENSRNA022762016","KQ422540",214709,214814,105
"34815","ENSRNA022762017","KQ416582",71149,71270,121
"34816","ENSRNA022762018","KQ416416",135290,135364,74
"34817","ENSRNA022762019","KQ416416",135076,135198,122
"34818","ENSRNA022762020","KQ421434",140196,140303,107
"34819","ENSRNA022762021","KQ416401",88107,88225,118
"34820","ENSRNA022762022","KQ417417",122973,123114,141
"34821","ENSRNA022762023","KQ417417",213697,213816,119
"34822","ENSRNA022762024","KQ422245",170290,170413,123
"34823","ENSRNA022762025","KQ418980",204357,204502,145
"34824","ENSRNA022762026","KQ416859",320957,321054,97
"34825","ENSRNA022762027","KQ418699",138811,138923,112
"34826","ENSRNA022762028","KQ419647",82486,82604,118
"34827","ENSRNA022762030","KQ430232",201857,201987,130
"34828","ENSRNA022762031","KQ418745",315937,316054,117
"34829","ENSRNA022762032","KQ415916",15137,15219,82
"34830","ENSRNA022762033","KQ421985",88189,88295,106
"34831","ENSRNA022762034","KQ421985",34745,34851,106
"34832","ENSRNA022762035","KQ418214",183111,183234,123
"34833","ENSRNA022762036","KQ416550",58889,58995,106
"34834","ENSRNA022762038","KQ418946",124798,124902,104
"34835","ENSRNA022762039","KQ417227",81226,81419,193
"34836","ENSRNA022762040","KQ417227",15897,15999,102
"34837","ENSRNA022762041","KQ419316",69652,69756,104
"34838","ENSRNA022762042","KQ416965",41913,42031,118
"34839","ENSRNA022762043","KQ416667",2918,3074,156
"34840","ENSRNA022762044","KQ421832",59877,59982,105
"34841","ENSRNA022762045","KQ426226",54577,54680,103
"34842","ENSRNA022762046","KQ431304",4700,4817,117
"34843","ENSRNA022762047","KQ429410",8218,8335,117
"34844","ENSRNA022762048","KQ420935",39046,39281,235
"34845","ENSRNA022762049","KQ426519",22339,22903,564
"34846","ENSRNA022762050","KQ427586",51102,51220,118
"34847","ENSRNA022762051","KQ428720",97672,97789,117
"34848","ENSRNA022762052","KQ416573",30388,30494,106
"34849","ENSRNA022762053","KQ422886",115752,115870,118
"34850","ENSRNA022762055","KQ428769",115727,115845,118
"34851","ENSRNA022762056","KQ425314",55135,55238,103
"34852","ENSRNA022762057","KQ417759",46803,46921,118
"34853","ENSRNA022762058","KQ424906",41333,41451,118
"34854","ENSRNA022762059","KQ425516",118661,118767,106
"34855","ENSRNA022762060","KQ419750",249038,249156,118
"34856","ENSRNA022762061","KQ419750",242142,242241,99
"34857","ENSRNA022762062","KQ421650",238667,238785,118
"34858","ENSRNA022762063","KQ424469",142264,142381,117
"34859","ENSRNA022762064","KQ420512",18512,18675,163
"34860","ENSRNA022762065","KQ429524",42542,42645,103
"34861","ENSRNA022762066","KQ431226",58713,58826,113
"34862","ENSRNA022762067","KQ431226",58843,59076,233
"34863","ENSRNA022762068","KQ432562",45646,45724,78
"34864","ENSRNA022762069","KQ419428",54196,54287,91
"34865","ENSRNA022762070","KQ426227",35663,35762,99
"34866","ENSRNA022762071","KQ432048",6369,6554,185
"34867","ENSRNA022762072","KQ425161",19193,19282,89
"34868","ENSRNA022762073","KQ427538",45500,45654,154
"34869","ENSRNA022762074","KQ424243",246522,246715,193
"34870","ENSRNA022762075","KQ424243",276380,276580,200
"34871","ENSRNA022762076","KQ424243",245653,245761,108
"34872","ENSRNA022762077","KQ424243",271149,271330,181
"34873","ENSRNA022762078","KQ416061",119056,119167,111
"34874","ENSRNA022762079","KQ423638",57800,57918,118
"34875","ENSRNA022762080","KQ423638",212334,212426,92
"34876","ENSRNA022762081","KQ417303",138694,138814,120
"34877","ENSRNA022762082","KQ417054",153529,153635,106
"34878","ENSRNA022762083","KQ419023",171735,171928,193
"34879","ENSRNA022762084","KQ419023",165992,166161,169
"34880","ENSRNA022762085","KQ425143",123103,123210,107
"34881","ENSRNA022762086","KQ416691",245930,246042,112
"34882","ENSRNA022762087","KQ429050",28067,28199,132
"34883","ENSRNA022762088","KQ426504",38882,39000,118
"34884","ENSRNA022762089","KQ422823",6385,6491,106
"34885","ENSRNA022762090","KQ416504",2021,2214,193
"34886","ENSRNA022762091","KQ416504",16267,16460,193
"34887","ENSRNA022762092","KQ416504",18369,18562,193
"34888","ENSRNA022762093","KQ423027",38857,38979,122
"34889","ENSRNA022762094","KQ429436",1836,1924,88
"34890","ENSRNA022762095","KQ419001",256,318,62
"34891","ENSRNA022762096","KQ429849",303,392,89
"34892","ENSRNA022762097","KQ424120",107530,107648,118
"34893","ENSRNA022762098","KQ420638",51197,51312,115
"34894","ENSRNA022762099","KQ416713",64118,64236,118
"34895","ENSRNA022762100","KQ433876",29661,29772,111
"34896","ENSRNA022762101","KQ423321",101606,101724,118
"34897","ENSRNA022762102","KQ425420",66539,66636,97
"34898","ENSRNA022762103","KQ423762",52722,52825,103
"34899","ENSRNA022762104","KQ419352",47784,47883,99
"34900","ENSRNA022762105","KQ416439",87114,87521,407
"34901","ENSRNA022762106","KQ419393",93666,93829,163
"34902","ENSRNA022762107","KQ423136",90077,90218,141
"34903","ENSRNA022762108","KQ423136",89616,89662,46
"34904","ENSRNA022762109","KQ416231",99568,99686,118
"34905","ENSRNA022762110","KQ430486",91918,92010,92
"34906","ENSRNA022762111","KQ425943",42136,42253,117
"34907","ENSRNA022762112","KQ423737",83095,83206,111
"34908","ENSRNA022762113","KQ431127",7000,7117,117
"34909","ENSRNA022762114","KQ415989",88038,88164,126
"34910","ENSRNA022762115","KQ427380",87024,87091,67
"34911","ENSRNA022762116","KQ427380",82420,82487,67
"34912","ENSRNA022762117","KQ427380",86067,86133,66
"34913","ENSRNA022762118","KQ427380",80361,80429,68
"34914","ENSRNA022762119","KQ427380",72680,72748,68
"34915","ENSRNA022762120","KQ427380",77897,77965,68
"34916","ENSRNA022762121","KQ424322",78351,78457,106
"34917","ENSRNA022762122","KQ416604",125724,125815,91
"34918","ENSRNA022762123","KQ416158",47057,47157,100
"34919","ENSRNA022762124","KQ423541",28381,28483,102
"34920","ENSRNA022762126","KQ426268",17496,17859,363
"34921","ENSRNA022762127","KQ426268",17872,18039,167
"34922","ENSRNA022762128","KQ416057",26265,26375,110
"34923","ENSRNA022762129","KQ428407",23326,23416,90
"34924","ENSRNA022762130","KQ422462",56307,56407,100
"34925","ENSRNA022762131","KQ430219",26889,26975,86
"34926","ENSRNA022762132","KQ418870",11880,11985,105
"34927","ENSRNA022762133","KQ419928",60351,60456,105
"34928","ENSRNA022762134","KQ419662",62186,62304,118
"34929","ENSRNA022762135","KQ425887",9527,9631,104
"34930","ENSRNA022762136","KQ422719",69409,69527,118
"34931","ENSRNA022762137","KQ421841",43084,43184,100
"34932","ENSRNA022762138","KQ417716",2226,2389,163
"34933","ENSRNA022762139","KQ430205",26639,26747,108
"34934","ENSRNA022762140","KQ422607",35936,36054,118
"34935","ENSRNA022762141","KQ422607",36225,36343,118
"34936","ENSRNA022762142","KQ418099",30784,30909,125
"34937","ENSRNA022762143","KQ428108",43132,43332,200
"34938","ENSRNA022762144","KQ423746",170324,170430,106
"34939","ENSRNA022762145","KQ416956",79502,79620,118
"34940","ENSRNA022762146","KQ421978",263229,263347,118
"34941","ENSRNA022762147","KQ416506",24492,24602,110
"34942","ENSRNA022762148","KQ430468",113283,113405,122
"34943","ENSRNA022762150","KQ419640",174022,174137,115
"34944","ENSRNA022762151","KQ419713",63968,64086,118
"34945","ENSRNA022762152","KQ421752",194729,194833,104
"34946","ENSRNA022762153","KQ428494",114894,115012,118
"34947","ENSRNA022762154","KQ420334",44402,44500,98
"34948","ENSRNA022762155","KQ419751",131763,131881,118
"34949","ENSRNA022762156","KQ416515",87790,87896,106
"34950","ENSRNA022762157","KQ418864",122757,122916,159
"34951","ENSRNA022762158","KQ425001",100618,100730,112
"34952","ENSRNA022762159","KQ417399",46326,46432,106
"34953","ENSRNA022762161","KQ417334",1529,1647,118
"34954","ENSRNA022762162","KQ428644",283,372,89
"34955","ENSRNA022762163","KQ429219",8,91,83
"34956","ENSRNA022762164","KQ428796",1595,1713,118
"34957","ENSRNA022762165","KQ421175",880375,880481,106
"34958","ENSRNA022762166","KQ421281",24198,24312,114
"34959","ENSRNA022762167","KQ418547",811320,811438,118
"34960","ENSRNA022762168","KQ417621",207378,207476,98
"34961","ENSRNA022762169","KQ418039",526701,527050,349
"34962","ENSRNA022762170","KQ418039",447879,448086,207
"34963","ENSRNA022762171","LGKD01671861",989,1090,101
"34964","ENSRNA022762173","KQ427356",898,1016,118
"34965","ENSRNA022762174","LGKD01581467",633,751,118
"34966","ENSRNA022762175","LGKD01545864",498,622,124
"34967","ENSRNA022762176","LGKD01557083",210,364,154
"34968","ENSRNA022762179","LGKD01607745",640,769,129
"34969","ENSRNA022762180","KQ423860",75436,75629,193
"34970","ENSRNA022762181","KQ420782",79848,79947,99
"34971","ENSRNA022762183","KQ415799",89142,89437,295
"34972","ENSRNA022762184","KQ427910",90442,90542,100
"34973","ENSRNA022762185","KQ424874",53944,54054,110
"34974","ENSRNA022762186","KQ421827",30713,30810,97
"34975","ENSRNA022762187","KQ426670",93921,94088,167
"34976","ENSRNA022762188","KQ426670",61999,62097,98
"34977","ENSRNA022762189","LGKD01389701",1156,1245,89
"34978","ENSRNA022762191","KQ429936",1644,1747,103
"34979","ENSRNA022762192","LGKD01683906",1655,1728,73
"34980","ENSRNA022762193","LGKD01588917",69,262,193
"34981","ENSRNA022762194","LGKD01612838",416,533,117
"34982","ENSRNA022762195","LGKD01655958",64,157,93
"34983","ENSRNA022762196","KQ427354",139389,139568,179
"34984","ENSRNA022762197","KQ426913",37147,37288,141
"34985","ENSRNA022762198","KQ419785",42417,42534,117
"34986","ENSRNA022762199","KQ418272",30488,30606,118
"34987","ENSRNA022762200","KQ423290",121875,122038,163
"34988","ENSRNA022762201","KQ423290",72246,72409,163
"34989","ENSRNA022762202","KQ423290",126680,126843,163
"34990","ENSRNA022762203","KQ423290",128037,128200,163
"34991","ENSRNA022762204","KQ423290",124559,124722,163
"34992","ENSRNA022762205","KQ423290",70101,70264,163
"34993","ENSRNA022762206","KQ423290",64510,64673,163
"34994","ENSRNA022762207","KQ423290",66416,66579,163
"34995","ENSRNA022762208","KQ423290",115000,115118,118
"34996","ENSRNA022762210","KQ425525",134951,135065,114
"34997","ENSRNA022762211","KQ423165",110633,110739,106
"34998","ENSRNA022762212","KQ426300",26720,26837,117
"34999","ENSRNA022762213","KQ417738",306747,306864,117
"35000","ENSRNA022762214","KQ417548",51266,51383,117
"35001","ENSRNA022762215","KQ421219",67063,67180,117
"35002","ENSRNA022762216","KQ416912",140035,140229,194
"35003","ENSRNA022762217","KQ416849",155509,155613,104
"35004","ENSRNA022762219","KQ418230",48137,48447,310
"35005","ENSRNA022762220","KQ416832",346507,346586,79
"35006","ENSRNA022762221","LGKD01644112",162,363,201
"35007","ENSRNA022762222","LGKD01313395",471,555,84
"35008","ENSRNA022762223","KQ432384",421,539,118
"35009","ENSRNA022762224","KQ432384",63,181,118
"35010","ENSRNA022762225","KQ432384",2184,2301,117
"35011","ENSRNA022762226","LGKD01232575",52,160,108
"35012","ENSRNA022762227","LGKD01549405",511,703,192
"35013","ENSRNA022762229","LGKD01549974",321,427,106
"35014","ENSRNA022762230","LGKD01634854",698,746,48
"35015","ENSRNA022762231","KQ428931",3972,4075,103
"35016","ENSRNA022762232","KQ420327",48,133,85
"35017","ENSRNA022762233","KQ420327",64,151,87
"35018","ENSRNA022762234","KQ432073",784,914,130
"35019","ENSRNA022762235","LGKD01688011",918,1014,96
"35020","ENSRNA022762236","LGKD01687840",508,556,48
"35021","ENSRNA022762237","KQ422812",8090,8214,124
"35022","ENSRNA022762238","KQ422812",5320,5443,123
"35023","ENSRNA022762239","KQ430529",2084,2190,106
"35024","ENSRNA022762241","KQ430892",4308,4425,117
"35025","ENSRNA022762242","KQ431805",542,730,188
"35026","ENSRNA022762243","LGKD01312762",189,277,88
"35027","ENSRNA022762244","LGKD01545410",121,210,89
"35028","ENSRNA022762246","LGKD01245501",151,213,62
"35029","ENSRNA022762247","LGKD01245501",150,212,62
"35030","ENSRNA022762248","LGKD01468222",221,323,102
"35031","ENSRNA022762249","LGKD01644921",49,125,76
"35032","ENSRNA022762250","LGKD01564086",164,280,116
"35033","ENSRNA022762252","LGKD01544225",497,571,74
"35034","ENSRNA022762253","KQ432688",449,518,69
"35035","ENSRNA022762254","LGKD01605064",194,273,79
"35036","ENSRNA022762255","LGKD01698155",2,98,96
"35037","ENSRNA022762256","LGKD01651984",441,523,82
"35038","ENSRNA022762258","KQ421118",139308,139441,133
"35039","ENSRNA022762259","KQ420036",283,386,103
"35040","ENSRNA022762260","KQ417898",129889,130010,121
"35041","ENSRNA022762261","KQ418019",101026,101144,118
"35042","ENSRNA022762262","KQ422315",55009,55120,111
"35043","ENSRNA022762263","LGKD01581950",1914,2032,118
"35044","ENSRNA022762264","KQ431740",1865,1979,114
"35045","ENSRNA022762265","KQ430053",2007,2073,66
"35046","ENSRNA022762266","KQ424034",1335,1424,89
"35047","ENSRNA022762267","LGKD01426646",16,97,81
"35048","ENSRNA022762268","LGKD01641293",1,88,87
"35049","ENSRNA022762270","LGKD01576683",227,390,163
"35050","ENSRNA022762271","LGKD01457666",518,613,95
"35051","ENSRNA022762273","KQ420913",501,587,86
"35052","ENSRNA022762274","LGKD01312558",148,271,123
"35053","ENSRNA022762275","LGKD01542338",66,152,86
"35054","ENSRNA022762276","LGKD01630773",7,109,102
"35055","ENSRNA022762277","LGKD01650440",172,253,81
"35056","ENSRNA022762278","LGKD01694268",38,137,99
"35057","ENSRNA022762279","LGKD01449895",93,195,102
"35058","ENSRNA022762280","LGKD01449895",92,194,102
"35059","ENSRNA022762281","LGKD01449895",98,189,91
"35060","ENSRNA022762282","LGKD01449895",98,189,91
"35061","ENSRNA022762283","LGKD01449895",76,209,133
"35062","ENSRNA022762284","LGKD01449895",78,211,133
"35063","ENSRNA022762285","LGKD01646565",419,526,107
"35064","ENSRNA022762286","LGKD01459871",43,131,88
"35065","ENSRNA022762287","KQ422530",189936,190042,106
"35066","ENSRNA022762288","KQ421138",175632,175784,152
"35067","ENSRNA022762289","KQ417122",155287,155405,118
"35068","ENSRNA022762290","KQ424569",115855,116309,454
"35069","ENSRNA022762291","KQ424569",133007,133108,101
"35070","ENSRNA022762292","KQ416545",43414,43514,100
"35071","ENSRNA022762293","KQ421621",11246,11364,118
"35072","ENSRNA022762294","LGKD01688244",144,248,104
"35073","ENSRNA022762295","LGKD01688244",155,248,93
"35074","ENSRNA022762297","LGKD01674735",77,122,45
"35075","ENSRNA022762298","LGKD01611480",532,764,232
"35076","ENSRNA022762299","LGKD01567491",787,852,65
"35077","ENSRNA022762300","LGKD01458494",9,123,114
"35078","ENSRNA022762301","LGKD01299357",539,649,110
"35079","ENSRNA022762302","LGKD01694885",389,469,80
"35080","ENSRNA022762303","KQ429828",10167,10285,118
"35081","ENSRNA022762304","KQ429828",8643,8761,118
"35082","ENSRNA022762305","LGKD01660074",360,454,94
"35083","ENSRNA022762306","LGKD01463579",93,194,101
"35084","ENSRNA022762307","LGKD01658895",438,537,99
"35085","ENSRNA022762308","LGKD01583490",15,113,98
"35086","ENSRNA022762309","LGKD01450680",338,437,99
"35087","ENSRNA022762310","LGKD01685069",94,226,132
"35088","ENSRNA022762311","LGKD01594551",247,349,102
"35089","ENSRNA022762312","LGKD01590139",258,332,74
"35090","ENSRNA022762313","LGKD01406741",18,103,85
"35091","ENSRNA022762315","LGKD01232974",180,294,114
"35092","ENSRNA022762317","LGKD01514514",38,129,91
"35093","ENSRNA022762318","KQ425025",290,381,91
"35094","ENSRNA022762319","LGKD01400107",428,527,99
"35095","ENSRNA022762320","LGKD01681688",462,551,89
"35096","ENSRNA022762321","LGKD01540376",120,190,70
"35097","ENSRNA022762322","LGKD01558649",140,248,108
"35098","ENSRNA022762323","LGKD01426627",175,246,71
"35099","ENSRNA022762324","LGKD01626793",168,253,85
"35100","ENSRNA022762325","LGKD01536069",513,615,102
"35101","ENSRNA022762326","LGKD01588919",210,307,97
"35102","ENSRNA022762328","LGKD01449024",34,112,78
"35103","ENSRNA022762329","LGKD01502608",94,212,118
"35104","ENSRNA022762330","LGKD01552713",117,204,87
"35105","ENSRNA022762331","LGKD01565198",6,83,77
"35106","ENSRNA022762332","LGKD01559273",184,243,59
"35107","ENSRNA022762333","LGKD01595637",2,63,61
"35108","ENSRNA022762334","LGKD01587145",26,99,73
"35109","ENSRNA022762335","LGKD01634749",20,106,86
"35110","ENSRNA022762337","LGKD01644650",116,234,118
"35111","ENSRNA022762338","LGKD01430401",230,332,102
"35112","ENSRNA022762339","LGKD01516151",226,329,103
"35113","ENSRNA022762340","LGKD01225626",6,79,73
"35114","ENSRNA022762341","LGKD01300635",106,230,124
"35115","ENSRNA022762342","LGKD01644019",1,92,91
"35116","ENSRNA022762343","LGKD01670783",226,307,81
"35117","ENSRNA022762344","LGKD01518465",348,433,85
"35118","ENSRNA022762345","LGKD01670111",510,597,87
"35119","ENSRNA022762346","LGKD01687821",274,359,85
"35120","ENSRNA022762347","LGKD01649894",565,640,75
"35121","ENSRNA022762349","LGKD01477530",4,94,90
"35122","ENSRNA022762350","LGKD01584842",105,161,56
"35123","ENSRNA022762351","LGKD01083679",143,207,64
"35124","ENSRNA022762352","LGKD01590445",187,259,72
"35125","ENSRNA022762353","LGKD01209893",285,382,97
"35126","ENSRNA022762354","LGKD01443338",108,184,76
"35127","ENSRNA022762355","LGKD01508163",195,269,74
"35128","ENSRNA022762356","KQ421471",73560,73662,102
"35129","ENSRNA022762357","KQ420310",28629,28751,122
"35130","ENSRNA022762358","KQ432015",1817,1935,118
"35131","ENSRNA022762360","KQ420074",17528,17612,84
"35132","ENSRNA022762361","KQ419483",27427,27528,101
"35133","ENSRNA022762362","KQ420311",1300,1652,352
"35134","ENSRNA022762363","KQ420311",31954,32060,106
"35135","ENSRNA022762364","KQ421238",17279,17397,118
"35136","ENSRNA022762365","KQ427081",19160,19267,107
"35137","ENSRNA022762366","KQ428790",43091,43169,78
"35138","ENSRNA022762367","KQ428790",41728,41798,70
"35139","ENSRNA022762368","KQ418831",80577,80690,113
"35140","ENSRNA022762369","KQ429098",1665,1782,117
"35141","ENSRNA022762370","KQ420067",37015,37226,211
"35142","ENSRNA022762371","KQ424614",27329,27424,95
"35143","ENSRNA022762372","LGKD01584240",140,248,108
"35144","ENSRNA022762373","LGKD01330019",3,103,100
"35145","ENSRNA022762374","LGKD01539141",63,140,77
"35146","ENSRNA022762375","LGKD01594150",164,253,89
"35147","ENSRNA022762376","LGKD01656054",50,149,99
"35148","ENSRNA022762377","LGKD01639589",6,95,89
"35149","ENSRNA022762378","LGKD01016595",84,129,45
"35150","ENSRNA022762379","LGKD01384969",101,190,89
"35151","ENSRNA022762380","LGKD01640985",151,237,86
"35152","ENSRNA022762381","LGKD01640145",49,117,68
"35153","ENSRNA022762384","LGKD01347454",123,206,83
"35154","ENSRNA022762386","KQ424484",24425,24543,118
"35155","ENSRNA022762388","KQ427660",46910,47192,282
"35156","ENSRNA022762389","KQ428999",1059,1162,103
"35157","ENSRNA022762390","KQ424135",39935,40054,119
"35158","ENSRNA022762392","LGKD01108548",176,265,89
"35159","ENSRNA022762393","LGKD01633873",177,216,39
"35160","ENSRNA022762394","LGKD01662665",103,183,80
"35161","ENSRNA022762395","LGKD01586429",75,164,89
"35162","ENSRNA022762396","LGKD01226527",7,92,85
"35163","ENSRNA022762397","LGKD01699889",37,120,83
"35164","ENSRNA022762399","LGKD01625861",6,81,75
"35165","ENSRNA022762400","LGKD01377986",159,246,87
"35166","ENSRNA022762401","LGKD01290909",102,188,86
"35167","ENSRNA022762402","LGKD01696243",29,118,89
"35168","ENSRNA022762404","LGKD01427237",63,149,86
"35169","ENSRNA022762406","LGKD01665653",80,177,97
"35170","ENSRNA022762407","LGKD01583516",296,382,86
"35171","ENSRNA022762408","LGKD01634497",206,374,168
"35172","ENSRNA022762409","LGKD01310197",32,171,139
"35173","ENSRNA022762410","LGKD01446473",65,154,89
"35174","ENSRNA022762411","LGKD01612593",120,204,84
"35175","ENSRNA022762412","LGKD01688956",109,239,130
"35176","ENSRNA022762414","LGKD01697930",322,405,83
"35177","ENSRNA022762415","LGKD01658415",73,166,93
"35178","ENSRNA022762416","LGKD01536419",63,132,69
"35179","ENSRNA022762417","LGKD01623946",170,284,114
"35180","ENSRNA022762418","LGKD01694160",22,111,89
"35181","ENSRNA022762419","LGKD01667219",49,144,95
"35182","ENSRNA022762421","LGKD01520077",72,167,95
"35183","ENSRNA022762422","LGKD01517158",105,223,118
"35184","ENSRNA022762423","LGKD01575845",78,178,100
"35185","ENSRNA022762424","KQ430103",25360,25466,106
"35186","ENSRNA022762425","KQ424468",21578,21696,118
"35187","ENSRNA022762426","KQ430348",13589,13687,98
"35188","ENSRNA022762427","KQ418237",1804,1968,164
"35189","ENSRNA022762428","KQ433098",10043,10157,114
"35190","ENSRNA022762429","KQ432177",16097,16319,222
"35191","ENSRNA022762430","LGKD01546691",142,284,142
"35192","ENSRNA022762431","LGKD01644954",173,271,98
"35193","ENSRNA022762432","LGKD01689481",35,134,99
"35194","ENSRNA022762433","LGKD01548224",9,104,95
"35195","ENSRNA022762434","LGKD01670323",2,93,91
"35196","ENSRNA022762436","LGKD01627732",39,133,94
"35197","ENSRNA022762438","LGKD01629165",29,147,118
"35198","ENSRNA022762439","LGKD01616176",158,254,96
"35199","ENSRNA022762440","LGKD01669352",73,180,107
"35200","ENSRNA022762441","LGKD01351020",11,50,39
"35201","ENSRNA022762443","LGKD01663695",391,480,89
"35202","ENSRNA022762444","LGKD01609578",252,329,77
"35203","ENSRNA022762445","LGKD01578367",39,173,134
"35204","ENSRNA022762446","LGKD01615406",16,95,79
"35205","ENSRNA022762447","LGKD01388947",70,113,43
"35206","ENSRNA022762448","LGKD01676018",121,281,160
"35207","ENSRNA022762449","LGKD01415829",281,320,39
"35208","ENSRNA022762450","LGKD01662181",85,168,83
"35209","ENSRNA022762452","LGKD01606729",201,285,84
"35210","ENSRNA022762453","LGKD01598666",519,607,88
"35211","ENSRNA022762456","LGKD01645429",28,114,86
"35212","ENSRNA022762457","LGKD01556029",64,153,89
"35213","ENSRNA022762458","LGKD01534186",155,232,77
"35214","ENSRNA022762459","LGKD01495945",178,270,92
"35215","ENSRNA022762460","LGKD01545888",226,306,80
"35216","ENSRNA022762461","LGKD01564446",69,158,89
"35217","ENSRNA022762462","LGKD01615670",368,457,89
"35218","ENSRNA022762463","LGKD01388524",246,367,121
"35219","ENSRNA022762464","KQ419390",101664,101819,155
"35220","ENSRNA022762465","KQ419459",41213,41317,104
"35221","ENSRNA022762466","KQ426997",11131,11234,103
"35222","ENSRNA022762468","LGKD01382701",183,254,71
"35223","ENSRNA022762469","KQ427198",35286,35404,118
"35224","ENSRNA022762471","KQ425616",39950,40069,119
"35225","ENSRNA022762473","KQ428765",16298,16395,97
"35226","ENSRNA022762474","KQ430145",4499,4600,101
"35227","ENSRNA022762476","KQ429535",47772,47875,103
"35228","ENSRNA022762478","KQ423869",133819,134116,297
"35229","ENSRNA022762479","KQ428859",62126,62244,118
"35230","ENSRNA022762480","KQ424760",75817,75935,118
"35231","ENSRNA022762481","KQ425156",127630,127752,122
"35232","ENSRNA022762482","KQ420441",107176,107298,122
"35233","ENSRNA022762483","KQ419112",22888,22993,105
"35234","ENSRNA022762484","LGKD01650478",120,210,90
"35235","ENSRNA022762486","LGKD01663296",48,148,100
"35236","ENSRNA022762487","KQ415958",188875,188993,118
"35237","ENSRNA022762488","KQ415958",111335,111453,118
"35238","ENSRNA022762489","KQ416556",85073,85561,488
"35239","ENSRNA022762490","KQ422659",159222,159386,164
"35240","ENSRNA022762491","KQ422662",193247,193349,102
"35241","ENSRNA022762492","KQ420387",245293,245411,118
"35242","ENSRNA022762493","KQ429255",139484,139549,65
"35243","ENSRNA022762494","LGKD01655962",549,604,55
"35244","ENSRNA022762495","LGKD01582894",561,626,65
"35245","ENSRNA022762496","LGKD01684497",24,112,88
"35246","ENSRNA022762497","KQ431445",37231,37340,109
"35247","ENSRNA022762498","KQ425501",33886,34050,164
"35248","ENSRNA022762499","KQ427377",83012,83171,159
"35249","ENSRNA022762500","KQ420998",42898,42975,77
"35250","ENSRNA022762501","KQ415961",28242,28501,259
"35251","ENSRNA022762502","KQ420290",7262,7360,98
"35252","ENSRNA022762503","KQ420596",66658,66782,124
"35253","ENSRNA022762504","KQ420596",70149,70273,124
"35254","ENSRNA022762505","KQ418378",15386,15502,116
"35255","ENSRNA022762506","KQ416846",374919,375007,88
"35256","ENSRNA022762507","KQ420700",181023,181127,104
"35257","ENSRNA022762508","KQ417996",282123,282238,115
"35258","ENSRNA022762509","KQ417353",231932,232050,118
"35259","ENSRNA022762510","LGKD01575964",74,160,86
"35260","ENSRNA022762511","LGKD01544271",493,583,90
"35261","ENSRNA022762512","LGKD01542938",180,253,73
"35262","ENSRNA022762513","LGKD01557931",108,199,91
"35263","ENSRNA022762514","LGKD01402089",245,334,89
"35264","ENSRNA022762515","LGKD01433195",14,104,90
"35265","ENSRNA022762516","LGKD01157193",160,249,89
"35266","ENSRNA022762517","LGKD01534611",87,194,107
"35267","ENSRNA022762518","LGKD01529493",255,356,101
"35268","ENSRNA022762521","LGKD01575727",237,341,104
"35269","ENSRNA022762522","KQ428291",4006,4122,116
"35270","ENSRNA022762523","KQ425694",6796,6920,124
"35271","ENSRNA022762524","KQ425694",4253,4375,122
"35272","ENSRNA022762525","KQ425694",5107,5231,124
"35273","ENSRNA022762526","KQ432310",12366,12468,102
"35274","ENSRNA022762527","KQ427048",16971,17089,118
"35275","ENSRNA022762528","KQ418314",17404,17497,93
"35276","ENSRNA022762529","KQ425811",18388,18551,163
"35277","ENSRNA022762530","KQ429553",11305,11423,118
"35278","ENSRNA022762531","KQ429004",18293,18396,103
"35279","ENSRNA022762532","KQ423630",70217,70323,106
"35280","ENSRNA022762533","KQ423378",48036,48699,663
"35281","ENSRNA022762534","KQ428717",242926,243029,103
"35282","ENSRNA022762535","KQ416874",249636,249724,88
"35283","ENSRNA022762536","KQ420070",67700,67818,118
"35284","ENSRNA022762537","KQ420159",86302,86401,99
"35285","ENSRNA022762538","KQ429057",130708,130866,158
"35286","ENSRNA022762539","LGKD01650051",97,191,94
"35287","ENSRNA022762540","LGKD01653777",408,482,74
"35288","ENSRNA022762541","KQ430505",26309,26427,118
"35289","ENSRNA022762542","LGKD01429021",313,401,88
"35290","ENSRNA022762543","LGKD01581726",86,192,106
"35291","ENSRNA022762545","KQ423865",24688,24806,118
"35292","ENSRNA022762546","KQ423865",21443,21561,118
"35293","ENSRNA022762547","KQ423865",12236,12354,118
"35294","ENSRNA022762548","KQ423865",13167,13285,118
"35295","ENSRNA022762549","KQ423865",23761,23878,117
"35296","ENSRNA022762550","KQ423865",20076,20194,118
"35297","ENSRNA022762551","KQ423865",20785,20909,124
"35298","ENSRNA022762552","KQ429074",10549,10655,106
"35299","ENSRNA022762553","KQ425627",14189,14289,100
"35300","ENSRNA022762554","KQ432913",11308,11430,122
"35301","ENSRNA022762555","KQ419595",13064,13148,84
"35302","ENSRNA022762556","KQ432369",17875,17993,118
"35303","ENSRNA022762557","KQ428638",8290,8403,113
"35304","ENSRNA022762558","KQ416634",14536,14654,118
"35305","ENSRNA022762559","KQ420616",131884,131990,106
"35306","ENSRNA022762560","KQ420971",62057,62157,100
"35307","ENSRNA022762561","KQ423774",175703,175923,220
"35308","ENSRNA022762562","KQ418266",40538,40645,107
"35309","ENSRNA022762563","KQ416384",114007,114131,124
"35310","ENSRNA022762564","KQ416384",117573,117697,124
"35311","ENSRNA022762565","KQ416384",116587,116711,124
"35312","ENSRNA022762566","KQ418389",17222,17340,118
"35313","ENSRNA022762567","KQ423826",55273,55669,396
"35314","ENSRNA022762568","KQ421835",58399,59279,880
"35315","ENSRNA022762569","KQ424697",9444,9562,118
"35316","ENSRNA022762570","KQ417079",28803,28901,98
"35317","ENSRNA022762571","KQ415734",31300,31417,117
"35318","ENSRNA022762572","KQ418255",16024,16143,119
"35319","ENSRNA022762573","KQ427574",4418,4529,111
"35320","ENSRNA022762574","KQ424849",51980,52094,114
"35321","ENSRNA022762575","KQ427927",89597,90272,675
"35322","ENSRNA022762576","KQ423912",62436,62577,141
"35323","ENSRNA022762577","KQ419268",26688,26802,114
"35324","ENSRNA022762578","KQ418261",82835,83145,310
"35325","ENSRNA022762579","KQ429479",31389,31535,146
"35326","ENSRNA022762580","KQ428332",17561,17680,119
"35327","ENSRNA022762581","KQ418694",68337,68455,118
"35328","ENSRNA022762582","KQ420182",146529,146647,118
"35329","ENSRNA022762583","KQ426767",100863,100975,112
"35330","ENSRNA022762584","KQ421672",54574,54689,115
"35331","ENSRNA022762585","KQ420752",93654,93951,297
"35332","ENSRNA022762586","KQ421122",91119,91222,103
"35333","ENSRNA022762587","KQ419565",36695,36848,153
"35334","ENSRNA022762588","KQ421991",58294,58752,458
"35335","ENSRNA022762589","KQ420136",9876,9994,118
"35336","ENSRNA022762590","KQ426780",14315,14433,118
"35337","ENSRNA022762591","KQ426780",10196,10294,98
"35338","ENSRNA022762592","KQ427583",6746,6905,159
"35339","ENSRNA022762593","KQ426668",46062,46160,98
"35340","ENSRNA022762594","KQ423657",13810,14106,296
"35341","ENSRNA022762595","KQ416743",16823,16962,139
"35342","ENSRNA022762596","KQ424997",8464,8652,188
"35343","ENSRNA022762597","KQ424997",8663,8728,65
"35344","ENSRNA022762598","KQ426659",3144,3262,118
"35345","ENSRNA022762599","KQ417307",44284,44386,102
"35346","ENSRNA022762600","KQ419523",13036,13153,117
"35347","ENSRNA022762601","KQ419848",76747,77188,441
"35348","ENSRNA022762602","KQ423107",22193,22481,288
"35349","ENSRNA022762603","KQ427054",80087,80349,262
"35350","ENSRNA022762604","KQ423861",118854,118960,106
"35351","ENSRNA022762605","KQ419584",12202,12343,141
"35352","ENSRNA022762606","KQ429031",119607,119713,106
"35353","ENSRNA022762607","KQ429031",99024,99130,106
"35354","ENSRNA022762608","KQ416587",107825,107904,79
"35355","ENSRNA022762609","KQ418522",137070,137188,118
"35356","ENSRNA022762610","KQ424680",86123,86249,126
"35357","ENSRNA022762611","LGKD01476789",137,255,118
"35358","ENSRNA022762612","LGKD01672082",126,209,83
"35359","ENSRNA022762613","LGKD01675461",186,293,107
"35360","ENSRNA022762614","LGKD01435281",220,307,87
"35361","ENSRNA022762615","LGKD01448594",78,147,69
"35362","ENSRNA022762616","LGKD01560407",84,172,88
"35363","ENSRNA022762617","LGKD01528139",49,97,48
"35364","ENSRNA022762618","LGKD01319965",89,193,104
"35365","ENSRNA022762619","LGKD01699034",184,308,124
"35366","ENSRNA022762623","LGKD01627064",142,231,89
"35367","ENSRNA022762625","LGKD01463529",337,431,94
"35368","ENSRNA022762628","KQ422640",12553,12716,163
"35369","ENSRNA022762629","KQ433784",2209,2438,229
"35370","ENSRNA022762630","KQ424472",6942,7061,119
"35371","ENSRNA022762631","KQ428028",1146,1264,118
"35372","ENSRNA022762632","KQ422369",5228,5273,45
"35373","ENSRNA022762633","KQ420224",9241,9317,76
"35374","ENSRNA022762634","KQ427181",3586,3705,119
"35375","ENSRNA022762635","KQ424128",4953,5071,118
"35376","ENSRNA022762636","KQ430506",7344,7532,188
"35377","ENSRNA022762637","KQ424843",2644,2724,80
"35378","ENSRNA022762638","KQ426708",6017,6260,243
"35379","ENSRNA022762639","LGKD01665669",7447,7610,163
"35380","ENSRNA022762640","LGKD01665669",10324,10487,163
