"","ensembl_gene_id","chromosome_name","start_position","end_position","length"
"1","Zm00001d000001","B73V4_ctg150",48820,51164,2344
"2","Zm00001d000002","B73V4_ctg150",193401,204736,11335
"3","Zm00001d000003","B73V4_ctg150",205855,207073,1218
"4","Zm00001d000004","B73V4_ctg150",262374,271967,9593
"5","Zm00001d000005","B73V4_ctg150",272045,275576,3531
"6","Zm00001d000009","B73V4_ctg150",597986,627204,29218
"7","Zm00001d000011","B73V4_ctg150",728868,734454,5586
"8","Zm00001d000013","B73V4_ctg150",816802,818350,1548
"9","Zm00001d000019","B73V4_ctg150",1315610,1316049,439
"10","Zm00001d000021","B73V4_ctg150",1459856,1464045,4189
"11","Zm00001d000023","B73V4_ctg150",1548548,1563325,14777
"12","Zm00001d000026","B73V4_ctg182",41961,43672,1711
"13","Zm00001d000027","B73V4_ctg182",51471,61298,9827
"14","Zm00001d000028","B73V4_ctg182",72804,74351,1547
"15","Zm00001d000029","B73V4_ctg182",112441,117019,4578
"16","Zm00001d000030","B73V4_ctg182",118656,122184,3528
"17","Zm00001d000032","B73V4_ctg182",259037,259393,356
"18","Zm00001d000034","B73V4_ctg182",378277,384064,5787
"19","Zm00001d000035","B73V4_ctg182",384330,387202,2872
"20","Zm00001d000038","B73V4_ctg182",474177,478548,4371
"21","Zm00001d000039","B73V4_ctg182",516538,520597,4059
"22","Zm00001d000040","B73V4_ctg182",631843,638267,6424
"23","Zm00001d000041","B73V4_ctg182",664090,674232,10142
"24","Zm00001d000042","B73V4_ctg182",729582,756794,27212
"25","Zm00001d000045","B73V4_ctg182",953004,953960,956
"26","Zm00001d000046","B73V4_ctg182",1051027,1054330,3303
"27","Zm00001d000051","B73V4_ctg182",1206837,1207997,1160
"28","Zm00001d000052","B73V4_ctg182",1208564,1214385,5821
"29","Zm00001d000053","B73V4_ctg182",1230822,1235148,4326
"30","Zm00001d000055","B73V4_ctg10",94253,97609,3356
"31","Zm00001d000062","B73V4_ctg10",518227,519667,1440
"32","Zm00001d000065","B73V4_ctg10",633830,634595,765
"33","Zm00001d000066","B73V4_ctg10",655391,657780,2389
"34","Zm00001d000071","B73V4_ctg10",856578,871342,14764
"35","Zm00001d000072","B73V4_ctg10",917444,925264,7820
"36","Zm00001d000074","B73V4_ctg31",78320,91352,13032
"37","Zm00001d000076","B73V4_ctg31",236238,242444,6206
"38","Zm00001d000077","B73V4_ctg31",243552,267664,24112
"39","Zm00001d000079","B73V4_ctg31",359763,361867,2104
"40","Zm00001d000080","B73V4_ctg31",421411,431957,10546
"41","Zm00001d000083","B73V4_ctg31",542102,559398,17296
"42","Zm00001d000085","B73V4_ctg31",591995,597038,5043
"43","Zm00001d000086","B73V4_ctg31",602596,604282,1686
"44","Zm00001d000087","B73V4_ctg31",604646,610425,5779
"45","Zm00001d000089","B73V4_ctg31",638364,640659,2295
"46","Zm00001d000093","B73V4_ctg31",721884,723473,1589
"47","Zm00001d000096","B73V4_ctg31",791577,793010,1433
"48","Zm00001d000098","B73V4_ctg91",51271,76184,24913
"49","Zm00001d000099","B73V4_ctg91",203934,209968,6034
"50","Zm00001d000102","B73V4_ctg91",576085,577149,1064
"51","Zm00001d000104","B73V4_ctg91",664683,665212,529
"52","Zm00001d000109","B73V4_ctg52",51214,56714,5500
"53","Zm00001d000110","B73V4_ctg52",187964,193349,5385
"54","Zm00001d000112","B73V4_ctg52",346937,349561,2624
"55","Zm00001d000113","B73V4_ctg52",429347,430532,1185
"56","Zm00001d000116","B73V4_ctg52",628311,634545,6234
"57","Zm00001d000117","B73V4_ctg142",68137,71202,3065
"58","Zm00001d000120","B73V4_ctg142",542642,545404,2762
"59","Zm00001d000122","B73V4_ctg56",93250,99802,6552
"60","Zm00001d000123","B73V4_ctg56",100371,104438,4067
"61","Zm00001d000124","B73V4_ctg56",125718,130113,4395
"62","Zm00001d000126","B73V4_ctg56",252289,254953,2664
"63","Zm00001d000128","B73V4_ctg56",342643,344161,1518
"64","Zm00001d000133","B73V4_ctg56",492709,499020,6311
"65","Zm00001d000134","B73V4_ctg56",517290,518693,1403
"66","Zm00001d000135","B73V4_ctg65",75416,77421,2005
"67","Zm00001d000137","B73V4_ctg65",290651,294129,3478
"68","Zm00001d000141","B73V4_ctg65",630898,631815,917
"69","Zm00001d000143","B73V4_ctg193",266240,271023,4783
"70","Zm00001d000147","B73V4_ctg193",374808,378665,3857
"71","Zm00001d000150","B73V4_ctg75",116649,127114,10465
"72","Zm00001d000152","B73V4_ctg75",176002,183308,7306
"73","Zm00001d000153","B73V4_ctg75",228571,239357,10786
"74","Zm00001d000154","B73V4_ctg75",356241,356918,677
"75","Zm00001d000156","B73V4_ctg75",455266,458201,2935
"76","Zm00001d000158","B73V4_ctg53",105994,107904,1910
"77","Zm00001d000160","B73V4_ctg53",296217,299719,3502
"78","Zm00001d000161","B73V4_ctg53",334998,335553,555
"79","Zm00001d000162","B73V4_ctg53",356335,358296,1961
"80","Zm00001d000164","B73V4_ctg50",6747,9235,2488
"81","Zm00001d000165","B73V4_ctg50",47321,48070,749
"82","Zm00001d000166","B73V4_ctg50",84566,91323,6757
"83","Zm00001d000168","B73V4_ctg50",189024,191498,2474
"84","Zm00001d000169","B73V4_ctg50",207558,215785,8227
"85","Zm00001d000170","B73V4_ctg50",223163,226388,3225
"86","Zm00001d000175","B73V4_ctg181",42145,44112,1967
"87","Zm00001d000178","B73V4_ctg181",132473,138116,5643
"88","Zm00001d000179","B73V4_ctg181",214703,215548,845
"89","Zm00001d000180","B73V4_ctg181",244852,246066,1214
"90","Zm00001d000181","B73V4_ctg181",248690,250107,1417
"91","Zm00001d000183","B73V4_ctg181",307491,312293,4802
"92","Zm00001d000184","B73V4_ctg181",314008,317339,3331
"93","Zm00001d000189","B73V4_ctg140",276457,292237,15780
"94","Zm00001d000191","B73V4_ctg72",95773,118440,22667
"95","Zm00001d000193","B73V4_ctg178",149138,155338,6200
"96","Zm00001d000194","B73V4_ctg178",177577,178790,1213
"97","Zm00001d000195","B73V4_ctg178",202000,204559,2559
"98","Zm00001d000196","B73V4_ctg178",204778,207105,2327
"99","Zm00001d000197","B73V4_ctg178",216729,217247,518
"100","Zm00001d000199","B73V4_ctg178",309330,314476,5146
"101","Zm00001d000200","B73V4_ctg6",82969,83806,837
"102","Zm00001d000202","B73V4_ctg6",202989,206597,3608
"103","Zm00001d000204","B73V4_ctg129",15011,19789,4778
"104","Zm00001d000205","B73V4_ctg129",44771,52582,7811
"105","Zm00001d000208","B73V4_ctg129",53844,54317,473
"106","Zm00001d000209","B73V4_ctg129",57550,60005,2455
"107","Zm00001d000211","B73V4_ctg129",111431,116621,5190
"108","Zm00001d000213","B73V4_ctg129",120508,127694,7186
"109","Zm00001d000214","B73V4_ctg129",173140,174744,1604
"110","Zm00001d000220","B73V4_ctg26",115480,117114,1634
"111","Zm00001d000222","B73V4_ctg26",144186,147832,3646
"112","Zm00001d000223","B73V4_ctg26",177561,180711,3150
"113","Zm00001d000224","B73V4_ctg26",181370,185154,3784
"114","Zm00001d000226","B73V4_ctg170",40997,63503,22506
"115","Zm00001d000227","B73V4_ctg98",2666,3625,959
"116","Zm00001d000228","B73V4_ctg98",12548,19095,6547
"117","Zm00001d000230","B73V4_ctg98",35084,39721,4637
"118","Zm00001d000232","B73V4_ctg98",63869,68060,4191
"119","Zm00001d000236","B73V4_ctg44",29069,33275,4206
"120","Zm00001d000237","B73V4_ctg44",71975,73515,1540
"121","Zm00001d000238","B73V4_ctg49",34019,35965,1946
"122","Zm00001d000240","B73V4_ctg11",22240,26791,4551
"123","Zm00001d000241","B73V4_ctg11",49629,52020,2391
"124","Zm00001d000242","B73V4_ctg11",52503,52820,317
"125","Zm00001d000243","B73V4_ctg11",97859,98410,551
"126","Zm00001d000247","B73V4_ctg123",9585,17517,7932
"127","Zm00001d000255","B73V4_ctg20",20953,24151,3198
"128","Zm00001d000256","B73V4_ctg100",4352,11693,7341
"129","Zm00001d000257","B73V4_ctg77",1,3900,3899
"130","Zm00001d000258","B73V4_ctg134",2887,2958,71
"131","Zm00001d000259","B73V4_ctg134",4126,4213,87
"132","Zm00001d000260","B73V4_ctg134",5196,6257,1061
"133","Zm00001d000263","B73V4_ctg134",9186,9259,73
"134","Zm00001d000264","B73V4_ctg134",11997,12068,71
"135","Zm00001d000265","B73V4_ctg134",12064,12135,71
"136","Zm00001d000266","B73V4_ctg134",12598,12670,72
"137","Zm00001d000268","B73V4_ctg134",13164,13237,73
"138","Zm00001d000270","B73V4_ctg134",17567,34329,16762
"139","Zm00001d000271","B73V4_ctg134",34343,34414,71
"140","Zm00001d000272","B73V4_ctg134",37464,39137,1673
"141","Zm00001d000274","B73V4_ctg134",42898,42984,86
"142","Zm00001d000275","B73V4_ctg134",44190,44262,72
"143","Zm00001d000276","B73V4_ctg134",45979,46051,72
"144","Zm00001d000277","B73V4_ctg134",46348,52214,5866
"145","Zm00001d000278","B73V4_ctg134",50129,50201,72
"146","Zm00001d000279","B73V4_ctg134",52981,54432,1451
"147","Zm00001d000280","B73V4_ctg134",61978,62051,73
"148","Zm00001d000281","B73V4_ctg134",62189,62262,73
"149","Zm00001d000282","B73V4_ctg134",66945,68363,1418
"150","Zm00001d000288","B73V4_ctg104",67198,68824,1626
"151","Zm00001d000291","B73V4_ctg14",71867,75016,3149
"152","Zm00001d000293","B73V4_ctg40",27712,33243,5531
"153","Zm00001d000294","B73V4_ctg73",52548,56015,3467
"154","Zm00001d000295","B73V4_ctg73",70157,74787,4630
"155","Zm00001d000298","B73V4_ctg103",43852,45744,1892
"156","Zm00001d000299","B73V4_ctg103",50560,54085,3525
"157","Zm00001d000300","B73V4_ctg107",25722,27077,1355
"158","Zm00001d000301","B73V4_ctg107",28850,31668,2818
"159","Zm00001d000302","B73V4_ctg107",36639,40287,3648
"160","Zm00001d000304","B73V4_ctg107",45539,50405,4866
"161","Zm00001d000305","B73V4_ctg107",50634,54140,3506
"162","Zm00001d000307","B73V4_ctg107",61610,62569,959
"163","Zm00001d000310","B73V4_ctg51",15658,16392,734
"164","Zm00001d000311","B73V4_ctg51",18625,23527,4902
"165","Zm00001d000312","B73V4_ctg51",27816,30222,2406
"166","Zm00001d000313","B73V4_ctg51",50346,55788,5442
"167","Zm00001d000314","B73V4_ctg51",58448,59686,1238
"168","Zm00001d000315","B73V4_ctg253",64236,64547,311
"169","Zm00001d000316","B73V4_ctg89",18903,24123,5220
"170","Zm00001d000319","B73V4_ctg188",18507,35190,16683
"171","Zm00001d000320","B73V4_ctg188",46568,49040,2472
"172","Zm00001d000321","B73V4_ctg188",50430,55087,4657
"173","Zm00001d000322","B73V4_ctg188",56000,58302,2302
"174","Zm00001d000328","B73V4_ctg74",56177,61576,5399
"175","Zm00001d000329","B73V4_ctg247",803,19871,19068
"176","Zm00001d000332","B73V4_ctg125",17680,19880,2200
"177","Zm00001d000339","B73V4_ctg23",49432,50133,701
"178","Zm00001d000345","B73V4_ctg61",46641,50924,4283
"179","Zm00001d000346","B73V4_ctg95",26643,34091,7448
"180","Zm00001d000349","B73V4_ctg35",19508,27375,7867
"181","Zm00001d000350","B73V4_ctg35",44795,47751,2956
"182","Zm00001d000355","B73V4_ctg206",55652,58153,2501
"183","Zm00001d000357","B73V4_ctg48",39499,44961,5462
"184","Zm00001d000358","B73V4_ctg115",30305,33567,3262
"185","Zm00001d000360","B73V4_ctg115",42964,45072,2108
"186","Zm00001d000361","B73V4_ctg115",46043,53651,7608
"187","Zm00001d000364","B73V4_ctg189",5457,7653,2196
"188","Zm00001d000366","B73V4_ctg189",53838,56034,2196
"189","Zm00001d000368","B73V4_ctg18",24291,28950,4659
"190","Zm00001d000370","B73V4_ctg147",430,6513,6083
"191","Zm00001d000377","B73V4_ctg147",45931,48729,2798
"192","Zm00001d000379","B73V4_ctg24",12019,14648,2629
"193","Zm00001d000380","B73V4_ctg24",17371,19441,2070
"194","Zm00001d000381","B73V4_ctg24",21822,27498,5676
"195","Zm00001d000382","B73V4_ctg66",34040,46131,12091
"196","Zm00001d000383","B73V4_ctg66",52941,58697,5756
"197","Zm00001d000387","B73V4_ctg42",27125,28246,1121
"198","Zm00001d000388","B73V4_ctg83",67145,67480,335
"199","Zm00001d000389","B73V4_ctg208",37618,41003,3385
"200","Zm00001d000390","B73V4_ctg41",3464,4234,770
"201","Zm00001d000391","B73V4_ctg41",6448,10639,4191
"202","Zm00001d000396","B73V4_ctg173",7834,11320,3486
"203","Zm00001d000399","B73V4_ctg4",28493,32925,4432
"204","Zm00001d000400","B73V4_ctg4",41986,43707,1721
"205","Zm00001d000401","B73V4_ctg248",21007,24366,3359
"206","Zm00001d000402","B73V4_ctg28",4355,7015,2660
"207","Zm00001d000403","B73V4_ctg28",10641,12680,2039
"208","Zm00001d000407","B73V4_ctg58",10359,22602,12243
"209","Zm00001d000408","B73V4_ctg58",30440,33578,3138
"210","Zm00001d000412","B73V4_ctg8",43499,46626,3127
"211","Zm00001d000413","B73V4_ctg8",51671,54164,2493
"212","Zm00001d000414","B73V4_ctg151",52117,53637,1520
"213","Zm00001d000417","B73V4_ctg121",20918,21979,1061
"214","Zm00001d000418","B73V4_ctg121",28928,30307,1379
"215","Zm00001d000419","B73V4_ctg141",39614,43058,3444
"216","Zm00001d000422","B73V4_ctg250",32293,32493,200
"217","Zm00001d000424","B73V4_ctg105",38570,40097,1527
"218","Zm00001d000428","B73V4_ctg68",36025,39222,3197
"219","Zm00001d000429","B73V4_ctg68",39521,39730,209
"220","Zm00001d000430","B73V4_ctg68",40310,44234,3924
"221","Zm00001d000431","B73V4_ctg2",11524,19975,8451
"222","Zm00001d000432","B73V4_ctg2",22138,29086,6948
"223","Zm00001d000434","B73V4_ctg3",46642,48363,1721
"224","Zm00001d000435","B73V4_ctg190",26426,31188,4762
"225","Zm00001d000436","B73V4_ctg190",31288,44877,13589
"226","Zm00001d000439","B73V4_ctg88",8525,11623,3098
"227","Zm00001d000443","B73V4_ctg88",30925,34037,3112
"228","Zm00001d000444","B73V4_ctg88",34954,40279,5325
"229","Zm00001d000445","B73V4_ctg110",4664,24941,20277
"230","Zm00001d000447","B73V4_ctg242",24505,26768,2263
"231","Zm00001d000452","B73V4_ctg205",21046,28338,7292
"232","Zm00001d000455","B73V4_ctg144",34672,45261,10589
"233","Zm00001d000458","B73V4_ctg119",9942,10808,866
"234","Zm00001d001763","2",40178,41023,845
"235","Zm00001d001765","2",99801,117243,17442
"236","Zm00001d001766","2",177013,177948,935
"237","Zm00001d001767","2",259078,260187,1109
"238","Zm00001d001771","2",473339,474814,1475
"239","Zm00001d001772","2",475371,476004,633
"240","Zm00001d001773","2",477842,481305,3463
"241","Zm00001d001774","2",481355,482248,893
"242","Zm00001d001776","2",591782,592024,242
"243","Zm00001d001779","2",707483,708601,1118
"244","Zm00001d001780","2",709269,717277,8008
"245","Zm00001d001781","2",740855,742900,2045
"246","Zm00001d001784","2",830360,832876,2516
"247","Zm00001d001785","2",833688,836726,3038
"248","Zm00001d001786","2",891741,896781,5040
"249","Zm00001d001787","2",923036,933728,10692
"250","Zm00001d001788","2",935639,948444,12805
"251","Zm00001d001789","2",954829,957763,2934
"252","Zm00001d001790","2",1019499,1023493,3994
"253","Zm00001d001791","2",1023933,1025879,1946
"254","Zm00001d001792","2",1026064,1029335,3271
"255","Zm00001d001793","2",1045117,1045344,227
"256","Zm00001d001796","2",1048983,1050344,1361
"257","Zm00001d001797","2",1064875,1074378,9503
"258","Zm00001d001798","2",1081627,1084219,2592
"259","Zm00001d001799","2",1084435,1086981,2546
"260","Zm00001d001800","2",1166301,1168004,1703
"261","Zm00001d001802","2",1193993,1196785,2792
"262","Zm00001d001803","2",1245474,1250143,4669
"263","Zm00001d001804","2",1251628,1257162,5534
"264","Zm00001d001806","2",1258169,1262749,4580
"265","Zm00001d001807","2",1263985,1266617,2632
"266","Zm00001d001808","2",1268179,1271746,3567
"267","Zm00001d001809","2",1294932,1314979,20047
"268","Zm00001d001810","2",1296558,1296631,73
"269","Zm00001d001811","2",1331499,1334759,3260
"270","Zm00001d001812","2",1341011,1342402,1391
"271","Zm00001d001813","2",1413569,1415916,2347
"272","Zm00001d001814","2",1415886,1419759,3873
"273","Zm00001d001818","2",1432077,1434514,2437
"274","Zm00001d001819","2",1434757,1438488,3731
"275","Zm00001d001824","2",1527403,1528307,904
"276","Zm00001d001825","2",1530585,1535057,4472
"277","Zm00001d001826","2",1537721,1538940,1219
"278","Zm00001d001827","2",1539660,1545379,5719
"279","Zm00001d001828","2",1548360,1557145,8785
"280","Zm00001d001830","2",1559610,1563496,3886
"281","Zm00001d001831","2",1617066,1621351,4285
"282","Zm00001d001832","2",1623040,1623795,755
"283","Zm00001d001834","2",1632057,1640150,8093
"284","Zm00001d001837","2",1669402,1673203,3801
"285","Zm00001d001838","2",1675459,1681671,6212
"286","Zm00001d001839","2",1684341,1685108,767
"287","Zm00001d001841","2",1703673,1708071,4398
"288","Zm00001d001842","2",1708851,1710647,1796
"289","Zm00001d001843","2",1710917,1712421,1504
"290","Zm00001d001844","2",1713365,1718096,4731
"291","Zm00001d001845","2",1718904,1720502,1598
"292","Zm00001d001846","2",1767080,1772657,5577
"293","Zm00001d001847","2",1804763,1811060,6297
"294","Zm00001d001848","2",1811147,1839106,27959
"295","Zm00001d001849","2",1910247,1912431,2184
"296","Zm00001d001850","2",1914398,1919938,5540
"297","Zm00001d001852","2",1946284,1947096,812
"298","Zm00001d001855","2",1962797,1966211,3414
"299","Zm00001d001856","2",1967641,1971284,3643
"300","Zm00001d001857","2",2015253,2016537,1284
"301","Zm00001d001858","2",2031382,2034507,3125
"302","Zm00001d001859","2",2037381,2043847,6466
"303","Zm00001d001860","2",2044959,2048593,3634
"304","Zm00001d001861","2",2048654,2054225,5571
"305","Zm00001d001862","2",2057092,2057988,896
"306","Zm00001d001864","2",2066590,2076640,10050
"307","Zm00001d001865","2",2078887,2079669,782
"308","Zm00001d001866","2",2101181,2107171,5990
"309","Zm00001d001868","2",2108590,2111200,2610
"310","Zm00001d001869","2",2113706,2114950,1244
"311","Zm00001d001870","2",2118161,2120623,2462
"312","Zm00001d001871","2",2125929,2128596,2667
"313","Zm00001d001877","2",2221345,2224783,3438
"314","Zm00001d001879","2",2248003,2256074,8071
"315","Zm00001d001880","2",2260663,2262908,2245
"316","Zm00001d001881","2",2309633,2313192,3559
"317","Zm00001d001882","2",2322242,2329784,7542
"318","Zm00001d001883","2",2344925,2348541,3616
"319","Zm00001d001884","2",2349516,2354941,5425
"320","Zm00001d001885","2",2465136,2466474,1338
"321","Zm00001d001887","2",2472648,2482331,9683
"322","Zm00001d001894","2",2491277,2493876,2599
"323","Zm00001d001895","2",2500957,2506732,5775
"324","Zm00001d001896","2",2509567,2511414,1847
"325","Zm00001d001897","2",2547151,2550966,3815
"326","Zm00001d001898","2",2553344,2559999,6655
"327","Zm00001d001899","2",2559817,2561845,2028
"328","Zm00001d001900","2",2562960,2566600,3640
"329","Zm00001d001901","2",2608019,2612382,4363
"330","Zm00001d001902","2",2633360,2636659,3299
"331","Zm00001d001903","2",2637031,2639743,2712
"332","Zm00001d001904","2",2641205,2642025,820
"333","Zm00001d001905","2",2643026,2643694,668
"334","Zm00001d001906","2",2644303,2648830,4527
"335","Zm00001d001907","2",2687734,2688264,530
"336","Zm00001d001908","2",2689185,2697141,7956
"337","Zm00001d001909","2",2779225,2782637,3412
"338","Zm00001d001910","2",2781817,2787493,5676
"339","Zm00001d001913","2",2799861,2803017,3156
"340","Zm00001d001914","2",2803876,2808599,4723
"341","Zm00001d001915","2",2812723,2813940,1217
"342","Zm00001d001916","2",2815963,2819126,3163
"343","Zm00001d001917","2",2907763,2919247,11484
"344","Zm00001d001918","2",2919825,2923030,3205
"345","Zm00001d001923","2",2987346,3010796,23450
"346","Zm00001d001924","2",3022804,3026409,3605
"347","Zm00001d001927","2",3061215,3062758,1543
"348","Zm00001d001928","2",3067705,3079031,11326
"349","Zm00001d001929","2",3079742,3089142,9400
"350","Zm00001d001931","2",3092327,3092746,419
"351","Zm00001d001932","2",3093088,3096658,3570
"352","Zm00001d001933","2",3097287,3101632,4345
"353","Zm00001d001934","2",3102593,3103210,617
"354","Zm00001d001935","2",3107291,3112383,5092
"355","Zm00001d001936","2",3114134,3117099,2965
"356","Zm00001d001937","2",3119830,3123912,4082
"357","Zm00001d001939","2",3192067,3195814,3747
"358","Zm00001d001940","2",3197994,3200378,2384
"359","Zm00001d001941","2",3201231,3204850,3619
"360","Zm00001d001943","2",3240579,3242932,2353
"361","Zm00001d001945","2",3367272,3374233,6961
"362","Zm00001d001946","2",3397867,3402119,4252
"363","Zm00001d001947","2",3404971,3408793,3822
"364","Zm00001d001949","2",3418932,3422178,3246
"365","Zm00001d001951","2",3423831,3424283,452
"366","Zm00001d001952","2",3425808,3432915,7107
"367","Zm00001d001953","2",3438958,3444350,5392
"368","Zm00001d001959","2",3543770,3549932,6162
"369","Zm00001d001960","2",3559183,3560951,1768
"370","Zm00001d001962","2",3572227,3587792,15565
"371","Zm00001d001964","2",3600255,3600683,428
"372","Zm00001d001966","2",3608159,3611883,3724
"373","Zm00001d001967","2",3611983,3617038,5055
"374","Zm00001d001968","2",3659023,3665954,6931
"375","Zm00001d001970","2",3707673,3710056,2383
"376","Zm00001d001971","2",3712994,3715116,2122
"377","Zm00001d001972","2",3717523,3719516,1993
"378","Zm00001d001973","2",3728194,3732158,3964
"379","Zm00001d001974","2",3757695,3762861,5166
"380","Zm00001d001978","2",3798163,3823892,25729
"381","Zm00001d001979","2",3824107,3826568,2461
"382","Zm00001d001980","2",3876007,3880702,4695
"383","Zm00001d001982","2",3891754,3892380,626
"384","Zm00001d001983","2",3939649,3950608,10959
"385","Zm00001d001984","2",3952212,3954752,2540
"386","Zm00001d001987","2",3958780,3962322,3542
"387","Zm00001d001988","2",4000536,4005122,4586
"388","Zm00001d001989","2",4005779,4006470,691
"389","Zm00001d001990","2",4060451,4060702,251
"390","Zm00001d001993","2",4069761,4072922,3161
"391","Zm00001d001994","2",4073693,4075345,1652
"392","Zm00001d001995","2",4120298,4126906,6608
"393","Zm00001d001996","2",4127517,4130914,3397
"394","Zm00001d001997","2",4132333,4133568,1235
"395","Zm00001d001999","2",4137849,4142554,4705
"396","Zm00001d002000","2",4150293,4154404,4111
"397","Zm00001d002001","2",4156560,4157278,718
"398","Zm00001d002003","2",4166904,4173548,6644
"399","Zm00001d002004","2",4177227,4180187,2960
"400","Zm00001d002006","2",4277523,4284581,7058
"401","Zm00001d002011","2",4324615,4325127,512
"402","Zm00001d002012","2",4325836,4336209,10373
"403","Zm00001d002019","2",4431377,4433393,2016
"404","Zm00001d002020","2",4479323,4481492,2169
"405","Zm00001d002021","2",4539076,4539570,494
"406","Zm00001d002022","2",4547285,4552574,5289
"407","Zm00001d002023","2",4587796,4589602,1806
"408","Zm00001d002024","2",4593403,4606170,12767
"409","Zm00001d002025","2",4628845,4634985,6140
"410","Zm00001d002026","2",4638994,4644379,5385
"411","Zm00001d002027","2",4656652,4661418,4766
"412","Zm00001d002028","2",4663113,4666196,3083
"413","Zm00001d002029","2",4666311,4670063,3752
"414","Zm00001d002032","2",4794172,4806276,12104
"415","Zm00001d002033","2",4807574,4809601,2027
"416","Zm00001d002034","2",4808158,4814502,6344
"417","Zm00001d002035","2",4821035,4823880,2845
"418","Zm00001d002036","2",4846237,4851797,5560
"419","Zm00001d002037","2",4852459,4853805,1346
"420","Zm00001d002038","2",4861458,4865979,4521
"421","Zm00001d002039","2",4866662,4870005,3343
"422","Zm00001d002040","2",4898710,4912448,13738
"423","Zm00001d002043","2",4922293,4928470,6177
"424","Zm00001d002044","2",4929052,4931551,2499
"425","Zm00001d002046","2",4935892,4945247,9355
"426","Zm00001d002047","2",4945629,4945956,327
"427","Zm00001d002048","2",4954094,4955881,1787
"428","Zm00001d002051","2",5013826,5016702,2876
"429","Zm00001d002052","2",5018197,5021343,3146
"430","Zm00001d002053","2",5032026,5036327,4301
"431","Zm00001d002054","2",5036500,5039237,2737
"432","Zm00001d002055","2",5040212,5040760,548
"433","Zm00001d002056","2",5042321,5047668,5347
"434","Zm00001d002058","2",5047549,5056668,9119
"435","Zm00001d002063","2",5176357,5177787,1430
"436","Zm00001d002064","2",5191813,5195757,3944
"437","Zm00001d002065","2",5233170,5237006,3836
"438","Zm00001d002066","2",5267442,5268449,1007
"439","Zm00001d002067","2",5288503,5289625,1122
"440","Zm00001d002068","2",5314317,5320223,5906
"441","Zm00001d002069","2",5364541,5364798,257
"442","Zm00001d002072","2",5413401,5413963,562
"443","Zm00001d002075","2",5456239,5459958,3719
"444","Zm00001d002079","2",5505054,5505812,758
"445","Zm00001d002080","2",5508384,5514971,6587
"446","Zm00001d002082","2",5631271,5638279,7008
"447","Zm00001d002083","2",5670030,5670731,701
"448","Zm00001d002084","2",5711305,5715286,3981
"449","Zm00001d002085","2",5765101,5768935,3834
"450","Zm00001d002086","2",5771336,5775212,3876
"451","Zm00001d002087","2",5777235,5781446,4211
"452","Zm00001d002088","2",5784528,5785115,587
"453","Zm00001d002089","2",5787176,5800531,13355
"454","Zm00001d002090","2",5807146,5814918,7772
"455","Zm00001d002091","2",5846187,5852086,5899
"456","Zm00001d002093","2",5870323,5870748,425
"457","Zm00001d002094","2",5872428,5873039,611
"458","Zm00001d002095","2",5873612,5878134,4522
"459","Zm00001d002096","2",5947564,5948181,617
"460","Zm00001d002097","2",5954841,5956025,1184
"461","Zm00001d002098","2",5964116,5965554,1438
"462","Zm00001d002099","2",5969116,5978995,9879
"463","Zm00001d002100","2",5979615,5981068,1453
"464","Zm00001d002101","2",5980086,5981005,919
"465","Zm00001d002103","2",5981831,5989287,7456
"466","Zm00001d002104","2",5993672,5998425,4753
"467","Zm00001d002105","2",6001996,6002805,809
"468","Zm00001d002106","2",6005693,6006923,1230
"469","Zm00001d002108","2",6029954,6034459,4505
"470","Zm00001d002111","2",6046858,6051509,4651
"471","Zm00001d002112","2",6047566,6048192,626
"472","Zm00001d002113","2",6080286,6092137,11851
"473","Zm00001d002115","2",6097422,6101496,4074
"474","Zm00001d002119","2",6125333,6132308,6975
"475","Zm00001d002121","2",6144651,6145983,1332
"476","Zm00001d002122","2",6150635,6155146,4511
"477","Zm00001d002125","2",6290891,6302652,11761
"478","Zm00001d002126","2",6309156,6311132,1976
"479","Zm00001d002127","2",6316912,6319518,2606
"480","Zm00001d002128","2",6409519,6412809,3290
"481","Zm00001d002129","2",6412909,6421954,9045
"482","Zm00001d002130","2",6422180,6424987,2807
"483","Zm00001d002131","2",6428322,6429743,1421
"484","Zm00001d002134","2",6445382,6447909,2527
"485","Zm00001d002135","2",6449296,6454805,5509
"486","Zm00001d002136","2",6496902,6497840,938
"487","Zm00001d002137","2",6508338,6509353,1015
"488","Zm00001d002138","2",6519765,6520292,527
"489","Zm00001d002139","2",6550006,6551872,1866
"490","Zm00001d002140","2",6555540,6559295,3755
"491","Zm00001d002141","2",6563943,6574240,10297
"492","Zm00001d002143","2",6636877,6642835,5958
"493","Zm00001d002145","2",6741571,6747368,5797
"494","Zm00001d002146","2",6773725,6776694,2969
"495","Zm00001d002147","2",6777775,6781319,3544
"496","Zm00001d002148","2",6814316,6818482,4166
"497","Zm00001d002149","2",6819751,6827540,7789
"498","Zm00001d002150","2",6820212,6823142,2930
"499","Zm00001d002153","2",6864643,6869033,4390
"500","Zm00001d002154","2",6869196,6875212,6016
"501","Zm00001d002155","2",6874784,6877507,2723
"502","Zm00001d002156","2",6878316,6881153,2837
"503","Zm00001d002157","2",6883711,6885633,1922
"504","Zm00001d002158","2",6886753,6887019,266
"505","Zm00001d002159","2",6889076,6889357,281
"506","Zm00001d002160","2",6893694,6893936,242
"507","Zm00001d002161","2",6896084,6896404,320
"508","Zm00001d002163","2",6959896,6965024,5128
"509","Zm00001d002164","2",7002198,7013173,10975
"510","Zm00001d002166","2",7053614,7066223,12609
"511","Zm00001d002168","2",7088395,7092058,3663
"512","Zm00001d002169","2",7094303,7100353,6050
"513","Zm00001d002172","2",7110526,7119435,8909
"514","Zm00001d002174","2",7239862,7249041,9179
"515","Zm00001d002175","2",7264838,7267531,2693
"516","Zm00001d002178","2",7300454,7304565,4111
"517","Zm00001d002181","2",7399561,7402797,3236
"518","Zm00001d002184","2",7537954,7546246,8292
"519","Zm00001d002185","2",7546109,7550392,4283
"520","Zm00001d002186","2",7609522,7614852,5330
"521","Zm00001d002188","2",7621202,7622833,1631
"522","Zm00001d002190","2",7649644,7654759,5115
"523","Zm00001d002191","2",7656052,7658947,2895
"524","Zm00001d002192","2",7733220,7735393,2173
"525","Zm00001d002198","2",7833348,7838132,4784
"526","Zm00001d002199","2",8127537,8131717,4180
"527","Zm00001d002208","2",8254579,8257472,2893
"528","Zm00001d002211","2",8299226,8300593,1367
"529","Zm00001d002215","2",8316318,8318440,2122
"530","Zm00001d002216","2",8320447,8327199,6752
"531","Zm00001d002217","2",8330859,8333622,2763
"532","Zm00001d002218","2",8369292,8372532,3240
"533","Zm00001d002232","2",8449826,8451193,1367
"534","Zm00001d002234","2",8463903,8470216,6313
"535","Zm00001d002235","2",8470331,8477172,6841
"536","Zm00001d002236","2",8477325,8478126,801
"537","Zm00001d002238","2",8598935,8599837,902
"538","Zm00001d002239","2",8607518,8615365,7847
"539","Zm00001d002240","2",8679377,8682078,2701
"540","Zm00001d002241","2",8682679,8686126,3447
"541","Zm00001d002242","2",8689588,8693978,4390
"542","Zm00001d002243","2",8725742,8730885,5143
"543","Zm00001d002244","2",8756124,8760087,3963
"544","Zm00001d002246","2",8903282,8911060,7778
"545","Zm00001d002250","2",8963531,8979381,15850
"546","Zm00001d002252","2",8982467,8987139,4672
"547","Zm00001d002253","2",8988852,8989265,413
"548","Zm00001d002256","2",9055230,9066450,11220
"549","Zm00001d002257","2",9067800,9076270,8470
"550","Zm00001d002258","2",9081347,9084382,3035
"551","Zm00001d002259","2",9085387,9088906,3519
"552","Zm00001d002260","2",9089887,9093334,3447
"553","Zm00001d002261","2",9094317,9098515,4198
"554","Zm00001d002262","2",9128245,9128913,668
"555","Zm00001d002263","2",9129688,9132600,2912
"556","Zm00001d002266","2",9167395,9172599,5204
"557","Zm00001d002267","2",9174693,9176754,2061
"558","Zm00001d002269","2",9179578,9183463,3885
"559","Zm00001d002271","2",9188022,9190971,2949
"560","Zm00001d002272","2",9189239,9198503,9264
"561","Zm00001d002274","2",9274911,9278376,3465
"562","Zm00001d002275","2",9302717,9316367,13650
"563","Zm00001d002276","2",9317072,9317798,726
"564","Zm00001d002277","2",9318025,9322925,4900
"565","Zm00001d002278","2",9427786,9430561,2775
"566","Zm00001d002282","2",9498177,9500738,2561
"567","Zm00001d002283","2",9543623,9547268,3645
"568","Zm00001d002284","2",9548790,9551959,3169
"569","Zm00001d002286","2",9608759,9609793,1034
"570","Zm00001d002287","2",9614924,9619283,4359
"571","Zm00001d002288","2",9618257,9621258,3001
"572","Zm00001d002290","2",9665024,9665482,458
"573","Zm00001d002292","2",9672073,9678050,5977
"574","Zm00001d002296","2",9726108,9730374,4266
"575","Zm00001d002299","2",9741120,9769903,28783
"576","Zm00001d002301","2",9772239,9773464,1225
"577","Zm00001d002302","2",9791380,9800679,9299
"578","Zm00001d002307","2",10000201,10001504,1303
"579","Zm00001d002309","2",10015431,10018697,3266
"580","Zm00001d002311","2",10081231,10081527,296
"581","Zm00001d002312","2",10104632,10109656,5024
"582","Zm00001d002313","2",10111470,10132339,20869
"583","Zm00001d002314","2",10148440,10150441,2001
"584","Zm00001d002315","2",10153307,10157551,4244
"585","Zm00001d002316","2",10157520,10164911,7391
"586","Zm00001d002317","2",10169661,10178662,9001
"587","Zm00001d002319","2",10185427,10189131,3704
"588","Zm00001d002320","2",10188496,10192581,4085
"589","Zm00001d002322","2",10209511,10210704,1193
"590","Zm00001d002323","2",10211159,10217251,6092
"591","Zm00001d002324","2",10315095,10316729,1634
"592","Zm00001d002325","2",10315847,10324930,9083
"593","Zm00001d002326","2",10330318,10335434,5116
"594","Zm00001d002330","2",10460528,10470318,9790
"595","Zm00001d002331","2",10472013,10473100,1087
"596","Zm00001d002332","2",10488890,10496373,7483
"597","Zm00001d002333","2",10501219,10506639,5420
"598","Zm00001d002334","2",10508133,10512232,4099
"599","Zm00001d002338","2",10590637,10594877,4240
"600","Zm00001d002339","2",10595493,10598060,2567
"601","Zm00001d002340","2",10598321,10603491,5170
"602","Zm00001d002341","2",10606800,10609111,2311
"603","Zm00001d002342","2",10613065,10616088,3023
"604","Zm00001d002343","2",10631062,10633353,2291
"605","Zm00001d002344","2",10634372,10635782,1410
"606","Zm00001d002345","2",10635912,10638275,2363
"607","Zm00001d002346","2",10649171,10653316,4145
"608","Zm00001d002347","2",10657877,10658439,562
"609","Zm00001d002348","2",10671529,10673482,1953
"610","Zm00001d002349","2",10674198,10679341,5143
"611","Zm00001d002352","2",10726433,10728012,1579
"612","Zm00001d002353","2",10743536,10746206,2670
"613","Zm00001d002356","2",10765402,10767639,2237
"614","Zm00001d002357","2",10768115,10773054,4939
"615","Zm00001d002358","2",10781211,10785395,4184
"616","Zm00001d002359","2",10788145,10793291,5146
"617","Zm00001d002360","2",10838361,10839551,1190
"618","Zm00001d002362","2",10896918,10901679,4761
"619","Zm00001d002364","2",10906553,10907221,668
"620","Zm00001d002365","2",10946009,10947271,1262
"621","Zm00001d002366","2",10962726,10972143,9417
"622","Zm00001d002369","2",11162219,11166257,4038
"623","Zm00001d002370","2",11175858,11179354,3496
"624","Zm00001d002371","2",11316558,11320759,4201
"625","Zm00001d002372","2",11320826,11324747,3921
"626","Zm00001d002373","2",11329158,11336821,7663
"627","Zm00001d002374","2",11368790,11369293,503
"628","Zm00001d002377","2",11421796,11427495,5699
"629","Zm00001d002381","2",11533203,11535248,2045
"630","Zm00001d002382","2",11626085,11630946,4861
"631","Zm00001d002384","2",11634309,11636302,1993
"632","Zm00001d002385","2",11636551,11638732,2181
"633","Zm00001d002386","2",11639148,11646440,7292
"634","Zm00001d002387","2",11646470,11650790,4320
"635","Zm00001d002388","2",11653880,11664164,10284
"636","Zm00001d002389","2",11655754,11655827,73
"637","Zm00001d002390","2",11665354,11689105,23751
"638","Zm00001d002391","2",11807219,11812274,5055
"639","Zm00001d002394","2",11856131,11856352,221
"640","Zm00001d002395","2",11863804,11866661,2857
"641","Zm00001d002396","2",11915378,11934643,19265
"642","Zm00001d002402","2",11994467,11998302,3835
"643","Zm00001d002403","2",12026823,12027955,1132
"644","Zm00001d002405","2",12046655,12047909,1254
"645","Zm00001d002407","2",12108932,12111101,2169
"646","Zm00001d002410","2",12121541,12122951,1410
"647","Zm00001d002411","2",12163005,12164170,1165
"648","Zm00001d002412","2",12176650,12177961,1311
"649","Zm00001d002415","2",12238404,12242986,4582
"650","Zm00001d002416","2",12274892,12277870,2978
"651","Zm00001d002418","2",12281370,12292546,11176
"652","Zm00001d002419","2",12301020,12303212,2192
"653","Zm00001d002420","2",12304517,12307127,2610
"654","Zm00001d002421","2",12307811,12310300,2489
"655","Zm00001d002422","2",12314865,12318602,3737
"656","Zm00001d002423","2",12371064,12374599,3535
"657","Zm00001d002424","2",12400461,12403506,3045
"658","Zm00001d002425","2",12403956,12406380,2424
"659","Zm00001d002426","2",12406436,12411685,5249
"660","Zm00001d002428","2",12420571,12421886,1315
"661","Zm00001d002429","2",12492416,12496032,3616
"662","Zm00001d002430","2",12498275,12499252,977
"663","Zm00001d002431","2",12526599,12536542,9943
"664","Zm00001d002432","2",12555275,12557201,1926
"665","Zm00001d002433","2",12559556,12564353,4797
"666","Zm00001d002434","2",12564577,12567196,2619
"667","Zm00001d002436","2",12637877,12640584,2707
"668","Zm00001d002437","2",12642298,12647096,4798
"669","Zm00001d002439","2",12647395,12650397,3002
"670","Zm00001d002440","2",12651592,12657446,5854
"671","Zm00001d002441","2",12745249,12759139,13890
"672","Zm00001d002444","2",12838775,12841594,2819
"673","Zm00001d002446","2",12874323,12877241,2918
"674","Zm00001d002447","2",12900552,12905101,4549
"675","Zm00001d002449","2",12914091,12917068,2977
"676","Zm00001d002450","2",12952260,12954772,2512
"677","Zm00001d002451","2",12958512,12961105,2593
"678","Zm00001d002454","2",13187123,13189193,2070
"679","Zm00001d002455","2",13189111,13192192,3081
"680","Zm00001d002456","2",13192313,13197224,4911
"681","Zm00001d002457","2",13208227,13212415,4188
"682","Zm00001d002458","2",13289459,13291427,1968
"683","Zm00001d002462","2",13293936,13307750,13814
"684","Zm00001d002465","2",13315676,13317090,1414
"685","Zm00001d002467","2",13384119,13385589,1470
"686","Zm00001d002470","2",13494060,13494896,836
"687","Zm00001d002473","2",13527258,13529081,1823
"688","Zm00001d002475","2",13572658,13576059,3401
"689","Zm00001d002476","2",13590866,13592608,1742
"690","Zm00001d002477","2",13594542,13595337,795
"691","Zm00001d002478","2",13595708,13602314,6606
"692","Zm00001d002479","2",13604789,13605838,1049
"693","Zm00001d002480","2",13625553,13628166,2613
"694","Zm00001d002481","2",13628848,13633113,4265
"695","Zm00001d002483","2",13639859,13645975,6116
"696","Zm00001d002485","2",13754420,13757455,3035
"697","Zm00001d002488","2",13774186,13774704,518
"698","Zm00001d002489","2",13850163,13852195,2032
"699","Zm00001d002490","2",13898546,13900702,2156
"700","Zm00001d002491","2",13920511,13921731,1220
"701","Zm00001d002495","2",14010848,14011777,929
"702","Zm00001d002496","2",14014925,14016528,1603
"703","Zm00001d002497","2",14017543,14037044,19501
"704","Zm00001d002498","2",14080929,14082176,1247
"705","Zm00001d002499","2",14086379,14100162,13783
"706","Zm00001d002500","2",14128413,14128673,260
"707","Zm00001d002501","2",14135350,14155809,20459
"708","Zm00001d002503","2",14159122,14168043,8921
"709","Zm00001d002504","2",14173717,14179836,6119
"710","Zm00001d002505","2",14183518,14185176,1658
"711","Zm00001d002510","2",14288361,14306790,18429
"712","Zm00001d002511","2",14409918,14417121,7203
"713","Zm00001d002512","2",14429314,14430177,863
"714","Zm00001d002514","2",14444751,14447285,2534
"715","Zm00001d002517","2",14574049,14574579,530
"716","Zm00001d002519","2",14661462,14662655,1193
"717","Zm00001d002520","2",14677835,14678137,302
"718","Zm00001d002521","2",14685314,14685574,260
"719","Zm00001d002522","2",14689077,14689382,305
"720","Zm00001d002523","2",14724861,14725891,1030
"721","Zm00001d002530","2",14789774,14791788,2014
"722","Zm00001d002531","2",14794259,14796980,2721
"723","Zm00001d002532","2",14856275,14861080,4805
"724","Zm00001d002533","2",14891505,14892330,825
"725","Zm00001d002534","2",14896272,14906202,9930
"726","Zm00001d002535","2",14920048,14920569,521
"727","Zm00001d002536","2",14924202,14926277,2075
"728","Zm00001d002537","2",14982846,14985863,3017
"729","Zm00001d002538","2",14986698,14990518,3820
"730","Zm00001d002539","2",14990724,14993381,2657
"731","Zm00001d002540","2",14993653,14998930,5277
"732","Zm00001d002541","2",15001466,15005577,4111
"733","Zm00001d002542","2",15061406,15064460,3054
"734","Zm00001d002543","2",15068321,15068632,311
"735","Zm00001d002544","2",15091610,15099493,7883
"736","Zm00001d002545","2",15128166,15131434,3268
"737","Zm00001d002546","2",15134464,15135291,827
"738","Zm00001d002547","2",15136122,15136535,413
"739","Zm00001d002548","2",15188664,15192121,3457
"740","Zm00001d002549","2",15219899,15220932,1033
"741","Zm00001d002553","2",15281181,15287925,6744
"742","Zm00001d002560","2",15366760,15371345,4585
"743","Zm00001d002562","2",15448580,15449809,1229
"744","Zm00001d002564","2",15538202,15540469,2267
"745","Zm00001d002565","2",15543044,15543589,545
"746","Zm00001d002570","2",15641587,15643396,1809
"747","Zm00001d002572","2",15665826,15669829,4003
"748","Zm00001d002573","2",15738092,15739963,1871
"749","Zm00001d002576","2",15881659,15882300,641
"750","Zm00001d002577","2",15924926,15934512,9586
"751","Zm00001d002579","2",15965706,15968330,2624
"752","Zm00001d002580","2",15969358,15979838,10480
"753","Zm00001d002584","2",16080982,16082543,1561
"754","Zm00001d002585","2",16083702,16098502,14800
"755","Zm00001d002586","2",16086460,16086533,73
"756","Zm00001d002587","2",16199354,16200901,1547
"757","Zm00001d002589","2",16287469,16289962,2493
"758","Zm00001d002590","2",16293696,16294615,919
"759","Zm00001d002591","2",16303560,16305135,1575
"760","Zm00001d002592","2",16311191,16314804,3613
"761","Zm00001d002593","2",16317432,16320079,2647
"762","Zm00001d002594","2",16330379,16331572,1193
"763","Zm00001d002595","2",16390038,16394413,4375
"764","Zm00001d002597","2",16398418,16401870,3452
"765","Zm00001d002598","2",16406635,16410974,4339
"766","Zm00001d002599","2",16416605,16420200,3595
"767","Zm00001d002600","2",16448127,16456419,8292
"768","Zm00001d002601","2",16461905,16462911,1006
"769","Zm00001d002602","2",16532480,16547602,15122
"770","Zm00001d002603","2",16547586,16553128,5542
"771","Zm00001d002607","2",16643404,16644693,1289
"772","Zm00001d002609","2",16657272,16658702,1430
"773","Zm00001d002610","2",16708568,16710668,2100
"774","Zm00001d002611","2",16718233,16722717,4484
"775","Zm00001d002614","2",16769959,16777172,7213
"776","Zm00001d002615","2",16782263,16790203,7940
"777","Zm00001d002616","2",16820816,16824368,3552
"778","Zm00001d002617","2",16872323,16895026,22703
"779","Zm00001d002618","2",16960148,16960816,668
"780","Zm00001d002621","2",16980363,16988258,7895
"781","Zm00001d002624","2",17074071,17087531,13460
"782","Zm00001d002625","2",17149611,17153983,4372
"783","Zm00001d002626","2",17190893,17193599,2706
"784","Zm00001d002628","2",17231899,17234633,2734
"785","Zm00001d002629","2",17326658,17330523,3865
"786","Zm00001d002630","2",17337400,17339739,2339
"787","Zm00001d002631","2",17552472,17558357,5885
"788","Zm00001d002632","2",17558498,17560398,1900
"789","Zm00001d002634","2",17629763,17633357,3594
"790","Zm00001d002637","2",17661390,17667676,6286
"791","Zm00001d002639","2",17683040,17689113,6073
"792","Zm00001d002640","2",17710877,17738889,28012
"793","Zm00001d002641","2",17744486,17748716,4230
"794","Zm00001d002642","2",17897820,17900567,2747
"795","Zm00001d002644","2",17989991,18026177,36186
"796","Zm00001d002647","2",18055267,18058246,2979
"797","Zm00001d002649","2",18092188,18095739,3551
"798","Zm00001d002650","2",18176301,18185185,8884
"799","Zm00001d002654","2",18312495,18320006,7511
"800","Zm00001d002656","2",18450320,18475288,24968
"801","Zm00001d002658","2",18550415,18564104,13689
"802","Zm00001d002659","2",18564412,18572241,7829
"803","Zm00001d002661","2",18646955,18652496,5541
"804","Zm00001d002662","2",18693524,18697258,3734
"805","Zm00001d002663","2",18761204,18766099,4895
"806","Zm00001d002666","2",18778671,18785498,6827
"807","Zm00001d002668","2",18798594,18804133,5539
"808","Zm00001d002669","2",18830491,18834922,4431
"809","Zm00001d002670","2",18879527,18881482,1955
"810","Zm00001d002671","2",18894011,18895354,1343
"811","Zm00001d002673","2",18907323,18909618,2295
"812","Zm00001d002674","2",18929764,18933522,3758
"813","Zm00001d002675","2",19011894,19013937,2043
"814","Zm00001d002676","2",19014788,19019381,4593
"815","Zm00001d002677","2",19020750,19022675,1925
"816","Zm00001d002678","2",19071690,19082040,10350
"817","Zm00001d002679","2",19084219,19087860,3641
"818","Zm00001d002680","2",19117544,19121103,3559
"819","Zm00001d002681","2",19183683,19185743,2060
"820","Zm00001d002682","2",19196343,19207627,11284
"821","Zm00001d002683","2",19201398,19204062,2664
"822","Zm00001d002684","2",19208728,19211883,3155
"823","Zm00001d002685","2",19212994,19214316,1322
"824","Zm00001d002687","2",19283194,19284804,1610
"825","Zm00001d002688","2",19320228,19329846,9618
"826","Zm00001d002690","2",19342470,19344477,2007
"827","Zm00001d002693","2",19414196,19420375,6179
"828","Zm00001d002694","2",19421000,19428059,7059
"829","Zm00001d002695","2",19448223,19453968,5745
"830","Zm00001d002696","2",19454076,19456451,2375
"831","Zm00001d002700","2",19546182,19546508,326
"832","Zm00001d002703","2",19703228,19707789,4561
"833","Zm00001d002704","2",19808074,19812687,4613
"834","Zm00001d002705","2",19814237,19820680,6443
"835","Zm00001d002706","2",19822929,19844820,21891
"836","Zm00001d002707","2",19851191,19852588,1397
"837","Zm00001d002708","2",19911563,19919891,8328
"838","Zm00001d002709","2",19917091,19917163,72
"839","Zm00001d002711","2",19964764,19967921,3157
"840","Zm00001d002712","2",19968159,19971314,3155
"841","Zm00001d002713","2",20013197,20016905,3708
"842","Zm00001d002715","2",20189768,20229132,39364
"843","Zm00001d002716","2",20247253,20251280,4027
"844","Zm00001d002718","2",20400045,20402210,2165
"845","Zm00001d002720","2",20450472,20451062,590
"846","Zm00001d002721","2",20455119,20455520,401
"847","Zm00001d002725","2",20512393,20517378,4985
"848","Zm00001d002726","2",20519841,20526507,6666
"849","Zm00001d002727","2",20534714,20537080,2366
"850","Zm00001d002729","2",20591311,20592776,1465
"851","Zm00001d002730","2",20595453,20596460,1007
"852","Zm00001d002731","2",20630941,20631864,923
"853","Zm00001d002733","2",20711228,20711941,713
"854","Zm00001d002734","2",20715434,20716471,1037
"855","Zm00001d002735","2",20723662,20727230,3568
"856","Zm00001d002737","2",20918928,20924673,5745
"857","Zm00001d002739","2",21108536,21113578,5042
"858","Zm00001d002740","2",21190588,21191425,837
"859","Zm00001d002741","2",21195675,21197462,1787
"860","Zm00001d002742","2",21198460,21202631,4171
"861","Zm00001d002744","2",21315391,21316053,662
"862","Zm00001d002748","2",21386536,21386988,452
"863","Zm00001d002751","2",21483045,21493504,10459
"864","Zm00001d002755","2",21696975,21699949,2974
"865","Zm00001d002757","2",21809327,21812003,2676
"866","Zm00001d002758","2",21813079,21818936,5857
"867","Zm00001d002759","2",21822630,21825221,2591
"868","Zm00001d002760","2",21850071,21851141,1070
"869","Zm00001d002762","2",21962709,21963548,839
"870","Zm00001d002768","2",22071813,22072283,470
"871","Zm00001d002770","2",22115028,22130846,15818
"872","Zm00001d002771","2",22167851,22169500,1649
"873","Zm00001d002773","2",22213490,22214805,1315
"874","Zm00001d002774","2",22245609,22246070,461
"875","Zm00001d002775","2",22293997,22297250,3253
"876","Zm00001d002776","2",22298801,22300512,1711
"877","Zm00001d002777","2",22315895,22319436,3541
"878","Zm00001d002778","2",22322661,22328202,5541
"879","Zm00001d002781","2",22563741,22576668,12927
"880","Zm00001d002782","2",22573347,22574486,1139
"881","Zm00001d002783","2",22579624,22583090,3466
"882","Zm00001d002784","2",22584758,22586779,2021
"883","Zm00001d002787","2",22588333,22591980,3647
"884","Zm00001d002788","2",22629133,22631572,2439
"885","Zm00001d002789","2",22698603,22700750,2147
"886","Zm00001d002790","2",22704567,22708332,3765
"887","Zm00001d002791","2",22779785,22793547,13762
"888","Zm00001d002796","2",22828445,22832747,4302
"889","Zm00001d002797","2",22932597,22937057,4460
"890","Zm00001d002798","2",22943320,22943949,629
"891","Zm00001d002799","2",22972434,22973879,1445
"892","Zm00001d002801","2",23082802,23086615,3813
"893","Zm00001d002802","2",23113153,23114211,1058
"894","Zm00001d002803","2",23171752,23174036,2284
"895","Zm00001d002806","2",23197620,23201256,3636
"896","Zm00001d002810","2",23325349,23329634,4285
"897","Zm00001d002811","2",23362233,23364607,2374
"898","Zm00001d002812","2",23397758,23400810,3052
"899","Zm00001d002813","2",23401605,23402088,483
"900","Zm00001d002814","2",23462897,23483867,20970
"901","Zm00001d002815","2",23483486,23484612,1126
"902","Zm00001d002817","2",23520867,23532848,11981
"903","Zm00001d002819","2",23558116,23563958,5842
"904","Zm00001d002821","2",23664633,23664974,341
"905","Zm00001d002822","2",23764187,23768501,4314
"906","Zm00001d002823","2",23768922,23777897,8975
"907","Zm00001d002824","2",23887917,23893357,5440
"908","Zm00001d002825","2",23893346,23895673,2327
"909","Zm00001d002827","2",23925320,23947636,22316
"910","Zm00001d002828","2",24002536,24006073,3537
"911","Zm00001d002829","2",24060517,24062482,1965
"912","Zm00001d002830","2",24145621,24150188,4567
"913","Zm00001d002833","2",24243407,24244918,1511
"914","Zm00001d002834","2",24246750,24247433,683
"915","Zm00001d002835","2",24248332,24253472,5140
"916","Zm00001d002836","2",24258448,24264660,6212
"917","Zm00001d002837","2",24267675,24271324,3649
"918","Zm00001d002839","2",24273995,24275036,1041
"919","Zm00001d002842","2",24286536,24291225,4689
"920","Zm00001d002843","2",24293846,24295521,1675
"921","Zm00001d002844","2",24434066,24435780,1714
"922","Zm00001d002847","2",24476398,24480168,3770
"923","Zm00001d002848","2",24521026,24525482,4456
"924","Zm00001d002849","2",24661293,24661571,278
"925","Zm00001d002850","2",24662753,24665050,2297
"926","Zm00001d002851","2",24692916,24693944,1028
"927","Zm00001d002853","2",24768474,24772222,3748
"928","Zm00001d002854","2",24772447,24776140,3693
"929","Zm00001d002856","2",24825537,24826490,953
"930","Zm00001d002857","2",24834213,24837594,3381
"931","Zm00001d002859","2",24840671,24844622,3951
"932","Zm00001d002860","2",24851162,24854883,3721
"933","Zm00001d002862","2",24929317,24931138,1821
"934","Zm00001d002864","2",24960797,24963400,2603
"935","Zm00001d002865","2",24999708,25004968,5260
"936","Zm00001d002866","2",25019427,25022210,2783
"937","Zm00001d002867","2",25029642,25031000,1358
"938","Zm00001d002868","2",25060415,25060900,485
"939","Zm00001d002869","2",25137332,25139634,2302
"940","Zm00001d002871","2",25171106,25176433,5327
"941","Zm00001d002873","2",25237629,25241162,3533
"942","Zm00001d002874","2",25244154,25248590,4436
"943","Zm00001d002875","2",25265030,25268673,3643
"944","Zm00001d002876","2",25317220,25323118,5898
"945","Zm00001d002878","2",25538721,25541083,2362
"946","Zm00001d002879","2",25544333,25546588,2255
"947","Zm00001d002880","2",25546609,25550239,3630
"948","Zm00001d002881","2",25550488,25552575,2087
"949","Zm00001d002882","2",25583792,25585021,1229
"950","Zm00001d002884","2",25678578,25679222,644
"951","Zm00001d002885","2",25740464,25741423,959
"952","Zm00001d002887","2",25778027,25783796,5769
"953","Zm00001d002888","2",25868912,25870961,2049
"954","Zm00001d002889","2",25913912,25921339,7427
"955","Zm00001d002890","2",25943853,25944443,590
"956","Zm00001d002891","2",25944776,25949547,4771
"957","Zm00001d002893","2",26045493,26048383,2890
"958","Zm00001d002896","2",26117809,26122010,4201
"959","Zm00001d002899","2",26144895,26145908,1013
"960","Zm00001d002900","2",26181380,26182293,913
"961","Zm00001d002904","2",26291671,26297749,6078
"962","Zm00001d002905","2",26329482,26339000,9518
"963","Zm00001d002917","2",26418750,26428989,10239
"964","Zm00001d002919","2",26656581,26661097,4516
"965","Zm00001d002925","2",26726246,26737510,11264
"966","Zm00001d002928","2",26785403,26786596,1193
"967","Zm00001d002929","2",26786830,26791581,4751
"968","Zm00001d002930","2",27022075,27022859,784
"969","Zm00001d002933","2",27103956,27117008,13052
"970","Zm00001d002934","2",27119340,27120568,1228
"971","Zm00001d002936","2",27303853,27322287,18434
"972","Zm00001d002937","2",27420578,27426388,5810
"973","Zm00001d002938","2",27443632,27447830,4198
"974","Zm00001d002939","2",27520572,27523950,3378
"975","Zm00001d002940","2",27630673,27637515,6842
"976","Zm00001d002941","2",27635318,27638176,2858
"977","Zm00001d002942","2",27638886,27641667,2781
"978","Zm00001d002943","2",27769845,27779192,9347
"979","Zm00001d002944","2",27779321,27782869,3548
"980","Zm00001d002945","2",27817387,27825275,7888
"981","Zm00001d002946","2",27826085,27829690,3605
"982","Zm00001d002950","2",27929335,27938858,9523
"983","Zm00001d002951","2",27938014,27939971,1957
"984","Zm00001d002952","2",27986031,27988042,2011
"985","Zm00001d002953","2",27992445,27996965,4520
"986","Zm00001d002954","2",28067652,28084390,16738
"987","Zm00001d002955","2",28083781,28084488,707
"988","Zm00001d002956","2",28085003,28089074,4071
"989","Zm00001d002958","2",28096160,28097300,1140
"990","Zm00001d002959","2",28100145,28101324,1179
"991","Zm00001d002960","2",28153170,28153838,668
"992","Zm00001d002961","2",28154594,28157878,3284
"993","Zm00001d002962","2",28204145,28226242,22097
"994","Zm00001d002964","2",28238409,28241298,2889
"995","Zm00001d002966","2",28255272,28260128,4856
"996","Zm00001d002967","2",28260454,28267177,6723
"997","Zm00001d002968","2",28307399,28309598,2199
"998","Zm00001d002969","2",28312353,28313132,779
"999","Zm00001d002970","2",28350907,28355040,4133
"1000","Zm00001d002971","2",28374464,28376302,1838
"1001","Zm00001d002974","2",28495049,28499783,4734
"1002","Zm00001d002975","2",28572815,28573831,1016
"1003","Zm00001d002978","2",28623742,28633144,9402
"1004","Zm00001d002979","2",28743892,28747973,4081
"1005","Zm00001d002980","2",28748575,28751422,2847
"1006","Zm00001d002982","2",28866474,28867724,1250
"1007","Zm00001d002984","2",28885268,28886767,1499
"1008","Zm00001d002987","2",28909230,28916069,6839
"1009","Zm00001d002988","2",28918248,28928372,10124
"1010","Zm00001d002989","2",28930734,28935603,4869
"1011","Zm00001d002990","2",28951364,28952328,964
"1012","Zm00001d002991","2",28953673,28957755,4082
"1013","Zm00001d002992","2",28970624,28976728,6104
"1014","Zm00001d002993","2",28976470,28977417,947
"1015","Zm00001d002996","2",29020896,29023225,2329
"1016","Zm00001d002998","2",29040801,29042026,1225
"1017","Zm00001d002999","2",29175293,29178113,2820
"1018","Zm00001d003001","2",29183230,29183817,587
"1019","Zm00001d003002","2",29217388,29229681,12293
"1020","Zm00001d003003","2",29237928,29238593,665
"1021","Zm00001d003004","2",29241190,29244157,2967
"1022","Zm00001d003005","2",29268895,29269239,344
"1023","Zm00001d003006","2",29275928,29278172,2244
"1024","Zm00001d003007","2",29298796,29300202,1406
"1025","Zm00001d003009","2",29360438,29360992,554
"1026","Zm00001d003012","2",29398384,29404173,5789
"1027","Zm00001d003013","2",29406645,29411158,4513
"1028","Zm00001d003014","2",29439500,29461773,22273
"1029","Zm00001d003015","2",29467931,29470598,2667
"1030","Zm00001d003016","2",29538173,29541434,3261
"1031","Zm00001d003017","2",29552168,29562830,10662
"1032","Zm00001d003019","2",29627526,29635338,7812
"1033","Zm00001d003021","2",29666263,29670199,3936
"1034","Zm00001d003022","2",29676767,29677519,752
"1035","Zm00001d003024","2",29734149,29735130,981
"1036","Zm00001d003031","2",29817833,29830611,12778
"1037","Zm00001d003032","2",29828154,29828227,73
"1038","Zm00001d003033","2",29989844,29995440,5596
"1039","Zm00001d003034","2",30048389,30052767,4378
"1040","Zm00001d003035","2",30053282,30054643,1361
"1041","Zm00001d003037","2",30056009,30059224,3215
"1042","Zm00001d003038","2",30071279,30073794,2515
"1043","Zm00001d003039","2",30079480,30081862,2382
"1044","Zm00001d003040","2",30082227,30086375,4148
"1045","Zm00001d003041","2",30125952,30126353,401
"1046","Zm00001d003044","2",30142617,30148922,6305
"1047","Zm00001d003045","2",30208146,30219319,11173
"1048","Zm00001d003046","2",30271748,30282044,10296
"1049","Zm00001d003047","2",30304175,30307240,3065
"1050","Zm00001d003048","2",30338613,30343062,4449
"1051","Zm00001d003049","2",30345292,30349962,4670
"1052","Zm00001d003050","2",30386679,30388610,1931
"1053","Zm00001d003051","2",30447950,30449800,1850
"1054","Zm00001d003052","2",30534378,30537200,2822
"1055","Zm00001d003053","2",30541042,30542287,1245
"1056","Zm00001d003058","2",30708047,30711219,3172
"1057","Zm00001d003059","2",30712433,30716196,3763
"1058","Zm00001d003060","2",30793837,30795420,1583
"1059","Zm00001d003062","2",30966715,30969433,2718
"1060","Zm00001d003064","2",30987718,30989878,2160
"1061","Zm00001d003066","2",31034006,31038692,4686
"1062","Zm00001d003067","2",31067940,31072441,4501
"1063","Zm00001d003068","2",31084436,31085836,1400
"1064","Zm00001d003071","2",31121753,31124408,2655
"1065","Zm00001d003072","2",31124353,31128731,4378
"1066","Zm00001d003075","2",31147564,31162539,14975
"1067","Zm00001d003076","2",31280704,31285467,4763
"1068","Zm00001d003081","2",31389813,31393200,3387
"1069","Zm00001d003082","2",31496154,31501141,4987
"1070","Zm00001d003083","2",31519654,31526365,6711
"1071","Zm00001d003084","2",31605254,31607326,2072
"1072","Zm00001d003085","2",31707031,31709757,2726
"1073","Zm00001d003086","2",31747661,31753661,6000
"1074","Zm00001d003087","2",31795516,31819914,24398
"1075","Zm00001d003088","2",31840048,31841648,1600
"1076","Zm00001d003089","2",31848132,31854253,6121
"1077","Zm00001d003091","2",31872015,31873109,1094
"1078","Zm00001d003093","2",31949502,31955881,6379
"1079","Zm00001d003096","2",31980064,31980747,683
"1080","Zm00001d003098","2",32021727,32024495,2768
"1081","Zm00001d003099","2",32030522,32034880,4358
"1082","Zm00001d003101","2",32083280,32088714,5434
"1083","Zm00001d003102","2",32088958,32090373,1415
"1084","Zm00001d003103","2",32308213,32309775,1562
"1085","Zm00001d003104","2",32315043,32316371,1328
"1086","Zm00001d003106","2",32427063,32432492,5429
"1087","Zm00001d003107","2",32462211,32463192,981
"1088","Zm00001d003108","2",32464010,32470101,6091
"1089","Zm00001d003109","2",32535157,32539571,4414
"1090","Zm00001d003110","2",32540978,32544536,3558
"1091","Zm00001d003112","2",32662030,32670568,8538
"1092","Zm00001d003114","2",32677543,32684692,7149
"1093","Zm00001d003115","2",32704373,32716660,12287
"1094","Zm00001d003116","2",32716813,32735908,19095
"1095","Zm00001d003118","2",32787350,32790222,2872
"1096","Zm00001d003119","2",32817694,32825886,8192
"1097","Zm00001d003123","2",32959428,32965922,6494
"1098","Zm00001d003124","2",33099050,33102379,3329
"1099","Zm00001d003125","2",33105163,33110061,4898
"1100","Zm00001d003127","2",33155003,33157011,2008
"1101","Zm00001d003128","2",33305015,33307758,2743
"1102","Zm00001d003129","2",33327793,33333386,5593
"1103","Zm00001d003135","2",33388427,33389276,849
"1104","Zm00001d003136","2",33389671,33391070,1399
"1105","Zm00001d003138","2",33424428,33425137,709
"1106","Zm00001d003142","2",33455883,33457903,2020
"1107","Zm00001d003143","2",33536664,33544277,7613
"1108","Zm00001d003146","2",33736756,33746475,9719
"1109","Zm00001d003147","2",33764519,33769876,5357
"1110","Zm00001d003148","2",33774188,33778057,3869
"1111","Zm00001d003149","2",33778157,33782681,4524
"1112","Zm00001d003151","2",33845079,33848826,3747
"1113","Zm00001d003152","2",33858418,33859435,1017
"1114","Zm00001d003153","2",33916456,33919535,3079
"1115","Zm00001d003155","2",33956257,33959338,3081
"1116","Zm00001d003157","2",33981493,33984783,3290
"1117","Zm00001d003158","2",33988459,33990760,2301
"1118","Zm00001d003159","2",33997633,33999503,1870
"1119","Zm00001d003160","2",34006199,34008593,2394
"1120","Zm00001d003161","2",34011466,34013265,1799
"1121","Zm00001d003162","2",34080161,34081769,1608
"1122","Zm00001d003163","2",34125296,34129372,4076
"1123","Zm00001d003164","2",34130488,34131507,1019
"1124","Zm00001d003166","2",34247761,34278227,30466
"1125","Zm00001d003167","2",34338012,34339444,1432
"1126","Zm00001d003168","2",34340843,34342956,2113
"1127","Zm00001d003172","2",34447811,34448392,581
"1128","Zm00001d003174","2",34501885,34505176,3291
"1129","Zm00001d003175","2",34558843,34560021,1178
"1130","Zm00001d003176","2",34606365,34611108,4743
"1131","Zm00001d003179","2",34710391,34713775,3384
"1132","Zm00001d003180","2",34882973,34887627,4654
"1133","Zm00001d003181","2",34889630,34892415,2785
"1134","Zm00001d003182","2",34897464,34897946,482
"1135","Zm00001d003183","2",34929927,34931427,1500
"1136","Zm00001d003184","2",34970572,34972451,1879
"1137","Zm00001d003186","2",35030790,35032650,1860
"1138","Zm00001d003187","2",35035258,35037644,2386
"1139","Zm00001d003190","2",35066062,35067313,1251
"1140","Zm00001d003192","2",35226569,35229786,3217
"1141","Zm00001d003193","2",35243617,35247317,3700
"1142","Zm00001d003194","2",35276371,35286449,10078
"1143","Zm00001d003195","2",35306395,35307301,906
"1144","Zm00001d003196","2",35307945,35310918,2973
"1145","Zm00001d003197","2",35313291,35313959,668
"1146","Zm00001d003198","2",35342453,35387667,45214
"1147","Zm00001d003199","2",35413857,35417683,3826
"1148","Zm00001d003200","2",35415696,35425758,10062
"1149","Zm00001d003202","2",35512929,35515267,2338
"1150","Zm00001d003203","2",35515788,35545102,29314
"1151","Zm00001d003205","2",35782743,35783705,962
"1152","Zm00001d003207","2",35907483,35926289,18806
"1153","Zm00001d003209","2",36039302,36040798,1496
"1154","Zm00001d003212","2",36102369,36105641,3272
"1155","Zm00001d003213","2",36131309,36140421,9112
"1156","Zm00001d003214","2",36238478,36251590,13112
"1157","Zm00001d003219","2",36446799,36447359,560
"1158","Zm00001d003220","2",36506464,36511337,4873
"1159","Zm00001d003222","2",36694332,36699139,4807
"1160","Zm00001d003223","2",36704203,36704982,779
"1161","Zm00001d003224","2",36774907,36779481,4574
"1162","Zm00001d003226","2",36779809,36782444,2635
"1163","Zm00001d003227","2",36786174,36790595,4421
"1164","Zm00001d003228","2",36827859,36829876,2017
"1165","Zm00001d003229","2",36851196,36864553,13357
"1166","Zm00001d003234","2",37154690,37155247,557
"1167","Zm00001d003239","2",37358483,37359061,578
"1168","Zm00001d003242","2",37432377,37436933,4556
"1169","Zm00001d003245","2",37571373,37573295,1922
"1170","Zm00001d003246","2",37617116,37637797,20681
"1171","Zm00001d003247","2",37815902,37818424,2522
"1172","Zm00001d003248","2",37818750,37828725,9975
"1173","Zm00001d003249","2",37857061,37859709,2648
"1174","Zm00001d003250","2",37946068,37950408,4340
"1175","Zm00001d003251","2",37951061,37953591,2530
"1176","Zm00001d003252","2",37956894,37965162,8268
"1177","Zm00001d003254","2",38063917,38068896,4979
"1178","Zm00001d003255","2",38076810,38079659,2849
"1179","Zm00001d003256","2",38086415,38091164,4749
"1180","Zm00001d003257","2",38091293,38098388,7095
"1181","Zm00001d003258","2",38097924,38102928,5004
"1182","Zm00001d003259","2",38105379,38121803,16424
"1183","Zm00001d003261","2",38257954,38268879,10925
"1184","Zm00001d003262","2",38268766,38273283,4517
"1185","Zm00001d003264","2",38333787,38335419,1632
"1186","Zm00001d003265","2",38342885,38347402,4517
"1187","Zm00001d003266","2",38348454,38352850,4396
"1188","Zm00001d003267","2",38396777,38402590,5813
"1189","Zm00001d003268","2",38416096,38418903,2807
"1190","Zm00001d003269","2",38421379,38422077,698
"1191","Zm00001d003271","2",38437219,38439671,2452
"1192","Zm00001d003272","2",38446414,38447769,1355
"1193","Zm00001d003273","2",38557841,38560622,2781
"1194","Zm00001d003274","2",38557923,38559861,1938
"1195","Zm00001d003275","2",38561318,38564297,2979
"1196","Zm00001d003276","2",38563122,38565277,2155
"1197","Zm00001d003277","2",38572522,38576707,4185
"1198","Zm00001d003278","2",38577223,38590549,13326
"1199","Zm00001d003279","2",38586400,38587859,1459
"1200","Zm00001d003281","2",38668117,38670450,2333
"1201","Zm00001d003282","2",38683613,38684065,452
"1202","Zm00001d003283","2",38745725,38747760,2035
"1203","Zm00001d003284","2",38748934,38756211,7277
"1204","Zm00001d003287","2",38811050,38812608,1558
"1205","Zm00001d003288","2",38812902,38817270,4368
"1206","Zm00001d003289","2",38818381,38832276,13895
"1207","Zm00001d003290","2",38837653,38841384,3731
"1208","Zm00001d003291","2",38955003,38958609,3606
"1209","Zm00001d003292","2",38985990,38989290,3300
"1210","Zm00001d003293","2",39094599,39100476,5877
"1211","Zm00001d003294","2",39107875,39110040,2165
"1212","Zm00001d003297","2",39113486,39115734,2248
"1213","Zm00001d003298","2",39213977,39217124,3147
"1214","Zm00001d003301","2",39389095,39393280,4185
"1215","Zm00001d003302","2",39394754,39401528,6774
"1216","Zm00001d003303","2",39430189,39437046,6857
"1217","Zm00001d003308","2",39659891,39663833,3942
"1218","Zm00001d003309","2",39693111,39700373,7262
"1219","Zm00001d003310","2",39700454,39702802,2348
"1220","Zm00001d003311","2",39752127,39753847,1720
"1221","Zm00001d003312","2",39759791,39762588,2797
"1222","Zm00001d003313","2",39856245,39858061,1816
"1223","Zm00001d003315","2",39889306,39890655,1349
"1224","Zm00001d003319","2",40110400,40119860,9460
"1225","Zm00001d003320","2",40126366,40127328,962
"1226","Zm00001d003321","2",40129192,40131783,2591
"1227","Zm00001d003322","2",40134430,40141796,7366
"1228","Zm00001d003328","2",40259439,40260926,1487
"1229","Zm00001d003329","2",40262906,40272959,10053
"1230","Zm00001d003331","2",40361661,40367040,5379
"1231","Zm00001d003332","2",40416855,40418197,1342
"1232","Zm00001d003333","2",40554847,40561652,6805
"1233","Zm00001d003334","2",40564802,40567943,3141
"1234","Zm00001d003335","2",40605988,40607442,1454
"1235","Zm00001d003336","2",40620430,40625476,5046
"1236","Zm00001d003343","2",40922658,40925501,2843
"1237","Zm00001d003344","2",41014327,41014884,557
"1238","Zm00001d003345","2",41017793,41019879,2086
"1239","Zm00001d003346","2",41020781,41020960,179
"1240","Zm00001d003347","2",41022707,41025532,2825
"1241","Zm00001d003348","2",41026233,41026306,73
"1242","Zm00001d003349","2",41028415,41031913,3498
"1243","Zm00001d003352","2",41240621,41247759,7138
"1244","Zm00001d003354","2",41358363,41370652,12289
"1245","Zm00001d003356","2",41420700,41432968,12268
"1246","Zm00001d003358","2",41528347,41529687,1340
"1247","Zm00001d003365","2",41647913,41648861,948
"1248","Zm00001d003366","2",41650584,41653382,2798
"1249","Zm00001d003368","2",41697065,41704348,7283
"1250","Zm00001d003369","2",41782004,41787090,5086
"1251","Zm00001d003372","2",41979302,41992353,13051
"1252","Zm00001d003373","2",42049274,42060770,11496
"1253","Zm00001d003374","2",42062511,42064978,2467
"1254","Zm00001d003376","2",42138897,42145159,6262
"1255","Zm00001d003377","2",42140112,42141719,1607
"1256","Zm00001d003378","2",42148337,42154340,6003
"1257","Zm00001d003379","2",42234465,42235544,1079
"1258","Zm00001d003380","2",42239268,42240320,1052
"1259","Zm00001d003381","2",42343911,42345140,1229
"1260","Zm00001d003382","2",42345836,42356555,10719
"1261","Zm00001d003386","2",42496182,42497972,1790
"1262","Zm00001d003390","2",42586358,42587392,1034
"1263","Zm00001d003392","2",42617018,42618010,992
"1264","Zm00001d003393","2",42619363,42625402,6039
"1265","Zm00001d003394","2",42771475,42773676,2201
"1266","Zm00001d003395","2",42789053,42794069,5016
"1267","Zm00001d003398","2",43019871,43020779,908
"1268","Zm00001d003399","2",43038974,43041805,2831
"1269","Zm00001d003400","2",43084830,43087036,2206
"1270","Zm00001d003401","2",43088493,43092367,3874
"1271","Zm00001d003404","2",43285525,43287246,1721
"1272","Zm00001d003405","2",43287051,43288011,960
"1273","Zm00001d003406","2",43299785,43302959,3174
"1274","Zm00001d003408","2",43542336,43543301,965
"1275","Zm00001d003409","2",43566862,43569682,2820
"1276","Zm00001d003411","2",43577688,43579327,1639
"1277","Zm00001d003412","2",43580336,43582878,2542
"1278","Zm00001d003414","2",43705185,43706945,1760
"1279","Zm00001d003415","2",43716790,43719931,3141
"1280","Zm00001d003422","2",43834579,43837696,3117
"1281","Zm00001d003423","2",43898277,43902131,3854
"1282","Zm00001d003425","2",43966118,43966495,377
"1283","Zm00001d003426","2",43975014,43982419,7405
"1284","Zm00001d003427","2",43982572,43986370,3798
"1285","Zm00001d003428","2",44077342,44098761,21419
"1286","Zm00001d003430","2",44199153,44200628,1475
"1287","Zm00001d003431","2",44205146,44207351,2205
"1288","Zm00001d003432","2",44207306,44209695,2389
"1289","Zm00001d003434","2",44260748,44263686,2938
"1290","Zm00001d003435","2",44315725,44316616,891
"1291","Zm00001d003438","2",44457553,44459430,1877
"1292","Zm00001d003439","2",44471631,44475463,3832
"1293","Zm00001d003445","2",44609738,44613698,3960
"1294","Zm00001d003446","2",44617641,44625098,7457
"1295","Zm00001d003447","2",44627755,44628030,275
"1296","Zm00001d003448","2",44633731,44639141,5410
"1297","Zm00001d003452","2",44831108,44832831,1723
"1298","Zm00001d003457","2",44953548,44954798,1250
"1299","Zm00001d003459","2",45018395,45021399,3004
"1300","Zm00001d003460","2",45024147,45033628,9481
"1301","Zm00001d003462","2",45036162,45039212,3050
"1302","Zm00001d003464","2",45202980,45209348,6368
"1303","Zm00001d003468","2",45234206,45238299,4093
"1304","Zm00001d003470","2",45281416,45286675,5259
"1305","Zm00001d003471","2",45287341,45292164,4823
"1306","Zm00001d003472","2",45337670,45341752,4082
"1307","Zm00001d003473","2",45338050,45343157,5107
"1308","Zm00001d003476","2",45418320,45425555,7235
"1309","Zm00001d003477","2",45426581,45430349,3768
"1310","Zm00001d003483","2",45547626,45549695,2069
"1311","Zm00001d003491","2",45881348,45890062,8714
"1312","Zm00001d003492","2",45893363,45895300,1937
"1313","Zm00001d003493","2",46024387,46026629,2242
"1314","Zm00001d003494","2",46044776,46046493,1717
"1315","Zm00001d003495","2",46044805,46059398,14593
"1316","Zm00001d003496","2",46050675,46052185,1510
"1317","Zm00001d003499","2",46118394,46119560,1166
"1318","Zm00001d003500","2",46120248,46122764,2516
"1319","Zm00001d003501","2",46132324,46134141,1817
"1320","Zm00001d003502","2",46156330,46162045,5715
"1321","Zm00001d003504","2",46187577,46189691,2114
"1322","Zm00001d003505","2",46190513,46195170,4657
"1323","Zm00001d003508","2",46235133,46238916,3783
"1324","Zm00001d003509","2",46242467,46247628,5161
"1325","Zm00001d003511","2",46292459,46295172,2713
"1326","Zm00001d003512","2",46296356,46301011,4655
"1327","Zm00001d003514","2",46327792,46328178,386
"1328","Zm00001d003515","2",46328464,46330364,1900
"1329","Zm00001d003516","2",46377970,46383438,5468
"1330","Zm00001d003518","2",46383763,46392581,8818
"1331","Zm00001d003520","2",46552579,46554582,2003
"1332","Zm00001d003522","2",46610469,46612649,2180
"1333","Zm00001d003523","2",46651353,46652542,1189
"1334","Zm00001d003524","2",46658256,46660165,1909
"1335","Zm00001d003525","2",46712428,46719121,6693
"1336","Zm00001d003533","2",47105187,47109372,4185
"1337","Zm00001d003534","2",47125747,47127543,1796
"1338","Zm00001d003538","2",47329222,47329644,422
"1339","Zm00001d003539","2",47409183,47414816,5633
"1340","Zm00001d003540","2",47414810,47417311,2501
"1341","Zm00001d003543","2",47658250,47659893,1643
"1342","Zm00001d003544","2",47662912,47664562,1650
"1343","Zm00001d003545","2",47671245,47671586,341
"1344","Zm00001d003546","2",47674141,47682191,8050
"1345","Zm00001d003549","2",47683309,47684466,1157
"1346","Zm00001d003551","2",47842659,47843877,1218
"1347","Zm00001d003552","2",47856909,47857950,1041
"1348","Zm00001d003553","2",47859916,47861739,1823
"1349","Zm00001d003555","2",47886593,47890119,3526
"1350","Zm00001d003556","2",47890233,47901925,11692
"1351","Zm00001d003559","2",48066763,48071352,4589
"1352","Zm00001d003566","2",48214656,48216669,2013
"1353","Zm00001d003567","2",48285278,48287291,2013
"1354","Zm00001d003572","2",48477271,48491185,13914
"1355","Zm00001d003577","2",48807618,48810084,2466
"1356","Zm00001d003578","2",48812144,48818283,6139
"1357","Zm00001d003579","2",48821524,48822197,673
"1358","Zm00001d003584","2",49052848,49056045,3197
"1359","Zm00001d003588","2",49077123,49078723,1600
"1360","Zm00001d003589","2",49078847,49082055,3208
"1361","Zm00001d003590","2",49123838,49128914,5076
"1362","Zm00001d003592","2",49141957,49146429,4472
"1363","Zm00001d003593","2",49227070,49227546,476
"1364","Zm00001d003598","2",49332907,49336119,3212
"1365","Zm00001d003600","2",49392293,49394518,2225
"1366","Zm00001d003601","2",49476573,49482029,5456
"1367","Zm00001d003602","2",49523237,49528762,5525
"1368","Zm00001d003603","2",49591583,49595579,3996
"1369","Zm00001d003605","2",49736613,49737682,1069
"1370","Zm00001d003606","2",49809214,49811410,2196
"1371","Zm00001d003607","2",49876647,49878832,2185
"1372","Zm00001d003610","2",50101247,50101795,548
"1373","Zm00001d003611","2",50109018,50117538,8520
"1374","Zm00001d003612","2",50120976,50124154,3178
"1375","Zm00001d003613","2",50128295,50141133,12838
"1376","Zm00001d003615","2",50414664,50419883,5219
"1377","Zm00001d003616","2",50474547,50483901,9354
"1378","Zm00001d003617","2",50619615,50621030,1415
"1379","Zm00001d003618","2",50621259,50624060,2801
"1380","Zm00001d003619","2",50632433,50636388,3955
"1381","Zm00001d003620","2",50644875,50649408,4533
"1382","Zm00001d003621","2",50696420,50706825,10405
"1383","Zm00001d003630","2",51047805,51050712,2907
"1384","Zm00001d003632","2",51106489,51111751,5262
"1385","Zm00001d003636","2",51259710,51262775,3065
"1386","Zm00001d003640","2",51340087,51353092,13005
"1387","Zm00001d003641","2",51368887,51371934,3047
"1388","Zm00001d003643","2",51509991,51522514,12523
"1389","Zm00001d003644","2",51528732,51562581,33849
"1390","Zm00001d003645","2",51732292,51733194,902
"1391","Zm00001d003646","2",51778257,51782320,4063
"1392","Zm00001d003648","2",51941038,51950006,8968
"1393","Zm00001d003649","2",51951526,51956734,5208
"1394","Zm00001d003651","2",52000876,52001574,698
"1395","Zm00001d003652","2",52004247,52009839,5592
"1396","Zm00001d003653","2",52010119,52013231,3112
"1397","Zm00001d003654","2",52014446,52017333,2887
"1398","Zm00001d003655","2",52478308,52539167,60859
"1399","Zm00001d003656","2",52523278,52526138,2860
"1400","Zm00001d003657","2",52665039,52666535,1496
"1401","Zm00001d003658","2",52836039,52839059,3020
"1402","Zm00001d003659","2",52839413,52844416,5003
"1403","Zm00001d003660","2",52986473,52987652,1179
"1404","Zm00001d003663","2",53137983,53140425,2442
"1405","Zm00001d003664","2",53140745,53145188,4443
"1406","Zm00001d003666","2",53218426,53220162,1736
"1407","Zm00001d003667","2",53266869,53273843,6974
"1408","Zm00001d003668","2",53273917,53276232,2315
"1409","Zm00001d003669","2",53281649,53283425,1776
"1410","Zm00001d003670","2",53322467,53329733,7266
"1411","Zm00001d003671","2",53371977,53375140,3163
"1412","Zm00001d003672","2",53480032,53483738,3706
"1413","Zm00001d003673","2",53484601,53488150,3549
"1414","Zm00001d003674","2",53590569,53593753,3184
"1415","Zm00001d003675","2",53664164,53668648,4484
"1416","Zm00001d003677","2",53849188,53854880,5692
"1417","Zm00001d003678","2",53856157,53860074,3917
"1418","Zm00001d003679","2",53861070,53867710,6640
"1419","Zm00001d003680","2",53960459,53963477,3018
"1420","Zm00001d003682","2",54072898,54075522,2624
"1421","Zm00001d003683","2",54203763,54206818,3055
"1422","Zm00001d003684","2",54268746,54272649,3903
"1423","Zm00001d003685","2",54347998,54351273,3275
"1424","Zm00001d003689","2",54514569,54515201,632
"1425","Zm00001d003690","2",54515841,54521636,5795
"1426","Zm00001d003693","2",54633543,54636161,2618
"1427","Zm00001d003701","2",55227577,55229673,2096
"1428","Zm00001d003707","2",55659655,55661242,1587
"1429","Zm00001d003709","2",55723782,55724426,644
"1430","Zm00001d003710","2",55847268,55852437,5169
"1431","Zm00001d003712","2",55894819,55896267,1448
"1432","Zm00001d003713","2",56082381,56097514,15133
"1433","Zm00001d003715","2",56141056,56143346,2290
"1434","Zm00001d003718","2",56318537,56320007,1470
"1435","Zm00001d003719","2",56339769,56340791,1022
"1436","Zm00001d003724","2",56539325,56541793,2468
"1437","Zm00001d003725","2",56544752,56545162,410
"1438","Zm00001d003726","2",56552189,56555570,3381
"1439","Zm00001d003728","2",56632216,56643296,11080
"1440","Zm00001d003729","2",56645455,56647672,2217
"1441","Zm00001d003730","2",56683255,56683907,652
"1442","Zm00001d003736","2",56946870,56951217,4347
"1443","Zm00001d003742","2",56993829,56999447,5618
"1444","Zm00001d003743","2",57065505,57066452,947
"1445","Zm00001d003749","2",57471738,57474116,2378
"1446","Zm00001d003750","2",57475947,57481107,5160
"1447","Zm00001d003751","2",57534253,57535567,1314
"1448","Zm00001d003754","2",57605144,57609429,4285
"1449","Zm00001d003755","2",57722583,57731864,9281
"1450","Zm00001d003756","2",57732693,57733740,1047
"1451","Zm00001d003757","2",57740876,57741842,966
"1452","Zm00001d003760","2",57804441,57805296,855
"1453","Zm00001d003761","2",57847903,57848406,503
"1454","Zm00001d003762","2",57854202,57855561,1359
"1455","Zm00001d003763","2",57889151,57889933,782
"1456","Zm00001d003765","2",57965609,57967414,1805
"1457","Zm00001d003768","2",58219346,58220064,718
"1458","Zm00001d003770","2",58263412,58265197,1785
"1459","Zm00001d003773","2",58372676,58378660,5984
"1460","Zm00001d003774","2",58484692,58490045,5353
"1461","Zm00001d003775","2",58629387,58630133,746
"1462","Zm00001d003776","2",58876332,58879327,2995
"1463","Zm00001d003778","2",58999294,59005449,6155
"1464","Zm00001d003779","2",59142984,59144327,1343
"1465","Zm00001d003781","2",59180386,59182787,2401
"1466","Zm00001d003782","2",59184173,59186510,2337
"1467","Zm00001d003784","2",59226304,59229740,3436
"1468","Zm00001d003785","2",59311672,59314891,3219
"1469","Zm00001d003786","2",59355125,59361028,5903
"1470","Zm00001d003789","2",59384911,59386717,1806
"1471","Zm00001d003791","2",59470932,59473694,2762
"1472","Zm00001d003793","2",59492106,59495512,3406
"1473","Zm00001d003796","2",59683445,59685363,1918
"1474","Zm00001d003797","2",59723085,59723552,467
"1475","Zm00001d003800","2",59826668,59845512,18844
"1476","Zm00001d003801","2",59830814,59835635,4821
"1477","Zm00001d003804","2",59926707,59928357,1650
"1478","Zm00001d003807","2",60097893,60108261,10368
"1479","Zm00001d003808","2",60146144,60147253,1109
"1480","Zm00001d003809","2",60195374,60198079,2705
"1481","Zm00001d003810","2",60202020,60203990,1970
"1482","Zm00001d003812","2",60529115,60533158,4043
"1483","Zm00001d003813","2",60626145,60637075,10930
"1484","Zm00001d003817","2",60752443,60763179,10736
"1485","Zm00001d003819","2",60851289,60852758,1469
"1486","Zm00001d003820","2",60886292,60886826,534
"1487","Zm00001d003822","2",60917100,60919425,2325
"1488","Zm00001d003823","2",60927051,60928640,1589
"1489","Zm00001d003825","2",61099310,61125886,26576
"1490","Zm00001d003826","2",61141665,61142303,638
"1491","Zm00001d003828","2",61149562,61150592,1030
"1492","Zm00001d003829","2",61176346,61177380,1034
"1493","Zm00001d003830","2",61203599,61204879,1280
"1494","Zm00001d003833","2",61457812,61460435,2623
"1495","Zm00001d003836","2",61532097,61537459,5362
"1496","Zm00001d003839","2",61795478,61801377,5899
"1497","Zm00001d003840","2",61892174,61893274,1100
"1498","Zm00001d003841","2",61914406,61915837,1431
"1499","Zm00001d003846","2",61944273,61948903,4630
"1500","Zm00001d003847","2",61984604,61991864,7260
"1501","Zm00001d003848","2",62255456,62263760,8304
"1502","Zm00001d003850","2",62448255,62449800,1545
"1503","Zm00001d003851","2",62503425,62507705,4280
"1504","Zm00001d003852","2",62770637,62772650,2013
"1505","Zm00001d003855","2",62855302,62860552,5250
"1506","Zm00001d003856","2",62901361,62902707,1346
"1507","Zm00001d003857","2",63033369,63037024,3655
"1508","Zm00001d003860","2",63424527,63427091,2564
"1509","Zm00001d003861","2",63431223,63436171,4948
"1510","Zm00001d003863","2",63595647,63598890,3243
"1511","Zm00001d003864","2",63709239,63723748,14509
"1512","Zm00001d003865","2",63887374,63888748,1374
"1513","Zm00001d003869","2",64103998,64104966,968
"1514","Zm00001d003872","2",64315958,64333167,17209
"1515","Zm00001d003875","2",64368246,64378577,10331
"1516","Zm00001d003878","2",64526539,64530682,4143
"1517","Zm00001d003879","2",64586567,64598584,12017
"1518","Zm00001d003884","2",65022354,65024176,1822
"1519","Zm00001d003888","2",65275989,65278517,2528
"1520","Zm00001d003889","2",65457795,65460979,3184
"1521","Zm00001d003890","2",65461148,65463708,2560
"1522","Zm00001d003894","2",65545285,65551844,6559
"1523","Zm00001d003895","2",65735275,65739011,3736
"1524","Zm00001d003896","2",65739234,65741073,1839
"1525","Zm00001d003897","2",65742713,65755466,12753
"1526","Zm00001d003902","2",66394925,66403430,8505
"1527","Zm00001d003904","2",66528931,66538358,9427
"1528","Zm00001d003905","2",66707941,66708477,536
"1529","Zm00001d003911","2",66815688,66823285,7597
"1530","Zm00001d003912","2",66899922,66900596,674
"1531","Zm00001d003913","2",66964007,66969688,5681
"1532","Zm00001d003917","2",67660105,67665061,4956
"1533","Zm00001d003922","2",68239457,68247954,8497
"1534","Zm00001d003923","2",68465595,68483377,17782
"1535","Zm00001d003924","2",68550654,68555257,4603
"1536","Zm00001d003925","2",68587601,68592566,4965
"1537","Zm00001d003927","2",68997259,68997672,413
"1538","Zm00001d003928","2",69381748,69387439,5691
"1539","Zm00001d003929","2",69607220,69609968,2748
"1540","Zm00001d003931","2",69777965,69780202,2237
"1541","Zm00001d003935","2",70122508,70149172,26664
"1542","Zm00001d003937","2",70442887,70460767,17880
"1543","Zm00001d003938","2",70460622,70462283,1661
"1544","Zm00001d003939","2",70548849,70558717,9868
"1545","Zm00001d003941","2",70598355,70604588,6233
"1546","Zm00001d003945","2",71037398,71040700,3302
"1547","Zm00001d003947","2",71150965,71157527,6562
"1548","Zm00001d003948","2",71573370,71575580,2210
"1549","Zm00001d003949","2",71579120,71583381,4261
"1550","Zm00001d003950","2",71776772,71780884,4112
"1551","Zm00001d003957","2",72199248,72202030,2782
"1552","Zm00001d003958","2",72202914,72211422,8508
"1553","Zm00001d003962","2",72420037,72420246,209
"1554","Zm00001d003966","2",72600749,72601084,335
"1555","Zm00001d003969","2",72941395,72942662,1267
"1556","Zm00001d003970","2",72943450,72946006,2556
"1557","Zm00001d003972","2",72963458,72964670,1212
"1558","Zm00001d003973","2",72985661,72985734,73
"1559","Zm00001d003974","2",72986095,72986979,884
"1560","Zm00001d003975","2",73016785,73020682,3897
"1561","Zm00001d003981","2",73518754,73519134,380
"1562","Zm00001d003982","2",73519830,73521307,1477
"1563","Zm00001d003983","2",73525142,73527644,2502
"1564","Zm00001d003984","2",73709485,73711737,2252
"1565","Zm00001d003986","2",73811638,73814597,2959
"1566","Zm00001d003993","2",74154075,74155773,1698
"1567","Zm00001d003995","2",74394439,74398961,4522
"1568","Zm00001d003996","2",74407929,74412907,4978
"1569","Zm00001d003999","2",74637520,74638152,632
"1570","Zm00001d004002","2",74666014,74667214,1200
"1571","Zm00001d004004","2",74914141,74915772,1631
"1572","Zm00001d004006","2",75025145,75030389,5244
"1573","Zm00001d004007","2",75054959,75056736,1777
"1574","Zm00001d004008","2",75122349,75135616,13267
"1575","Zm00001d004009","2",75235597,75238270,2673
"1576","Zm00001d004012","2",75641850,75675408,33558
"1577","Zm00001d004013","2",75743192,75744592,1400
"1578","Zm00001d004015","2",75789250,75791994,2744
"1579","Zm00001d004019","2",76032746,76036570,3824
"1580","Zm00001d004020","2",76069583,76077522,7939
"1581","Zm00001d004021","2",76077655,76080443,2788
"1582","Zm00001d004022","2",76081377,76085776,4399
"1583","Zm00001d004023","2",76316303,76331103,14800
"1584","Zm00001d004024","2",76504003,76504242,239
"1585","Zm00001d004025","2",76578813,76580774,1961
"1586","Zm00001d004033","2",77475647,77477608,1961
"1587","Zm00001d004036","2",77705738,77717321,11583
"1588","Zm00001d004040","2",78186135,78187699,1564
"1589","Zm00001d004042","2",78528269,78549917,21648
"1590","Zm00001d004047","2",78780459,78781369,910
"1591","Zm00001d004048","2",78973344,78974639,1295
"1592","Zm00001d004049","2",79047671,79049747,2076
"1593","Zm00001d004051","2",79495413,79500693,5280
"1594","Zm00001d004052","2",79610945,79613138,2193
"1595","Zm00001d004053","2",79773043,79793069,20026
"1596","Zm00001d004055","2",79794500,79799042,4542
"1597","Zm00001d004057","2",79920330,79922983,2653
"1598","Zm00001d004058","2",79938581,79941012,2431
"1599","Zm00001d004059","2",79946985,79947440,455
"1600","Zm00001d004064","2",79991655,79992690,1035
"1601","Zm00001d004065","2",80053932,80060295,6363
"1602","Zm00001d004066","2",80058017,80059465,1448
"1603","Zm00001d004070","2",80075697,80081259,5562
"1604","Zm00001d004071","2",80170140,80171831,1691
"1605","Zm00001d004073","2",80282831,80290342,7511
"1606","Zm00001d004075","2",80531432,80537038,5606
"1607","Zm00001d004078","2",80769759,80771390,1631
"1608","Zm00001d004083","2",80849340,80851066,1726
"1609","Zm00001d004086","2",81414319,81415921,1602
"1610","Zm00001d004087","2",81421075,81421813,738
"1611","Zm00001d004088","2",81499091,81501487,2396
"1612","Zm00001d004090","2",81696526,81701884,5358
"1613","Zm00001d004091","2",81972462,82000539,28077
"1614","Zm00001d004094","2",82432131,82436818,4687
"1615","Zm00001d004097","2",82649428,82650957,1529
"1616","Zm00001d004098","2",82651040,82652055,1015
"1617","Zm00001d004099","2",82708337,82715538,7201
"1618","Zm00001d004102","2",82839363,82842765,3402
"1619","Zm00001d004105","2",83174192,83175831,1639
"1620","Zm00001d004109","2",83268894,83272972,4078
"1621","Zm00001d004115","2",83489685,83491567,1882
"1622","Zm00001d004118","2",83750412,83790051,39639
"1623","Zm00001d004119","2",83933935,83945839,11904
"1624","Zm00001d004120","2",84068128,84079028,10900
"1625","Zm00001d004121","2",84102438,84106073,3635
"1626","Zm00001d004123","2",84344353,84356520,12167
"1627","Zm00001d004125","2",84495887,84510274,14387
"1628","Zm00001d004126","2",84727345,84729782,2437
"1629","Zm00001d004128","2",85295503,85298934,3431
"1630","Zm00001d004129","2",85346348,85347337,989
"1631","Zm00001d004130","2",85362121,85368441,6320
"1632","Zm00001d004131","2",85411658,85412453,795
"1633","Zm00001d004132","2",85448480,85453083,4603
"1634","Zm00001d004133","2",85452984,85454824,1840
"1635","Zm00001d004136","2",85695276,85704125,8849
"1636","Zm00001d004137","2",85731223,85732587,1364
"1637","Zm00001d004138","2",85736310,85737686,1376
"1638","Zm00001d004139","2",85783948,85803502,19554
"1639","Zm00001d004140","2",86026385,86044778,18393
"1640","Zm00001d004141","2",86033794,86033867,73
"1641","Zm00001d004143","2",86093715,86098066,4351
"1642","Zm00001d004145","2",86182810,86182883,73
"1643","Zm00001d004146","2",86233344,86236604,3260
"1644","Zm00001d004147","2",86359248,86367245,7997
"1645","Zm00001d004152","2",86802376,86814508,12132
"1646","Zm00001d004153","2",86910137,86914927,4790
"1647","Zm00001d004154","2",86919815,86983031,63216
"1648","Zm00001d004159","2",87723383,87750246,26863
"1649","Zm00001d004164","2",88283079,88285403,2324
"1650","Zm00001d004165","2",88500798,88502045,1247
"1651","Zm00001d004167","2",88547087,88552834,5747
"1652","Zm00001d004169","2",88644108,88659399,15291
"1653","Zm00001d004171","2",88958976,88963643,4667
"1654","Zm00001d004172","2",89151589,89175203,23614
"1655","Zm00001d004173","2",89164906,89166345,1439
"1656","Zm00001d004176","2",89300458,89300971,513
"1657","Zm00001d004187","2",90014009,90015460,1451
"1658","Zm00001d004190","2",90080589,90083187,2598
"1659","Zm00001d004193","2",90154652,90161111,6459
"1660","Zm00001d004196","2",90578487,90586376,7889
"1661","Zm00001d004198","2",91038189,91040615,2426
"1662","Zm00001d004200","2",91149638,91153961,4323
"1663","Zm00001d004202","2",91155492,91156019,527
"1664","Zm00001d004215","2",92153770,92167937,14167
"1665","Zm00001d004216","2",92294818,92306910,12092
"1666","Zm00001d004220","2",92824856,92826914,2058
"1667","Zm00001d004221","2",92986060,92986130,70
"1668","Zm00001d004222","2",92987738,92988916,1178
"1669","Zm00001d004230","2",94054835,94067869,13034
"1670","Zm00001d004231","2",94071356,94072171,815
"1671","Zm00001d004234","2",94228544,94231577,3033
"1672","Zm00001d004236","2",94299742,94309143,9401
"1673","Zm00001d004238","2",94750208,94752752,2544
"1674","Zm00001d004245","2",95654560,95664114,9554
"1675","Zm00001d004249","2",96016720,96017292,572
"1676","Zm00001d004252","2",96711037,96711507,470
"1677","Zm00001d004259","2",97643770,97655581,11811
"1678","Zm00001d004260","2",97679315,97692204,12889
"1679","Zm00001d004270","2",98318065,98333899,15834
"1680","Zm00001d004271","2",98321489,98321561,72
"1681","Zm00001d004282","2",99994718,99996904,2186
"1682","Zm00001d004287","2",100288906,100290144,1238
"1683","Zm00001d004293","2",100974371,100988003,13632
"1684","Zm00001d004298","2",101435299,101437745,2446
"1685","Zm00001d004300","2",101481769,101492289,10520
"1686","Zm00001d004305","2",102029424,102031072,1648
"1687","Zm00001d004323","2",103087361,103088798,1437
"1688","Zm00001d004326","2",103393808,103396558,2750
"1689","Zm00001d004330","2",103785591,103788319,2728
"1690","Zm00001d004332","2",104142097,104144386,2289
"1691","Zm00001d004335","2",104167039,104172347,5308
"1692","Zm00001d004336","2",104249148,104251327,2179
"1693","Zm00001d004339","2",104567260,104574379,7119
"1694","Zm00001d004340","2",104759766,104765209,5443
"1695","Zm00001d004343","2",105200917,105204490,3573
"1696","Zm00001d004347","2",105337726,105346227,8501
"1697","Zm00001d004354","2",105824109,105832763,8654
"1698","Zm00001d004357","2",105975690,105979822,4132
"1699","Zm00001d004358","2",106081084,106087544,6460
"1700","Zm00001d004359","2",106089345,106094524,5179
"1701","Zm00001d004361","2",106288124,106297306,9182
"1702","Zm00001d004362","2",106459779,106460150,371
"1703","Zm00001d004363","2",106492268,106494016,1748
"1704","Zm00001d004365","2",106625633,106628492,2859
"1705","Zm00001d004366","2",106628660,106630400,1740
"1706","Zm00001d004370","2",106726023,106726880,857
"1707","Zm00001d004372","2",106904147,106908784,4637
"1708","Zm00001d004375","2",107040785,107042488,1703
"1709","Zm00001d004379","2",107365020,107365884,864
"1710","Zm00001d004382","2",107685831,107687488,1657
"1711","Zm00001d004383","2",107689269,107709950,20681
"1712","Zm00001d004384","2",107710366,107710761,395
"1713","Zm00001d004386","2",107913435,107917205,3770
"1714","Zm00001d004388","2",108124871,108125353,482
"1715","Zm00001d004389","2",108158838,108160344,1506
"1716","Zm00001d004390","2",108387768,108388463,695
"1717","Zm00001d004392","2",108518434,108535572,17138
"1718","Zm00001d004396","2",108736242,108762263,26021
"1719","Zm00001d004400","2",109230347,109237741,7394
"1720","Zm00001d004401","2",109327004,109328229,1225
"1721","Zm00001d004407","2",110120314,110125179,4865
"1722","Zm00001d004409","2",110207245,110210898,3653
"1723","Zm00001d004410","2",110216975,110222616,5641
"1724","Zm00001d004412","2",110310942,110312623,1681
"1725","Zm00001d004413","2",110314499,110316622,2123
"1726","Zm00001d004414","2",110343635,110345001,1366
"1727","Zm00001d004416","2",110383916,110417211,33295
"1728","Zm00001d004417","2",110448343,110449312,969
"1729","Zm00001d004419","2",110481721,110482872,1151
"1730","Zm00001d004426","2",110929826,110930478,652
"1731","Zm00001d004428","2",111134165,111142775,8610
"1732","Zm00001d004431","2",111471969,111473513,1544
"1733","Zm00001d004432","2",111475168,111476745,1577
"1734","Zm00001d004433","2",111480480,111485308,4828
"1735","Zm00001d004434","2",111528064,111532562,4498
"1736","Zm00001d004435","2",111709370,111716415,7045
"1737","Zm00001d004436","2",111711317,111713703,2386
"1738","Zm00001d004437","2",111722006,111723284,1278
"1739","Zm00001d004438","2",111723172,111775606,52434
"1740","Zm00001d004442","2",112221153,112226107,4954
"1741","Zm00001d004443","2",112231521,112233025,1504
"1742","Zm00001d004446","2",112621367,112622188,821
"1743","Zm00001d004448","2",112706664,112712176,5512
"1744","Zm00001d004451","2",113037591,113038604,1013
"1745","Zm00001d004457","2",113221514,113223309,1795
"1746","Zm00001d004458","2",113246759,113251908,5149
"1747","Zm00001d004460","2",113301631,113309379,7748
"1748","Zm00001d004463","2",113526922,113567649,40727
"1749","Zm00001d004465","2",113586026,113591041,5015
"1750","Zm00001d004466","2",113646637,113661165,14528
"1751","Zm00001d004467","2",113711203,113713227,2024
"1752","Zm00001d004468","2",113818870,113827650,8780
"1753","Zm00001d004469","2",113923134,113924264,1130
"1754","Zm00001d004471","2",113977630,113980207,2577
"1755","Zm00001d004472","2",114012780,114016467,3687
"1756","Zm00001d004473","2",114085506,114089423,3917
"1757","Zm00001d004477","2",114362210,114365356,3146
"1758","Zm00001d004478","2",114435461,114439440,3979
"1759","Zm00001d004480","2",114516177,114517353,1176
"1760","Zm00001d004481","2",114550220,114557638,7418
"1761","Zm00001d004482","2",114558262,114558645,383
"1762","Zm00001d004483","2",114559829,114560905,1076
"1763","Zm00001d004488","2",114727714,114731413,3699
"1764","Zm00001d004489","2",114735276,114741306,6030
"1765","Zm00001d004493","2",114968433,114969050,617
"1766","Zm00001d004494","2",115139251,115142869,3618
"1767","Zm00001d004497","2",115226193,115228070,1877
"1768","Zm00001d004498","2",115228698,115233806,5108
"1769","Zm00001d004502","2",115349017,115355753,6736
"1770","Zm00001d004506","2",115648626,115650787,2161
"1771","Zm00001d004510","2",115887565,115891106,3541
"1772","Zm00001d004512","2",115910521,115916044,5523
"1773","Zm00001d004513","2",115917625,115925795,8170
"1774","Zm00001d004517","2",116133439,116141847,8408
"1775","Zm00001d004521","2",116470474,116480753,10279
"1776","Zm00001d004523","2",116567249,116568460,1211
"1777","Zm00001d004525","2",116607517,116611184,3667
"1778","Zm00001d004526","2",116652453,116655949,3496
"1779","Zm00001d004531","2",116800854,116802446,1592
"1780","Zm00001d004535","2",116870370,116872330,1960
"1781","Zm00001d004539","2",117088713,117089147,434
"1782","Zm00001d004541","2",117112005,117121714,9709
"1783","Zm00001d004543","2",117221421,117225649,4228
"1784","Zm00001d004545","2",117226282,117229328,3046
"1785","Zm00001d004546","2",117280218,117282818,2600
"1786","Zm00001d004547","2",117337369,117341154,3785
"1787","Zm00001d004548","2",117348804,117350316,1512
"1788","Zm00001d004551","2",117415866,117422215,6349
"1789","Zm00001d004552","2",117517382,117523345,5963
"1790","Zm00001d004553","2",117599896,117603633,3737
"1791","Zm00001d004554","2",117604029,117607568,3539
"1792","Zm00001d004555","2",117756964,117758990,2026
"1793","Zm00001d004557","2",117903594,117908380,4786
"1794","Zm00001d004559","2",118056520,118081233,24713
"1795","Zm00001d004560","2",118137849,118143180,5331
"1796","Zm00001d004561","2",118161397,118171157,9760
"1797","Zm00001d004562","2",118171645,118171718,73
"1798","Zm00001d004564","2",118175342,118183006,7664
"1799","Zm00001d004568","2",118363111,118363707,596
"1800","Zm00001d004573","2",118655591,118670633,15042
"1801","Zm00001d004576","2",118979544,118982387,2843
"1802","Zm00001d004580","2",119441175,119443659,2484
"1803","Zm00001d004581","2",119532842,119534142,1300
"1804","Zm00001d004585","2",119952845,119954464,1619
"1805","Zm00001d004586","2",120064675,120068672,3997
"1806","Zm00001d004589","2",120540375,120540912,537
"1807","Zm00001d004591","2",120678264,120682358,4094
"1808","Zm00001d004595","2",120889840,120894646,4806
"1809","Zm00001d004600","2",121349832,121350233,401
"1810","Zm00001d004603","2",121415653,121416458,805
"1811","Zm00001d004614","2",121848851,121849602,751
"1812","Zm00001d004616","2",122073292,122078694,5402
"1813","Zm00001d004617","2",122093799,122094176,377
"1814","Zm00001d004619","2",122405488,122406398,910
"1815","Zm00001d004620","2",122442335,122443832,1497
"1816","Zm00001d004621","2",122476413,122478624,2211
"1817","Zm00001d004623","2",122489904,122491422,1518
"1818","Zm00001d004625","2",122585539,122586054,515
"1819","Zm00001d004626","2",122675520,122679186,3666
"1820","Zm00001d004635","2",124419556,124423848,4292
"1821","Zm00001d004637","2",124454515,124459590,5075
"1822","Zm00001d004639","2",124625290,124626984,1694
"1823","Zm00001d004640","2",124660879,124683534,22655
"1824","Zm00001d004641","2",124685332,124686327,995
"1825","Zm00001d004644","2",124805300,124818947,13647
"1826","Zm00001d004646","2",124949366,124950540,1174
"1827","Zm00001d004649","2",125603869,125605944,2075
"1828","Zm00001d004650","2",125937581,125938516,935
"1829","Zm00001d004651","2",126256187,126280335,24148
"1830","Zm00001d004655","2",126652987,126654733,1746
"1831","Zm00001d004658","2",126817694,126818273,579
"1832","Zm00001d004659","2",126969673,127005982,36309
"1833","Zm00001d004667","2",128132374,128184491,52117
"1834","Zm00001d004669","2",128628426,128652133,23707
"1835","Zm00001d004670","2",129056836,129058405,1569
"1836","Zm00001d004671","2",129305723,129306046,323
"1837","Zm00001d004674","2",129625308,129627179,1871
"1838","Zm00001d004675","2",129629091,129630069,978
"1839","Zm00001d004676","2",129832143,129846832,14689
"1840","Zm00001d004677","2",129843765,129846878,3113
"1841","Zm00001d004679","2",129932563,129939279,6716
"1842","Zm00001d004680","2",129971040,129991961,20921
"1843","Zm00001d004682","2",130189183,130190484,1301
"1844","Zm00001d004684","2",130495769,130497196,1427
"1845","Zm00001d004689","2",131242393,131243911,1518
"1846","Zm00001d004690","2",131371138,131371917,779
"1847","Zm00001d004691","2",131619680,131622816,3136
"1848","Zm00001d004692","2",131664853,131666048,1195
"1849","Zm00001d004697","2",131929878,131937148,7270
"1850","Zm00001d004698","2",132002826,132005184,2358
"1851","Zm00001d004700","2",132138157,132139180,1023
"1852","Zm00001d004702","2",132209575,132244262,34687
"1853","Zm00001d004703","2",132214546,132214619,73
"1854","Zm00001d004706","2",132363395,132367683,4288
"1855","Zm00001d004707","2",132433054,132465319,32265
"1856","Zm00001d004708","2",132579699,132581191,1492
"1857","Zm00001d004709","2",132743325,132766708,23383
"1858","Zm00001d004713","2",133076206,133077763,1557
"1859","Zm00001d004716","2",133451627,133457602,5975
"1860","Zm00001d004720","2",133771845,133775173,3328
"1861","Zm00001d004722","2",133863022,133864502,1480
"1862","Zm00001d004729","2",134367381,134368158,777
"1863","Zm00001d004731","2",134453744,134457995,4251
"1864","Zm00001d004733","2",134524075,134527308,3233
"1865","Zm00001d004734","2",134686452,134689699,3247
"1866","Zm00001d004736","2",134747713,134748868,1155
"1867","Zm00001d004737","2",134905661,134916730,11069
"1868","Zm00001d004739","2",135107481,135114390,6909
"1869","Zm00001d004740","2",135147704,135154431,6727
"1870","Zm00001d004744","2",135504533,135506004,1471
"1871","Zm00001d004746","2",135724418,135726737,2319
"1872","Zm00001d004747","2",135728851,135744016,15165
"1873","Zm00001d004751","2",136241469,136248634,7165
"1874","Zm00001d004753","2",136266649,136267215,566
"1875","Zm00001d004755","2",136496398,136499244,2846
"1876","Zm00001d004758","2",136751517,136752047,530
"1877","Zm00001d004762","2",137325937,137330047,4110
"1878","Zm00001d004765","2",137445957,137447501,1544
"1879","Zm00001d004768","2",137853555,137856240,2685
"1880","Zm00001d004771","2",138058633,138069736,11103
"1881","Zm00001d004772","2",138161045,138168957,7912
"1882","Zm00001d004775","2",138470096,138479847,9751
"1883","Zm00001d004778","2",138482227,138484439,2212
"1884","Zm00001d004779","2",138647642,138657256,9614
"1885","Zm00001d004782","2",138884630,138899209,14579
"1886","Zm00001d004784","2",139072783,139074023,1240
"1887","Zm00001d004785","2",139099237,139105284,6047
"1888","Zm00001d004787","2",139197464,139198428,964
"1889","Zm00001d004790","2",139440936,139457504,16568
"1890","Zm00001d004798","2",140008464,140011300,2836
"1891","Zm00001d004804","2",140341974,140345724,3750
"1892","Zm00001d004805","2",140441082,140444057,2975
"1893","Zm00001d004806","2",140441997,140448284,6287
"1894","Zm00001d004807","2",140587723,140592773,5050
"1895","Zm00001d004808","2",140666283,140666841,558
"1896","Zm00001d004810","2",140744018,140750309,6291
"1897","Zm00001d004812","2",140809252,140813969,4717
"1898","Zm00001d004814","2",140902296,140903771,1475
"1899","Zm00001d004817","2",140977385,140982487,5102
"1900","Zm00001d004818","2",141025001,141035997,10996
"1901","Zm00001d004819","2",141044586,141048265,3679
"1902","Zm00001d004821","2",141195744,141198243,2499
"1903","Zm00001d004825","2",141496101,141499720,3619
"1904","Zm00001d004826","2",141506630,141507993,1363
"1905","Zm00001d004831","2",142068578,142070282,1704
"1906","Zm00001d004835","2",142242020,142243186,1166
"1907","Zm00001d004836","2",142526160,142527494,1334
"1908","Zm00001d004837","2",142729514,142739676,10162
"1909","Zm00001d004839","2",143074865,143077854,2989
"1910","Zm00001d004841","2",143651473,143654532,3059
"1911","Zm00001d004843","2",143855973,143857138,1165
"1912","Zm00001d004848","2",144414921,144416162,1241
"1913","Zm00001d004851","2",144529394,144530704,1310
"1914","Zm00001d004855","2",144882980,144890090,7110
"1915","Zm00001d004856","2",145083433,145087343,3910
"1916","Zm00001d004857","2",145114887,145119368,4481
"1917","Zm00001d004861","2",145357641,145376160,18519
"1918","Zm00001d004864","2",145436002,145441456,5454
"1919","Zm00001d004866","2",145444788,145448501,3713
"1920","Zm00001d004867","2",145453830,145454228,398
"1921","Zm00001d004868","2",145454892,145460926,6034
"1922","Zm00001d004870","2",145654895,145657192,2297
"1923","Zm00001d004871","2",145661756,145663526,1770
"1924","Zm00001d004872","2",145664677,145670448,5771
"1925","Zm00001d004875","2",145683678,145688881,5203
"1926","Zm00001d004876","2",145767597,145770791,3194
"1927","Zm00001d004877","2",145962314,145989846,27532
"1928","Zm00001d004880","2",146131896,146134667,2771
"1929","Zm00001d004881","2",146206362,146207063,701
"1930","Zm00001d004882","2",146379218,146380414,1196
"1931","Zm00001d004885","2",146496349,146501430,5081
"1932","Zm00001d004889","2",147004057,147005221,1164
"1933","Zm00001d004890","2",147021230,147025006,3776
"1934","Zm00001d004891","2",147086132,147089566,3434
"1935","Zm00001d004894","2",147269761,147270804,1043
"1936","Zm00001d004896","2",147532850,147537808,4958
"1937","Zm00001d004898","2",147703036,147707778,4742
"1938","Zm00001d004899","2",147710765,147712793,2028
"1939","Zm00001d004903","2",147882115,147883489,1374
"1940","Zm00001d004908","2",147970803,147971519,716
"1941","Zm00001d004909","2",147984285,147985524,1239
"1942","Zm00001d004912","2",148091273,148143354,52081
"1943","Zm00001d004913","2",148160530,148162597,2067
"1944","Zm00001d004914","2",148228223,148233422,5199
"1945","Zm00001d004915","2",148273239,148274261,1022
"1946","Zm00001d004916","2",148560206,148564300,4094
"1947","Zm00001d004917","2",148582996,148585868,2872
"1948","Zm00001d004918","2",148588232,148589926,1694
"1949","Zm00001d004924","2",149026476,149029096,2620
"1950","Zm00001d004925","2",149182642,149191037,8395
"1951","Zm00001d004927","2",149224009,149226714,2705
"1952","Zm00001d004929","2",149268089,149270752,2663
"1953","Zm00001d004930","2",149275452,149278598,3146
"1954","Zm00001d004931","2",149353232,149355845,2613
"1955","Zm00001d004933","2",149548555,149551030,2475
"1956","Zm00001d004934","2",149552424,149555856,3432
"1957","Zm00001d004936","2",149585939,149589630,3691
"1958","Zm00001d004938","2",149610064,149610775,711
"1959","Zm00001d004941","2",149614309,149619583,5274
"1960","Zm00001d004943","2",149874146,149875416,1270
"1961","Zm00001d004951","2",150219586,150221925,2339
"1962","Zm00001d004953","2",150446177,150451317,5140
"1963","Zm00001d004955","2",150554959,150558746,3787
"1964","Zm00001d004956","2",150578240,150597318,19078
"1965","Zm00001d004957","2",150613845,150616281,2436
"1966","Zm00001d004959","2",150682992,150686218,3226
"1967","Zm00001d004960","2",150751651,150757700,6049
"1968","Zm00001d004965","2",150852931,150854567,1636
"1969","Zm00001d004966","2",150962219,150965287,3068
"1970","Zm00001d004968","2",151122486,151126192,3706
"1971","Zm00001d004972","2",151267002,151267565,563
"1972","Zm00001d004973","2",151358659,151363700,5041
"1973","Zm00001d004975","2",151396908,151400701,3793
"1974","Zm00001d004976","2",151616446,151621321,4875
"1975","Zm00001d004977","2",151850327,151853942,3615
"1976","Zm00001d004978","2",151887246,151891610,4364
"1977","Zm00001d004979","2",151892428,151907067,14639
"1978","Zm00001d004982","2",152191770,152198852,7082
"1979","Zm00001d004983","2",152200319,152203049,2730
"1980","Zm00001d004985","2",152229476,152229562,86
"1981","Zm00001d004986","2",152282189,152291110,8921
"1982","Zm00001d004992","2",152645285,152651759,6474
"1983","Zm00001d004993","2",152731213,152742157,10944
"1984","Zm00001d004994","2",152814071,152818335,4264
"1985","Zm00001d004997","2",153083988,153087202,3214
"1986","Zm00001d004998","2",153089892,153092511,2619
"1987","Zm00001d004999","2",153093270,153094176,906
"1988","Zm00001d005001","2",153144332,153148743,4411
"1989","Zm00001d005002","2",153238644,153242689,4045
"1990","Zm00001d005004","2",153295095,153299657,4562
"1991","Zm00001d005006","2",153444868,153448483,3615
"1992","Zm00001d005007","2",153449367,153449951,584
"1993","Zm00001d005008","2",153457401,153461174,3773
"1994","Zm00001d005009","2",153475411,153476533,1122
"1995","Zm00001d005010","2",153499579,153500433,854
"1996","Zm00001d005011","2",153601632,153727710,126078
"1997","Zm00001d005012","2",153729878,153753926,24048
"1998","Zm00001d005013","2",153755348,153769526,14178
"1999","Zm00001d005015","2",153783162,153787082,3920
"2000","Zm00001d005016","2",153920645,153926320,5675
"2001","Zm00001d005017","2",154098613,154100666,2053
"2002","Zm00001d005018","2",154107681,154110474,2793
"2003","Zm00001d005019","2",154112079,154118952,6873
"2004","Zm00001d005023","2",154380003,154380449,446
"2005","Zm00001d005026","2",154614760,154616824,2064
"2006","Zm00001d005027","2",154617731,154621976,4245
"2007","Zm00001d005028","2",154629678,154631157,1479
"2008","Zm00001d005029","2",154743078,154746493,3415
"2009","Zm00001d005030","2",154831004,154835182,4178
"2010","Zm00001d005035","2",155214141,155229333,15192
"2011","Zm00001d005036","2",155301263,155306254,4991
"2012","Zm00001d005038","2",155403486,155405109,1623
"2013","Zm00001d005039","2",155435155,155436114,959
"2014","Zm00001d005040","2",155438279,155441199,2920
"2015","Zm00001d005047","2",156243172,156244137,965
"2016","Zm00001d005051","2",156270103,156272641,2538
"2017","Zm00001d005052","2",156305437,156311224,5787
"2018","Zm00001d005055","2",156345821,156346504,683
"2019","Zm00001d005059","2",156642268,156645976,3708
"2020","Zm00001d005062","2",156883161,156887322,4161
"2021","Zm00001d005063","2",156913472,156927315,13843
"2022","Zm00001d005064","2",156933960,156947069,13109
"2023","Zm00001d005065","2",156948668,156951694,3026
"2024","Zm00001d005071","2",157220798,157223456,2658
"2025","Zm00001d005072","2",157224518,157228483,3965
"2026","Zm00001d005073","2",157268816,157271132,2316
"2027","Zm00001d005075","2",157349606,157350700,1094
"2028","Zm00001d005076","2",157557968,157559489,1521
"2029","Zm00001d005077","2",157581551,157582657,1106
"2030","Zm00001d005080","2",157613247,157617354,4107
"2031","Zm00001d005081","2",157617482,157618891,1409
"2032","Zm00001d005082","2",157619104,157622725,3621
"2033","Zm00001d005083","2",157652306,157655116,2810
"2034","Zm00001d005085","2",157726036,157732431,6395
"2035","Zm00001d005087","2",157736007,157737776,1769
"2036","Zm00001d005089","2",157768411,157770397,1986
"2037","Zm00001d005090","2",157782896,157793519,10623
"2038","Zm00001d005092","2",157946199,157950863,4664
"2039","Zm00001d005094","2",158026680,158029187,2507
"2040","Zm00001d005097","2",158070354,158071233,879
"2041","Zm00001d005099","2",158134866,158139401,4535
"2042","Zm00001d005100","2",158142366,158156919,14553
"2043","Zm00001d005101","2",158207282,158209105,1823
"2044","Zm00001d005102","2",158273978,158277824,3846
"2045","Zm00001d005104","2",158392214,158395842,3628
"2046","Zm00001d005105","2",158411267,158415830,4563
"2047","Zm00001d005106","2",158478752,158485915,7163
"2048","Zm00001d005107","2",158546989,158561534,14545
"2049","Zm00001d005108","2",158564427,158572132,7705
"2050","Zm00001d005109","2",158573948,158574220,272
"2051","Zm00001d005110","2",158575159,158586743,11584
"2052","Zm00001d005114","2",159058949,159063855,4906
"2053","Zm00001d005118","2",159221472,159230066,8594
"2054","Zm00001d005121","2",159304300,159307785,3485
"2055","Zm00001d005124","2",159686924,159692287,5363
"2056","Zm00001d005125","2",159692891,159695636,2745
"2057","Zm00001d005126","2",159707540,159724452,16912
"2058","Zm00001d005127","2",159740529,159770203,29674
"2059","Zm00001d005135","2",160460364,160465842,5478
"2060","Zm00001d005136","2",160516566,160518614,2048
"2061","Zm00001d005137","2",160527706,160580969,53263
"2062","Zm00001d005140","2",160691580,160697757,6177
"2063","Zm00001d005143","2",160785204,160795415,10211
"2064","Zm00001d005144","2",160874292,160889881,15589
"2065","Zm00001d005146","2",161023220,161023567,347
"2066","Zm00001d005148","2",161094504,161096484,1980
"2067","Zm00001d005149","2",161142292,161146791,4499
"2068","Zm00001d005151","2",161363227,161368845,5618
"2069","Zm00001d005154","2",161423330,161427064,3734
"2070","Zm00001d005155","2",161487307,161487985,678
"2071","Zm00001d005156","2",161487565,161499622,12057
"2072","Zm00001d005157","2",161572788,161593818,21030
"2073","Zm00001d005159","2",161850986,161855350,4364
"2074","Zm00001d005160","2",161883752,161884455,703
"2075","Zm00001d005161","2",161884678,161887223,2545
"2076","Zm00001d005162","2",161901907,161903278,1371
"2077","Zm00001d005163","2",161913112,161913739,627
"2078","Zm00001d005164","2",161924685,161932707,8022
"2079","Zm00001d005166","2",161951697,161955956,4259
"2080","Zm00001d005168","2",162092060,162124973,32913
"2081","Zm00001d005169","2",162168216,162170065,1849
"2082","Zm00001d005170","2",162191711,162197329,5618
"2083","Zm00001d005172","2",162267125,162269487,2362
"2084","Zm00001d005173","2",162271491,162281270,9779
"2085","Zm00001d005174","2",162398074,162402945,4871
"2086","Zm00001d005175","2",162409167,162409853,686
"2087","Zm00001d005176","2",162426218,162432882,6664
"2088","Zm00001d005177","2",162446822,162447442,620
"2089","Zm00001d005178","2",162536992,162545905,8913
"2090","Zm00001d005179","2",162701249,162708553,7304
"2091","Zm00001d005182","2",162854863,162858098,3235
"2092","Zm00001d005183","2",162878151,162878838,687
"2093","Zm00001d005184","2",162902441,162909949,7508
"2094","Zm00001d005185","2",162911443,162914557,3114
"2095","Zm00001d005188","2",163003511,163010881,7370
"2096","Zm00001d005190","2",163038225,163041426,3201
"2097","Zm00001d005192","2",163044078,163045608,1530
"2098","Zm00001d005193","2",163079620,163082144,2524
"2099","Zm00001d005194","2",163082970,163093018,10048
"2100","Zm00001d005195","2",163095556,163101315,5759
"2101","Zm00001d005199","2",163239951,163244821,4870
"2102","Zm00001d005200","2",163303610,163305990,2380
"2103","Zm00001d005203","2",163456179,163457054,875
"2104","Zm00001d005205","2",163509070,163514363,5293
"2105","Zm00001d005208","2",163612209,163613834,1625
"2106","Zm00001d005215","2",163862650,163864152,1502
"2107","Zm00001d005228","2",164595462,164597890,2428
"2108","Zm00001d005229","2",164676117,164681882,5765
"2109","Zm00001d005230","2",164746346,164746813,467
"2110","Zm00001d005231","2",164761161,164765303,4142
"2111","Zm00001d005238","2",165152617,165157842,5225
"2112","Zm00001d005240","2",165391566,165398971,7405
"2113","Zm00001d005241","2",165407124,165415539,8415
"2114","Zm00001d005244","2",165521128,165527158,6030
"2115","Zm00001d005246","2",165580326,165581730,1404
"2116","Zm00001d005247","2",165585737,165587321,1584
"2117","Zm00001d005248","2",165633997,165638983,4986
"2118","Zm00001d005250","2",165690684,165696645,5961
"2119","Zm00001d005252","2",165864515,165868015,3500
"2120","Zm00001d005253","2",165939745,165942452,2707
"2121","Zm00001d005256","2",165995200,165998280,3080
"2122","Zm00001d005257","2",166025505,166063210,37705
"2123","Zm00001d005264","2",166202913,166214873,11960
"2124","Zm00001d005266","2",166358877,166362593,3716
"2125","Zm00001d005267","2",166363063,166363553,490
"2126","Zm00001d005269","2",166451535,166466680,15145
"2127","Zm00001d005270","2",166551926,166562036,10110
"2128","Zm00001d005271","2",166695163,166700867,5704
"2129","Zm00001d005275","2",166840385,166842121,1736
"2130","Zm00001d005276","2",167097474,167102855,5381
"2131","Zm00001d005277","2",167120178,167120837,659
"2132","Zm00001d005278","2",167123453,167126125,2672
"2133","Zm00001d005281","2",167625991,167646542,20551
"2134","Zm00001d005282","2",167648139,167649312,1173
"2135","Zm00001d005283","2",167666606,167667184,578
"2136","Zm00001d005293","2",168005838,168007927,2089
"2137","Zm00001d005295","2",168137133,168145157,8024
"2138","Zm00001d005297","2",168256464,168265313,8849
"2139","Zm00001d005298","2",168386230,168389148,2918
"2140","Zm00001d005299","2",168472380,168476285,3905
"2141","Zm00001d005300","2",168527945,168528802,857
"2142","Zm00001d005301","2",168529789,168546720,16931
"2143","Zm00001d005302","2",168641662,168642855,1193
"2144","Zm00001d005303","2",168784695,168788171,3476
"2145","Zm00001d005306","2",168880537,168884895,4358
"2146","Zm00001d005308","2",169022631,169026843,4212
"2147","Zm00001d005312","2",169181914,169183278,1364
"2148","Zm00001d005313","2",169267988,169271203,3215
"2149","Zm00001d005315","2",169380169,169381164,995
"2150","Zm00001d005317","2",169450468,169452918,2450
"2151","Zm00001d005323","2",169611582,169617202,5620
"2152","Zm00001d005324","2",169619009,169623924,4915
"2153","Zm00001d005325","2",169619391,169620743,1352
"2154","Zm00001d005327","2",169636601,169637071,470
"2155","Zm00001d005328","2",169705296,169710634,5338
"2156","Zm00001d005329","2",169718350,169719510,1160
"2157","Zm00001d005333","2",169798951,169799577,626
"2158","Zm00001d005334","2",169838654,169842673,4019
"2159","Zm00001d005337","2",169965148,169969026,3878
"2160","Zm00001d005338","2",170014476,170018582,4106
"2161","Zm00001d005339","2",170023199,170025234,2035
"2162","Zm00001d005342","2",170110817,170111497,680
"2163","Zm00001d005343","2",170142297,170146226,3929
"2164","Zm00001d005344","2",170204369,170207404,3035
"2165","Zm00001d005345","2",170220226,170222846,2620
"2166","Zm00001d005346","2",170380531,170384466,3935
"2167","Zm00001d005347","2",170386767,170391584,4817
"2168","Zm00001d005348","2",170425943,170436807,10864
"2169","Zm00001d005349","2",170601641,170603719,2078
"2170","Zm00001d005350","2",170606178,170612205,6027
"2171","Zm00001d005351","2",170643478,170644746,1268
"2172","Zm00001d005354","2",170845869,170850000,4131
"2173","Zm00001d005355","2",170852630,170856301,3671
"2174","Zm00001d005356","2",170856998,170871299,14301
"2175","Zm00001d005357","2",170859344,170859417,73
"2176","Zm00001d005358","2",170877680,170902373,24693
"2177","Zm00001d005359","2",170959556,170961867,2311
"2178","Zm00001d005361","2",171059897,171064674,4777
"2179","Zm00001d005366","2",171098470,171101501,3031
"2180","Zm00001d005367","2",171114902,171115709,807
"2181","Zm00001d005368","2",171115942,171122381,6439
"2182","Zm00001d005369","2",171122914,171123806,892
"2183","Zm00001d005370","2",171125479,171128890,3411
"2184","Zm00001d005372","2",171218601,171226061,7460
"2185","Zm00001d005373","2",171265620,171276393,10773
"2186","Zm00001d005378","2",171593350,171594999,1649
"2187","Zm00001d005384","2",171872301,171873188,887
"2188","Zm00001d005387","2",171976326,171978043,1717
"2189","Zm00001d005391","2",172032915,172034444,1529
"2190","Zm00001d005392","2",172065137,172067442,2305
"2191","Zm00001d005393","2",172153302,172161498,8196
"2192","Zm00001d005394","2",172200289,172201842,1553
"2193","Zm00001d005395","2",172237665,172248235,10570
"2194","Zm00001d005396","2",172253192,172255990,2798
"2195","Zm00001d005398","2",172424708,172428645,3937
"2196","Zm00001d005399","2",172534745,172539572,4827
"2197","Zm00001d005402","2",172688325,172696553,8228
"2198","Zm00001d005403","2",172806062,172844621,38559
"2199","Zm00001d005406","2",173045666,173049298,3632
"2200","Zm00001d005407","2",173082255,173089865,7610
"2201","Zm00001d005416","2",173246132,173246932,800
"2202","Zm00001d005419","2",173366656,173367575,919
"2203","Zm00001d005420","2",173374776,173375104,328
"2204","Zm00001d005421","2",173378742,173382478,3736
"2205","Zm00001d005423","2",173516205,173516885,680
"2206","Zm00001d005424","2",173518441,173524779,6338
"2207","Zm00001d005425","2",173592990,173593806,816
"2208","Zm00001d005426","2",173612018,173614069,2051
"2209","Zm00001d005429","2",173709958,173717006,7048
"2210","Zm00001d005430","2",173721407,173735527,14120
"2211","Zm00001d005431","2",173737963,173758943,20980
"2212","Zm00001d005432","2",173781887,173793490,11603
"2213","Zm00001d005434","2",173882328,173889679,7351
"2214","Zm00001d005437","2",173966248,173967645,1397
"2215","Zm00001d005441","2",174328388,174333623,5235
"2216","Zm00001d005442","2",174337143,174340895,3752
"2217","Zm00001d005445","2",174370956,174373091,2135
"2218","Zm00001d005446","2",174389496,174390471,975
"2219","Zm00001d005450","2",174563818,174573581,9763
"2220","Zm00001d005451","2",174589103,174595166,6063
"2221","Zm00001d005453","2",174636123,174667515,31392
"2222","Zm00001d005454","2",174826099,174827859,1760
"2223","Zm00001d005456","2",174866938,174869050,2112
"2224","Zm00001d005457","2",174870233,174870574,341
"2225","Zm00001d005458","2",174938654,174942588,3934
"2226","Zm00001d005459","2",174943009,174945711,2702
"2227","Zm00001d005460","2",174981909,174985881,3972
"2228","Zm00001d005461","2",175015114,175016058,944
"2229","Zm00001d005462","2",175095163,175100194,5031
"2230","Zm00001d005465","2",175164223,175165140,917
"2231","Zm00001d005466","2",175166226,175171256,5030
"2232","Zm00001d005468","2",175202127,175205252,3125
"2233","Zm00001d005473","2",175395655,175401157,5502
"2234","Zm00001d005476","2",175467672,175473036,5364
"2235","Zm00001d005478","2",175506166,175511789,5623
"2236","Zm00001d005479","2",175573813,175580218,6405
"2237","Zm00001d005480","2",175580220,175583917,3697
"2238","Zm00001d005481","2",175588378,175590288,1910
"2239","Zm00001d005482","2",175596000,175598464,2464
"2240","Zm00001d005484","2",175599089,175605258,6169
"2241","Zm00001d005485","2",175607776,175613053,5277
"2242","Zm00001d005486","2",175613563,175616820,3257
"2243","Zm00001d005487","2",175631316,175632091,775
"2244","Zm00001d005488","2",175658712,175659957,1245
"2245","Zm00001d005489","2",175795127,175802848,7721
"2246","Zm00001d005490","2",175825128,175825694,566
"2247","Zm00001d005495","2",175967213,175970912,3699
"2248","Zm00001d005497","2",175971908,175976643,4735
"2249","Zm00001d005498","2",175999839,176006292,6453
"2250","Zm00001d005501","2",176332667,176339738,7071
"2251","Zm00001d005502","2",176553637,176561230,7593
"2252","Zm00001d005503","2",176562853,176567171,4318
"2253","Zm00001d005504","2",176567431,176570578,3147
"2254","Zm00001d005506","2",176645346,176648449,3103
"2255","Zm00001d005507","2",176648910,176662238,13328
"2256","Zm00001d005512","2",176915776,176915855,79
"2257","Zm00001d005513","2",176946884,176956922,10038
"2258","Zm00001d005514","2",176953544,176953615,71
"2259","Zm00001d005516","2",177061818,177071736,9918
"2260","Zm00001d005517","2",177072895,177075399,2504
"2261","Zm00001d005518","2",177076117,177087986,11869
"2262","Zm00001d005520","2",177218082,177221636,3554
"2263","Zm00001d005523","2",177280596,177281775,1179
"2264","Zm00001d005524","2",177283367,177286586,3219
"2265","Zm00001d005528","2",177301062,177306292,5230
"2266","Zm00001d005529","2",177314311,177316238,1927
"2267","Zm00001d005530","2",177345314,177349031,3717
"2268","Zm00001d005532","2",177521140,177524929,3789
"2269","Zm00001d005534","2",177646510,177655780,9270
"2270","Zm00001d005535","2",177655850,177675449,19599
"2271","Zm00001d005536","2",177663856,177665243,1387
"2272","Zm00001d005537","2",177761782,177762270,488
"2273","Zm00001d005538","2",177986492,178020096,33604
"2274","Zm00001d005539","2",178058279,178065291,7012
"2275","Zm00001d005540","2",178070483,178072538,2055
"2276","Zm00001d005541","2",178095230,178095963,733
"2277","Zm00001d005542","2",178096528,178100358,3830
"2278","Zm00001d005544","2",178130749,178133713,2964
"2279","Zm00001d005546","2",178195810,178206466,10656
"2280","Zm00001d005547","2",178261462,178270758,9296
"2281","Zm00001d005548","2",178263200,178263273,73
"2282","Zm00001d005550","2",178272006,178275113,3107
"2283","Zm00001d005552","2",178280696,178281362,666
"2284","Zm00001d005554","2",178299637,178303185,3548
"2285","Zm00001d005558","2",178429165,178436518,7353
"2286","Zm00001d005563","2",178602264,178619387,17123
"2287","Zm00001d005570","2",178765358,178768491,3133
"2288","Zm00001d005573","2",178919567,178933420,13853
"2289","Zm00001d005578","2",179315956,179317710,1754
"2290","Zm00001d005579","2",179323021,179329228,6207
"2291","Zm00001d005583","2",179523071,179523442,371
"2292","Zm00001d005584","2",179525467,179531907,6440
"2293","Zm00001d005586","2",179797901,179801854,3953
"2294","Zm00001d005587","2",179826385,179831450,5065
"2295","Zm00001d005590","2",180005803,180013761,7958
"2296","Zm00001d005591","2",180015582,180017621,2039
"2297","Zm00001d005594","2",180121139,180123254,2115
"2298","Zm00001d005598","2",180222268,180234088,11820
"2299","Zm00001d005600","2",180270065,180271486,1421
"2300","Zm00001d005602","2",180430152,180430769,617
"2301","Zm00001d005607","2",180548102,180551841,3739
"2302","Zm00001d005608","2",180562750,180580465,17715
"2303","Zm00001d005609","2",180648852,180649904,1052
"2304","Zm00001d005612","2",180671311,180673246,1935
"2305","Zm00001d005614","2",180730952,180739978,9026
"2306","Zm00001d005616","2",180790191,180792445,2254
"2307","Zm00001d005617","2",180792671,180794516,1845
"2308","Zm00001d005619","2",180795962,180796219,257
"2309","Zm00001d005620","2",180837844,180839608,1764
"2310","Zm00001d005621","2",180905170,180907696,2526
"2311","Zm00001d005623","2",180993722,180994213,491
"2312","Zm00001d005624","2",181044326,181045720,1394
"2313","Zm00001d005627","2",181165986,181173007,7021
"2314","Zm00001d005628","2",181214717,181215268,551
"2315","Zm00001d005630","2",181236281,181237609,1328
"2316","Zm00001d005631","2",181237525,181241171,3646
"2317","Zm00001d005632","2",181289644,181297282,7638
"2318","Zm00001d005636","2",181459859,181465569,5710
"2319","Zm00001d005638","2",181606124,181613639,7515
"2320","Zm00001d005639","2",181625391,181630233,4842
"2321","Zm00001d005641","2",181705802,181715994,10192
"2322","Zm00001d005642","2",181731962,181733845,1883
"2323","Zm00001d005645","2",181818631,181822298,3667
"2324","Zm00001d005647","2",181872595,181877925,5330
"2325","Zm00001d005648","2",181901483,181904315,2832
"2326","Zm00001d005649","2",181908131,181911665,3534
"2327","Zm00001d005650","2",181987311,181992325,5014
"2328","Zm00001d005652","2",182098990,182102562,3572
"2329","Zm00001d005653","2",182137851,182141418,3567
"2330","Zm00001d005654","2",182185442,182186092,650
"2331","Zm00001d005656","2",182284237,182285115,878
"2332","Zm00001d005657","2",182382405,182383968,1563
"2333","Zm00001d005658","2",182513911,182516018,2107
"2334","Zm00001d005661","2",182615989,182617089,1100
"2335","Zm00001d005662","2",182619491,182627675,8184
"2336","Zm00001d005663","2",182688634,182689557,923
"2337","Zm00001d005664","2",182691742,182692998,1256
"2338","Zm00001d005666","2",182755798,182758430,2632
"2339","Zm00001d005671","2",182856428,182859197,2769
"2340","Zm00001d005672","2",182907562,182913622,6060
"2341","Zm00001d005674","2",182914026,182928799,14773
"2342","Zm00001d005675","2",183064274,183068668,4394
"2343","Zm00001d005678","2",183145357,183146727,1370
"2344","Zm00001d005679","2",183153987,183166970,12983
"2345","Zm00001d005680","2",183167299,183168666,1367
"2346","Zm00001d005681","2",183180787,183181551,764
"2347","Zm00001d005682","2",183194823,183197373,2550
"2348","Zm00001d005684","2",183288690,183291321,2631
"2349","Zm00001d005685","2",183315360,183316496,1136
"2350","Zm00001d005686","2",183361110,183362137,1027
"2351","Zm00001d005687","2",183363790,183370827,7037
"2352","Zm00001d005692","2",183562202,183564363,2161
"2353","Zm00001d005694","2",183651912,183653332,1420
"2354","Zm00001d005695","2",183653698,183659439,5741
"2355","Zm00001d005696","2",183690135,183698634,8499
"2356","Zm00001d005698","2",183790605,183791147,542
"2357","Zm00001d005699","2",183810719,183812320,1601
"2358","Zm00001d005700","2",183835151,183837553,2402
"2359","Zm00001d005705","2",183947295,183952261,4966
"2360","Zm00001d005707","2",184018266,184027174,8908
"2361","Zm00001d005708","2",184109212,184113653,4441
"2362","Zm00001d005710","2",184116268,184116686,418
"2363","Zm00001d005711","2",184164721,184174451,9730
"2364","Zm00001d005712","2",184286504,184287422,918
"2365","Zm00001d005713","2",184330535,184335470,4935
"2366","Zm00001d005714","2",184336005,184337431,1426
"2367","Zm00001d005715","2",184452989,184461356,8367
"2368","Zm00001d005716","2",184487684,184490180,2496
"2369","Zm00001d005717","2",184528359,184530896,2537
"2370","Zm00001d005722","2",184680887,184681330,443
"2371","Zm00001d005724","2",184744636,184746137,1501
"2372","Zm00001d005726","2",184842614,184845272,2658
"2373","Zm00001d005727","2",184929124,184937138,8014
"2374","Zm00001d005732","2",185158331,185164690,6359
"2375","Zm00001d005733","2",185170256,185171065,809
"2376","Zm00001d005735","2",185222328,185229056,6728
"2377","Zm00001d005736","2",185226462,185236893,10431
"2378","Zm00001d005740","2",185575930,185578477,2547
"2379","Zm00001d005742","2",185588363,185590379,2016
"2380","Zm00001d005743","2",185603679,185607050,3371
"2381","Zm00001d005747","2",185849033,185850181,1148
"2382","Zm00001d005748","2",185946481,185947866,1385
"2383","Zm00001d005751","2",186191022,186194061,3039
"2384","Zm00001d005752","2",186198238,186199503,1265
"2385","Zm00001d005754","2",186345211,186352223,7012
"2386","Zm00001d005756","2",186575672,186586392,10720
"2387","Zm00001d005757","2",186640920,186642005,1085
"2388","Zm00001d005758","2",186851974,186864267,12293
"2389","Zm00001d005760","2",186872023,186873836,1813
"2390","Zm00001d005762","2",187005829,187013142,7313
"2391","Zm00001d005763","2",187123029,187124514,1485
"2392","Zm00001d005764","2",187147474,187151967,4493
"2393","Zm00001d005765","2",187199700,187205185,5485
"2394","Zm00001d005766","2",187317766,187318308,542
"2395","Zm00001d005769","2",187446021,187452551,6530
"2396","Zm00001d005772","2",187740365,187742024,1659
"2397","Zm00001d005773","2",187743003,187745051,2048
"2398","Zm00001d005775","2",187822656,187827500,4844
"2399","Zm00001d005776","2",187830483,187837915,7432
"2400","Zm00001d005777","2",187843506,187846171,2665
"2401","Zm00001d005779","2",188005707,188020534,14827
"2402","Zm00001d005782","2",188139025,188146351,7326
"2403","Zm00001d005783","2",188163535,188169807,6272
"2404","Zm00001d005785","2",188375253,188393203,17950
"2405","Zm00001d005789","2",188710662,188711219,557
"2406","Zm00001d005790","2",188712428,188713414,986
"2407","Zm00001d005791","2",188810174,188810485,311
"2408","Zm00001d005793","2",188849023,188849574,551
"2409","Zm00001d005794","2",188896263,188907951,11688
"2410","Zm00001d005795","2",188910705,188919424,8719
"2411","Zm00001d005798","2",189023745,189025630,1885
"2412","Zm00001d005802","2",189128516,189128986,470
"2413","Zm00001d005803","2",189211330,189212136,806
"2414","Zm00001d005805","2",189322882,189368274,45392
"2415","Zm00001d005806","2",189324500,189325576,1076
"2416","Zm00001d005808","2",189439983,189444202,4219
"2417","Zm00001d005812","2",189451023,189467263,16240
"2418","Zm00001d005813","2",189505960,189508316,2356
"2419","Zm00001d005814","2",189518235,189520622,2387
"2420","Zm00001d005815","2",189555403,189561478,6075
"2421","Zm00001d005816","2",189574551,189576464,1913
"2422","Zm00001d005817","2",189633786,189637238,3452
"2423","Zm00001d005818","2",189658754,189670074,11320
"2424","Zm00001d005819","2",189677194,189677646,452
"2425","Zm00001d005821","2",189704103,189706705,2602
"2426","Zm00001d005822","2",189708364,189712407,4043
"2427","Zm00001d005823","2",189797589,189799971,2382
"2428","Zm00001d005824","2",189868857,189873743,4886
"2429","Zm00001d005826","2",189991149,189994800,3651
"2430","Zm00001d005828","2",190018435,190023429,4994
"2431","Zm00001d005831","2",190284721,190291227,6506
"2432","Zm00001d005832","2",190309053,190311312,2259
"2433","Zm00001d005833","2",190344608,190350123,5515
"2434","Zm00001d005834","2",190352551,190353920,1369
"2435","Zm00001d005837","2",190479047,190479916,869
"2436","Zm00001d005839","2",190535752,190538683,2931
"2437","Zm00001d005840","2",190539671,190546933,7262
"2438","Zm00001d005842","2",190584581,190597067,12486
"2439","Zm00001d005843","2",190605384,190606902,1518
"2440","Zm00001d005846","2",190700415,190703601,3186
"2441","Zm00001d005847","2",190761654,190768786,7132
"2442","Zm00001d005848","2",190807532,190810711,3179
"2443","Zm00001d005849","2",190823918,190826106,2188
"2444","Zm00001d005851","2",190884602,190889693,5091
"2445","Zm00001d005852","2",190894703,190897345,2642
"2446","Zm00001d005856","2",190962154,190972152,9998
"2447","Zm00001d005858","2",190973608,190979528,5920
"2448","Zm00001d005859","2",190995148,190996506,1358
"2449","Zm00001d005860","2",191022484,191023815,1331
"2450","Zm00001d005863","2",191081161,191083458,2297
"2451","Zm00001d005864","2",191162197,191162877,680
"2452","Zm00001d005865","2",191165955,191167271,1316
"2453","Zm00001d005866","2",191179662,191185177,5515
"2454","Zm00001d005867","2",191187571,191188776,1205
"2455","Zm00001d005869","2",191222821,191224017,1196
"2456","Zm00001d005871","2",191279063,191282059,2996
"2457","Zm00001d005873","2",191372098,191374009,1911
"2458","Zm00001d005874","2",191436169,191438639,2470
"2459","Zm00001d005875","2",191461110,191462620,1510
"2460","Zm00001d005879","2",191548746,191549021,275
"2461","Zm00001d005881","2",191713265,191717270,4005
"2462","Zm00001d005882","2",191723801,191726602,2801
"2463","Zm00001d005884","2",191754966,191757817,2851
"2464","Zm00001d005885","2",191770814,191772016,1202
"2465","Zm00001d005888","2",191778849,191782862,4013
"2466","Zm00001d005892","2",191897839,191898630,791
"2467","Zm00001d005893","2",191929625,191936363,6738
"2468","Zm00001d005894","2",192024817,192028922,4105
"2469","Zm00001d005895","2",192049716,192050012,296
"2470","Zm00001d005896","2",192056731,192058276,1545
"2471","Zm00001d005897","2",192117923,192119901,1978
"2472","Zm00001d005898","2",192211300,192212453,1153
"2473","Zm00001d005899","2",192214109,192221811,7702
"2474","Zm00001d005901","2",192223719,192225106,1387
"2475","Zm00001d005902","2",192256971,192280550,23579
"2476","Zm00001d005905","2",192376325,192377383,1058
"2477","Zm00001d005908","2",192405455,192408359,2904
"2478","Zm00001d005909","2",192448650,192450890,2240
"2479","Zm00001d005910","2",192450623,192451606,983
"2480","Zm00001d005912","2",192531480,192536267,4787
"2481","Zm00001d005915","2",192547616,192552402,4786
"2482","Zm00001d005917","2",192687906,192692019,4113
"2483","Zm00001d005920","2",192762349,192766625,4276
"2484","Zm00001d005922","2",192832482,192834768,2286
"2485","Zm00001d005924","2",192988965,192991429,2464
"2486","Zm00001d005925","2",192991654,192996971,5317
"2487","Zm00001d005926","2",193000868,193008427,7559
"2488","Zm00001d005928","2",193091484,193094035,2551
"2489","Zm00001d005931","2",193254454,193255314,860
"2490","Zm00001d005932","2",193258782,193262494,3712
"2491","Zm00001d005933","2",193264829,193267543,2714
"2492","Zm00001d005934","2",193307734,193311021,3287
"2493","Zm00001d005939","2",193440250,193442203,1953
"2494","Zm00001d005940","2",193447338,193448411,1073
"2495","Zm00001d005941","2",193486913,193488491,1578
"2496","Zm00001d005944","2",193501632,193503819,2187
"2497","Zm00001d005945","2",193506565,193507005,440
"2498","Zm00001d005946","2",193510609,193511116,507
"2499","Zm00001d005948","2",193530287,193553106,22819
"2500","Zm00001d005949","2",193582548,193587675,5127
"2501","Zm00001d005950","2",193717043,193722275,5232
"2502","Zm00001d005951","2",193728105,193730506,2401
"2503","Zm00001d005952","2",193764066,193765878,1812
"2504","Zm00001d005957","2",193812259,193813380,1121
"2505","Zm00001d005958","2",193814484,193820330,5846
"2506","Zm00001d005959","2",193820450,193821676,1226
"2507","Zm00001d005961","2",194011591,194015333,3742
"2508","Zm00001d005964","2",194057868,194060798,2930
"2509","Zm00001d005966","2",194069215,194071131,1916
"2510","Zm00001d005969","2",194253687,194260197,6510
"2511","Zm00001d005970","2",194261659,194262393,734
"2512","Zm00001d005971","2",194309786,194310601,815
"2513","Zm00001d005972","2",194430643,194444880,14237
"2514","Zm00001d005974","2",194484025,194486632,2607
"2515","Zm00001d005975","2",194488202,194490236,2034
"2516","Zm00001d005976","2",194515524,194519448,3924
"2517","Zm00001d005978","2",194543937,194544415,478
"2518","Zm00001d005980","2",194587917,194591943,4026
"2519","Zm00001d005981","2",194592768,194597099,4331
"2520","Zm00001d005983","2",194678094,194679159,1065
"2521","Zm00001d005984","2",194741383,194741934,551
"2522","Zm00001d005986","2",194817023,194820832,3809
"2523","Zm00001d005989","2",194858082,194858342,260
"2524","Zm00001d005990","2",194859678,194862485,2807
"2525","Zm00001d005991","2",194879654,194902888,23234
"2526","Zm00001d005993","2",194914879,194915718,839
"2527","Zm00001d005995","2",194924153,194930709,6556
"2528","Zm00001d005996","2",194931495,194932217,722
"2529","Zm00001d005997","2",194951202,194954366,3164
"2530","Zm00001d005998","2",194954684,194956316,1632
"2531","Zm00001d006001","2",195047188,195051225,4037
"2532","Zm00001d006002","2",195072053,195073262,1209
"2533","Zm00001d006008","2",195179025,195182945,3920
"2534","Zm00001d006010","2",195228750,195230170,1420
"2535","Zm00001d006011","2",195231015,195246454,15439
"2536","Zm00001d006013","2",195255047,195255618,571
"2537","Zm00001d006014","2",195257402,195259311,1909
"2538","Zm00001d006016","2",195298613,195299098,485
"2539","Zm00001d006017","2",195306607,195307923,1316
"2540","Zm00001d006019","2",195358970,195361575,2605
"2541","Zm00001d006022","2",195425336,195428897,3561
"2542","Zm00001d006024","2",195440959,195443355,2396
"2543","Zm00001d006025","2",195445740,195447994,2254
"2544","Zm00001d006026","2",195514497,195514982,485
"2545","Zm00001d006027","2",195561468,195570994,9526
"2546","Zm00001d006028","2",195579800,195583642,3842
"2547","Zm00001d006029","2",195679940,195680353,413
"2548","Zm00001d006030","2",195706441,195714239,7798
"2549","Zm00001d006031","2",195761096,195762196,1100
"2550","Zm00001d006032","2",195797936,195798310,374
"2551","Zm00001d006033","2",195811241,195819078,7837
"2552","Zm00001d006034","2",195820134,195824384,4250
"2553","Zm00001d006036","2",195892796,195896295,3499
"2554","Zm00001d006040","2",196142203,196146694,4491
"2555","Zm00001d006041","2",196151062,196157967,6905
"2556","Zm00001d006043","2",196208545,196208934,389
"2557","Zm00001d006044","2",196208834,196209061,227
"2558","Zm00001d006046","2",196379947,196403384,23437
"2559","Zm00001d006047","2",196520756,196522983,2227
"2560","Zm00001d006049","2",196549581,196558567,8986
"2561","Zm00001d006050","2",196558630,196560244,1614
"2562","Zm00001d006051","2",196572120,196575594,3474
"2563","Zm00001d006052","2",196575825,196581941,6116
"2564","Zm00001d006053","2",196582504,196584317,1813
"2565","Zm00001d006054","2",196609825,196611039,1214
"2566","Zm00001d006055","2",196661880,196666379,4499
"2567","Zm00001d006056","2",196690494,196696633,6139
"2568","Zm00001d006057","2",196697374,196700761,3387
"2569","Zm00001d006059","2",196801414,196802728,1314
"2570","Zm00001d006060","2",196878663,196879046,383
"2571","Zm00001d006061","2",196886906,196890424,3518
"2572","Zm00001d006063","2",197034354,197040580,6226
"2573","Zm00001d006064","2",197103692,197105520,1828
"2574","Zm00001d006065","2",197131272,197133841,2569
"2575","Zm00001d006066","2",197195556,197208536,12980
"2576","Zm00001d006067","2",197252964,197253703,739
"2577","Zm00001d006068","2",197297065,197298764,1699
"2578","Zm00001d006070","2",197414822,197417429,2607
"2579","Zm00001d006071","2",197417497,197420294,2797
"2580","Zm00001d006072","2",197421179,197424807,3628
"2581","Zm00001d006073","2",197444793,197447426,2633
"2582","Zm00001d006078","2",197542925,197543503,578
"2583","Zm00001d006079","2",197544668,197551476,6808
"2584","Zm00001d006080","2",197575106,197579019,3913
"2585","Zm00001d006082","2",197602488,197606112,3624
"2586","Zm00001d006084","2",197709202,197717272,8070
"2587","Zm00001d006085","2",197748870,197753145,4275
"2588","Zm00001d006089","2",197838173,197852949,14776
"2589","Zm00001d006090","2",197865474,197870127,4653
"2590","Zm00001d006091","2",197898982,197903861,4879
"2591","Zm00001d006094","2",197965590,197973716,8126
"2592","Zm00001d006096","2",198090417,198092894,2477
"2593","Zm00001d006097","2",198119518,198121782,2264
"2594","Zm00001d006098","2",198138267,198148545,10278
"2595","Zm00001d006099","2",198147947,198155511,7564
"2596","Zm00001d006100","2",198157322,198159769,2447
"2597","Zm00001d006101","2",198162667,198163122,455
"2598","Zm00001d006102","2",198166081,198172199,6118
"2599","Zm00001d006103","2",198177578,198179576,1998
"2600","Zm00001d006106","2",198198555,198200085,1530
"2601","Zm00001d006107","2",198318592,198324907,6315
"2602","Zm00001d006108","2",198339948,198347001,7053
"2603","Zm00001d006109","2",198436916,198438553,1637
"2604","Zm00001d006110","2",198518592,198520833,2241
"2605","Zm00001d006111","2",198625267,198625929,662
"2606","Zm00001d006112","2",198703510,198708598,5088
"2607","Zm00001d006113","2",198798411,198822169,23758
"2608","Zm00001d006115","2",198986664,198998001,11337
"2609","Zm00001d006116","2",199001851,199007982,6131
"2610","Zm00001d006117","2",199028000,199036096,8096
"2611","Zm00001d006118","2",199148929,199152831,3902
"2612","Zm00001d006119","2",199181914,199182393,479
"2613","Zm00001d006122","2",199207550,199208441,891
"2614","Zm00001d006124","2",199251572,199256700,5128
"2615","Zm00001d006125","2",199259912,199262530,2618
"2616","Zm00001d006126","2",199262613,199265379,2766
"2617","Zm00001d006127","2",199265525,199270738,5213
"2618","Zm00001d006128","2",199356142,199361506,5364
"2619","Zm00001d006130","2",199406737,199412468,5731
"2620","Zm00001d006131","2",199416217,199426495,10278
"2621","Zm00001d006132","2",199483327,199486703,3376
"2622","Zm00001d006133","2",199509522,199514949,5427
"2623","Zm00001d006134","2",199512791,199513658,867
"2624","Zm00001d006136","2",199540273,199541992,1719
"2625","Zm00001d006142","2",199695211,199699168,3957
"2626","Zm00001d006143","2",199701466,199706707,5241
"2627","Zm00001d006148","2",199732274,199737516,5242
"2628","Zm00001d006153","2",199939674,199944750,5076
"2629","Zm00001d006154","2",199945525,199947408,1883
"2630","Zm00001d006157","2",200049082,200051424,2342
"2631","Zm00001d006158","2",200053666,200054876,1210
"2632","Zm00001d006159","2",200079624,200081355,1731
"2633","Zm00001d006160","2",200081380,200085900,4520
"2634","Zm00001d006162","2",200196709,200220177,23468
"2635","Zm00001d006165","2",200270198,200271190,992
"2636","Zm00001d006166","2",200272553,200276422,3869
"2637","Zm00001d006167","2",200299238,200303499,4261
"2638","Zm00001d006168","2",200357239,200361951,4712
"2639","Zm00001d006169","2",200397718,200398512,794
"2640","Zm00001d006170","2",200403153,200403895,742
"2641","Zm00001d006171","2",200420127,200421725,1598
"2642","Zm00001d006172","2",200515460,200522859,7399
"2643","Zm00001d006175","2",200675716,200678474,2758
"2644","Zm00001d006176","2",200726468,200731634,5166
"2645","Zm00001d006177","2",200734879,200745262,10383
"2646","Zm00001d006179","2",200782471,200786352,3881
"2647","Zm00001d006180","2",200830545,200833132,2587
"2648","Zm00001d006181","2",200885450,200888974,3524
"2649","Zm00001d006182","2",200890503,200891555,1052
"2650","Zm00001d006183","2",200914588,200917495,2907
"2651","Zm00001d006184","2",200972420,200977073,4653
"2652","Zm00001d006185","2",200996430,200999253,2823
"2653","Zm00001d006190","2",201035353,201040173,4820
"2654","Zm00001d006192","2",201119689,201125472,5783
"2655","Zm00001d006193","2",201255021,201257277,2256
"2656","Zm00001d006194","2",201266019,201271833,5814
"2657","Zm00001d006195","2",201274832,201276496,1664
"2658","Zm00001d006196","2",201279600,201279866,266
"2659","Zm00001d006197","2",201329839,201334835,4996
"2660","Zm00001d006198","2",201392406,201400007,7601
"2661","Zm00001d006199","2",201505641,201507497,1856
"2662","Zm00001d006203","2",201671754,201673782,2028
"2663","Zm00001d006204","2",201767594,201770825,3231
"2664","Zm00001d006205","2",201773191,201776998,3807
"2665","Zm00001d006207","2",201786822,201788703,1881
"2666","Zm00001d006208","2",201886054,201892147,6093
"2667","Zm00001d006209","2",201896427,201897959,1532
"2668","Zm00001d006210","2",201905639,201911544,5905
"2669","Zm00001d006211","2",201912795,201914678,1883
"2670","Zm00001d006212","2",201957643,201964027,6384
"2671","Zm00001d006213","2",201970912,201971385,473
"2672","Zm00001d006214","2",201993607,202010674,17067
"2673","Zm00001d006215","2",202055895,202062873,6978
"2674","Zm00001d006217","2",202081239,202085911,4672
"2675","Zm00001d006219","2",202177264,202181030,3766
"2676","Zm00001d006220","2",202182423,202186723,4300
"2677","Zm00001d006221","2",202188330,202192176,3846
"2678","Zm00001d006226","2",202327057,202329536,2479
"2679","Zm00001d006227","2",202364747,202368567,3820
"2680","Zm00001d006230","2",202392518,202411974,19456
"2681","Zm00001d006231","2",202413009,202414316,1307
"2682","Zm00001d006232","2",202416891,202418828,1937
"2683","Zm00001d006235","2",202495264,202498539,3275
"2684","Zm00001d006236","2",202580128,202588798,8670
"2685","Zm00001d006237","2",202588963,202591234,2271
"2686","Zm00001d006238","2",202615728,202622663,6935
"2687","Zm00001d006242","2",202646606,202650071,3465
"2688","Zm00001d006243","2",202663871,202670238,6367
"2689","Zm00001d006244","2",202673092,202674300,1208
"2690","Zm00001d006246","2",202741786,202747195,5409
"2691","Zm00001d006247","2",202804445,202804870,425
"2692","Zm00001d006249","2",202837832,202840525,2693
"2693","Zm00001d006250","2",202844285,202847831,3546
"2694","Zm00001d006251","2",202849064,202852007,2943
"2695","Zm00001d006252","2",202859109,202862675,3566
"2696","Zm00001d006254","2",202895910,202898244,2334
"2697","Zm00001d006255","2",202900948,202902555,1607
"2698","Zm00001d006256","2",202903835,202904632,797
"2699","Zm00001d006257","2",202910034,202917109,7075
"2700","Zm00001d006261","2",203134987,203135343,356
"2701","Zm00001d006262","2",203183372,203184196,824
"2702","Zm00001d006263","2",203194535,203195885,1350
"2703","Zm00001d006267","2",203274963,203284292,9329
"2704","Zm00001d006269","2",203287605,203291085,3480
"2705","Zm00001d006270","2",203313532,203322278,8746
"2706","Zm00001d006271","2",203376662,203391214,14552
"2707","Zm00001d006272","2",203379297,203381647,2350
"2708","Zm00001d006274","2",203395420,203402757,7337
"2709","Zm00001d006278","2",203403256,203403672,416
"2710","Zm00001d006279","2",203405094,203405564,470
"2711","Zm00001d006282","2",203489297,203489769,472
"2712","Zm00001d006283","2",203490871,203491346,475
"2713","Zm00001d006286","2",203633940,203638997,5057
"2714","Zm00001d006287","2",203642768,203644284,1516
"2715","Zm00001d006288","2",203647462,203651595,4133
"2716","Zm00001d006291","2",203787929,203790186,2257
"2717","Zm00001d006293","2",203858974,203864535,5561
"2718","Zm00001d006294","2",203866427,203867230,803
"2719","Zm00001d006295","2",203933323,203937922,4599
"2720","Zm00001d006296","2",203995835,204009490,13655
"2721","Zm00001d006297","2",204009613,204013076,3463
"2722","Zm00001d006298","2",204036760,204047868,11108
"2723","Zm00001d006302","2",204077037,204077887,850
"2724","Zm00001d006306","2",204114307,204116336,2029
"2725","Zm00001d006307","2",204151697,204175780,24083
"2726","Zm00001d006308","2",204222180,204225586,3406
"2727","Zm00001d006309","2",204243913,204249878,5965
"2728","Zm00001d006310","2",204252569,204255735,3166
"2729","Zm00001d006311","2",204256542,204260847,4305
"2730","Zm00001d006312","2",204262006,204262752,746
"2731","Zm00001d006315","2",204313242,204316524,3282
"2732","Zm00001d006316","2",204321472,204322036,564
"2733","Zm00001d006317","2",204325597,204331428,5831
"2734","Zm00001d006319","2",204432499,204451772,19273
"2735","Zm00001d006320","2",204487381,204491071,3690
"2736","Zm00001d006321","2",204514961,204517027,2066
"2737","Zm00001d006322","2",204521272,204527408,6136
"2738","Zm00001d006323","2",204593375,204611852,18477
"2739","Zm00001d006324","2",204611682,204615749,4067
"2740","Zm00001d006327","2",204637780,204641095,3315
"2741","Zm00001d006328","2",204816152,204820265,4113
"2742","Zm00001d006329","2",204888454,204889753,1299
"2743","Zm00001d006330","2",204891476,204893008,1532
"2744","Zm00001d006331","2",204901088,204902529,1441
"2745","Zm00001d006332","2",204904645,204906248,1603
"2746","Zm00001d006333","2",204940530,204943456,2926
"2747","Zm00001d006335","2",204943685,204948597,4912
"2748","Zm00001d006336","2",204951629,204962354,10725
"2749","Zm00001d006337","2",204963561,204973694,10133
"2750","Zm00001d006340","2",205015688,205019006,3318
"2751","Zm00001d006341","2",205066158,205070059,3901
"2752","Zm00001d006342","2",205070819,205077078,6259
"2753","Zm00001d006343","2",205076861,205080041,3180
"2754","Zm00001d006344","2",205082198,205087995,5797
"2755","Zm00001d006345","2",205186688,205195527,8839
"2756","Zm00001d006346","2",205249271,205252094,2823
"2757","Zm00001d006347","2",205253494,205257434,3940
"2758","Zm00001d006348","2",205258531,205260875,2344
"2759","Zm00001d006350","2",205337432,205343055,5623
"2760","Zm00001d006351","2",205398373,205404779,6406
"2761","Zm00001d006353","2",205435734,205439727,3993
"2762","Zm00001d006354","2",205440510,205444726,4216
"2763","Zm00001d006355","2",205467197,205471995,4798
"2764","Zm00001d006357","2",205658135,205671973,13838
"2765","Zm00001d006358","2",205687911,205689836,1925
"2766","Zm00001d006360","2",205697587,205699901,2314
"2767","Zm00001d006361","2",205704420,205705283,863
"2768","Zm00001d006364","2",205730168,205731628,1460
"2769","Zm00001d006365","2",205733931,205735679,1748
"2770","Zm00001d006368","2",205866818,205869808,2990
"2771","Zm00001d006369","2",205908412,205911375,2963
"2772","Zm00001d006370","2",205959669,205971341,11672
"2773","Zm00001d006372","2",205994533,205995809,1276
"2774","Zm00001d006373","2",205996236,206013907,17671
"2775","Zm00001d006374","2",206057451,206060931,3480
"2776","Zm00001d006377","2",206076000,206098072,22072
"2777","Zm00001d006382","2",206162736,206214491,51755
"2778","Zm00001d006383","2",206307891,206310167,2276
"2779","Zm00001d006384","2",206326049,206332270,6221
"2780","Zm00001d006387","2",206364249,206367453,3204
"2781","Zm00001d006388","2",206393416,206395466,2050
"2782","Zm00001d006389","2",206397414,206403110,5696
"2783","Zm00001d006390","2",206473408,206475669,2261
"2784","Zm00001d006396","2",206581586,206582314,728
"2785","Zm00001d006397","2",206585770,206587212,1442
"2786","Zm00001d006400","2",206594345,206597312,2967
"2787","Zm00001d006401","2",206597858,206602521,4663
"2788","Zm00001d006402","2",206603849,206617133,13284
"2789","Zm00001d006405","2",206810508,206812243,1735
"2790","Zm00001d006408","2",206925694,206933192,7498
"2791","Zm00001d006409","2",206933855,206943463,9608
"2792","Zm00001d006410","2",206972087,206978257,6170
"2793","Zm00001d006415","2",207275185,207284943,9758
"2794","Zm00001d006416","2",207289644,207290750,1106
"2795","Zm00001d006417","2",207291140,207302436,11296
"2796","Zm00001d006419","2",207348593,207352653,4060
"2797","Zm00001d006420","2",207446621,207450015,3394
"2798","Zm00001d006421","2",207451897,207463190,11293
"2799","Zm00001d006422","2",207465555,207484588,19033
"2800","Zm00001d006424","2",207475472,207476351,879
"2801","Zm00001d006426","2",207632720,207633785,1065
"2802","Zm00001d006428","2",207695606,207743821,48215
"2803","Zm00001d006430","2",207773994,207778741,4747
"2804","Zm00001d006433","2",207978895,207988982,10087
"2805","Zm00001d006435","2",207995752,207998297,2545
"2806","Zm00001d006438","2",208170854,208196792,25938
"2807","Zm00001d006439","2",208238550,208242017,3467
"2808","Zm00001d006440","2",208245555,208249764,4209
"2809","Zm00001d006443","2",208320521,208366475,45954
"2810","Zm00001d006444","2",208340822,208340895,73
"2811","Zm00001d006448","2",208518409,208521632,3223
"2812","Zm00001d006449","2",208538743,208540185,1442
"2813","Zm00001d006451","2",208544401,208546453,2052
"2814","Zm00001d006453","2",208705755,208713297,7542
"2815","Zm00001d006454","2",208726723,208733569,6846
"2816","Zm00001d006455","2",208748329,208752777,4448
"2817","Zm00001d006456","2",208770104,208775751,5647
"2818","Zm00001d006457","2",208849437,208854779,5342
"2819","Zm00001d006458","2",208855966,208856205,239
"2820","Zm00001d006459","2",208858703,208874260,15557
"2821","Zm00001d006460","2",208880307,208885292,4985
"2822","Zm00001d006461","2",208886176,208891521,5345
"2823","Zm00001d006463","2",208994101,208995156,1055
"2824","Zm00001d006464","2",208999149,209000577,1428
"2825","Zm00001d006466","2",209024796,209025665,869
"2826","Zm00001d006467","2",209132700,209135945,3245
"2827","Zm00001d009619","8",73563517,73564793,1276
"2828","Zm00001d009622","8",73601361,73602152,791
"2829","Zm00001d009626","8",73804434,73806809,2375
"2830","Zm00001d009627","8",73809006,73812662,3656
"2831","Zm00001d009631","8",73926124,73932511,6387
"2832","Zm00001d009632","8",73960382,73960903,521
"2833","Zm00001d009634","8",73966258,73968033,1775
"2834","Zm00001d009637","8",73988825,73989052,227
"2835","Zm00001d009638","8",73989684,73993106,3422
"2836","Zm00001d009639","8",74042271,74043501,1230
"2837","Zm00001d009640","8",74045695,74049815,4120
"2838","Zm00001d009641","8",74062769,74068522,5753
"2839","Zm00001d009642","8",74127546,74130567,3021
"2840","Zm00001d009645","8",74159857,74162455,2598
"2841","Zm00001d009646","8",74205128,74206555,1427
"2842","Zm00001d009648","8",74317968,74318441,473
"2843","Zm00001d009649","8",74319439,74349436,29997
"2844","Zm00001d009652","8",74457985,74460428,2443
"2845","Zm00001d009653","8",74612588,74614857,2269
"2846","Zm00001d009657","8",74879413,74913123,33710
"2847","Zm00001d009658","8",74913546,74918903,5357
"2848","Zm00001d009659","8",74949200,74950484,1284
"2849","Zm00001d009660","8",74951345,74955026,3681
"2850","Zm00001d009661","8",74956156,74962734,6578
"2851","Zm00001d009666","8",75117321,75122209,4888
"2852","Zm00001d009667","8",75122095,75124917,2822
"2853","Zm00001d009669","8",75146233,75152432,6199
"2854","Zm00001d009671","8",75375953,75379692,3739
"2855","Zm00001d009673","8",75380764,75381747,983
"2856","Zm00001d009674","8",75385981,75386700,719
"2857","Zm00001d009676","8",75406721,75412753,6032
"2858","Zm00001d009677","8",75506434,75508428,1994
"2859","Zm00001d009683","8",75778090,75788245,10155
"2860","Zm00001d009686","8",75878549,75880163,1614
"2861","Zm00001d009687","8",75918222,75919097,875
"2862","Zm00001d009690","8",76114808,76124300,9492
"2863","Zm00001d009693","8",76211167,76215916,4749
"2864","Zm00001d009694","8",76220435,76223080,2645
"2865","Zm00001d009695","8",76224121,76226394,2273
"2866","Zm00001d009697","8",76269865,76274649,4784
"2867","Zm00001d009700","8",76355207,76355707,500
"2868","Zm00001d009702","8",76423474,76428876,5402
"2869","Zm00001d009707","8",77010835,77013364,2529
"2870","Zm00001d009708","8",77013599,77017336,3737
"2871","Zm00001d009709","8",77053963,77055849,1886
"2872","Zm00001d009714","8",77386882,77391860,4978
"2873","Zm00001d009716","8",77435891,77440466,4575
"2874","Zm00001d009717","8",77524892,77526895,2003
"2875","Zm00001d009718","8",77713138,77713932,794
"2876","Zm00001d009719","8",77715746,77728401,12655
"2877","Zm00001d009723","8",77904227,77909237,5010
"2878","Zm00001d009724","8",77913640,77925636,11996
"2879","Zm00001d009726","8",77933762,77941132,7370
"2880","Zm00001d009727","8",78048174,78051296,3122
"2881","Zm00001d009728","8",78053324,78054686,1362
"2882","Zm00001d009730","8",78166129,78167664,1535
"2883","Zm00001d009731","8",78406103,78411071,4968
"2884","Zm00001d009732","8",78413554,78415125,1571
"2885","Zm00001d009733","8",78509895,78519823,9928
"2886","Zm00001d009734","8",78554635,78556193,1558
"2887","Zm00001d009735","8",78597291,78602479,5188
"2888","Zm00001d009736","8",78659182,78659787,605
"2889","Zm00001d009738","8",78664431,78667427,2996
"2890","Zm00001d009740","8",78864307,78867209,2902
"2891","Zm00001d009741","8",78866446,78869538,3092
"2892","Zm00001d009743","8",79019679,79021421,1742
"2893","Zm00001d009745","8",79159645,79185286,25641
"2894","Zm00001d009746","8",79189766,79191121,1355
"2895","Zm00001d009747","8",79418294,79421379,3085
"2896","Zm00001d009749","8",79541746,79548341,6595
"2897","Zm00001d009750","8",79623875,79651205,27330
"2898","Zm00001d009751","8",79664630,79676090,11460
"2899","Zm00001d009753","8",79788466,79795801,7335
"2900","Zm00001d009756","8",79839422,79844401,4979
"2901","Zm00001d009760","8",80074289,80077977,3688
"2902","Zm00001d009761","8",80078099,80082890,4791
"2903","Zm00001d009762","8",80083617,80085673,2056
"2904","Zm00001d009763","8",80087989,80092194,4205
"2905","Zm00001d009765","8",80235664,80240611,4947
"2906","Zm00001d009766","8",80256502,80259115,2613
"2907","Zm00001d009767","8",80260063,80261486,1423
"2908","Zm00001d009771","8",80433878,80440706,6828
"2909","Zm00001d009772","8",80442196,80442981,785
"2910","Zm00001d009773","8",80504928,80508153,3225
"2911","Zm00001d009774","8",80508328,80511529,3201
"2912","Zm00001d009775","8",80598451,80600049,1598
"2913","Zm00001d009776","8",80600743,80602204,1461
"2914","Zm00001d009779","8",80645709,80652834,7125
"2915","Zm00001d009780","8",80730257,80736271,6014
"2916","Zm00001d009783","8",80843265,80852115,8850
"2917","Zm00001d009786","8",81143296,81148339,5043
"2918","Zm00001d009787","8",81148760,81151947,3187
"2919","Zm00001d009790","8",81562747,81563859,1112
"2920","Zm00001d009791","8",81566526,81567864,1338
"2921","Zm00001d009792","8",81579628,81588173,8545
"2922","Zm00001d009794","8",81740813,81742184,1371
"2923","Zm00001d009795","8",81764683,81771357,6674
"2924","Zm00001d009797","8",81867264,81868166,902
"2925","Zm00001d009799","8",81983144,81986520,3376
"2926","Zm00001d009800","8",82037517,82040530,3013
"2927","Zm00001d009801","8",82095098,82105652,10554
"2928","Zm00001d009802","8",82152551,82155226,2675
"2929","Zm00001d009805","8",82284833,82286047,1214
"2930","Zm00001d009807","8",82290678,82294944,4266
"2931","Zm00001d009808","8",82342609,82346386,3777
"2932","Zm00001d009810","8",82399469,82420640,21171
"2933","Zm00001d009811","8",82521546,82526249,4703
"2934","Zm00001d009813","8",82664581,82669224,4643
"2935","Zm00001d009814","8",82751665,82755501,3836
"2936","Zm00001d009820","8",83444248,83444925,677
"2937","Zm00001d009821","8",83734688,83741390,6702
"2938","Zm00001d009823","8",83961158,83963468,2310
"2939","Zm00001d009824","8",83964141,83975862,11721
"2940","Zm00001d009826","8",84081260,84081703,443
"2941","Zm00001d009827","8",84137550,84142965,5415
"2942","Zm00001d009829","8",84167514,84169146,1632
"2943","Zm00001d009837","8",84424231,84443192,18961
"2944","Zm00001d009840","8",84651735,84665315,13580
"2945","Zm00001d009841","8",84656182,84656257,75
"2946","Zm00001d009843","8",84728701,84730303,1602
"2947","Zm00001d009844","8",84731498,84735845,4347
"2948","Zm00001d009847","8",84850186,84852212,2026
"2949","Zm00001d009848","8",84947841,84951081,3240
"2950","Zm00001d009849","8",85009775,85013595,3820
"2951","Zm00001d009850","8",85065908,85071126,5218
"2952","Zm00001d009856","8",85387075,85393144,6069
"2953","Zm00001d009858","8",85446294,85449522,3228
"2954","Zm00001d009859","8",85575018,85579656,4638
"2955","Zm00001d009860","8",85586338,85587757,1419
"2956","Zm00001d009861","8",85590624,85591268,644
"2957","Zm00001d009866","8",85801961,85806980,5019
"2958","Zm00001d009868","8",86006161,86009235,3074
"2959","Zm00001d009870","8",86257136,86260258,3122
"2960","Zm00001d009872","8",86435082,86440261,5179
"2961","Zm00001d009873","8",86595281,86616755,21474
"2962","Zm00001d009874","8",86637512,86639226,1714
"2963","Zm00001d009875","8",86744168,86745360,1192
"2964","Zm00001d009876","8",86749320,86750225,905
"2965","Zm00001d009878","8",86792766,86798116,5350
"2966","Zm00001d009879","8",86964414,86974986,10572
"2967","Zm00001d009883","8",87301378,87313130,11752
"2968","Zm00001d009888","8",87461049,87464607,3558
"2969","Zm00001d009889","8",87464523,87467367,2844
"2970","Zm00001d009890","8",87550201,87555557,5356
"2971","Zm00001d009891","8",87730225,87731601,1376
"2972","Zm00001d009896","8",88346876,88348228,1352
"2973","Zm00001d009899","8",88359892,88361920,2028
"2974","Zm00001d009902","8",88538583,88539110,527
"2975","Zm00001d009903","8",88654283,88664095,9812
"2976","Zm00001d009904","8",88701504,88703234,1730
"2977","Zm00001d009907","8",88814089,88820257,6168
"2978","Zm00001d009908","8",88820372,88824486,4114
"2979","Zm00001d009909","8",88932289,88934514,2225
"2980","Zm00001d009910","8",89031988,89036730,4742
"2981","Zm00001d009912","8",89305511,89308955,3444
"2982","Zm00001d009917","8",89367383,89369652,2269
"2983","Zm00001d009918","8",89376858,89377982,1124
"2984","Zm00001d009919","8",89463524,89490687,27163
"2985","Zm00001d009920","8",89468817,89469254,437
"2986","Zm00001d009923","8",89514439,89514723,284
"2987","Zm00001d009925","8",89557678,89567208,9530
"2988","Zm00001d009926","8",89589846,89594378,4532
"2989","Zm00001d009927","8",89836959,89844830,7871
"2990","Zm00001d009928","8",90095684,90107086,11402
"2991","Zm00001d009930","8",90323684,90345058,21374
"2992","Zm00001d009931","8",90450426,90452016,1590
"2993","Zm00001d009932","8",90455463,90456568,1105
"2994","Zm00001d009938","8",90687124,90692850,5726
"2995","Zm00001d009939","8",90768544,90769854,1310
"2996","Zm00001d009940","8",90887412,90900689,13277
"2997","Zm00001d009941","8",91082108,91093443,11335
"2998","Zm00001d009943","8",91379472,91379927,455
"2999","Zm00001d009944","8",91486603,91488381,1778
"3000","Zm00001d009945","8",91618566,91619117,551
"3001","Zm00001d009946","8",91667723,91670375,2652
"3002","Zm00001d009948","8",91813684,91819885,6201
"3003","Zm00001d009950","8",91946184,91954177,7993
"3004","Zm00001d009952","8",92079626,92080870,1244
"3005","Zm00001d009954","8",92226611,92230073,3462
"3006","Zm00001d009957","8",92291684,92292100,416
"3007","Zm00001d009958","8",92365751,92370669,4918
"3008","Zm00001d009960","8",92432744,92434990,2246
"3009","Zm00001d009962","8",92539196,92543525,4329
"3010","Zm00001d009964","8",92639578,92640662,1084
"3011","Zm00001d009965","8",92683851,92686179,2328
"3012","Zm00001d009967","8",92806471,92809519,3048
"3013","Zm00001d009968","8",92810217,92814940,4723
"3014","Zm00001d009969","8",92864170,92865394,1224
"3015","Zm00001d009971","8",93018884,93020443,1559
"3016","Zm00001d009978","8",93224718,93232598,7880
"3017","Zm00001d009979","8",93239142,93240713,1571
"3018","Zm00001d009981","8",93300280,93300732,452
"3019","Zm00001d009983","8",93324376,93339948,15572
"3020","Zm00001d009984","8",93354954,93355892,938
"3021","Zm00001d009985","8",93476338,93476907,569
"3022","Zm00001d009987","8",93548283,93551747,3464
"3023","Zm00001d009990","8",93603801,93617450,13649
"3024","Zm00001d009991","8",93654128,93655124,996
"3025","Zm00001d009993","8",93658817,93659596,779
"3026","Zm00001d009994","8",93778552,93782184,3632
"3027","Zm00001d009997","8",93874492,93879064,4572
"3028","Zm00001d010000","8",94267880,94280726,12846
"3029","Zm00001d010001","8",94479714,94480373,659
"3030","Zm00001d010005","8",94793182,94793514,332
"3031","Zm00001d010007","8",94844625,94845188,563
"3032","Zm00001d010008","8",94945161,94946129,968
"3033","Zm00001d010009","8",94987331,94992881,5550
"3034","Zm00001d010012","8",95062802,95064229,1427
"3035","Zm00001d010016","8",95242385,95245137,2752
"3036","Zm00001d010017","8",95277830,95279023,1193
"3037","Zm00001d010018","8",95284496,95290533,6037
"3038","Zm00001d010019","8",95340879,95346245,5366
"3039","Zm00001d010021","8",95481233,95494643,13410
"3040","Zm00001d010022","8",95491555,95491629,74
"3041","Zm00001d010023","8",95603408,95610248,6840
"3042","Zm00001d010025","8",95728603,95728815,212
"3043","Zm00001d010026","8",95731144,95746178,15034
"3044","Zm00001d010029","8",96089579,96110859,21280
"3045","Zm00001d010030","8",96117840,96119368,1528
"3046","Zm00001d010031","8",96226104,96230791,4687
"3047","Zm00001d010033","8",96359755,96364011,4256
"3048","Zm00001d010037","8",96478441,96481137,2696
"3049","Zm00001d010038","8",96491004,96492002,998
"3050","Zm00001d010039","8",96545534,96548068,2534
"3051","Zm00001d010040","8",96550754,96552913,2159
"3052","Zm00001d010043","8",96651144,96654539,3395
"3053","Zm00001d010044","8",96676310,96679113,2803
"3054","Zm00001d010047","8",96814230,96821045,6815
"3055","Zm00001d010048","8",96823511,96826858,3347
"3056","Zm00001d010049","8",96929763,96933742,3979
"3057","Zm00001d010050","8",97186607,97202827,16220
"3058","Zm00001d010052","8",97369263,97369553,290
"3059","Zm00001d010053","8",97370524,97377339,6815
"3060","Zm00001d010054","8",97426597,97434373,7776
"3061","Zm00001d010055","8",97441713,97445990,4277
"3062","Zm00001d010056","8",97510673,97521556,10883
"3063","Zm00001d010060","8",97570198,97574373,4175
"3064","Zm00001d010061","8",97788426,97791489,3063
"3065","Zm00001d010062","8",97855255,97858701,3446
"3066","Zm00001d010066","8",98053188,98055472,2284
"3067","Zm00001d010067","8",98130878,98131378,500
"3068","Zm00001d010068","8",98132272,98144958,12686
"3069","Zm00001d010075","8",98424998,98426575,1577
"3070","Zm00001d010082","8",98725100,98728770,3670
"3071","Zm00001d010093","8",99085952,99087440,1488
"3072","Zm00001d010098","8",99153235,99164797,11562
"3073","Zm00001d010101","8",99188636,99188902,266
"3074","Zm00001d010103","8",99201987,99215876,13889
"3075","Zm00001d010104","8",99265097,99267822,2725
"3076","Zm00001d010106","8",99278127,99285066,6939
"3077","Zm00001d010109","8",99413208,99423754,10546
"3078","Zm00001d010112","8",99679515,99683976,4461
"3079","Zm00001d010113","8",99704881,99707179,2298
"3080","Zm00001d010115","8",99793883,99798377,4494
"3081","Zm00001d010116","8",99888781,99890778,1997
"3082","Zm00001d010117","8",99953745,99955435,1690
"3083","Zm00001d010118","8",99977954,99980670,2716
"3084","Zm00001d010120","8",100001051,100003421,2370
"3085","Zm00001d010121","8",100027537,100029612,2075
"3086","Zm00001d010126","8",100366359,100381929,15570
"3087","Zm00001d010128","8",100554189,100558541,4352
"3088","Zm00001d010129","8",100614218,100628152,13934
"3089","Zm00001d010131","8",100728784,100731672,2888
"3090","Zm00001d010135","8",100961776,100968102,6326
"3091","Zm00001d010137","8",101127432,101131077,3645
"3092","Zm00001d010138","8",101134356,101136244,1888
"3093","Zm00001d010141","8",101170117,101176771,6654
"3094","Zm00001d010143","8",101193687,101196577,2890
"3095","Zm00001d010146","8",101393528,101397699,4171
"3096","Zm00001d010148","8",101477864,101478750,886
"3097","Zm00001d010149","8",101497876,101502119,4243
"3098","Zm00001d010151","8",101516044,101519727,3683
"3099","Zm00001d010152","8",101638347,101645644,7297
"3100","Zm00001d010154","8",101952644,101953272,628
"3101","Zm00001d010155","8",102124695,102126389,1694
"3102","Zm00001d010157","8",102208222,102209684,1462
"3103","Zm00001d010159","8",102413407,102417640,4233
"3104","Zm00001d010162","8",102489032,102493406,4374
"3105","Zm00001d010168","8",102731520,102732709,1189
"3106","Zm00001d010169","8",102775476,102778015,2539
"3107","Zm00001d010171","8",102865067,102866878,1811
"3108","Zm00001d010172","8",102868668,102871737,3069
"3109","Zm00001d010173","8",102966044,102970742,4698
"3110","Zm00001d010174","8",102988900,102995883,6983
"3111","Zm00001d010176","8",103051255,103056161,4906
"3112","Zm00001d010177","8",103168730,103177381,8651
"3113","Zm00001d010178","8",103220122,103223093,2971
"3114","Zm00001d010179","8",103253523,103255817,2294
"3115","Zm00001d010180","8",103282261,103285386,3125
"3116","Zm00001d010182","8",103309593,103310399,806
"3117","Zm00001d010183","8",103311689,103312009,320
"3118","Zm00001d010184","8",103317537,103318258,721
"3119","Zm00001d010185","8",103319743,103320901,1158
"3120","Zm00001d010189","8",103431417,103434226,2809
"3121","Zm00001d010190","8",103456053,103460657,4604
"3122","Zm00001d010191","8",103461446,103462392,946
"3123","Zm00001d010193","8",103471796,103474708,2912
"3124","Zm00001d010195","8",103505231,103510959,5728
"3125","Zm00001d010196","8",103511647,103515671,4024
"3126","Zm00001d010197","8",103517662,103519284,1622
"3127","Zm00001d010198","8",103711081,103714624,3543
"3128","Zm00001d010199","8",103715364,103721070,5706
"3129","Zm00001d010200","8",103828466,103834917,6451
"3130","Zm00001d010201","8",103881482,103882231,749
"3131","Zm00001d010202","8",103899795,103902224,2429
"3132","Zm00001d010206","8",104000522,104004490,3968
"3133","Zm00001d010207","8",104003186,104013846,10660
"3134","Zm00001d010209","8",104126081,104126925,844
"3135","Zm00001d010210","8",104156555,104161455,4900
"3136","Zm00001d010211","8",104190537,104193407,2870
"3137","Zm00001d010212","8",104219167,104225767,6600
"3138","Zm00001d010213","8",104356766,104359468,2702
"3139","Zm00001d010214","8",104421415,104424050,2635
"3140","Zm00001d010216","8",104483932,104490884,6952
"3141","Zm00001d010220","8",104634542,104636543,2001
"3142","Zm00001d010221","8",104638259,104640544,2285
"3143","Zm00001d010222","8",104651150,104664433,13283
"3144","Zm00001d010225","8",104666103,104672339,6236
"3145","Zm00001d010227","8",104776612,104781353,4741
"3146","Zm00001d010228","8",104781411,104783647,2236
"3147","Zm00001d010229","8",104834692,104836455,1763
"3148","Zm00001d010230","8",104878461,104883524,5063
"3149","Zm00001d010231","8",104889503,104892637,3134
"3150","Zm00001d010232","8",105191750,105194782,3032
"3151","Zm00001d010233","8",105235028,105237892,2864
"3152","Zm00001d010234","8",105238117,105240069,1952
"3153","Zm00001d010235","8",105392133,105402990,10857
"3154","Zm00001d010236","8",105522084,105524781,2697
"3155","Zm00001d010240","8",105682069,105684075,2006
"3156","Zm00001d010241","8",105685601,105692553,6952
"3157","Zm00001d010243","8",105772525,105778881,6356
"3158","Zm00001d010244","8",105840363,105843126,2763
"3159","Zm00001d010248","8",105912796,105915953,3157
"3160","Zm00001d010249","8",106104980,106108483,3503
"3161","Zm00001d010251","8",106127323,106136257,8934
"3162","Zm00001d010254","8",106233072,106233144,72
"3163","Zm00001d010255","8",106233472,106242362,8890
"3164","Zm00001d010256","8",106410927,106411274,347
"3165","Zm00001d010257","8",106416156,106418799,2643
"3166","Zm00001d010259","8",106433937,106440262,6325
"3167","Zm00001d010260","8",106438797,106442510,3713
"3168","Zm00001d010261","8",106441757,106443479,1722
"3169","Zm00001d010262","8",106443650,106449673,6023
"3170","Zm00001d010266","8",106704067,106706040,1973
"3171","Zm00001d010269","8",106754905,106758240,3335
"3172","Zm00001d010271","8",106923773,106927424,3651
"3173","Zm00001d010272","8",106933113,106940357,7244
"3174","Zm00001d010274","8",106962806,106966802,3996
"3175","Zm00001d010275","8",107054058,107056775,2717
"3176","Zm00001d010278","8",107106041,107110813,4772
"3177","Zm00001d010279","8",107180171,107181825,1654
"3178","Zm00001d010280","8",107186649,107187548,899
"3179","Zm00001d010281","8",107230840,107239533,8693
"3180","Zm00001d010282","8",107273501,107276222,2721
"3181","Zm00001d010284","8",107398664,107399764,1100
"3182","Zm00001d010285","8",107515891,107520432,4541
"3183","Zm00001d010287","8",107618947,107621285,2338
"3184","Zm00001d010290","8",107773334,107777619,4285
"3185","Zm00001d010292","8",107889974,107895386,5412
"3186","Zm00001d010293","8",107984844,107994295,9451
"3187","Zm00001d010294","8",108101384,108104528,3144
"3188","Zm00001d010295","8",108162420,108163298,878
"3189","Zm00001d010300","8",108442669,108447132,4463
"3190","Zm00001d010304","8",108569248,108571613,2365
"3191","Zm00001d010305","8",108605879,108617303,11424
"3192","Zm00001d010308","8",108952820,108955164,2344
"3193","Zm00001d010309","8",109067495,109086927,19432
"3194","Zm00001d010313","8",109187145,109191635,4490
"3195","Zm00001d010314","8",109191593,109194518,2925
"3196","Zm00001d010315","8",109278193,109288346,10153
"3197","Zm00001d010317","8",109290280,109303103,12823
"3198","Zm00001d010319","8",109386250,109388789,2539
"3199","Zm00001d010321","8",109459050,109469711,10661
"3200","Zm00001d010322","8",109537444,109549673,12229
"3201","Zm00001d010324","8",109670375,109688082,17707
"3202","Zm00001d010325","8",109745230,109750097,4867
"3203","Zm00001d010329","8",109953875,109955137,1262
"3204","Zm00001d010333","8",110140571,110142090,1519
"3205","Zm00001d010336","8",110250082,110255517,5435
"3206","Zm00001d010337","8",110331514,110338034,6520
"3207","Zm00001d010339","8",110343399,110344710,1311
"3208","Zm00001d010340","8",110435824,110437308,1484
"3209","Zm00001d010341","8",110486620,110507227,20607
"3210","Zm00001d010343","8",110625726,110630782,5056
"3211","Zm00001d010352","8",110720107,110722725,2618
"3212","Zm00001d010360","8",111039047,111041287,2240
"3213","Zm00001d010366","8",111285374,111287271,1897
"3214","Zm00001d010367","8",111455394,111459241,3847
"3215","Zm00001d010368","8",111481667,111489438,7771
"3216","Zm00001d010371","8",111651373,111652278,905
"3217","Zm00001d010376","8",111891316,111892444,1128
"3218","Zm00001d010380","8",112187739,112189008,1269
"3219","Zm00001d010381","8",112230867,112233995,3128
"3220","Zm00001d010386","8",112567927,112570020,2093
"3221","Zm00001d010387","8",112571027,112572392,1365
"3222","Zm00001d010390","8",112606816,112611515,4699
"3223","Zm00001d010393","8",112613882,112618778,4896
"3224","Zm00001d010395","8",112627132,112633726,6594
"3225","Zm00001d010397","8",112811990,112813974,1984
"3226","Zm00001d010399","8",112882140,112884372,2232
"3227","Zm00001d010400","8",112885015,112906534,21519
"3228","Zm00001d010401","8",112914086,112917486,3400
"3229","Zm00001d010402","8",113056986,113057636,650
"3230","Zm00001d010403","8",113059177,113063728,4551
"3231","Zm00001d010404","8",113170632,113175869,5237
"3232","Zm00001d010406","8",113202370,113208725,6355
"3233","Zm00001d010409","8",113368257,113369757,1500
"3234","Zm00001d010410","8",113391975,113394577,2602
"3235","Zm00001d010411","8",113492914,113496509,3595
"3236","Zm00001d010413","8",113632424,113641803,9379
"3237","Zm00001d010414","8",113686929,113687780,851
"3238","Zm00001d010416","8",113888005,113894973,6968
"3239","Zm00001d010419","8",114173636,114174318,682
"3240","Zm00001d010420","8",114332704,114333342,638
"3241","Zm00001d010421","8",114332739,114337964,5225
"3242","Zm00001d010422","8",114407024,114407967,943
"3243","Zm00001d010424","8",114429696,114437920,8224
"3244","Zm00001d010425","8",114503452,114510881,7429
"3245","Zm00001d010426","8",114527255,114533597,6342
"3246","Zm00001d010427","8",114561277,114563902,2625
"3247","Zm00001d010428","8",114567038,114574956,7918
"3248","Zm00001d010430","8",114708506,114709489,983
"3249","Zm00001d010431","8",114839778,114842051,2273
"3250","Zm00001d010434","8",115007050,115007858,808
"3251","Zm00001d010436","8",115029092,115038370,9278
"3252","Zm00001d010439","8",115165591,115169781,4190
"3253","Zm00001d010440","8",115240665,115242366,1701
"3254","Zm00001d010441","8",115292481,115293126,645
"3255","Zm00001d010443","8",115380456,115387332,6876
"3256","Zm00001d010445","8",115433371,115435609,2238
"3257","Zm00001d010447","8",115541975,115546228,4253
"3258","Zm00001d010448","8",115603884,115610448,6564
"3259","Zm00001d010451","8",115726579,115728797,2218
"3260","Zm00001d010452","8",115783056,115786089,3033
"3261","Zm00001d010453","8",115881589,115884016,2427
"3262","Zm00001d010454","8",115914488,115918396,3908
"3263","Zm00001d010455","8",115967122,115979410,12288
"3264","Zm00001d010456","8",116048099,116074297,26198
"3265","Zm00001d010457","8",116068700,116069586,886
"3266","Zm00001d010458","8",116141888,116147596,5708
"3267","Zm00001d010459","8",116264102,116265454,1352
"3268","Zm00001d010460","8",116268070,116273853,5783
"3269","Zm00001d010461","8",116331820,116334299,2479
"3270","Zm00001d010462","8",116428681,116443993,15312
"3271","Zm00001d010463","8",116485946,116490538,4592
"3272","Zm00001d010465","8",116622336,116623424,1088
"3273","Zm00001d010466","8",116647539,116654587,7048
"3274","Zm00001d010470","8",116794753,116821433,26680
"3275","Zm00001d010476","8",117146840,117163644,16804
"3276","Zm00001d010478","8",117172758,117177215,4457
"3277","Zm00001d010480","8",117336587,117344203,7616
"3278","Zm00001d010481","8",117390702,117391457,755
"3279","Zm00001d010482","8",117400373,117403599,3226
"3280","Zm00001d010488","8",117495296,117501405,6109
"3281","Zm00001d010489","8",117531416,117535036,3620
"3282","Zm00001d010490","8",117575051,117587415,12364
"3283","Zm00001d010491","8",117740344,117744264,3920
"3284","Zm00001d010492","8",117765218,117780166,14948
"3285","Zm00001d010493","8",117899468,117903017,3549
"3286","Zm00001d010494","8",117945851,117946881,1030
"3287","Zm00001d010495","8",118000011,118007378,7367
"3288","Zm00001d010496","8",118061497,118063581,2084
"3289","Zm00001d010497","8",118067478,118071101,3623
"3290","Zm00001d010499","8",118126464,118128699,2235
"3291","Zm00001d010500","8",118163693,118167143,3450
"3292","Zm00001d010502","8",118234676,118240043,5367
"3293","Zm00001d010504","8",118250736,118254293,3557
"3294","Zm00001d010507","8",118419214,118420164,950
"3295","Zm00001d010510","8",118575434,118578714,3280
"3296","Zm00001d010512","8",118588081,118591573,3492
"3297","Zm00001d010514","8",118706704,118714516,7812
"3298","Zm00001d010515","8",118823956,118824476,520
"3299","Zm00001d010516","8",118826535,118828228,1693
"3300","Zm00001d010519","8",118867607,118872391,4784
"3301","Zm00001d010520","8",118976642,118978776,2134
"3302","Zm00001d010521","8",119045452,119050075,4623
"3303","Zm00001d010522","8",119101596,119110131,8535
"3304","Zm00001d010523","8",119143166,119149436,6270
"3305","Zm00001d010524","8",119166488,119169233,2745
"3306","Zm00001d010525","8",119256795,119260935,4140
"3307","Zm00001d010526","8",119261912,119278968,17056
"3308","Zm00001d010527","8",119321629,119322921,1292
"3309","Zm00001d010528","8",119336634,119338376,1742
"3310","Zm00001d010529","8",119419987,119423027,3040
"3311","Zm00001d010530","8",119423081,119427901,4820
"3312","Zm00001d010532","8",119571291,119572116,825
"3313","Zm00001d010534","8",119590651,119595708,5057
"3314","Zm00001d010535","8",119686699,119690647,3948
"3315","Zm00001d010536","8",119691974,119695828,3854
"3316","Zm00001d010537","8",119697753,119699902,2149
"3317","Zm00001d010538","8",119702969,119706314,3345
"3318","Zm00001d010543","8",119991826,119993034,1208
"3319","Zm00001d010545","8",120067262,120068632,1370
"3320","Zm00001d010546","8",120069723,120087832,18109
"3321","Zm00001d010547","8",120110986,120111879,893
"3322","Zm00001d010552","8",120190138,120191057,919
"3323","Zm00001d010554","8",120208529,120210536,2007
"3324","Zm00001d010556","8",120214574,120222701,8127
"3325","Zm00001d010558","8",120340485,120345629,5144
"3326","Zm00001d010560","8",120354275,120355551,1276
"3327","Zm00001d010564","8",120465369,120489619,24250
"3328","Zm00001d010565","8",120486731,120486946,215
"3329","Zm00001d010566","8",120517493,120519263,1770
"3330","Zm00001d010567","8",120521843,120553693,31850
"3331","Zm00001d010568","8",120539729,120541472,1743
"3332","Zm00001d010569","8",120641666,120642528,862
"3333","Zm00001d010572","8",120659293,120673593,14300
"3334","Zm00001d010573","8",120709091,120712055,2964
"3335","Zm00001d010574","8",120713490,120716661,3171
"3336","Zm00001d010575","8",120733570,120733881,311
"3337","Zm00001d010576","8",120764519,120771258,6739
"3338","Zm00001d010577","8",120764599,120767763,3164
"3339","Zm00001d010578","8",120771225,120776089,4864
"3340","Zm00001d010579","8",120806361,120811444,5083
"3341","Zm00001d010583","8",120891791,120902147,10356
"3342","Zm00001d010584","8",120904982,120906366,1384
"3343","Zm00001d010585","8",121006820,121019315,12495
"3344","Zm00001d010586","8",121034171,121034963,792
"3345","Zm00001d010587","8",121036274,121036795,521
"3346","Zm00001d010588","8",121126170,121128814,2644
"3347","Zm00001d010589","8",121139851,121141888,2037
"3348","Zm00001d010590","8",121144352,121148411,4059
"3349","Zm00001d010592","8",121234827,121235653,826
"3350","Zm00001d010594","8",121278982,121279731,749
"3351","Zm00001d010596","8",121427947,121428690,743
"3352","Zm00001d010599","8",121491863,121510968,19105
"3353","Zm00001d010602","8",121532075,121534063,1988
"3354","Zm00001d010603","8",121650264,121651522,1258
"3355","Zm00001d010604","8",121656899,121661464,4565
"3356","Zm00001d010606","8",121735846,121745421,9575
"3357","Zm00001d010607","8",121751703,121753400,1697
"3358","Zm00001d010610","8",121822415,121825887,3472
"3359","Zm00001d010611","8",121835234,121840580,5346
"3360","Zm00001d010614","8",121855840,121858325,2485
"3361","Zm00001d010615","8",121859419,121863645,4226
"3362","Zm00001d010616","8",121973116,121975989,2873
"3363","Zm00001d010617","8",122038132,122039596,1464
"3364","Zm00001d010618","8",122041622,122047006,5384
"3365","Zm00001d010619","8",122046356,122048785,2429
"3366","Zm00001d010620","8",122052965,122057327,4362
"3367","Zm00001d010622","8",122164068,122168126,4058
"3368","Zm00001d010625","8",122237999,122247973,9974
"3369","Zm00001d010628","8",122252032,122253246,1214
"3370","Zm00001d010629","8",122278283,122281316,3033
"3371","Zm00001d010631","8",122406423,122410156,3733
"3372","Zm00001d010632","8",122513877,122514876,999
"3373","Zm00001d010633","8",122649472,122649855,383
"3374","Zm00001d010634","8",122651175,122654847,3672
"3375","Zm00001d010635","8",122679613,122680551,938
"3376","Zm00001d010638","8",122764919,122767912,2993
"3377","Zm00001d010639","8",122780822,122786723,5901
"3378","Zm00001d010640","8",122789933,122790997,1064
"3379","Zm00001d010645","8",122851051,122852068,1017
"3380","Zm00001d010646","8",122873951,122875909,1958
"3381","Zm00001d010649","8",122943984,122944412,428
"3382","Zm00001d010650","8",122947080,122947421,341
"3383","Zm00001d010651","8",122974459,122974956,497
"3384","Zm00001d010652","8",122977749,122978627,878
"3385","Zm00001d010653","8",122980778,122981713,935
"3386","Zm00001d010654","8",123057413,123058486,1073
"3387","Zm00001d010655","8",123098135,123099861,1726
"3388","Zm00001d010656","8",123103586,123106431,2845
"3389","Zm00001d010658","8",123182660,123185472,2812
"3390","Zm00001d010661","8",123211885,123212355,470
"3391","Zm00001d010662","8",123263372,123266229,2857
"3392","Zm00001d010667","8",123641909,123643672,1763
"3393","Zm00001d010670","8",123786952,123790784,3832
"3394","Zm00001d010671","8",123808321,123811312,2991
"3395","Zm00001d010672","8",123814340,123816096,1756
"3396","Zm00001d010673","8",123817267,123819044,1777
"3397","Zm00001d010675","8",123944597,123946927,2330
"3398","Zm00001d010676","8",123949136,123949753,617
"3399","Zm00001d010678","8",124068184,124073672,5488
"3400","Zm00001d010679","8",124099236,124101535,2299
"3401","Zm00001d010680","8",124102246,124103296,1050
"3402","Zm00001d010684","8",124240535,124284136,43601
"3403","Zm00001d010689","8",124498926,124500368,1442
"3404","Zm00001d010690","8",124548140,124549582,1442
"3405","Zm00001d010693","8",124738149,124740137,1988
"3406","Zm00001d010697","8",124866876,124869473,2597
"3407","Zm00001d010698","8",124955542,124959901,4359
"3408","Zm00001d010700","8",124961672,124970124,8452
"3409","Zm00001d010702","8",124974034,124976815,2781
"3410","Zm00001d010703","8",125097970,125105036,7066
"3411","Zm00001d010704","8",125139476,125140021,545
"3412","Zm00001d010705","8",125143906,125145144,1238
"3413","Zm00001d010706","8",125229882,125230312,430
"3414","Zm00001d010710","8",125242585,125262467,19882
"3415","Zm00001d010711","8",125264862,125271121,6259
"3416","Zm00001d010712","8",125271534,125284867,13333
"3417","Zm00001d010713","8",125353037,125356933,3896
"3418","Zm00001d010714","8",125357230,125363502,6272
"3419","Zm00001d010715","8",125482282,125483096,814
"3420","Zm00001d010716","8",125524850,125538429,13579
"3421","Zm00001d010717","8",125540238,125542393,2155
"3422","Zm00001d010719","8",125575872,125588157,12285
"3423","Zm00001d010720","8",125869668,125880230,10562
"3424","Zm00001d010722","8",125886253,125887701,1448
"3425","Zm00001d010723","8",125888822,125894023,5201
"3426","Zm00001d010724","8",125953884,125957239,3355
"3427","Zm00001d010725","8",125964166,125967235,3069
"3428","Zm00001d010727","8",126049914,126051817,1903
"3429","Zm00001d010728","8",126076102,126078343,2241
"3430","Zm00001d010730","8",126238922,126239749,827
"3431","Zm00001d010731","8",126262318,126268366,6048
"3432","Zm00001d010732","8",126282952,126285155,2203
"3433","Zm00001d010733","8",126285347,126288165,2818
"3434","Zm00001d010734","8",126289362,126291913,2551
"3435","Zm00001d010735","8",126341522,126344134,2612
"3436","Zm00001d010736","8",126378027,126380486,2459
"3437","Zm00001d010738","8",126393988,126395618,1630
"3438","Zm00001d010740","8",126441198,126441836,638
"3439","Zm00001d010741","8",126443231,126443927,696
"3440","Zm00001d010743","8",126502112,126503641,1529
"3441","Zm00001d010744","8",126505748,126509894,4146
"3442","Zm00001d010749","8",126702595,126703446,851
"3443","Zm00001d010750","8",126704063,126706506,2443
"3444","Zm00001d010751","8",126849996,126850937,941
"3445","Zm00001d010752","8",126880531,126882389,1858
"3446","Zm00001d010754","8",126888364,126893011,4647
"3447","Zm00001d010755","8",126969528,126978127,8599
"3448","Zm00001d010756","8",126983553,126984104,551
"3449","Zm00001d010758","8",127166352,127183436,17084
"3450","Zm00001d010759","8",127187617,127188279,662
"3451","Zm00001d010763","8",127324745,127328114,3369
"3452","Zm00001d010764","8",127331260,127335064,3804
"3453","Zm00001d010765","8",127353795,127356821,3026
"3454","Zm00001d010768","8",127375395,127377900,2505
"3455","Zm00001d010770","8",127405251,127407793,2542
"3456","Zm00001d010771","8",127417553,127417921,368
"3457","Zm00001d010772","8",127427998,127431420,3422
"3458","Zm00001d010773","8",127462799,127467034,4235
"3459","Zm00001d010780","8",127573648,127577957,4309
"3460","Zm00001d010782","8",127602768,127607332,4564
"3461","Zm00001d010783","8",127618302,127620447,2145
"3462","Zm00001d010784","8",127677367,127682293,4926
"3463","Zm00001d010785","8",127752529,127754303,1774
"3464","Zm00001d010786","8",127756972,127757678,706
"3465","Zm00001d010790","8",127852075,127860775,8700
"3466","Zm00001d010791","8",127880214,127887153,6939
"3467","Zm00001d010792","8",127989073,127989276,203
"3468","Zm00001d010793","8",127990790,127992883,2093
"3469","Zm00001d010795","8",128032677,128035296,2619
"3470","Zm00001d010796","8",128039610,128045077,5467
"3471","Zm00001d010797","8",128115856,128116962,1106
"3472","Zm00001d010798","8",128194128,128195278,1150
"3473","Zm00001d010799","8",128196797,128210614,13817
"3474","Zm00001d010800","8",128212334,128215465,3131
"3475","Zm00001d010803","8",128340719,128342749,2030
"3476","Zm00001d010804","8",128347494,128353068,5574
"3477","Zm00001d010805","8",128361517,128362582,1065
"3478","Zm00001d010806","8",128421459,128425329,3870
"3479","Zm00001d010808","8",128526652,128530176,3524
"3480","Zm00001d010809","8",128593064,128595227,2163
"3481","Zm00001d010811","8",128600595,128623332,22737
"3482","Zm00001d010812","8",128602960,128604732,1772
"3483","Zm00001d010813","8",128624529,128626084,1555
"3484","Zm00001d010814","8",128678323,128678739,416
"3485","Zm00001d010816","8",128720707,128725365,4658
"3486","Zm00001d010818","8",128726095,128728727,2632
"3487","Zm00001d010819","8",128731751,128732017,266
"3488","Zm00001d010821","8",128734662,128743577,8915
"3489","Zm00001d010822","8",128819168,128821322,2154
"3490","Zm00001d010823","8",128844845,128851355,6510
"3491","Zm00001d010824","8",128893375,128896851,3476
"3492","Zm00001d010825","8",128897121,128901066,3945
"3493","Zm00001d010826","8",129099442,129101240,1798
"3494","Zm00001d010827","8",129101920,129102856,936
"3495","Zm00001d010828","8",129176182,129180135,3953
"3496","Zm00001d010832","8",129280800,129281597,797
"3497","Zm00001d010834","8",129331385,129334443,3058
"3498","Zm00001d010835","8",129351635,129358502,6867
"3499","Zm00001d010838","8",129538321,129541025,2704
"3500","Zm00001d010841","8",129806051,129808850,2799
"3501","Zm00001d010842","8",129920062,129926481,6419
"3502","Zm00001d010845","8",130064540,130065590,1050
"3503","Zm00001d010849","8",130303051,130312915,9864
"3504","Zm00001d010850","8",130351343,130365339,13996
"3505","Zm00001d010851","8",130405024,130407302,2278
"3506","Zm00001d010852","8",130475466,130479982,4516
"3507","Zm00001d010854","8",130507087,130512329,5242
"3508","Zm00001d010855","8",130579934,130582076,2142
"3509","Zm00001d010856","8",130582741,130583307,566
"3510","Zm00001d010858","8",130735309,130743521,8212
"3511","Zm00001d010859","8",130746935,130759764,12829
"3512","Zm00001d010862","8",130828250,130838826,10576
"3513","Zm00001d010863","8",130918702,130924131,5429
"3514","Zm00001d010866","8",131137504,131151595,14091
"3515","Zm00001d010867","8",131312765,131315032,2267
"3516","Zm00001d010868","8",131402311,131405968,3657
"3517","Zm00001d010869","8",131438563,131445218,6655
"3518","Zm00001d010871","8",131613133,131614413,1280
"3519","Zm00001d010872","8",131663121,131665828,2707
"3520","Zm00001d010874","8",131718096,131721200,3104
"3521","Zm00001d010877","8",131819719,131826254,6535
"3522","Zm00001d010880","8",131986532,131992085,5553
"3523","Zm00001d010883","8",132075633,132079394,3761
"3524","Zm00001d010884","8",132112713,132116755,4042
"3525","Zm00001d010885","8",132229099,132229569,470
"3526","Zm00001d010887","8",132233718,132244663,10945
"3527","Zm00001d010888","8",132246239,132247146,907
"3528","Zm00001d010889","8",132313361,132314587,1226
"3529","Zm00001d010892","8",132353505,132361349,7844
"3530","Zm00001d010894","8",132435792,132443091,7299
"3531","Zm00001d010895","8",132443170,132444536,1366
"3532","Zm00001d010901","8",132597426,132600443,3017
"3533","Zm00001d010902","8",132642732,132650793,8061
"3534","Zm00001d010905","8",132960114,132961254,1140
"3535","Zm00001d010906","8",132968203,132971400,3197
"3536","Zm00001d010907","8",132971022,132973384,2362
"3537","Zm00001d010908","8",133021675,133038871,17196
"3538","Zm00001d010909","8",133065083,133068403,3320
"3539","Zm00001d010910","8",133191620,133213896,22276
"3540","Zm00001d010914","8",133297510,133300574,3064
"3541","Zm00001d010915","8",133302073,133305442,3369
"3542","Zm00001d010918","8",133384901,133388865,3964
"3543","Zm00001d010919","8",133390968,133396135,5167
"3544","Zm00001d010920","8",133482823,133486240,3417
"3545","Zm00001d010924","8",133674282,133675882,1600
"3546","Zm00001d010926","8",133734451,133743726,9275
"3547","Zm00001d010927","8",133818073,133822277,4204
"3548","Zm00001d010928","8",133839411,133861487,22076
"3549","Zm00001d010929","8",133855942,133857172,1230
"3550","Zm00001d010936","8",134114418,134119217,4799
"3551","Zm00001d010939","8",134232723,134236713,3990
"3552","Zm00001d010940","8",134322252,134326104,3852
"3553","Zm00001d010942","8",134410312,134412421,2109
"3554","Zm00001d010943","8",134412981,134414678,1697
"3555","Zm00001d010944","8",134422478,134428729,6251
"3556","Zm00001d010945","8",134568860,134571722,2862
"3557","Zm00001d010946","8",134633259,134637535,4276
"3558","Zm00001d010948","8",134760586,134766141,5555
"3559","Zm00001d010950","8",134829668,134841732,12064
"3560","Zm00001d010954","8",134898932,134900131,1199
"3561","Zm00001d010956","8",134965004,134966797,1793
"3562","Zm00001d010957","8",135035604,135038405,2801
"3563","Zm00001d010958","8",135048675,135052501,3826
"3564","Zm00001d010961","8",135100380,135102824,2444
"3565","Zm00001d010962","8",135146519,135151310,4791
"3566","Zm00001d010965","8",135160655,135175817,15162
"3567","Zm00001d010967","8",135268693,135275891,7198
"3568","Zm00001d010968","8",135290042,135291508,1466
"3569","Zm00001d010969","8",135352146,135353765,1619
"3570","Zm00001d010970","8",135473700,135484287,10587
"3571","Zm00001d010971","8",135478420,135486619,8199
"3572","Zm00001d010972","8",135489409,135497743,8334
"3573","Zm00001d010973","8",135499333,135505055,5722
"3574","Zm00001d010974","8",135530020,135542207,12187
"3575","Zm00001d010975","8",135640289,135644098,3809
"3576","Zm00001d010976","8",135650671,135656323,5652
"3577","Zm00001d010982","8",135759694,135764370,4676
"3578","Zm00001d010985","8",135928640,135930519,1879
"3579","Zm00001d010986","8",135932034,135940852,8818
"3580","Zm00001d010987","8",136009216,136012084,2868
"3581","Zm00001d010988","8",136011962,136013101,1139
"3582","Zm00001d010991","8",136108091,136117602,9511
"3583","Zm00001d010994","8",136140894,136141484,590
"3584","Zm00001d010995","8",136175479,136181191,5712
"3585","Zm00001d010996","8",136177968,136178041,73
"3586","Zm00001d010997","8",136181225,136185544,4319
"3587","Zm00001d011000","8",136345772,136347914,2142
"3588","Zm00001d011003","8",136383321,136385182,1861
"3589","Zm00001d011004","8",136501174,136504583,3409
"3590","Zm00001d011005","8",136504799,136508752,3953
"3591","Zm00001d011006","8",136509479,136511617,2138
"3592","Zm00001d011007","8",136513437,136514465,1028
"3593","Zm00001d011013","8",136856323,136861244,4921
"3594","Zm00001d011014","8",136861793,136865800,4007
"3595","Zm00001d011015","8",136862423,136862496,73
"3596","Zm00001d011016","8",136862727,136863791,1064
"3597","Zm00001d011017","8",136945981,136947711,1730
"3598","Zm00001d011018","8",136946525,136946598,73
"3599","Zm00001d011020","8",136970923,136972274,1351
"3600","Zm00001d011023","8",136988544,136989134,590
"3601","Zm00001d011025","8",137005242,137005315,73
"3602","Zm00001d011026","8",137005681,137008014,2333
"3603","Zm00001d011027","8",137014426,137014499,73
"3604","Zm00001d011028","8",137014865,137015692,827
"3605","Zm00001d011034","8",137153416,137156549,3133
"3606","Zm00001d011035","8",137157191,137159528,2337
"3607","Zm00001d011036","8",137160033,137161709,1676
"3608","Zm00001d011037","8",137163480,137166111,2631
"3609","Zm00001d011038","8",137168646,137180188,11542
"3610","Zm00001d011040","8",137243767,137245380,1613
"3611","Zm00001d011041","8",137259915,137262192,2277
"3612","Zm00001d011042","8",137263199,137264292,1093
"3613","Zm00001d011048","8",137336032,137341707,5675
"3614","Zm00001d011049","8",137407523,137410764,3241
"3615","Zm00001d011050","8",137412009,137412332,323
"3616","Zm00001d011051","8",137414912,137418125,3213
"3617","Zm00001d011055","8",137530714,137531411,697
"3618","Zm00001d011057","8",137623293,137626148,2855
"3619","Zm00001d011058","8",137738410,137739805,1395
"3620","Zm00001d011059","8",137782297,137784337,2040
"3621","Zm00001d011060","8",137865331,137867859,2528
"3622","Zm00001d011061","8",137870763,137875616,4853
"3623","Zm00001d011062","8",137878655,137880829,2174
"3624","Zm00001d011063","8",137939414,137940319,905
"3625","Zm00001d011064","8",137946079,137947769,1690
"3626","Zm00001d011066","8",137997933,138000993,3060
"3627","Zm00001d011067","8",138001059,138003787,2728
"3628","Zm00001d011068","8",138006339,138008714,2375
"3629","Zm00001d011069","8",138012317,138019459,7142
"3630","Zm00001d011072","8",138049175,138049510,335
"3631","Zm00001d011073","8",138088618,138089577,959
"3632","Zm00001d011075","8",138093685,138114618,20933
"3633","Zm00001d011076","8",138160358,138161521,1163
"3634","Zm00001d011078","8",138325200,138331960,6760
"3635","Zm00001d011079","8",138332949,138333170,221
"3636","Zm00001d011080","8",138416663,138416884,221
"3637","Zm00001d011081","8",138418132,138420302,2170
"3638","Zm00001d011086","8",138467734,138470464,2730
"3639","Zm00001d011087","8",138475456,138478501,3045
"3640","Zm00001d011089","8",138646179,138656729,10550
"3641","Zm00001d011091","8",138660037,138672465,12428
"3642","Zm00001d011092","8",138776297,138778888,2591
"3643","Zm00001d011093","8",138778868,138779863,995
"3644","Zm00001d011095","8",138813684,138815295,1611
"3645","Zm00001d011096","8",138816382,138824360,7978
"3646","Zm00001d011097","8",138824703,138825854,1151
"3647","Zm00001d011099","8",139011948,139022404,10456
"3648","Zm00001d011100","8",139023538,139026280,2742
"3649","Zm00001d011101","8",139029176,139032177,3001
"3650","Zm00001d011102","8",139046022,139050812,4790
"3651","Zm00001d011103","8",139051855,139052400,545
"3652","Zm00001d011104","8",139082575,139085139,2564
"3653","Zm00001d011108","8",139153111,139157427,4316
"3654","Zm00001d011110","8",139269871,139272723,2852
"3655","Zm00001d011111","8",139303508,139306189,2681
"3656","Zm00001d011112","8",139306221,139307532,1311
"3657","Zm00001d011113","8",139372046,139374129,2083
"3658","Zm00001d011117","8",139408609,139410750,2141
"3659","Zm00001d011118","8",139411312,139412455,1143
"3660","Zm00001d011119","8",139412828,139416792,3964
"3661","Zm00001d011121","8",139540392,139546514,6122
"3662","Zm00001d011122","8",139568855,139571751,2896
"3663","Zm00001d011123","8",139676207,139677622,1415
"3664","Zm00001d011124","8",139732022,139736729,4707
"3665","Zm00001d011125","8",139738103,139742326,4223
"3666","Zm00001d011126","8",139741555,139742462,907
"3667","Zm00001d011130","8",139920304,139924414,4110
"3668","Zm00001d011131","8",139985928,139987215,1287
"3669","Zm00001d011132","8",140008931,140009959,1028
"3670","Zm00001d011133","8",140010389,140011159,770
"3671","Zm00001d011134","8",140017045,140019085,2040
"3672","Zm00001d011135","8",140019374,140028075,8701
"3673","Zm00001d011136","8",140060927,140065565,4638
"3674","Zm00001d011138","8",140114159,140118764,4605
"3675","Zm00001d011139","8",140120555,140123091,2536
"3676","Zm00001d011140","8",140252516,140267706,15190
"3677","Zm00001d011143","8",140382370,140386433,4063
"3678","Zm00001d011144","8",140400456,140402893,2437
"3679","Zm00001d011145","8",140403097,140406939,3842
"3680","Zm00001d011147","8",140680606,140689294,8688
"3681","Zm00001d011149","8",140722355,140727923,5568
"3682","Zm00001d011150","8",140735619,140741566,5947
"3683","Zm00001d011152","8",140853342,140860116,6774
"3684","Zm00001d011155","8",140995042,141000244,5202
"3685","Zm00001d011158","8",141169109,141194917,25808
"3686","Zm00001d011159","8",141235427,141250554,15127
"3687","Zm00001d011160","8",141328645,141333318,4673
"3688","Zm00001d011162","8",141382327,141385399,3072
"3689","Zm00001d011163","8",141396846,141397825,979
"3690","Zm00001d011164","8",141406799,141407230,431
"3691","Zm00001d011165","8",141490907,141495134,4227
"3692","Zm00001d011166","8",141517174,141521112,3938
"3693","Zm00001d011167","8",141582543,141586775,4232
"3694","Zm00001d011168","8",141588276,141595443,7167
"3695","Zm00001d011169","8",141595126,141602631,7505
"3696","Zm00001d011173","8",141779160,141783268,4108
"3697","Zm00001d011174","8",141805331,141812617,7286
"3698","Zm00001d011177","8",141824631,141849920,25289
"3699","Zm00001d011178","8",142037367,142043523,6156
"3700","Zm00001d011179","8",142099701,142102964,3263
"3701","Zm00001d011180","8",142163536,142168999,5463
"3702","Zm00001d011182","8",142209717,142212537,2820
"3703","Zm00001d011183","8",142217718,142219220,1502
"3704","Zm00001d011185","8",142292769,142293158,389
"3705","Zm00001d011187","8",142339407,142340699,1292
"3706","Zm00001d011188","8",142392309,142403203,10894
"3707","Zm00001d011189","8",142471390,142471749,359
"3708","Zm00001d011192","8",142592861,142598233,5372
"3709","Zm00001d011193","8",142602686,142607439,4753
"3710","Zm00001d011195","8",142645175,142650869,5694
"3711","Zm00001d011197","8",142733476,142738003,4527
"3712","Zm00001d011198","8",142745650,142747911,2261
"3713","Zm00001d011199","8",142755423,142759090,3667
"3714","Zm00001d011202","8",142838650,142846028,7378
"3715","Zm00001d011204","8",142921602,142927201,5599
"3716","Zm00001d011208","8",142999025,143000704,1679
"3717","Zm00001d011210","8",143020695,143027838,7143
"3718","Zm00001d011211","8",143046789,143050596,3807
"3719","Zm00001d011213","8",143159959,143167232,7273
"3720","Zm00001d011214","8",143201387,143209908,8521
"3721","Zm00001d011217","8",143248933,143249868,935
"3722","Zm00001d011220","8",143287270,143294857,7587
"3723","Zm00001d011222","8",143429094,143442206,13112
"3724","Zm00001d011223","8",143496324,143502314,5990
"3725","Zm00001d011224","8",143653902,143655972,2070
"3726","Zm00001d011225","8",143689328,143691031,1703
"3727","Zm00001d011226","8",143745669,143749054,3385
"3728","Zm00001d011227","8",143824670,143826338,1668
"3729","Zm00001d011228","8",143868837,143871501,2664
"3730","Zm00001d011229","8",143878381,143879600,1219
"3731","Zm00001d011231","8",143885370,143889762,4392
"3732","Zm00001d011233","8",144110777,144127837,17060
"3733","Zm00001d011236","8",144142073,144142525,452
"3734","Zm00001d011238","8",144163335,144166542,3207
"3735","Zm00001d011239","8",144197398,144200652,3254
"3736","Zm00001d011241","8",144284141,144285379,1238
"3737","Zm00001d011242","8",144285793,144288703,2910
"3738","Zm00001d011243","8",144386283,144391723,5440
"3739","Zm00001d011244","8",144396134,144400274,4140
"3740","Zm00001d011245","8",144402591,144406381,3790
"3741","Zm00001d011246","8",144409494,144413652,4158
"3742","Zm00001d011252","8",144609854,144617400,7546
"3743","Zm00001d011253","8",144623902,144628703,4801
"3744","Zm00001d011255","8",144690877,144693119,2242
"3745","Zm00001d011256","8",144697819,144699023,1204
"3746","Zm00001d011258","8",144732264,144737024,4760
"3747","Zm00001d011259","8",144791864,144807175,15311
"3748","Zm00001d011263","8",144951798,144954935,3137
"3749","Zm00001d011266","8",145117930,145123153,5223
"3750","Zm00001d011268","8",145143791,145144951,1160
"3751","Zm00001d011269","8",145257272,145259091,1819
"3752","Zm00001d011270","8",145290758,145291826,1068
"3753","Zm00001d011272","8",145369667,145384961,15294
"3754","Zm00001d011274","8",145454537,145455565,1028
"3755","Zm00001d011275","8",145509650,145510105,455
"3756","Zm00001d011276","8",145538120,145540432,2312
"3757","Zm00001d011277","8",145550689,145553038,2349
"3758","Zm00001d011278","8",145553974,145556680,2706
"3759","Zm00001d011282","8",145689308,145696596,7288
"3760","Zm00001d011283","8",145769052,145772245,3193
"3761","Zm00001d011284","8",145783765,145784846,1081
"3762","Zm00001d011285","8",145825712,145826506,794
"3763","Zm00001d011286","8",145832874,145835384,2510
"3764","Zm00001d011287","8",145974288,145978521,4233
"3765","Zm00001d011288","8",145979013,145985394,6381
"3766","Zm00001d011290","8",145988735,145990140,1405
"3767","Zm00001d011294","8",146062014,146075281,13267
"3768","Zm00001d011297","8",146093892,146095667,1775
"3769","Zm00001d011298","8",146108765,146113773,5008
"3770","Zm00001d011299","8",146128641,146131503,2862
"3771","Zm00001d011301","8",146174056,146176755,2699
"3772","Zm00001d011302","8",146180242,146181231,989
"3773","Zm00001d011304","8",146192052,146196828,4776
"3774","Zm00001d011308","8",146317656,146322089,4433
"3775","Zm00001d011309","8",146353906,146364466,10560
"3776","Zm00001d011311","8",146409219,146411054,1835
"3777","Zm00001d011312","8",146414508,146420244,5736
"3778","Zm00001d011314","8",146490050,146490819,769
"3779","Zm00001d011315","8",146513037,146520523,7486
"3780","Zm00001d011319","8",146546991,146554204,7213
"3781","Zm00001d011321","8",146619391,146622999,3608
"3782","Zm00001d011323","8",146669804,146671210,1406
"3783","Zm00001d011325","8",146690622,146694044,3422
"3784","Zm00001d011326","8",146725502,146726798,1296
"3785","Zm00001d011327","8",146781789,146783051,1262
"3786","Zm00001d011329","8",146863198,146868117,4919
"3787","Zm00001d011330","8",146957682,146961482,3800
"3788","Zm00001d011331","8",147057186,147058121,935
"3789","Zm00001d011333","8",147150138,147150711,573
"3790","Zm00001d011334","8",147199565,147204907,5342
"3791","Zm00001d011335","8",147223917,147226682,2765
"3792","Zm00001d011336","8",147228068,147231731,3663
"3793","Zm00001d011340","8",147322981,147323332,351
"3794","Zm00001d011342","8",147353740,147354088,348
"3795","Zm00001d011345","8",147384452,147384742,290
"3796","Zm00001d011346","8",147385385,147385869,484
"3797","Zm00001d011347","8",147387271,147396132,8861
"3798","Zm00001d011348","8",147533284,147535094,1810
"3799","Zm00001d011349","8",147535376,147539282,3906
"3800","Zm00001d011350","8",147564557,147566080,1523
"3801","Zm00001d011351","8",147718573,147727814,9241
"3802","Zm00001d011352","8",147819974,147824314,4340
"3803","Zm00001d011353","8",147890594,147896004,5410
"3804","Zm00001d011355","8",147966473,147976741,10268
"3805","Zm00001d011357","8",148193529,148200051,6522
"3806","Zm00001d011358","8",148347246,148348913,1667
"3807","Zm00001d011360","8",148421209,148436906,15697
"3808","Zm00001d011362","8",148481033,148484238,3205
"3809","Zm00001d011363","8",148506457,148509460,3003
"3810","Zm00001d011364","8",148605323,148613271,7948
"3811","Zm00001d011365","8",148696781,148699784,3003
"3812","Zm00001d011366","8",148702797,148711327,8530
"3813","Zm00001d011369","8",148782535,148785419,2884
"3814","Zm00001d011370","8",148833239,148839951,6712
"3815","Zm00001d011373","8",148912004,148917649,5645
"3816","Zm00001d011376","8",148941529,148941843,314
"3817","Zm00001d011377","8",148947109,148951347,4238
"3818","Zm00001d011378","8",148976902,148979037,2135
"3819","Zm00001d011379","8",149086163,149104674,18511
"3820","Zm00001d011382","8",149189401,149196570,7169
"3821","Zm00001d011384","8",149205043,149206335,1292
"3822","Zm00001d011386","8",149257114,149261860,4746
"3823","Zm00001d011387","8",149262980,149266214,3234
"3824","Zm00001d011388","8",149328151,149329765,1614
"3825","Zm00001d011392","8",149387614,149392198,4584
"3826","Zm00001d011394","8",149460412,149466127,5715
"3827","Zm00001d011395","8",149468056,149471702,3646
"3828","Zm00001d011396","8",149473967,149475758,1791
"3829","Zm00001d011397","8",149488689,149490233,1544
"3830","Zm00001d011398","8",149502003,149502899,896
"3831","Zm00001d011399","8",149508135,149509217,1082
"3832","Zm00001d011401","8",149523666,149538687,15021
"3833","Zm00001d011402","8",149530133,149531338,1205
"3834","Zm00001d011403","8",149539154,149540733,1579
"3835","Zm00001d011405","8",149593538,149597550,4012
"3836","Zm00001d011407","8",149727409,149729139,1730
"3837","Zm00001d011411","8",149791810,149800697,8887
"3838","Zm00001d011412","8",149801298,149801537,239
"3839","Zm00001d011413","8",149844919,149847262,2343
"3840","Zm00001d011417","8",149925945,149933256,7311
"3841","Zm00001d011418","8",149939788,149946885,7097
"3842","Zm00001d011419","8",149989038,149991368,2330
"3843","Zm00001d011420","8",150003296,150005437,2141
"3844","Zm00001d011424","8",150158919,150166669,7750
"3845","Zm00001d011426","8",150205443,150211752,6309
"3846","Zm00001d011427","8",150235940,150246330,10390
"3847","Zm00001d011428","8",150252009,150255723,3714
"3848","Zm00001d011429","8",150280527,150283978,3451
"3849","Zm00001d011430","8",150334356,150342192,7836
"3850","Zm00001d011433","8",150402349,150407215,4866
"3851","Zm00001d011435","8",150433596,150434378,782
"3852","Zm00001d011436","8",150438724,150441836,3112
"3853","Zm00001d011438","8",150482983,150484456,1473
"3854","Zm00001d011441","8",150500202,150502967,2765
"3855","Zm00001d011442","8",150519246,150520878,1632
"3856","Zm00001d011444","8",150552450,150556599,4149
"3857","Zm00001d011445","8",150552979,150561519,8540
"3858","Zm00001d011446","8",150561818,150568628,6810
"3859","Zm00001d011447","8",150745309,150759997,14688
"3860","Zm00001d011448","8",150835820,150848273,12453
"3861","Zm00001d011450","8",150848229,150851704,3475
"3862","Zm00001d011451","8",150860389,150861180,791
"3863","Zm00001d011454","8",150927227,150934087,6860
"3864","Zm00001d011457","8",150978531,150982287,3756
"3865","Zm00001d011458","8",150984719,150988729,4010
"3866","Zm00001d011459","8",150993826,150996995,3169
"3867","Zm00001d011461","8",151002173,151002925,752
"3868","Zm00001d011463","8",151149351,151150232,881
"3869","Zm00001d011465","8",151223811,151229866,6055
"3870","Zm00001d011466","8",151230889,151231338,449
"3871","Zm00001d011467","8",151280912,151281930,1018
"3872","Zm00001d011468","8",151319500,151319892,392
"3873","Zm00001d011471","8",151422855,151427992,5137
"3874","Zm00001d011473","8",151507871,151513696,5825
"3875","Zm00001d011474","8",151593900,151596896,2996
"3876","Zm00001d011476","8",151681893,151683677,1784
"3877","Zm00001d011477","8",151686903,151688979,2076
"3878","Zm00001d011478","8",151704998,151707238,2240
"3879","Zm00001d011483","8",151866938,151893350,26412
"3880","Zm00001d011486","8",152031011,152037797,6786
"3881","Zm00001d011487","8",152072966,152077705,4739
"3882","Zm00001d011490","8",152111717,152120844,9127
"3883","Zm00001d011491","8",152160885,152161811,926
"3884","Zm00001d011492","8",152164719,152170855,6136
"3885","Zm00001d011495","8",152339070,152343283,4213
"3886","Zm00001d011500","8",152633181,152636260,3079
"3887","Zm00001d011504","8",152696181,152705526,9345
"3888","Zm00001d011506","8",152782371,152788872,6501
"3889","Zm00001d011507","8",152823450,152824058,608
"3890","Zm00001d011510","8",152919755,152921651,1896
"3891","Zm00001d011511","8",152922425,152927023,4598
"3892","Zm00001d011512","8",152928115,152935307,7192
"3893","Zm00001d011513","8",152937472,152939599,2127
"3894","Zm00001d011514","8",152940770,152945300,4530
"3895","Zm00001d011517","8",153158834,153167071,8237
"3896","Zm00001d011518","8",153273584,153280045,6461
"3897","Zm00001d011519","8",153380566,153388211,7645
"3898","Zm00001d011520","8",153389142,153391041,1899
"3899","Zm00001d011523","8",153504230,153513873,9643
"3900","Zm00001d011525","8",153516587,153522891,6304
"3901","Zm00001d011526","8",153524335,153530937,6602
"3902","Zm00001d011527","8",153565171,153568905,3734
"3903","Zm00001d011528","8",153625010,153627475,2465
"3904","Zm00001d011529","8",153628391,153628786,395
"3905","Zm00001d011531","8",153644945,153649405,4460
"3906","Zm00001d011532","8",153672058,153703021,30963
"3907","Zm00001d011533","8",153698575,153703961,5386
"3908","Zm00001d011534","8",153717172,153718808,1636
"3909","Zm00001d011535","8",153750338,153752692,2354
"3910","Zm00001d011536","8",153754155,153756490,2335
"3911","Zm00001d011537","8",153797627,153801345,3718
"3912","Zm00001d011541","8",153955691,153971609,15918
"3913","Zm00001d011543","8",154129779,154130258,479
"3914","Zm00001d011551","8",154348667,154351099,2432
"3915","Zm00001d011555","8",154368362,154374551,6189
"3916","Zm00001d011558","8",154453455,154454081,626
"3917","Zm00001d011559","8",154455231,154456667,1436
"3918","Zm00001d011560","8",154457261,154486289,29028
"3919","Zm00001d011561","8",154491666,154495115,3449
"3920","Zm00001d011562","8",154552556,154555181,2625
"3921","Zm00001d011563","8",154569382,154576253,6871
"3922","Zm00001d011564","8",154577682,154582616,4934
"3923","Zm00001d011565","8",154584801,154588468,3667
"3924","Zm00001d011567","8",154589734,154591552,1818
"3925","Zm00001d011569","8",154611911,154620158,8247
"3926","Zm00001d011570","8",154700939,154705547,4608
"3927","Zm00001d011571","8",154708719,154709666,947
"3928","Zm00001d011572","8",154714166,154721196,7030
"3929","Zm00001d011573","8",154750703,154754636,3933
"3930","Zm00001d011576","8",154833208,154834329,1121
"3931","Zm00001d011577","8",154834948,154839347,4399
"3932","Zm00001d011578","8",154851163,154856045,4882
"3933","Zm00001d011579","8",154889188,154895325,6137
"3934","Zm00001d011580","8",154898654,154911041,12387
"3935","Zm00001d011581","8",154934544,154938908,4364
"3936","Zm00001d011585","8",155017528,155019848,2320
"3937","Zm00001d011587","8",155088689,155089376,687
"3938","Zm00001d011588","8",155128553,155133508,4955
"3939","Zm00001d011589","8",155137898,155138968,1070
"3940","Zm00001d011592","8",155293349,155295780,2431
"3941","Zm00001d011593","8",155321212,155335059,13847
"3942","Zm00001d011595","8",155342607,155378292,35685
"3943","Zm00001d011596","8",155437080,155438816,1736
"3944","Zm00001d011597","8",155439885,155445416,5531
"3945","Zm00001d011598","8",155464778,155473339,8561
"3946","Zm00001d011599","8",155473422,155477904,4482
"3947","Zm00001d011601","8",155555460,155561418,5958
"3948","Zm00001d011602","8",155605254,155612415,7161
"3949","Zm00001d011604","8",155670822,155680914,10092
"3950","Zm00001d011605","8",155682044,155685357,3313
"3951","Zm00001d011606","8",155789536,155794685,5149
"3952","Zm00001d011610","8",155807923,155820009,12086
"3953","Zm00001d011611","8",155860195,155866759,6564
"3954","Zm00001d011613","8",155923303,155925526,2223
"3955","Zm00001d011614","8",155950883,155952700,1817
"3956","Zm00001d011615","8",156039607,156044114,4507
"3957","Zm00001d011616","8",156079122,156082309,3187
"3958","Zm00001d011617","8",156102519,156107781,5262
"3959","Zm00001d011619","8",156247529,156251549,4020
"3960","Zm00001d011620","8",156255009,156256336,1327
"3961","Zm00001d011622","8",156364342,156377731,13389
"3962","Zm00001d011623","8",156440018,156444291,4273
"3963","Zm00001d011624","8",156531506,156535059,3553
"3964","Zm00001d011625","8",156535245,156540434,5189
"3965","Zm00001d011626","8",156542114,156543055,941
"3966","Zm00001d011628","8",156686200,156694580,8380
"3967","Zm00001d011629","8",156763311,156774071,10760
"3968","Zm00001d011630","8",156787111,156787413,302
"3969","Zm00001d011631","8",156787784,156790459,2675
"3970","Zm00001d011632","8",156789926,156801563,11637
"3971","Zm00001d011634","8",156906365,156914798,8433
"3972","Zm00001d011635","8",156918795,156919250,455
"3973","Zm00001d011636","8",156956138,156961395,5257
"3974","Zm00001d011638","8",157105897,157112089,6192
"3975","Zm00001d011639","8",157135997,157137214,1217
"3976","Zm00001d011640","8",157209018,157210495,1477
"3977","Zm00001d011641","8",157262559,157265938,3379
"3978","Zm00001d011642","8",157266444,157270844,4400
"3979","Zm00001d011643","8",157374297,157378344,4047
"3980","Zm00001d011644","8",157385847,157391117,5270
"3981","Zm00001d011646","8",157428446,157432723,4277
"3982","Zm00001d011648","8",157442417,157443844,1427
"3983","Zm00001d011649","8",157447787,157449229,1442
"3984","Zm00001d011650","8",157470984,157471706,722
"3985","Zm00001d011652","8",157561939,157568005,6066
"3986","Zm00001d011654","8",157636613,157637983,1370
"3987","Zm00001d011655","8",157649540,157650979,1439
"3988","Zm00001d011656","8",157692739,157694157,1418
"3989","Zm00001d011657","8",157706090,157707520,1430
"3990","Zm00001d011658","8",157722173,157725722,3549
"3991","Zm00001d011660","8",157761148,157769182,8034
"3992","Zm00001d011661","8",157816116,157817894,1778
"3993","Zm00001d011663","8",157967522,157972140,4618
"3994","Zm00001d011667","8",158090768,158092224,1456
"3995","Zm00001d011668","8",158113028,158118589,5561
"3996","Zm00001d011669","8",158166587,158167961,1374
"3997","Zm00001d011670","8",158185474,158188798,3324
"3998","Zm00001d011673","8",158269867,158274000,4133
"3999","Zm00001d011676","8",158309275,158313766,4491
"4000","Zm00001d011678","8",158327736,158331518,3782
"4001","Zm00001d011679","8",158415720,158417282,1562
"4002","Zm00001d011680","8",158512216,158527236,15020
"4003","Zm00001d011681","8",158521288,158522014,726
"4004","Zm00001d011684","8",158588724,158594994,6270
"4005","Zm00001d011685","8",158633943,158638370,4427
"4006","Zm00001d011688","8",158788080,158794162,6082
"4007","Zm00001d011691","8",158898274,158905198,6924
"4008","Zm00001d011692","8",158905685,158906986,1301
"4009","Zm00001d011694","8",158924825,158925220,395
"4010","Zm00001d011696","8",159018331,159024627,6296
"4011","Zm00001d011697","8",159028132,159032540,4408
"4012","Zm00001d011699","8",159166693,159171850,5157
"4013","Zm00001d011700","8",159172370,159181013,8643
"4014","Zm00001d011705","8",159247250,159252702,5452
"4015","Zm00001d011706","8",159306374,159314076,7702
"4016","Zm00001d011708","8",159401583,159404367,2784
"4017","Zm00001d011709","8",159455238,159458863,3625
"4018","Zm00001d011710","8",159460166,159461104,938
"4019","Zm00001d011711","8",159470815,159471792,977
"4020","Zm00001d011712","8",159488658,159493031,4373
"4021","Zm00001d011713","8",159513499,159578586,65087
"4022","Zm00001d011714","8",159667660,159672679,5019
"4023","Zm00001d011716","8",159801024,159805217,4193
"4024","Zm00001d011717","8",159811366,159814712,3346
"4025","Zm00001d011718","8",159815952,159822848,6896
"4026","Zm00001d011719","8",159824328,159833569,9241
"4027","Zm00001d011720","8",159835548,159840848,5300
"4028","Zm00001d011721","8",159899428,159902796,3368
"4029","Zm00001d011722","8",159972201,159972850,649
"4030","Zm00001d011729","8",160069393,160090055,20662
"4031","Zm00001d011730","8",160093938,160094990,1052
"4032","Zm00001d011732","8",160220321,160223281,2960
"4033","Zm00001d011734","8",160235115,160235972,857
"4034","Zm00001d011735","8",160278127,160279059,932
"4035","Zm00001d011736","8",160338061,160339605,1544
"4036","Zm00001d011737","8",160377553,160379112,1559
"4037","Zm00001d011738","8",160386965,160392640,5675
"4038","Zm00001d011739","8",160432796,160433990,1194
"4039","Zm00001d011740","8",160440621,160442292,1671
"4040","Zm00001d011741","8",160442324,160444345,2021
"4041","Zm00001d011742","8",160445596,160459263,13667
"4042","Zm00001d011745","8",160627041,160632198,5157
"4043","Zm00001d011746","8",160671478,160678347,6869
"4044","Zm00001d011748","8",160706837,160710739,3902
"4045","Zm00001d011750","8",160744068,160748987,4919
"4046","Zm00001d011751","8",160749792,160750217,425
"4047","Zm00001d011753","8",160753687,160755164,1477
"4048","Zm00001d011754","8",160755483,160759763,4280
"4049","Zm00001d011755","8",160797624,160798695,1071
"4050","Zm00001d011756","8",160818522,160825421,6899
"4051","Zm00001d011757","8",160827185,160828531,1346
"4052","Zm00001d011758","8",160885990,160890793,4803
"4053","Zm00001d011759","8",160937042,160941578,4536
"4054","Zm00001d011760","8",160944524,160947119,2595
"4055","Zm00001d011761","8",160949609,160951534,1925
"4056","Zm00001d011762","8",161003849,161009679,5830
"4057","Zm00001d011763","8",161020006,161022048,2042
"4058","Zm00001d011764","8",161071221,161074991,3770
"4059","Zm00001d011765","8",161174717,161177072,2355
"4060","Zm00001d011766","8",161195803,161197827,2024
"4061","Zm00001d011767","8",161248146,161252725,4579
"4062","Zm00001d011768","8",161255339,161256861,1522
"4063","Zm00001d011769","8",161258608,161260512,1904
"4064","Zm00001d011770","8",161262490,161265159,2669
"4065","Zm00001d011771","8",161288497,161289891,1394
"4066","Zm00001d011773","8",161292877,161297384,4507
"4067","Zm00001d011774","8",161297361,161300019,2658
"4068","Zm00001d011775","8",161301289,161305093,3804
"4069","Zm00001d011776","8",161307150,161320632,13482
"4070","Zm00001d011778","8",161412063,161413479,1416
"4071","Zm00001d011779","8",161454835,161467149,12314
"4072","Zm00001d011780","8",161467649,161470337,2688
"4073","Zm00001d011781","8",161472200,161475123,2923
"4074","Zm00001d011782","8",161475214,161477513,2299
"4075","Zm00001d011784","8",161511637,161511945,308
"4076","Zm00001d011785","8",161545498,161546157,659
"4077","Zm00001d011786","8",161548685,161550315,1630
"4078","Zm00001d011788","8",161618982,161621182,2200
"4079","Zm00001d011789","8",161623974,161624864,890
"4080","Zm00001d011790","8",161650580,161666693,16113
"4081","Zm00001d011791","8",161666961,161668296,1335
"4082","Zm00001d011792","8",161705740,161709095,3355
"4083","Zm00001d011796","8",161717957,161722781,4824
"4084","Zm00001d011799","8",161724919,161726722,1803
"4085","Zm00001d011802","8",161757825,161764087,6262
"4086","Zm00001d011803","8",161769734,161773104,3370
"4087","Zm00001d011805","8",161834426,161839733,5307
"4088","Zm00001d011807","8",161914631,161919227,4596
"4089","Zm00001d011811","8",161922944,161928459,5515
"4090","Zm00001d011812","8",161927179,161929095,1916
"4091","Zm00001d011816","8",162012206,162014429,2223
"4092","Zm00001d011817","8",162014895,162018508,3613
"4093","Zm00001d011819","8",162062147,162065473,3326
"4094","Zm00001d011821","8",162133324,162138282,4958
"4095","Zm00001d011823","8",162142980,162146256,3276
"4096","Zm00001d011825","8",162158586,162160692,2106
"4097","Zm00001d011826","8",162215583,162216743,1160
"4098","Zm00001d011827","8",162217111,162224500,7389
"4099","Zm00001d011828","8",162227066,162236070,9004
"4100","Zm00001d011829","8",162241780,162249101,7321
"4101","Zm00001d011830","8",162249758,162253382,3624
"4102","Zm00001d011831","8",162253836,162260358,6522
"4103","Zm00001d011832","8",162291112,162292515,1403
"4104","Zm00001d011833","8",162293750,162297261,3511
"4105","Zm00001d011834","8",162301393,162305275,3882
"4106","Zm00001d011835","8",162305845,162312576,6731
"4107","Zm00001d011838","8",162441108,162442697,1589
"4108","Zm00001d011839","8",162488291,162493316,5025
"4109","Zm00001d011842","8",162540520,162541875,1355
"4110","Zm00001d011843","8",162564729,162565898,1169
"4111","Zm00001d011845","8",162607205,162608301,1096
"4112","Zm00001d011846","8",162644978,162646063,1085
"4113","Zm00001d011847","8",162652002,162656985,4983
"4114","Zm00001d011849","8",162775996,162782061,6065
"4115","Zm00001d011850","8",162783924,162789981,6057
"4116","Zm00001d011851","8",162797209,162805481,8272
"4117","Zm00001d011854","8",162915395,162925930,10535
"4118","Zm00001d011855","8",162939768,162950018,10250
"4119","Zm00001d011856","8",163067901,163069837,1936
"4120","Zm00001d011857","8",163123875,163127899,4024
"4121","Zm00001d011866","8",163254602,163255885,1283
"4122","Zm00001d011869","8",163318649,163320005,1356
"4123","Zm00001d011871","8",163348171,163349091,920
"4124","Zm00001d011872","8",163438578,163443056,4478
"4125","Zm00001d011873","8",163443311,163445290,1979
"4126","Zm00001d011874","8",163447712,163449596,1884
"4127","Zm00001d011876","8",163614240,163618286,4046
"4128","Zm00001d011877","8",163757649,163765413,7764
"4129","Zm00001d011878","8",163837344,163840432,3088
"4130","Zm00001d011879","8",163860396,163861291,895
"4131","Zm00001d011880","8",163862708,163865205,2497
"4132","Zm00001d011881","8",163868830,163870179,1349
"4133","Zm00001d011882","8",163875069,163878710,3641
"4134","Zm00001d011883","8",163883378,163884377,999
"4135","Zm00001d011885","8",163934356,163941137,6781
"4136","Zm00001d011889","8",164038137,164044860,6723
"4137","Zm00001d011890","8",164045195,164048986,3791
"4138","Zm00001d011891","8",164106171,164115399,9228
"4139","Zm00001d011895","8",164149048,164153140,4092
"4140","Zm00001d011898","8",164189762,164194511,4749
"4141","Zm00001d011900","8",164238449,164244768,6319
"4142","Zm00001d011901","8",164246091,164251059,4968
"4143","Zm00001d011902","8",164253205,164253871,666
"4144","Zm00001d011903","8",164256281,164257564,1283
"4145","Zm00001d011904","8",164264227,164283829,19602
"4146","Zm00001d011908","8",164313713,164318410,4697
"4147","Zm00001d011912","8",164358886,164361386,2500
"4148","Zm00001d011913","8",164362879,164368379,5500
"4149","Zm00001d011917","8",164542655,164544125,1470
"4150","Zm00001d011918","8",164544656,164552085,7429
"4151","Zm00001d011919","8",164591701,164592765,1064
"4152","Zm00001d011920","8",164595644,164600231,4587
"4153","Zm00001d011921","8",164602381,164602755,374
"4154","Zm00001d011923","8",164678915,164684859,5944
"4155","Zm00001d011924","8",164684984,164686049,1065
"4156","Zm00001d011927","8",164785266,164788777,3511
"4157","Zm00001d011928","8",164790898,164792481,1583
"4158","Zm00001d011929","8",164793032,164802617,9585
"4159","Zm00001d011930","8",164802584,164803787,1203
"4160","Zm00001d011931","8",164804556,164806814,2258
"4161","Zm00001d011932","8",164811359,164812930,1571
"4162","Zm00001d011933","8",164814167,164814805,638
"4163","Zm00001d011938","8",164854178,164855277,1099
"4164","Zm00001d011940","8",164858297,164858638,341
"4165","Zm00001d011941","8",164860103,164864678,4575
"4166","Zm00001d011943","8",164882398,164886007,3609
"4167","Zm00001d011944","8",164891049,164894713,3664
"4168","Zm00001d011945","8",164894308,164898870,4562
"4169","Zm00001d011948","8",164910837,164919493,8656
"4170","Zm00001d011950","8",164972442,164978555,6113
"4171","Zm00001d011952","8",164981703,164987039,5336
"4172","Zm00001d011953","8",164990904,164996249,5345
"4173","Zm00001d011955","8",165136441,165139490,3049
"4174","Zm00001d011956","8",165140334,165155029,14695
"4175","Zm00001d011958","8",165203502,165205430,1928
"4176","Zm00001d011959","8",165240608,165244472,3864
"4177","Zm00001d011963","8",165266721,165275070,8349
"4178","Zm00001d011964","8",165280380,165283828,3448
"4179","Zm00001d011965","8",165285679,165288425,2746
"4180","Zm00001d011966","8",165292236,165296943,4707
"4181","Zm00001d011967","8",165304523,165309412,4889
"4182","Zm00001d011969","8",165320638,165322096,1458
"4183","Zm00001d011970","8",165339966,165343531,3565
"4184","Zm00001d011971","8",165343810,165345886,2076
"4185","Zm00001d011972","8",165426450,165430584,4134
"4186","Zm00001d011975","8",165490510,165506030,15520
"4187","Zm00001d011976","8",165537102,165541804,4702
"4188","Zm00001d011979","8",165566436,165576339,9903
"4189","Zm00001d011981","8",165739738,165746851,7113
"4190","Zm00001d011983","8",165872885,165879693,6808
"4191","Zm00001d011984","8",165880817,165889059,8242
"4192","Zm00001d011985","8",165936679,165937626,947
"4193","Zm00001d011990","8",166013366,166015642,2276
"4194","Zm00001d011991","8",166017346,166017924,578
"4195","Zm00001d011992","8",166018999,166021525,2526
"4196","Zm00001d011993","8",166037850,166039713,1863
"4197","Zm00001d011994","8",166064478,166068375,3897
"4198","Zm00001d011996","8",166092023,166094834,2811
"4199","Zm00001d011997","8",166101521,166105262,3741
"4200","Zm00001d011999","8",166138939,166141336,2397
"4201","Zm00001d012003","8",166200531,166205536,5005
"4202","Zm00001d012004","8",166296568,166300731,4163
"4203","Zm00001d012005","8",166369165,166375273,6108
"4204","Zm00001d012006","8",166416374,166417639,1265
"4205","Zm00001d012007","8",166418982,166423965,4983
"4206","Zm00001d012010","8",166461603,166461962,359
"4207","Zm00001d012013","8",166469592,166471809,2217
"4208","Zm00001d012015","8",166514041,166517345,3304
"4209","Zm00001d012016","8",166534607,166536143,1536
"4210","Zm00001d012017","8",166554917,166558182,3265
"4211","Zm00001d012019","8",166620718,166622319,1601
"4212","Zm00001d012020","8",166623987,166626005,2018
"4213","Zm00001d012022","8",166711119,166712722,1603
"4214","Zm00001d012027","8",166745975,166755465,9490
"4215","Zm00001d012029","8",166757788,166769178,11390
"4216","Zm00001d012030","8",166780698,166784066,3368
"4217","Zm00001d012031","8",166790119,166792274,2155
"4218","Zm00001d012032","8",166819383,166835118,15735
"4219","Zm00001d012033","8",166838901,166842661,3760
"4220","Zm00001d012034","8",166861044,166902381,41337
"4221","Zm00001d012035","8",166903610,166906333,2723
"4222","Zm00001d012036","8",166917606,166923260,5654
"4223","Zm00001d012040","8",167025708,167029182,3474
"4224","Zm00001d012041","8",167029388,167031334,1946
"4225","Zm00001d012042","8",167077414,167081392,3978
"4226","Zm00001d012043","8",167096675,167099930,3255
"4227","Zm00001d012044","8",167187771,167190749,2978
"4228","Zm00001d012047","8",167201109,167202412,1303
"4229","Zm00001d012049","8",167234279,167239072,4793
"4230","Zm00001d012050","8",167241013,167241890,877
"4231","Zm00001d012052","8",167250646,167252718,2072
"4232","Zm00001d012054","8",167346497,167358198,11701
"4233","Zm00001d012060","8",167470863,167476562,5699
"4234","Zm00001d012061","8",167515702,167528413,12711
"4235","Zm00001d012064","8",167543593,167547578,3985
"4236","Zm00001d012067","8",167566134,167569229,3095
"4237","Zm00001d012068","8",167588205,167588672,467
"4238","Zm00001d012069","8",167595112,167595978,866
"4239","Zm00001d012070","8",167598483,167601000,2517
"4240","Zm00001d012073","8",167671835,167672460,625
"4241","Zm00001d012074","8",167679457,167682478,3021
"4242","Zm00001d012078","8",167757620,167758571,951
"4243","Zm00001d012079","8",167759340,167760532,1192
"4244","Zm00001d012081","8",167766216,167766518,302
"4245","Zm00001d012082","8",167829118,167833648,4530
"4246","Zm00001d012083","8",167838073,167839724,1651
"4247","Zm00001d012084","8",167840472,167845646,5174
"4248","Zm00001d012085","8",167847285,167854405,7120
"4249","Zm00001d012086","8",167856339,167866530,10191
"4250","Zm00001d012087","8",167976609,167980265,3656
"4251","Zm00001d012090","8",168031831,168032298,467
"4252","Zm00001d012091","8",168039290,168040576,1286
"4253","Zm00001d012092","8",168113678,168117049,3371
"4254","Zm00001d012095","8",168180113,168181978,1865
"4255","Zm00001d012097","8",168219475,168220941,1466
"4256","Zm00001d012098","8",168223693,168226133,2440
"4257","Zm00001d012100","8",168244239,168249589,5350
"4258","Zm00001d012101","8",168277736,168281863,4127
"4259","Zm00001d012102","8",168283208,168289577,6369
"4260","Zm00001d012103","8",168303869,168306204,2335
"4261","Zm00001d012108","8",168364890,168371205,6315
"4262","Zm00001d012109","8",168378132,168379047,915
"4263","Zm00001d012110","8",168383836,168385029,1193
"4264","Zm00001d012118","8",168419834,168430142,10308
"4265","Zm00001d012119","8",168442999,168449985,6986
"4266","Zm00001d012121","8",168477740,168480878,3138
"4267","Zm00001d012122","8",168482516,168485478,2962
"4268","Zm00001d012124","8",168487218,168497229,10011
"4269","Zm00001d012126","8",168499982,168507430,7448
"4270","Zm00001d012127","8",168508873,168510872,1999
"4271","Zm00001d012128","8",168571952,168576042,4090
"4272","Zm00001d012130","8",168610296,168612769,2473
"4273","Zm00001d012131","8",168615878,168619047,3169
"4274","Zm00001d012137","8",168708662,168716908,8246
"4275","Zm00001d012138","8",168717328,168723055,5727
"4276","Zm00001d012140","8",168727319,168730510,3191
"4277","Zm00001d012141","8",168732016,168736038,4022
"4278","Zm00001d012142","8",168736577,168739121,2544
"4279","Zm00001d012144","8",168855687,168867132,11445
"4280","Zm00001d012145","8",168870912,168875246,4334
"4281","Zm00001d012146","8",168883542,168888435,4893
"4282","Zm00001d012148","8",168926998,168937218,10220
"4283","Zm00001d012153","8",169011340,169020658,9318
"4284","Zm00001d012154","8",169023581,169026072,2491
"4285","Zm00001d012155","8",169041107,169049261,8154
"4286","Zm00001d012156","8",169060792,169075234,14442
"4287","Zm00001d012158","8",169118061,169122308,4247
"4288","Zm00001d012159","8",169165307,169173792,8485
"4289","Zm00001d012160","8",169176092,169181164,5072
"4290","Zm00001d012161","8",169183712,169186572,2860
"4291","Zm00001d012165","8",169363195,169363680,485
"4292","Zm00001d012166","8",169363891,169370370,6479
"4293","Zm00001d012167","8",169382734,169386405,3671
"4294","Zm00001d012168","8",169391662,169396340,4678
"4295","Zm00001d012169","8",169426918,169427745,827
"4296","Zm00001d012170","8",169429054,169433174,4120
"4297","Zm00001d012171","8",169443002,169444175,1173
"4298","Zm00001d012172","8",169460698,169462895,2197
"4299","Zm00001d012173","8",169516096,169525048,8952
"4300","Zm00001d012175","8",169547499,169551527,4028
"4301","Zm00001d012176","8",169557355,169562468,5113
"4302","Zm00001d012177","8",169573763,169577154,3391
"4303","Zm00001d012178","8",169610519,169612653,2134
"4304","Zm00001d012180","8",169618708,169621826,3118
"4305","Zm00001d012194","8",169912082,169912459,377
"4306","Zm00001d012195","8",169913481,169917971,4490
"4307","Zm00001d012196","8",169919970,169924239,4269
"4308","Zm00001d012197","8",169924646,169928100,3454
"4309","Zm00001d012198","8",169939479,169944694,5215
"4310","Zm00001d012199","8",170004527,170012968,8441
"4311","Zm00001d012203","8",170033894,170036587,2693
"4312","Zm00001d012204","8",170042407,170043615,1208
"4313","Zm00001d012205","8",170071902,170075152,3250
"4314","Zm00001d012206","8",170076975,170078757,1782
"4315","Zm00001d012208","8",170082170,170084266,2096
"4316","Zm00001d012211","8",170110027,170115232,5205
"4317","Zm00001d012213","8",170144186,170164756,20570
"4318","Zm00001d012216","8",170338401,170340344,1943
"4319","Zm00001d012219","8",170356402,170357442,1040
"4320","Zm00001d012220","8",170362957,170364624,1667
"4321","Zm00001d012221","8",170366926,170368457,1531
"4322","Zm00001d012223","8",170387866,170397045,9179
"4323","Zm00001d012224","8",170419466,170424898,5432
"4324","Zm00001d012226","8",170452341,170454988,2647
"4325","Zm00001d012227","8",170455563,170457114,1551
"4326","Zm00001d012228","8",170458719,170462003,3284
"4327","Zm00001d012229","8",170466437,170472563,6126
"4328","Zm00001d012231","8",170532866,170534989,2123
"4329","Zm00001d012232","8",170589813,170596332,6519
"4330","Zm00001d012233","8",170593617,170597148,3531
"4331","Zm00001d012234","8",170600288,170602763,2475
"4332","Zm00001d012237","8",170724735,170730425,5690
"4333","Zm00001d012238","8",170738666,170744400,5734
"4334","Zm00001d012239","8",170751541,170756148,4607
"4335","Zm00001d012240","8",170777809,170781884,4075
"4336","Zm00001d012241","8",170787855,170788898,1043
"4337","Zm00001d012242","8",170791056,170793403,2347
"4338","Zm00001d012243","8",170830141,170831442,1301
"4339","Zm00001d012244","8",170881851,170885565,3714
"4340","Zm00001d012245","8",170916913,170919259,2346
"4341","Zm00001d012246","8",170927673,170929026,1353
"4342","Zm00001d012247","8",170932391,170938329,5938
"4343","Zm00001d012248","8",170967124,170967956,832
"4344","Zm00001d012251","8",171032405,171035095,2690
"4345","Zm00001d012252","8",171035928,171036965,1037
"4346","Zm00001d012254","8",171064822,171067905,3083
"4347","Zm00001d012255","8",171085931,171087013,1082
"4348","Zm00001d012257","8",171216718,171226043,9325
"4349","Zm00001d012258","8",171228378,171231523,3145
"4350","Zm00001d012259","8",171234043,171236231,2188
"4351","Zm00001d012260","8",171319753,171321312,1559
"4352","Zm00001d012261","8",171344660,171346209,1549
"4353","Zm00001d012263","8",171421196,171427134,5938
"4354","Zm00001d012265","8",171473506,171483308,9802
"4355","Zm00001d012266","8",171483914,171485603,1689
"4356","Zm00001d012267","8",171610394,171615563,5169
"4357","Zm00001d012269","8",171641850,171647628,5778
"4358","Zm00001d012270","8",171649129,171654566,5437
"4359","Zm00001d012273","8",171684370,171696504,12134
"4360","Zm00001d012274","8",171718376,171721067,2691
"4361","Zm00001d012275","8",171735134,171739795,4661
"4362","Zm00001d012276","8",171739920,171740516,596
"4363","Zm00001d012277","8",171775071,171778423,3352
"4364","Zm00001d012281","8",171836888,171837640,752
"4365","Zm00001d012282","8",171844019,171844762,743
"4366","Zm00001d012284","8",171862718,171867456,4738
"4367","Zm00001d012285","8",171871807,171872971,1164
"4368","Zm00001d012286","8",171908319,171912516,4197
"4369","Zm00001d012287","8",171912508,171913492,984
"4370","Zm00001d012289","8",171916105,171917804,1699
"4371","Zm00001d012290","8",171956973,171957721,748
"4372","Zm00001d012292","8",172024417,172027229,2812
"4373","Zm00001d012294","8",172035363,172043591,8228
"4374","Zm00001d012295","8",172039519,172048923,9404
"4375","Zm00001d012296","8",172051538,172056127,4589
"4376","Zm00001d012297","8",172058782,172061399,2617
"4377","Zm00001d012301","8",172072955,172076143,3188
"4378","Zm00001d012302","8",172078594,172079778,1184
"4379","Zm00001d012304","8",172140280,172142915,2635
"4380","Zm00001d012306","8",172154535,172156824,2289
"4381","Zm00001d012307","8",172160772,172166114,5342
"4382","Zm00001d012308","8",172187449,172194743,7294
"4383","Zm00001d012311","8",172208290,172208965,675
"4384","Zm00001d012313","8",172255204,172257134,1930
"4385","Zm00001d012314","8",172325977,172333899,7922
"4386","Zm00001d012316","8",172334941,172335622,681
"4387","Zm00001d012317","8",172337798,172338788,990
"4388","Zm00001d012320","8",172365657,172369913,4256
"4389","Zm00001d012321","8",172400471,172401895,1424
"4390","Zm00001d012322","8",172403401,172405359,1958
"4391","Zm00001d012323","8",172423693,172430433,6740
"4392","Zm00001d012325","8",172451996,172454361,2365
"4393","Zm00001d012327","8",172500097,172513999,13902
"4394","Zm00001d012328","8",172514625,172517390,2765
"4395","Zm00001d012329","8",172519109,172527499,8390
"4396","Zm00001d012331","8",172532292,172533675,1383
"4397","Zm00001d012332","8",172547738,172548139,401
"4398","Zm00001d012335","8",172652749,172654298,1549
"4399","Zm00001d012336","8",172697736,172698849,1113
"4400","Zm00001d012337","8",172699749,172700888,1139
"4401","Zm00001d012338","8",172708664,172712351,3687
"4402","Zm00001d012339","8",172717220,172718296,1076
"4403","Zm00001d012340","8",172721881,172723989,2108
"4404","Zm00001d012341","8",172725327,172728238,2911
"4405","Zm00001d012342","8",172728717,172729887,1170
"4406","Zm00001d012346","8",172799166,172803581,4415
"4407","Zm00001d012349","8",172811349,172828780,17431
"4408","Zm00001d012350","8",172835583,172837490,1907
"4409","Zm00001d012351","8",172912446,172913614,1168
"4410","Zm00001d012353","8",172918437,172918835,398
"4411","Zm00001d012360","8",172998398,172999372,974
"4412","Zm00001d012361","8",173019571,173023422,3851
"4413","Zm00001d012362","8",173025773,173029514,3741
"4414","Zm00001d012369","8",173121002,173122031,1029
"4415","Zm00001d012373","8",173137855,173147234,9379
"4416","Zm00001d012379","8",173237609,173239733,2124
"4417","Zm00001d012380","8",173245748,173250090,4342
"4418","Zm00001d012381","8",173254406,173259963,5557
"4419","Zm00001d012382","8",173269489,173271090,1601
"4420","Zm00001d012383","8",173271092,173275059,3967
"4421","Zm00001d012387","8",173335252,173336838,1586
"4422","Zm00001d012391","8",173415190,173423162,7972
"4423","Zm00001d012392","8",173435429,173447107,11678
"4424","Zm00001d012393","8",173519570,173522067,2497
"4425","Zm00001d012394","8",173522111,173525090,2979
"4426","Zm00001d012395","8",173526390,173530216,3826
"4427","Zm00001d012396","8",173533358,173539418,6060
"4428","Zm00001d012398","8",173581012,173587177,6165
"4429","Zm00001d012399","8",173676809,173682000,5191
"4430","Zm00001d012400","8",173694140,173701898,7758
"4431","Zm00001d012401","8",173733501,173735518,2017
"4432","Zm00001d012402","8",173744941,173746395,1454
"4433","Zm00001d012403","8",173833171,173833791,620
"4434","Zm00001d012404","8",173912366,173925507,13141
"4435","Zm00001d012407","8",173978431,173987430,8999
"4436","Zm00001d012408","8",173986933,173990308,3375
"4437","Zm00001d012409","8",173992671,173997174,4503
"4438","Zm00001d012411","8",174030108,174033815,3707
"4439","Zm00001d012413","8",174053520,174058410,4890
"4440","Zm00001d012415","8",174152244,174153551,1307
"4441","Zm00001d012417","8",174164451,174165731,1280
"4442","Zm00001d012418","8",174169491,174171263,1772
"4443","Zm00001d012419","8",174174647,174177720,3073
"4444","Zm00001d012420","8",174179964,174183186,3222
"4445","Zm00001d012421","8",174231535,174235465,3930
"4446","Zm00001d012422","8",174236954,174237026,72
"4447","Zm00001d012423","8",174293032,174293445,413
"4448","Zm00001d012424","8",174295765,174296612,847
"4449","Zm00001d012425","8",174297216,174300917,3701
"4450","Zm00001d012426","8",174303331,174305106,1775
"4451","Zm00001d012427","8",174309868,174310377,509
"4452","Zm00001d012428","8",174326446,174330359,3913
"4453","Zm00001d012429","8",174355901,174357929,2028
"4454","Zm00001d012430","8",174360496,174361131,635
"4455","Zm00001d012432","8",174375639,174376277,638
"4456","Zm00001d012433","8",174376458,174380066,3608
"4457","Zm00001d012435","8",174416984,174418177,1193
"4458","Zm00001d012437","8",174468924,174470270,1346
"4459","Zm00001d012438","8",174478989,174481220,2231
"4460","Zm00001d012439","8",174489288,174489599,311
"4461","Zm00001d012445","8",174626161,174634719,8558
"4462","Zm00001d012446","8",174687822,174699554,11732
"4463","Zm00001d012447","8",174713669,174718082,4413
"4464","Zm00001d012448","8",174720307,174723576,3269
"4465","Zm00001d012449","8",174727605,174728591,986
"4466","Zm00001d012450","8",174728877,174730604,1727
"4467","Zm00001d012451","8",174780887,174784022,3135
"4468","Zm00001d012452","8",174784986,174790049,5063
"4469","Zm00001d012457","8",174849024,174856985,7961
"4470","Zm00001d012458","8",174858650,174861025,2375
"4471","Zm00001d012459","8",174876309,174878746,2437
"4472","Zm00001d012460","8",174881205,174884611,3406
"4473","Zm00001d012463","8",174967533,174969278,1745
"4474","Zm00001d012464","8",174970601,174974661,4060
"4475","Zm00001d012465","8",174975143,174978806,3663
"4476","Zm00001d012466","8",175042782,175045636,2854
"4477","Zm00001d012467","8",175045544,175067069,21525
"4478","Zm00001d012468","8",175070147,175070985,838
"4479","Zm00001d012469","8",175073817,175074230,413
"4480","Zm00001d012471","8",175078336,175078683,347
"4481","Zm00001d012472","8",175083746,175085658,1912
"4482","Zm00001d012474","8",175162648,175164824,2176
"4483","Zm00001d012475","8",175178145,175184442,6297
"4484","Zm00001d012476","8",175266420,175268144,1724
"4485","Zm00001d012477","8",175268593,175271215,2622
"4486","Zm00001d012479","8",175279648,175291084,11436
"4487","Zm00001d012480","8",175295472,175295996,524
"4488","Zm00001d012482","8",175328253,175331243,2990
"4489","Zm00001d012484","8",175353033,175354813,1780
"4490","Zm00001d012485","8",175357855,175362943,5088
"4491","Zm00001d012488","8",175394172,175396386,2214
"4492","Zm00001d012492","8",175443577,175446159,2582
"4493","Zm00001d012493","8",175446798,175447211,413
"4494","Zm00001d012494","8",175457337,175459328,1991
"4495","Zm00001d012498","8",175509375,175510460,1085
"4496","Zm00001d012499","8",175514095,175517917,3822
"4497","Zm00001d012501","8",175524889,175531976,7087
"4498","Zm00001d012503","8",175558015,175570673,12658
"4499","Zm00001d012504","8",175572544,175576928,4384
"4500","Zm00001d012505","8",175577410,175578506,1096
"4501","Zm00001d012509","8",175618869,175624876,6007
"4502","Zm00001d012510","8",175694309,175696390,2081
"4503","Zm00001d012511","8",175846051,175866846,20795
"4504","Zm00001d012512","8",175868426,175870258,1832
"4505","Zm00001d012513","8",175871642,175876540,4898
"4506","Zm00001d012514","8",175887579,175890704,3125
"4507","Zm00001d012515","8",175898933,175903845,4912
"4508","Zm00001d012516","8",175931640,175934827,3187
"4509","Zm00001d012517","8",175969428,175975434,6006
"4510","Zm00001d012518","8",176004430,176009389,4959
"4511","Zm00001d012520","8",176016314,176016934,620
"4512","Zm00001d012521","8",176021482,176024817,3335
"4513","Zm00001d012522","8",176046167,176049646,3479
"4514","Zm00001d012524","8",176060117,176062979,2862
"4515","Zm00001d012525","8",176068190,176095819,27629
"4516","Zm00001d012526","8",176069539,176069611,72
"4517","Zm00001d012527","8",176104082,176105842,1760
"4518","Zm00001d012528","8",176106383,176108142,1759
"4519","Zm00001d012529","8",176119291,176123198,3907
"4520","Zm00001d012530","8",176195066,176195707,641
"4521","Zm00001d012531","8",176198185,176199816,1631
"4522","Zm00001d012532","8",176203820,176207127,3307
"4523","Zm00001d012533","8",176249618,176251923,2305
"4524","Zm00001d012534","8",176254330,176258415,4085
"4525","Zm00001d012535","8",176258816,176260070,1254
"4526","Zm00001d012536","8",176311492,176316730,5238
"4527","Zm00001d012537","8",176319099,176327611,8512
"4528","Zm00001d012538","8",176375165,176376142,977
"4529","Zm00001d012539","8",176387457,176388488,1031
"4530","Zm00001d012542","8",176406745,176407884,1139
"4531","Zm00001d012543","8",176418688,176418996,308
"4532","Zm00001d012544","8",176420877,176424706,3829
"4533","Zm00001d012545","8",176434645,176435040,395
"4534","Zm00001d012546","8",176436045,176440104,4059
"4535","Zm00001d012549","8",176466250,176469340,3090
"4536","Zm00001d012550","8",176472551,176477257,4706
"4537","Zm00001d012551","8",176482256,176483443,1187
"4538","Zm00001d012553","8",176514160,176521162,7002
"4539","Zm00001d012556","8",176577453,176580718,3265
"4540","Zm00001d012557","8",176581701,176584547,2846
"4541","Zm00001d012559","8",176632409,176646619,14210
"4542","Zm00001d012560","8",176648813,176651657,2844
"4543","Zm00001d012561","8",176655420,176657307,1887
"4544","Zm00001d012562","8",176682155,176683237,1082
"4545","Zm00001d012563","8",176683821,176684273,452
"4546","Zm00001d012564","8",176755046,176762074,7028
"4547","Zm00001d012566","8",176768297,176771649,3352
"4548","Zm00001d012567","8",176775799,176779233,3434
"4549","Zm00001d012569","8",176786650,176789645,2995
"4550","Zm00001d012570","8",176792029,176793772,1743
"4551","Zm00001d012571","8",176802144,176808472,6328
"4552","Zm00001d012572","8",176808613,176813009,4396
"4553","Zm00001d012573","8",176814933,176819466,4533
"4554","Zm00001d012574","8",176822275,176827553,5278
"4555","Zm00001d012575","8",176835289,176839722,4433
"4556","Zm00001d012576","8",176841565,176842545,980
"4557","Zm00001d012577","8",176845974,176846168,194
"4558","Zm00001d012578","8",176853051,176855156,2105
"4559","Zm00001d012581","8",176870352,176874678,4326
"4560","Zm00001d012584","8",176883525,176884022,497
"4561","Zm00001d012585","8",176892933,176893658,725
"4562","Zm00001d012587","8",176928236,176930528,2292
"4563","Zm00001d012590","8",176950180,176952032,1852
"4564","Zm00001d012591","8",176955466,176958213,2747
"4565","Zm00001d012593","8",177011476,177014797,3321
"4566","Zm00001d012595","8",177029818,177031440,1622
"4567","Zm00001d012596","8",177034496,177034942,446
"4568","Zm00001d012597","8",177035542,177039950,4408
"4569","Zm00001d012598","8",177040668,177042867,2199
"4570","Zm00001d012599","8",177042978,177048079,5101
"4571","Zm00001d012600","8",177051210,177055756,4546
"4572","Zm00001d012601","8",177056647,177058840,2193
"4573","Zm00001d012603","8",177064376,177066295,1919
"4574","Zm00001d012604","8",177070569,177080643,10074
"4575","Zm00001d012605","8",177084651,177090378,5727
"4576","Zm00001d012606","8",177094098,177095459,1361
"4577","Zm00001d012607","8",177130907,177134597,3690
"4578","Zm00001d012608","8",177138910,177143229,4319
"4579","Zm00001d012609","8",177156652,177162505,5853
"4580","Zm00001d012610","8",177166352,177167152,800
"4581","Zm00001d012611","8",177172385,177175355,2970
"4582","Zm00001d012612","8",177177845,177179851,2006
"4583","Zm00001d012613","8",177227423,177228219,796
"4584","Zm00001d012614","8",177243572,177247519,3947
"4585","Zm00001d012615","8",177260647,177274310,13663
"4586","Zm00001d012618","8",177290270,177290911,641
"4587","Zm00001d012619","8",177291734,177295258,3524
"4588","Zm00001d012620","8",177298702,177308389,9687
"4589","Zm00001d012621","8",177316235,177317092,857
"4590","Zm00001d012623","8",177321112,177321947,835
"4591","Zm00001d012624","8",177398158,177408853,10695
"4592","Zm00001d012625","8",177409431,177411470,2039
"4593","Zm00001d012626","8",177416087,177416356,269
"4594","Zm00001d012627","8",177416338,177419647,3309
"4595","Zm00001d012628","8",177454976,177456537,1561
"4596","Zm00001d012629","8",177496009,177501834,5825
"4597","Zm00001d012632","8",177517401,177518357,956
"4598","Zm00001d012633","8",177521742,177526391,4649
"4599","Zm00001d012634","8",177537356,177544564,7208
"4600","Zm00001d012635","8",177547104,177549864,2760
"4601","Zm00001d012636","8",177550298,177553275,2977
"4602","Zm00001d012640","8",177653401,177663257,9856
"4603","Zm00001d012641","8",177673222,177677285,4063
"4604","Zm00001d012642","8",177705263,177706934,1671
"4605","Zm00001d012643","8",177712284,177732855,20571
"4606","Zm00001d012644","8",177767336,177768568,1232
"4607","Zm00001d012645","8",177771286,177774387,3101
"4608","Zm00001d012646","8",177775792,177778312,2520
"4609","Zm00001d012647","8",177797195,177800097,2902
"4610","Zm00001d012648","8",177801987,177803507,1520
"4611","Zm00001d012649","8",177827211,177832883,5672
"4612","Zm00001d012651","8",177871180,177879400,8220
"4613","Zm00001d012652","8",177983385,177988780,5395
"4614","Zm00001d012653","8",177991773,178000195,8422
"4615","Zm00001d012654","8",178002681,178009554,6873
"4616","Zm00001d012655","8",178011318,178018236,6918
"4617","Zm00001d012656","8",178057916,178061854,3938
"4618","Zm00001d012659","8",178077109,178082439,5330
"4619","Zm00001d012660","8",178109254,178113480,4226
"4620","Zm00001d012661","8",178170786,178201113,30327
"4621","Zm00001d012662","8",178243990,178247079,3089
"4622","Zm00001d012663","8",178279543,178282000,2457
"4623","Zm00001d012664","8",178284288,178286057,1769
"4624","Zm00001d012665","8",178290064,178293854,3790
"4625","Zm00001d012666","8",178294352,178298974,4622
"4626","Zm00001d012667","8",178302434,178314196,11762
"4627","Zm00001d012668","8",178315076,178315444,368
"4628","Zm00001d012670","8",178335676,178339115,3439
"4629","Zm00001d012671","8",178351501,178359306,7805
"4630","Zm00001d012672","8",178360607,178372390,11783
"4631","Zm00001d012673","8",178372943,178378074,5131
"4632","Zm00001d012674","8",178397389,178409967,12578
"4633","Zm00001d012675","8",178411857,178414647,2790
"4634","Zm00001d012676","8",178444578,178446175,1597
"4635","Zm00001d012677","8",178446315,178457867,11552
"4636","Zm00001d012679","8",178499451,178502466,3015
"4637","Zm00001d012680","8",178503396,178513034,9638
"4638","Zm00001d012681","8",178514135,178531003,16868
"4639","Zm00001d012682","8",178603215,178609501,6286
"4640","Zm00001d012684","8",178616999,178617343,344
"4641","Zm00001d012685","8",178635302,178641627,6325
"4642","Zm00001d012686","8",178642508,178644235,1727
"4643","Zm00001d012687","8",178645606,178650028,4422
"4644","Zm00001d012688","8",178683463,178701014,17551
"4645","Zm00001d012689","8",178701046,178703315,2269
"4646","Zm00001d012690","8",178703289,178706744,3455
"4647","Zm00001d012691","8",178707473,178709709,2236
"4648","Zm00001d012693","8",178730558,178734205,3647
"4649","Zm00001d012694","8",178736934,178742762,5828
"4650","Zm00001d012699","8",178819719,178826711,6992
"4651","Zm00001d012701","8",178866204,178881882,15678
"4652","Zm00001d012702","8",178935008,178947931,12923
"4653","Zm00001d012703","8",178952194,178952865,671
"4654","Zm00001d012706","8",179027114,179028985,1871
"4655","Zm00001d012707","8",179032130,179037162,5032
"4656","Zm00001d012708","8",179043085,179046513,3428
"4657","Zm00001d012709","8",179050887,179052423,1536
"4658","Zm00001d012710","8",179073312,179076818,3506
"4659","Zm00001d012711","8",179078879,179081493,2614
"4660","Zm00001d012712","8",179086672,179088998,2326
"4661","Zm00001d012713","8",179095392,179099956,4564
"4662","Zm00001d012714","8",179100848,179101078,230
"4663","Zm00001d012716","8",179104456,179105385,929
"4664","Zm00001d012718","8",179120409,179124173,3764
"4665","Zm00001d012719","8",179164455,179168169,3714
"4666","Zm00001d012720","8",179173501,179174214,713
"4667","Zm00001d012725","8",179214402,179228713,14311
"4668","Zm00001d012728","8",179391080,179396140,5060
"4669","Zm00001d012729","8",179415114,179417574,2460
"4670","Zm00001d012731","8",179454361,179460511,6150
"4671","Zm00001d012732","8",179488826,179492378,3552
"4672","Zm00001d012734","8",179510785,179513781,2996
"4673","Zm00001d012735","8",179516302,179522672,6370
"4674","Zm00001d012736","8",179522293,179525398,3105
"4675","Zm00001d012737","8",179527539,179530251,2712
"4676","Zm00001d012738","8",179531188,179533834,2646
"4677","Zm00001d012741","8",179545649,179546407,758
"4678","Zm00001d012742","8",179545784,179546197,413
"4679","Zm00001d012743","8",179562398,179566026,3628
"4680","Zm00001d012744","8",179565860,179569311,3451
"4681","Zm00001d012745","8",179580076,179583723,3647
"4682","Zm00001d012746","8",179620170,179621660,1490
"4683","Zm00001d012747","8",179644395,179650153,5758
"4684","Zm00001d012748","8",179664693,179669878,5185
"4685","Zm00001d012749","8",179671303,179673854,2551
"4686","Zm00001d012750","8",179683029,179693484,10455
"4687","Zm00001d012751","8",179755488,179769766,14278
"4688","Zm00001d012752","8",179798348,179803586,5238
"4689","Zm00001d012753","8",179853403,179863712,10309
"4690","Zm00001d012754","8",179865498,179868206,2708
"4691","Zm00001d012755","8",179870572,179883823,13251
"4692","Zm00001d012757","8",180032642,180034434,1792
"4693","Zm00001d012760","8",180048744,180055916,7172
"4694","Zm00001d012761","8",180159950,180181292,21342
"4695","Zm00001d012763","8",180226489,180258297,31808
"4696","Zm00001d012764","8",180332662,180336615,3953
"4697","Zm00001d012765","8",180339773,180344860,5087
"4698","Zm00001d012766","8",180363894,180365434,1540
"4699","Zm00001d012768","8",180444394,180446096,1702
"4700","Zm00001d012769","8",180446677,180449856,3179
"4701","Zm00001d012770","8",180488563,180493813,5250
"4702","Zm00001d012771","8",180533264,180534913,1649
"4703","Zm00001d012774","8",180639774,180644672,4898
"4704","Zm00001d012775","8",180660841,180661204,363
"4705","Zm00001d012776","8",180682193,180684162,1969
"4706","Zm00001d012778","8",180736474,180739111,2637
"4707","Zm00001d012779","8",180741992,180742576,584
"4708","Zm00001d012785","8",180900185,180901786,1601
"4709","Zm00001d012787","8",180933690,180941840,8150
"4710","Zm00001d012788","8",181001862,181003295,1433
"4711","Zm00001d012791","8",181042885,181044792,1907
"4712","Zm00001d012794","5",32368,35621,3253
"4713","Zm00001d012795","5",35783,42435,6652
"4714","Zm00001d012796","5",48181,49991,1810
"4715","Zm00001d012797","5",50443,62268,11825
"4716","Zm00001d012800","5",119556,122098,2542
"4717","Zm00001d012801","5",241989,254837,12848
"4718","Zm00001d012803","5",254977,268446,13469
"4719","Zm00001d012805","5",376334,379023,2689
"4720","Zm00001d012806","5",380336,389692,9356
"4721","Zm00001d012807","5",472727,484777,12050
"4722","Zm00001d012808","5",572302,574716,2414
"4723","Zm00001d012809","5",635965,639349,3384
"4724","Zm00001d012810","5",684894,687528,2634
"4725","Zm00001d012811","5",688154,696271,8117
"4726","Zm00001d012812","5",696779,701482,4703
"4727","Zm00001d012814","5",720146,720610,464
"4728","Zm00001d012815","5",776419,787466,11047
"4729","Zm00001d012816","5",789953,792448,2495
"4730","Zm00001d012817","5",834692,841621,6929
"4731","Zm00001d012818","5",845040,846051,1011
"4732","Zm00001d012819","5",846193,847287,1094
"4733","Zm00001d012820","5",848901,851867,2966
"4734","Zm00001d012821","5",898964,904115,5151
"4735","Zm00001d012822","5",919123,924671,5548
"4736","Zm00001d012823","5",925235,928518,3283
"4737","Zm00001d012824","5",928945,929484,539
"4738","Zm00001d012825","5",930687,933796,3109
"4739","Zm00001d012826","5",933935,937151,3216
"4740","Zm00001d012827","5",939545,943194,3649
"4741","Zm00001d012830","5",949750,951996,2246
"4742","Zm00001d012831","5",953000,956110,3110
"4743","Zm00001d012832","5",956683,958210,1527
"4744","Zm00001d012834","5",958297,964764,6467
"4745","Zm00001d012836","5",969717,971009,1292
"4746","Zm00001d012837","5",975110,975562,452
"4747","Zm00001d012838","5",980443,982656,2213
"4748","Zm00001d012839","5",983375,990618,7243
"4749","Zm00001d012840","5",990110,994697,4587
"4750","Zm00001d012842","5",1030177,1036813,6636
"4751","Zm00001d012844","5",1060873,1065790,4917
"4752","Zm00001d012845","5",1066531,1071306,4775
"4753","Zm00001d012846","5",1071426,1076029,4603
"4754","Zm00001d012847","5",1077775,1079269,1494
"4755","Zm00001d012848","5",1080944,1081672,728
"4756","Zm00001d012849","5",1082609,1084730,2121
"4757","Zm00001d012850","5",1084640,1087652,3012
"4758","Zm00001d012851","5",1092746,1099057,6311
"4759","Zm00001d012852","5",1099259,1101829,2570
"4760","Zm00001d012853","5",1115868,1118754,2886
"4761","Zm00001d012854","5",1119957,1122587,2630
"4762","Zm00001d012855","5",1124569,1127670,3101
"4763","Zm00001d012856","5",1129423,1135486,6063
"4764","Zm00001d012857","5",1163084,1165592,2508
"4765","Zm00001d012858","5",1169589,1180180,10591
"4766","Zm00001d012859","5",1221504,1223598,2094
"4767","Zm00001d012861","5",1269106,1283069,13963
"4768","Zm00001d012862","5",1289643,1291724,2081
"4769","Zm00001d012863","5",1291937,1298884,6947
"4770","Zm00001d012864","5",1300450,1301239,789
"4771","Zm00001d012865","5",1349308,1357093,7785
"4772","Zm00001d012866","5",1358353,1362950,4597
"4773","Zm00001d012867","5",1366642,1369293,2651
"4774","Zm00001d012868","5",1369611,1375366,5755
"4775","Zm00001d012869","5",1375911,1397930,22019
"4776","Zm00001d012872","5",1471553,1480897,9344
"4777","Zm00001d012875","5",1499743,1505321,5578
"4778","Zm00001d012878","5",1531936,1534668,2732
"4779","Zm00001d012880","5",1564032,1566921,2889
"4780","Zm00001d012881","5",1566875,1569101,2226
"4781","Zm00001d012882","5",1573806,1578947,5141
"4782","Zm00001d012883","5",1584315,1587019,2704
"4783","Zm00001d012884","5",1587906,1593592,5686
"4784","Zm00001d012885","5",1594063,1594988,925
"4785","Zm00001d012886","5",1605087,1607673,2586
"4786","Zm00001d012887","5",1609222,1611862,2640
"4787","Zm00001d012888","5",1612077,1615249,3172
"4788","Zm00001d012889","5",1615998,1616651,653
"4789","Zm00001d012890","5",1618038,1622184,4146
"4790","Zm00001d012891","5",1622705,1631341,8636
"4791","Zm00001d012892","5",1642983,1653530,10547
"4792","Zm00001d012893","5",1661518,1666868,5350
"4793","Zm00001d012894","5",1702326,1705261,2935
"4794","Zm00001d012895","5",1713093,1718062,4969
"4795","Zm00001d012896","5",1719447,1724144,4697
"4796","Zm00001d012897","5",1754456,1759018,4562
"4797","Zm00001d012898","5",1759263,1764689,5426
"4798","Zm00001d012900","5",1768374,1778661,10287
"4799","Zm00001d012902","5",1776398,1778463,2065
"4800","Zm00001d012909","5",1879412,1882859,3447
"4801","Zm00001d012910","5",1880345,1881006,661
"4802","Zm00001d012911","5",1884199,1891050,6851
"4803","Zm00001d012913","5",1891852,1900865,9013
"4804","Zm00001d012915","5",1905304,1908332,3028
"4805","Zm00001d012916","5",1908305,1915026,6721
"4806","Zm00001d012917","5",1934208,1936982,2774
"4807","Zm00001d012918","5",1940928,1956957,16029
"4808","Zm00001d012920","5",1958516,1959313,797
"4809","Zm00001d012921","5",1959713,1963560,3847
"4810","Zm00001d012922","5",1978763,1993142,14379
"4811","Zm00001d012923","5",1993895,2003080,9185
"4812","Zm00001d012924","5",2004892,2007704,2812
"4813","Zm00001d012925","5",2065025,2068818,3793
"4814","Zm00001d012928","5",2162733,2165262,2529
"4815","Zm00001d012929","5",2166712,2169144,2432
"4816","Zm00001d012930","5",2169425,2171887,2462
"4817","Zm00001d012931","5",2173189,2178440,5251
"4818","Zm00001d012932","5",2183943,2186302,2359
"4819","Zm00001d012933","5",2194975,2197929,2954
"4820","Zm00001d012934","5",2198176,2201920,3744
"4821","Zm00001d012935","5",2204320,2225211,20891
"4822","Zm00001d012936","5",2225609,2227382,1773
"4823","Zm00001d012937","5",2228453,2229426,973
"4824","Zm00001d012938","5",2230365,2235259,4894
"4825","Zm00001d012939","5",2237403,2238414,1011
"4826","Zm00001d012943","5",2286794,2296592,9798
"4827","Zm00001d012953","5",2330281,2333027,2746
"4828","Zm00001d012954","5",2343012,2343815,803
"4829","Zm00001d012955","5",2345664,2348616,2952
"4830","Zm00001d012956","5",2349740,2350027,287
"4831","Zm00001d012957","5",2355513,2357943,2430
"4832","Zm00001d012958","5",2364388,2370531,6143
"4833","Zm00001d012960","5",2379741,2380346,605
"4834","Zm00001d012961","5",2387556,2389415,1859
"4835","Zm00001d012962","5",2395497,2399273,3776
"4836","Zm00001d012963","5",2416250,2425046,8796
"4837","Zm00001d012964","5",2431015,2437696,6681
"4838","Zm00001d012965","5",2439260,2442023,2763
"4839","Zm00001d012966","5",2443185,2445279,2094
"4840","Zm00001d012968","5",2459657,2460184,527
"4841","Zm00001d012969","5",2467426,2481571,14145
"4842","Zm00001d012970","5",2554674,2558207,3533
"4843","Zm00001d012971","5",2560596,2569361,8765
"4844","Zm00001d012972","5",2582304,2584012,1708
"4845","Zm00001d012973","5",2608395,2610069,1674
"4846","Zm00001d012974","5",2610660,2624658,13998
"4847","Zm00001d012975","5",2624940,2626072,1132
"4848","Zm00001d012978","5",2663422,2665225,1803
"4849","Zm00001d012979","5",2666357,2681120,14763
"4850","Zm00001d012980","5",2680365,2689832,9467
"4851","Zm00001d012981","5",2680388,2692291,11903
"4852","Zm00001d012982","5",2772181,2774600,2419
"4853","Zm00001d012984","5",2827981,2833133,5152
"4854","Zm00001d012988","5",2849021,2850279,1258
"4855","Zm00001d012989","5",2850921,2852153,1232
"4856","Zm00001d012991","5",2857770,2867371,9601
"4857","Zm00001d012992","5",2871120,2873693,2573
"4858","Zm00001d012993","5",2874875,2878453,3578
"4859","Zm00001d012994","5",2879546,2882574,3028
"4860","Zm00001d012995","5",2882929,2884405,1476
"4861","Zm00001d012996","5",2886366,2890377,4011
"4862","Zm00001d012998","5",2893965,2896910,2945
"4863","Zm00001d013003","5",2977575,2979101,1526
"4864","Zm00001d013004","5",2995849,2996508,659
"4865","Zm00001d013005","5",2997319,3000825,3506
"4866","Zm00001d013006","5",3132563,3148461,15898
"4867","Zm00001d013007","5",3149161,3151741,2580
"4868","Zm00001d013008","5",3153649,3159513,5864
"4869","Zm00001d013009","5",3161899,3162291,392
"4870","Zm00001d013010","5",3162431,3171017,8586
"4871","Zm00001d013012","5",3197352,3202002,4650
"4872","Zm00001d013013","5",3206170,3213965,7795
"4873","Zm00001d013014","5",3228063,3233201,5138
"4874","Zm00001d013019","5",3281413,3292822,11409
"4875","Zm00001d013020","5",3283568,3286317,2749
"4876","Zm00001d013022","5",3410175,3412752,2577
"4877","Zm00001d013023","5",3417817,3427573,9756
"4878","Zm00001d013024","5",3420273,3420344,71
"4879","Zm00001d013025","5",3430063,3432771,2708
"4880","Zm00001d013026","5",3433739,3437031,3292
"4881","Zm00001d013027","5",3457051,3461537,4486
"4882","Zm00001d013028","5",3464279,3465049,770
"4883","Zm00001d013029","5",3467417,3471866,4449
"4884","Zm00001d013030","5",3472230,3476498,4268
"4885","Zm00001d013031","5",3486306,3487932,1626
"4886","Zm00001d013033","5",3492135,3493834,1699
"4887","Zm00001d013034","5",3494823,3496592,1769
"4888","Zm00001d013035","5",3537738,3542307,4569
"4889","Zm00001d013036","5",3549293,3553774,4481
"4890","Zm00001d013037","5",3579930,3583194,3264
"4891","Zm00001d013038","5",3586891,3587917,1026
"4892","Zm00001d013040","5",3606324,3612670,6346
"4893","Zm00001d013041","5",3613357,3618413,5056
"4894","Zm00001d013042","5",3621250,3622125,875
"4895","Zm00001d013043","5",3626153,3629045,2892
"4896","Zm00001d017765","5",206195445,206198744,3299
"4897","Zm00001d017766","5",206199093,206201012,1919
"4898","Zm00001d017767","5",206244670,206247552,2882
"4899","Zm00001d017768","5",206249302,206254075,4773
"4900","Zm00001d017769","5",206295967,206299220,3253
"4901","Zm00001d017770","5",206299496,206304043,4547
"4902","Zm00001d017771","5",206343101,206346122,3021
"4903","Zm00001d017772","5",206349763,206353137,3374
"4904","Zm00001d017773","5",206380933,206384191,3258
"4905","Zm00001d017774","5",206385460,206386071,611
"4906","Zm00001d017777","5",206411178,206414574,3396
"4907","Zm00001d017778","5",206414473,206416485,2012
"4908","Zm00001d017780","5",206546323,206552409,6086
"4909","Zm00001d017781","5",206584432,206587009,2577
"4910","Zm00001d017783","5",206691760,206696301,4541
"4911","Zm00001d017784","5",206700640,206701893,1253
"4912","Zm00001d017786","5",206748709,206751630,2921
"4913","Zm00001d017787","5",206752152,206757266,5114
"4914","Zm00001d017789","5",206898283,206898994,711
"4915","Zm00001d017790","5",206950056,206955130,5074
"4916","Zm00001d017791","5",206956208,206962117,5909
"4917","Zm00001d017793","5",206964939,206969131,4192
"4918","Zm00001d017798","5",207066204,207098182,31978
"4919","Zm00001d017799","5",207115775,207118184,2409
"4920","Zm00001d017800","5",207118180,207122586,4406
"4921","Zm00001d017801","5",207142340,207144828,2488
"4922","Zm00001d017802","5",207144269,207147422,3153
"4923","Zm00001d017803","5",207165777,207168266,2489
"4924","Zm00001d017805","5",207302222,207308368,6146
"4925","Zm00001d017806","5",207369388,207372376,2988
"4926","Zm00001d017807","5",207375638,207378185,2547
"4927","Zm00001d017808","5",207409444,207425497,16053
"4928","Zm00001d017809","5",207482554,207491210,8656
"4929","Zm00001d017810","5",207491705,207497156,5451
"4930","Zm00001d017811","5",207513991,207515469,1478
"4931","Zm00001d017812","5",207515530,207524652,9122
"4932","Zm00001d017817","5",207626509,207626934,425
"4933","Zm00001d017818","5",207638868,207671710,32842
"4934","Zm00001d017820","5",207733647,207736615,2968
"4935","Zm00001d017821","5",207742585,207746674,4089
"4936","Zm00001d017822","5",207752591,207753046,455
"4937","Zm00001d017823","5",207755678,207763540,7862
"4938","Zm00001d017825","5",207839207,207840181,974
"4939","Zm00001d017826","5",207860764,207865964,5200
"4940","Zm00001d017827","5",207918441,207919463,1022
"4941","Zm00001d017829","5",207953995,207958553,4558
"4942","Zm00001d017830","5",208016509,208023474,6965
"4943","Zm00001d017831","5",208057546,208063084,5538
"4944","Zm00001d017832","5",208249380,208257275,7895
"4945","Zm00001d017833","5",208259089,208262363,3274
"4946","Zm00001d017834","5",208264486,208266307,1821
"4947","Zm00001d017836","5",208266641,208271222,4581
"4948","Zm00001d017837","5",208273343,208273918,575
"4949","Zm00001d017838","5",208358406,208359206,800
"4950","Zm00001d017840","5",208461206,208462369,1163
"4951","Zm00001d017843","5",208581631,208582399,768
"4952","Zm00001d017845","5",208603374,208605036,1662
"4953","Zm00001d017846","5",208632549,208641965,9416
"4954","Zm00001d017847","5",208645801,208649527,3726
"4955","Zm00001d017848","5",208664935,208684240,19305
"4956","Zm00001d017849","5",208733011,208737362,4351
"4957","Zm00001d017850","5",208742451,208744562,2111
"4958","Zm00001d017852","5",208841207,208841407,200
"4959","Zm00001d017853","5",208842057,208846275,4218
"4960","Zm00001d017855","5",208910768,208912103,1335
"4961","Zm00001d017857","5",208984585,208987631,3046
"4962","Zm00001d017859","5",209058601,209062935,4334
"4963","Zm00001d017860","5",209065470,209070347,4877
"4964","Zm00001d017861","5",209075772,209076365,593
"4965","Zm00001d017862","5",209091060,209095479,4419
"4966","Zm00001d017863","5",209096527,209100036,3509
"4967","Zm00001d017864","5",209118987,209121465,2478
"4968","Zm00001d017865","5",209123539,209129506,5967
"4969","Zm00001d017866","5",209132505,209139911,7406
"4970","Zm00001d017867","5",209143391,209145843,2452
"4971","Zm00001d017868","5",209147917,209153884,5967
"4972","Zm00001d017869","5",209156904,209161914,5010
"4973","Zm00001d017871","5",209242050,209250119,8069
"4974","Zm00001d017872","5",209274818,209280493,5675
"4975","Zm00001d017874","5",209352390,209357003,4613
"4976","Zm00001d017876","5",209361893,209367885,5992
"4977","Zm00001d017877","5",209453899,209455860,1961
"4978","Zm00001d017878","5",209468909,209472256,3347
"4979","Zm00001d017879","5",209496108,209496181,73
"4980","Zm00001d017880","5",209498712,209501781,3069
"4981","Zm00001d017881","5",209502895,209507334,4439
"4982","Zm00001d017882","5",209528751,209533960,5209
"4983","Zm00001d017883","5",209534213,209545337,11124
"4984","Zm00001d017885","5",209614260,209620254,5994
"4985","Zm00001d017886","5",209622400,209626936,4536
"4986","Zm00001d017887","5",209631841,209639778,7937
"4987","Zm00001d017888","5",209640646,209644166,3520
"4988","Zm00001d017889","5",209652199,209653828,1629
"4989","Zm00001d017890","5",209654501,209671076,16575
"4990","Zm00001d017893","5",209703274,209706844,3570
"4991","Zm00001d017894","5",209707498,209709330,1832
"4992","Zm00001d017895","5",209709534,209714278,4744
"4993","Zm00001d017896","5",209714173,209717529,3356
"4994","Zm00001d017897","5",209719922,209722622,2700
"4995","Zm00001d017898","5",209724572,209725408,836
"4996","Zm00001d017899","5",209742538,209743296,758
"4997","Zm00001d017900","5",209782489,209783391,902
"4998","Zm00001d017901","5",209804558,209821388,16830
"4999","Zm00001d017904","5",209855128,209856637,1509
"5000","Zm00001d017905","5",209876443,209879538,3095
"5001","Zm00001d017906","5",209944102,209948357,4255
"5002","Zm00001d017907","5",209973548,209974192,644
"5003","Zm00001d017908","5",209974275,209978114,3839
"5004","Zm00001d017911","5",210005007,210005537,530
"5005","Zm00001d017912","5",210036826,210039426,2600
"5006","Zm00001d017913","5",210045106,210049644,4538
"5007","Zm00001d017914","5",210052135,210055768,3633
"5008","Zm00001d017915","5",210055877,210059325,3448
"5009","Zm00001d017916","5",210061664,210062956,1292
"5010","Zm00001d017920","5",210110059,210112307,2248
"5011","Zm00001d017925","5",210190144,210195309,5165
"5012","Zm00001d017926","5",210202931,210207440,4509
"5013","Zm00001d017927","5",210209890,210212065,2175
"5014","Zm00001d017928","5",210212564,210215163,2599
"5015","Zm00001d017930","5",210256398,210262442,6044
"5016","Zm00001d017931","5",210262377,210263936,1559
"5017","Zm00001d017932","5",210273759,210285475,11716
"5018","Zm00001d017935","5",210378851,210382756,3905
"5019","Zm00001d017936","5",210382851,210383930,1079
"5020","Zm00001d017937","5",210385310,210401948,16638
"5021","Zm00001d017941","5",210498173,210500108,1935
"5022","Zm00001d017942","5",210507670,210509638,1968
"5023","Zm00001d017943","5",210528507,210531177,2670
"5024","Zm00001d017944","5",210535051,210536825,1774
"5025","Zm00001d017945","5",210540116,210543847,3731
"5026","Zm00001d017946","5",210558734,210581460,22726
"5027","Zm00001d017947","5",210665706,210667821,2115
"5028","Zm00001d017949","5",210674350,210677138,2788
"5029","Zm00001d017950","5",210702654,210703193,539
"5030","Zm00001d017951","5",210778082,210779268,1186
"5031","Zm00001d017952","5",210781408,210782962,1554
"5032","Zm00001d017953","5",210785282,210790516,5234
"5033","Zm00001d017954","5",210807462,210811487,4025
"5034","Zm00001d017955","5",210812448,210813281,833
"5035","Zm00001d017956","5",210857857,210858255,398
"5036","Zm00001d017957","5",210861055,210866038,4983
"5037","Zm00001d017958","5",210867625,210871221,3596
"5038","Zm00001d017959","5",210906424,210910522,4098
"5039","Zm00001d017960","5",210911927,210914408,2481
"5040","Zm00001d017961","5",210933744,210939753,6009
"5041","Zm00001d017962","5",210947384,210954891,7507
"5042","Zm00001d017964","5",210959844,210965383,5539
"5043","Zm00001d017965","5",210963442,210968727,5285
"5044","Zm00001d017966","5",210969323,210974977,5654
"5045","Zm00001d017967","5",210992940,211000013,7073
"5046","Zm00001d017968","5",211000353,211000697,344
"5047","Zm00001d017970","5",211022670,211023208,538
"5048","Zm00001d017977","5",211161703,211171628,9925
"5049","Zm00001d017978","5",211180278,211183912,3634
"5050","Zm00001d017979","5",211184326,211211518,27192
"5051","Zm00001d017980","5",211285164,211300568,15404
"5052","Zm00001d017981","5",211303399,211321137,17738
"5053","Zm00001d017982","5",211334503,211343257,8754
"5054","Zm00001d017983","5",211349626,211354097,4471
"5055","Zm00001d017984","5",211370735,211372359,1624
"5056","Zm00001d017985","5",211401090,211405864,4774
"5057","Zm00001d017986","5",211406416,211411375,4959
"5058","Zm00001d017987","5",211412495,211416317,3822
"5059","Zm00001d017988","5",211455711,211463306,7595
"5060","Zm00001d017989","5",211463522,211465214,1692
"5061","Zm00001d017995","5",211635631,211640602,4971
"5062","Zm00001d017996","5",211642539,211643627,1088
"5063","Zm00001d017997","5",211648510,211653599,5089
"5064","Zm00001d017998","5",211658453,211660266,1813
"5065","Zm00001d018001","5",211694641,211703345,8704
"5066","Zm00001d018003","5",211742129,211742884,755
"5067","Zm00001d018004","5",211768723,211777331,8608
"5068","Zm00001d018005","5",211811435,211817914,6479
"5069","Zm00001d018009","5",211938923,211947803,8880
"5070","Zm00001d018011","5",211975629,211984184,8555
"5071","Zm00001d018012","5",211978697,211982782,4085
"5072","Zm00001d018013","5",212102698,212106748,4050
"5073","Zm00001d018014","5",212108530,212117488,8958
"5074","Zm00001d018016","5",212198363,212199559,1196
"5075","Zm00001d018017","5",212204911,212205450,539
"5076","Zm00001d018019","5",212215701,212217938,2237
"5077","Zm00001d018024","5",212254262,212257744,3482
"5078","Zm00001d018025","5",212350402,212368255,17853
"5079","Zm00001d018026","5",212364417,212364487,70
"5080","Zm00001d018028","5",212372579,212374838,2259
"5081","Zm00001d018030","5",212391759,212393282,1523
"5082","Zm00001d018031","5",212483686,212485307,1621
"5083","Zm00001d018032","5",212488580,212492036,3456
"5084","Zm00001d018033","5",212494773,212500400,5627
"5085","Zm00001d018034","5",212543656,212546035,2379
"5086","Zm00001d018035","5",212546517,212547423,906
"5087","Zm00001d018036","5",212569064,212573328,4264
"5088","Zm00001d018037","5",212580241,212583888,3647
"5089","Zm00001d018038","5",212630308,212636028,5720
"5090","Zm00001d018040","5",212684919,212689770,4851
"5091","Zm00001d018041","5",212692584,212696936,4352
"5092","Zm00001d018042","5",212712300,212716910,4610
"5093","Zm00001d018043","5",212717180,212720262,3082
"5094","Zm00001d018046","5",212798586,212804962,6376
"5095","Zm00001d018047","5",212828616,212850685,22069
"5096","Zm00001d018048","5",212841881,212843454,1573
"5097","Zm00001d018049","5",213151971,213160764,8793
"5098","Zm00001d018050","5",213161649,213165885,4236
"5099","Zm00001d018051","5",213219441,213220187,746
"5100","Zm00001d018055","5",213262134,213273317,11183
"5101","Zm00001d018056","5",213279676,213281098,1422
"5102","Zm00001d018057","5",213288385,213294605,6220
"5103","Zm00001d018058","5",213446943,213448076,1133
"5104","Zm00001d018059","5",213450456,213456337,5881
"5105","Zm00001d018060","5",213494647,213524574,29927
"5106","Zm00001d018061","5",213495789,213498656,2867
"5107","Zm00001d018065","5",213694436,213695611,1175
"5108","Zm00001d018066","5",213696372,213697544,1172
"5109","Zm00001d018069","5",213760677,213761423,746
"5110","Zm00001d018070","5",213768773,213771405,2632
"5111","Zm00001d018072","5",213774589,213779282,4693
"5112","Zm00001d018074","5",213809766,213814190,4424
"5113","Zm00001d018075","5",213815299,213816720,1421
"5114","Zm00001d018076","5",213819658,213821136,1478
"5115","Zm00001d018077","5",213824475,213826162,1687
"5116","Zm00001d018078","5",213833777,213836884,3107
"5117","Zm00001d018080","5",213839290,213843472,4182
"5118","Zm00001d018081","5",213912954,213913979,1025
"5119","Zm00001d018085","5",213951246,213951617,371
"5120","Zm00001d018086","5",213976676,213977392,716
"5121","Zm00001d018087","5",213984418,213985413,995
"5122","Zm00001d018088","5",213988699,213992184,3485
"5123","Zm00001d018089","5",214041553,214042179,626
"5124","Zm00001d018090","5",214042874,214045954,3080
"5125","Zm00001d018096","5",214119645,214121623,1978
"5126","Zm00001d018097","5",214127646,214129053,1407
"5127","Zm00001d018098","5",214145696,214154284,8588
"5128","Zm00001d018099","5",214157648,214160124,2476
"5129","Zm00001d020718","7",130047693,130048670,977
"5130","Zm00001d020725","7",130286350,130287261,911
"5131","Zm00001d020726","7",130295212,130300354,5142
"5132","Zm00001d020727","7",130345805,130357946,12141
"5133","Zm00001d020728","7",130390863,130417870,27007
"5134","Zm00001d020729","7",130432383,130432837,454
"5135","Zm00001d020731","7",130467170,130469083,1913
"5136","Zm00001d020736","7",130689762,130690802,1040
"5137","Zm00001d020737","7",130745556,130746503,947
"5138","Zm00001d020738","7",130768508,130769509,1001
"5139","Zm00001d020740","7",130817340,130818332,992
"5140","Zm00001d020741","7",130840864,130842003,1139
"5141","Zm00001d020743","7",130915119,130919620,4501
"5142","Zm00001d020744","7",130940525,130941516,991
"5143","Zm00001d020747","7",131061325,131061969,644
"5144","Zm00001d020748","7",131101945,131106713,4768
"5145","Zm00001d020752","7",131210348,131213927,3579
"5146","Zm00001d020755","7",131254670,131257545,2875
"5147","Zm00001d020757","7",131304876,131305619,743
"5148","Zm00001d020760","7",131540493,131548810,8317
"5149","Zm00001d020761","7",131547993,131548851,858
"5150","Zm00001d020762","7",131549688,131551010,1322
"5151","Zm00001d020764","7",131557949,131561931,3982
"5152","Zm00001d020765","7",131564225,131568019,3794
"5153","Zm00001d020768","7",131675954,131676955,1001
"5154","Zm00001d020769","7",131678626,131700543,21917
"5155","Zm00001d020770","7",131820907,131823805,2898
"5156","Zm00001d020771","7",131824428,131829394,4966
"5157","Zm00001d020772","7",131855551,131857649,2098
"5158","Zm00001d020773","7",131952446,131953919,1473
"5159","Zm00001d020774","7",132034507,132035328,821
"5160","Zm00001d020775","7",132100220,132104288,4068
"5161","Zm00001d020776","7",132117347,132122646,5299
"5162","Zm00001d020779","7",132445668,132447423,1755
"5163","Zm00001d020780","7",132447942,132449006,1064
"5164","Zm00001d020781","7",132449037,132455871,6834
"5165","Zm00001d020783","7",132507882,132520893,13011
"5166","Zm00001d020790","7",132794517,132796578,2061
"5167","Zm00001d020791","7",132829319,132830404,1085
"5168","Zm00001d020793","7",132928791,132929628,837
"5169","Zm00001d020794","7",132947391,132948359,968
"5170","Zm00001d020799","7",133232803,133244605,11802
"5171","Zm00001d020803","7",133370055,133376861,6806
"5172","Zm00001d020804","7",133411779,133413849,2070
"5173","Zm00001d020807","7",133502732,133510166,7434
"5174","Zm00001d020808","7",133517158,133521665,4507
"5175","Zm00001d020810","7",133596384,133609425,13041
"5176","Zm00001d020811","7",133774093,133778933,4840
"5177","Zm00001d020814","7",133809754,133821908,12154
"5178","Zm00001d020817","7",133826534,133830600,4066
"5179","Zm00001d020818","7",133883308,133883393,85
"5180","Zm00001d020820","7",133907684,133908130,446
"5181","Zm00001d020821","7",133911775,133930671,18896
"5182","Zm00001d020822","7",133917294,133920456,3162
"5183","Zm00001d020823","7",133939918,133940505,587
"5184","Zm00001d020825","7",133990554,133992308,1754
"5185","Zm00001d020826","7",133997692,134000698,3006
"5186","Zm00001d020827","7",134001581,134006410,4829
"5187","Zm00001d020828","7",134113060,134114967,1907
"5188","Zm00001d020834","7",134251695,134259327,7632
"5189","Zm00001d020835","7",134261242,134274862,13620
"5190","Zm00001d020837","7",134352325,134353122,797
"5191","Zm00001d020838","7",134390627,134393802,3175
"5192","Zm00001d020839","7",134394293,134395390,1097
"5193","Zm00001d020840","7",134445122,134445928,806
"5194","Zm00001d020845","7",134486165,134489807,3642
"5195","Zm00001d020851","7",134652923,134663134,10211
"5196","Zm00001d020852","7",134723869,134728829,4960
"5197","Zm00001d020853","7",134779523,134783267,3744
"5198","Zm00001d020858","7",134901536,134904779,3243
"5199","Zm00001d020860","7",134913533,134914997,1464
"5200","Zm00001d020861","7",134916785,134917437,652
"5201","Zm00001d020862","7",134954297,134958341,4044
"5202","Zm00001d020863","7",134962596,134965720,3124
"5203","Zm00001d020864","7",135003267,135008627,5360
"5204","Zm00001d020867","7",135064149,135071720,7571
"5205","Zm00001d020868","7",135068706,135068779,73
"5206","Zm00001d020869","7",135114949,135115323,374
"5207","Zm00001d020870","7",135138697,135140598,1901
"5208","Zm00001d020871","7",135142770,135143315,545
"5209","Zm00001d020872","7",135156779,135157039,260
"5210","Zm00001d020874","7",135216263,135216865,602
"5211","Zm00001d020875","7",135220239,135221598,1359
"5212","Zm00001d020879","7",135265751,135268897,3146
"5213","Zm00001d020881","7",135317302,135321287,3985
"5214","Zm00001d020882","7",135398610,135400475,1865
"5215","Zm00001d020883","7",135413340,135414170,830
"5216","Zm00001d020886","7",135469300,135471079,1779
"5217","Zm00001d020887","7",135474565,135477046,2481
"5218","Zm00001d020891","7",135609061,135620005,10944
"5219","Zm00001d020892","7",135679272,135687679,8407
"5220","Zm00001d020898","7",135842402,135846744,4342
"5221","Zm00001d020899","7",135891155,135891640,485
"5222","Zm00001d020900","7",135891863,135894153,2290
"5223","Zm00001d020901","7",136108132,136115361,7229
"5224","Zm00001d020902","7",136115418,136125608,10190
"5225","Zm00001d020903","7",136132216,136133013,797
"5226","Zm00001d020904","7",136137124,136146235,9111
"5227","Zm00001d020905","7",136147501,136149899,2398
"5228","Zm00001d020906","7",136150746,136151527,781
"5229","Zm00001d020908","7",136238439,136243677,5238
"5230","Zm00001d020909","7",136246208,136247296,1088
"5231","Zm00001d020910","7",136264881,136266357,1476
"5232","Zm00001d020911","7",136267590,136271907,4317
"5233","Zm00001d020913","7",136282835,136284622,1787
"5234","Zm00001d020915","7",136479777,136482266,2489
"5235","Zm00001d020923","7",136683805,136689077,5272
"5236","Zm00001d020925","7",136721755,136722342,587
"5237","Zm00001d020926","7",136725907,136726398,491
"5238","Zm00001d020929","7",136898721,136904152,5431
"5239","Zm00001d020930","7",136911485,136911832,347
"5240","Zm00001d020931","7",136913647,136915619,1972
"5241","Zm00001d020932","7",136986209,136988745,2536
"5242","Zm00001d020935","7",137126539,137129617,3078
"5243","Zm00001d020936","7",137150743,137154652,3909
"5244","Zm00001d020937","7",137154591,137157038,2447
"5245","Zm00001d020938","7",137232926,137243079,10153
"5246","Zm00001d020939","7",137263513,137265342,1829
"5247","Zm00001d020941","7",137273600,137277139,3539
"5248","Zm00001d020943","7",137361936,137370496,8560
"5249","Zm00001d020944","7",137377035,137378060,1025
"5250","Zm00001d020946","7",137472537,137479934,7397
"5251","Zm00001d020947","7",137482526,137485454,2928
"5252","Zm00001d020948","7",137486579,137487673,1094
"5253","Zm00001d020950","7",137491639,137493598,1959
"5254","Zm00001d020951","7",137493946,137514552,20606
"5255","Zm00001d020953","7",137599102,137608563,9461
"5256","Zm00001d020954","7",137626105,137626968,863
"5257","Zm00001d020955","7",137670000,137672835,2835
"5258","Zm00001d020957","7",137711314,137713490,2176
"5259","Zm00001d020960","7",137934293,137939512,5219
"5260","Zm00001d020962","7",138003516,138006566,3050
"5261","Zm00001d020963","7",138057377,138061501,4124
"5262","Zm00001d020965","7",138116641,138122918,6277
"5263","Zm00001d020968","7",138172661,138173344,683
"5264","Zm00001d020969","7",138202794,138208053,5259
"5265","Zm00001d020970","7",138208287,138210135,1848
"5266","Zm00001d020971","7",138210336,138221164,10828
"5267","Zm00001d020972","7",138223556,138229618,6062
"5268","Zm00001d020973","7",138248896,138256381,7485
"5269","Zm00001d020974","7",138260086,138261759,1673
"5270","Zm00001d020975","7",138262824,138266459,3635
"5271","Zm00001d020976","7",138349670,138351460,1790
"5272","Zm00001d020977","7",138407898,138409603,1705
"5273","Zm00001d020978","7",138410439,138455911,45472
"5274","Zm00001d020979","7",138692805,138696697,3892
"5275","Zm00001d020980","7",138698158,138702131,3973
"5276","Zm00001d020982","7",138832493,138835958,3465
"5277","Zm00001d020983","7",139018844,139024560,5716
"5278","Zm00001d020984","7",139074709,139076907,2198
"5279","Zm00001d020985","7",139305004,139364561,59557
"5280","Zm00001d020986","7",139367277,139370608,3331
"5281","Zm00001d020989","7",139575199,139624018,48819
"5282","Zm00001d021000","7",139890422,139921005,30583
"5283","Zm00001d021001","7",139906379,139910748,4369
"5284","Zm00001d021006","7",140181294,140182626,1332
"5285","Zm00001d021011","7",140404199,140407451,3252
"5286","Zm00001d021014","7",140471692,140477878,6186
"5287","Zm00001d021015","7",140479942,140497099,17157
"5288","Zm00001d021016","7",140499249,140501074,1825
"5289","Zm00001d021018","7",140506559,140508508,1949
"5290","Zm00001d021019","7",140533153,140535630,2477
"5291","Zm00001d021020","7",140560504,140562258,1754
"5292","Zm00001d021021","7",140562622,140567401,4779
"5293","Zm00001d021023","7",140682154,140688142,5988
"5294","Zm00001d021024","7",140750988,140754908,3920
"5295","Zm00001d021025","7",140788218,140790075,1857
"5296","Zm00001d021026","7",140795172,140796635,1463
"5297","Zm00001d021028","7",140896165,140901926,5761
"5298","Zm00001d021030","7",140935029,140936185,1156
"5299","Zm00001d021031","7",140949104,140954205,5101
"5300","Zm00001d021032","7",140954748,140973549,18801
"5301","Zm00001d021034","7",141004039,141005047,1008
"5302","Zm00001d021035","7",141008297,141008939,642
"5303","Zm00001d021036","7",141009143,141013714,4571
"5304","Zm00001d021046","7",141160173,141163742,3569
"5305","Zm00001d021050","7",141288160,141292427,4267
"5306","Zm00001d021051","7",141401773,141405263,3490
"5307","Zm00001d021053","7",141602512,141603882,1370
"5308","Zm00001d021054","7",141615733,141619939,4206
"5309","Zm00001d021056","7",141662438,141666340,3902
"5310","Zm00001d021057","7",141716954,141728132,11178
"5311","Zm00001d021058","7",141732990,141733358,368
"5312","Zm00001d021059","7",141819946,141821175,1229
"5313","Zm00001d021060","7",141821900,141824221,2321
"5314","Zm00001d021061","7",141851056,141853484,2428
"5315","Zm00001d021062","7",141857876,141858286,410
"5316","Zm00001d021063","7",141944251,141946568,2317
"5317","Zm00001d021064","7",141949476,141951690,2214
"5318","Zm00001d021065","7",141953686,141960985,7299
"5319","Zm00001d021069","7",142080504,142083844,3340
"5320","Zm00001d021070","7",142133051,142138801,5750
"5321","Zm00001d021071","7",142141971,142150217,8246
"5322","Zm00001d021072","7",142151607,142159817,8210
"5323","Zm00001d021073","7",142161083,142167277,6194
"5324","Zm00001d021075","7",142286500,142291128,4628
"5325","Zm00001d021081","7",142382414,142387700,5286
"5326","Zm00001d021082","7",142420831,142427998,7167
"5327","Zm00001d021085","7",142427917,142438706,10789
"5328","Zm00001d021086","7",142451964,142454359,2395
"5329","Zm00001d021087","7",142484402,142493269,8867
"5330","Zm00001d021089","7",142530712,142532073,1361
"5331","Zm00001d021090","7",142550344,142554948,4604
"5332","Zm00001d021104","7",142843160,142846598,3438
"5333","Zm00001d021109","7",142894006,142896483,2477
"5334","Zm00001d021119","7",143115379,143119792,4413
"5335","Zm00001d021120","7",143199722,143204781,5059
"5336","Zm00001d021122","7",143280820,143283847,3027
"5337","Zm00001d021123","7",143285797,143288834,3037
"5338","Zm00001d021126","7",143316001,143319672,3671
"5339","Zm00001d021127","7",143327655,143344805,17150
"5340","Zm00001d021128","7",143414684,143416530,1846
"5341","Zm00001d021129","7",143419272,143421737,2465
"5342","Zm00001d021130","7",143426765,143428189,1424
"5343","Zm00001d021131","7",143430931,143435172,4241
"5344","Zm00001d021132","7",143453893,143458551,4658
"5345","Zm00001d021133","7",143493508,143496377,2869
"5346","Zm00001d021135","7",143617763,143627668,9905
"5347","Zm00001d021136","7",143640566,143645192,4626
"5348","Zm00001d021137","7",143756966,143760726,3760
"5349","Zm00001d021138","7",143847983,143858642,10659
"5350","Zm00001d021139","7",143856218,143860073,3855
"5351","Zm00001d021140","7",143872080,143877237,5157
"5352","Zm00001d021141","7",143879896,143880393,497
"5353","Zm00001d021142","7",143938849,143949787,10938
"5354","Zm00001d021143","7",143954654,143959409,4755
"5355","Zm00001d021144","7",143962423,143965375,2952
"5356","Zm00001d021145","7",144088215,144096509,8294
"5357","Zm00001d021147","7",144097014,144107041,10027
"5358","Zm00001d021149","7",144128263,144129613,1350
"5359","Zm00001d021160","7",144296960,144297214,254
"5360","Zm00001d021162","7",144351398,144353422,2024
"5361","Zm00001d021166","7",144572852,144578085,5233
"5362","Zm00001d021167","7",144659589,144661331,1742
"5363","Zm00001d021168","7",144743120,144744903,1783
"5364","Zm00001d021169","7",144827166,144831009,3843
"5365","Zm00001d021170","7",144831920,144839494,7574
"5366","Zm00001d021171","7",144839835,144840167,332
"5367","Zm00001d021173","7",144970206,144973502,3296
"5368","Zm00001d021176","7",145030207,145044894,14687
"5369","Zm00001d021177","7",145080744,145081383,639
"5370","Zm00001d021178","7",145097442,145098301,859
"5371","Zm00001d021179","7",145104553,145105903,1350
"5372","Zm00001d021180","7",145134997,145143590,8593
"5373","Zm00001d021181","7",145151826,145159580,7754
"5374","Zm00001d021187","7",145306214,145310459,4245
"5375","Zm00001d021188","7",145411775,145418536,6761
"5376","Zm00001d021189","7",145424990,145430280,5290
"5377","Zm00001d021191","7",145445635,145448907,3272
"5378","Zm00001d021192","7",145448190,145449889,1699
"5379","Zm00001d021193","7",145450783,145453837,3054
"5380","Zm00001d021195","7",145558394,145561493,3099
"5381","Zm00001d021196","7",145562443,145567534,5091
"5382","Zm00001d021197","7",145649789,145651701,1912
"5383","Zm00001d021199","7",145757912,145759757,1845
"5384","Zm00001d021200","7",145766119,145767552,1433
"5385","Zm00001d021201","7",145827021,145831069,4048
"5386","Zm00001d021202","7",145864711,145878539,13828
"5387","Zm00001d021203","7",145879432,145884960,5528
"5388","Zm00001d021204","7",146019810,146024828,5018
"5389","Zm00001d021205","7",146027044,146027784,740
"5390","Zm00001d021207","7",146034693,146035409,716
"5391","Zm00001d021208","7",146038525,146039307,782
"5392","Zm00001d021215","7",146372201,146380667,8466
"5393","Zm00001d021216","7",146426539,146429054,2515
"5394","Zm00001d021218","7",146448139,146450719,2580
"5395","Zm00001d021219","7",146460969,146463025,2056
"5396","Zm00001d021220","7",146481870,146483374,1504
"5397","Zm00001d021221","7",146489261,146494703,5442
"5398","Zm00001d021223","7",146506351,146507646,1295
"5399","Zm00001d021224","7",146508204,146510684,2480
"5400","Zm00001d021225","7",146550796,146555239,4443
"5401","Zm00001d021226","7",146556758,146557628,870
"5402","Zm00001d021227","7",146557648,146567208,9560
"5403","Zm00001d021231","7",146607570,146610451,2881
"5404","Zm00001d021232","7",146619730,146622285,2555
"5405","Zm00001d021236","7",146658310,146664494,6184
"5406","Zm00001d021237","7",146666554,146668407,1853
"5407","Zm00001d021240","7",146735831,146741337,5506
"5408","Zm00001d021241","7",146744186,146756271,12085
"5409","Zm00001d021242","7",146763235,146765187,1952
"5410","Zm00001d021243","7",146768955,146770070,1115
"5411","Zm00001d021244","7",146789970,146799955,9985
"5412","Zm00001d021245","7",146809739,146813458,3719
"5413","Zm00001d021246","7",146813084,146815732,2648
"5414","Zm00001d021247","7",146817751,146825126,7375
"5415","Zm00001d021248","7",146829648,146832066,2418
"5416","Zm00001d021249","7",146833035,146836048,3013
"5417","Zm00001d021250","7",146859110,146860060,950
"5418","Zm00001d021251","7",146867422,146876752,9330
"5419","Zm00001d021253","7",146958309,146960077,1768
"5420","Zm00001d021254","7",146961275,146964107,2832
"5421","Zm00001d021258","7",147085277,147096083,10806
"5422","Zm00001d021261","7",147104875,147135066,30191
"5423","Zm00001d021262","7",147154617,147158295,3678
"5424","Zm00001d021263","7",147163459,147165213,1754
"5425","Zm00001d021265","7",147242505,147243247,742
"5426","Zm00001d021267","7",147321667,147331351,9684
"5427","Zm00001d021268","7",147335002,147336496,1494
"5428","Zm00001d021269","7",147346346,147361021,14675
"5429","Zm00001d021272","7",147466700,147467242,542
"5430","Zm00001d021273","7",147467203,147467622,419
"5431","Zm00001d021278","7",147632776,147636889,4113
"5432","Zm00001d021279","7",147725357,147726867,1510
"5433","Zm00001d021280","7",147731835,147735312,3477
"5434","Zm00001d021282","7",147762070,147764900,2830
"5435","Zm00001d021283","7",147803103,147807697,4594
"5436","Zm00001d021285","7",147853086,147854863,1777
"5437","Zm00001d021286","7",147952084,147953976,1892
"5438","Zm00001d021287","7",147960306,147965257,4951
"5439","Zm00001d021288","7",147970755,147972640,1885
"5440","Zm00001d021289","7",147999944,148000603,659
"5441","Zm00001d021290","7",148061214,148062014,800
"5442","Zm00001d021291","7",148065548,148071232,5684
"5443","Zm00001d021292","7",148076081,148081677,5596
"5444","Zm00001d021294","7",148128045,148129250,1205
"5445","Zm00001d021295","7",148139612,148148607,8995
"5446","Zm00001d021296","7",148154982,148165194,10212
"5447","Zm00001d021297","7",148166430,148190176,23746
"5448","Zm00001d021298","7",148190216,148191262,1046
"5449","Zm00001d021299","7",148222733,148226124,3391
"5450","Zm00001d021300","7",148227448,148227942,494
"5451","Zm00001d021301","7",148264574,148273453,8879
"5452","Zm00001d021303","7",148332483,148336874,4391
"5453","Zm00001d021304","7",148348269,148353225,4956
"5454","Zm00001d021305","7",148354226,148356976,2750
"5455","Zm00001d021306","7",148361780,148365833,4053
"5456","Zm00001d021309","7",148452001,148458141,6140
"5457","Zm00001d021310","7",148461116,148465035,3919
"5458","Zm00001d021313","7",148569648,148572118,2470
"5459","Zm00001d021314","7",148630663,148635120,4457
"5460","Zm00001d021316","7",148698772,148699347,575
"5461","Zm00001d021318","7",148759147,148769945,10798
"5462","Zm00001d021321","7",148806602,148807834,1232
"5463","Zm00001d021328","7",149013126,149015597,2471
"5464","Zm00001d021329","7",149024878,149026351,1473
"5465","Zm00001d021330","7",149027267,149054381,27114
"5466","Zm00001d021332","7",149060166,149064823,4657
"5467","Zm00001d021335","7",149129974,149134091,4117
"5468","Zm00001d021336","7",149167346,149179144,11798
"5469","Zm00001d021338","7",149248068,149251047,2979
"5470","Zm00001d021339","7",149309446,149310770,1324
"5471","Zm00001d021340","7",149326226,149327233,1007
"5472","Zm00001d021341","7",149327183,149328523,1340
"5473","Zm00001d021342","7",149411835,149416604,4769
"5474","Zm00001d021343","7",149427463,149430451,2988
"5475","Zm00001d021344","7",149456670,149462712,6042
"5476","Zm00001d021345","7",149522562,149527823,5261
"5477","Zm00001d021346","7",149528661,149531321,2660
"5478","Zm00001d021347","7",149582625,149589183,6558
"5479","Zm00001d021350","7",149680769,149689844,9075
"5480","Zm00001d021351","7",149691857,149697713,5856
"5481","Zm00001d021352","7",149732790,149733558,768
"5482","Zm00001d021353","7",149735354,149738325,2971
"5483","Zm00001d021356","7",149757277,149757543,266
"5484","Zm00001d021359","7",149802378,149805494,3116
"5485","Zm00001d021360","7",149842280,149844889,2609
"5486","Zm00001d021362","7",149911394,149914056,2662
"5487","Zm00001d021363","7",149916057,149920082,4025
"5488","Zm00001d021365","7",150013061,150027380,14319
"5489","Zm00001d021367","7",150060843,150064672,3829
"5490","Zm00001d021368","7",150079651,150084317,4666
"5491","Zm00001d021370","7",150111805,150113628,1823
"5492","Zm00001d021371","7",150146640,150149440,2800
"5493","Zm00001d021372","7",150158588,150167531,8943
"5494","Zm00001d021375","7",150241573,150244589,3016
"5495","Zm00001d021376","7",150246031,150250848,4817
"5496","Zm00001d021378","7",150322957,150329229,6272
"5497","Zm00001d021379","7",150380281,150388648,8367
"5498","Zm00001d021382","7",150548777,150553253,4476
"5499","Zm00001d021383","7",150576886,150578342,1456
"5500","Zm00001d021384","7",150583860,150593396,9536
"5501","Zm00001d021385","7",150624324,150635185,10861
"5502","Zm00001d021386","7",150642387,150642920,533
"5503","Zm00001d021387","7",150649030,150650340,1310
"5504","Zm00001d021388","7",150652542,150658382,5840
"5505","Zm00001d021389","7",150664292,150665299,1007
"5506","Zm00001d021390","7",150688180,150693940,5760
"5507","Zm00001d021391","7",150693937,150694821,884
"5508","Zm00001d021392","7",150695962,150700278,4316
"5509","Zm00001d021393","7",150853513,150856167,2654
"5510","Zm00001d021395","7",150900094,150910045,9951
"5511","Zm00001d021396","7",150910524,150917934,7410
"5512","Zm00001d021400","7",151056579,151061402,4823
"5513","Zm00001d021401","7",151061639,151067413,5774
"5514","Zm00001d021403","7",151211055,151215873,4818
"5515","Zm00001d021404","7",151347708,151355546,7838
"5516","Zm00001d021407","7",151457303,151476815,19512
"5517","Zm00001d021410","7",151481395,151484398,3003
"5518","Zm00001d021411","7",151509562,151512844,3282
"5519","Zm00001d021412","7",151514107,151515828,1721
"5520","Zm00001d021413","7",151517790,151529322,11532
"5521","Zm00001d021414","7",151541812,151542450,638
"5522","Zm00001d021415","7",151548269,151549788,1519
"5523","Zm00001d021417","7",151554716,151557062,2346
"5524","Zm00001d021418","7",151605094,151605897,803
"5525","Zm00001d021420","7",151700876,151704007,3131
"5526","Zm00001d021421","7",151705669,151712216,6547
"5527","Zm00001d021422","7",151786254,151786667,413
"5528","Zm00001d021423","7",151788597,151792933,4336
"5529","Zm00001d021424","7",151795011,151797484,2473
"5530","Zm00001d021425","7",151803864,151806894,3030
"5531","Zm00001d021426","7",151842892,151845660,2768
"5532","Zm00001d021430","7",151968691,151992054,23363
"5533","Zm00001d021433","7",152095387,152097351,1964
"5534","Zm00001d021435","7",152283433,152284280,847
"5535","Zm00001d021436","7",152284814,152288199,3385
"5536","Zm00001d021437","7",152289225,152290130,905
"5537","Zm00001d021438","7",152291798,152298021,6223
"5538","Zm00001d021439","7",152303404,152303772,368
"5539","Zm00001d021440","7",152304445,152305540,1095
"5540","Zm00001d021441","7",152320129,152320914,785
"5541","Zm00001d021442","7",152335837,152341211,5374
"5542","Zm00001d021444","7",152348851,152351171,2320
"5543","Zm00001d021445","7",152358112,152359792,1680
"5544","Zm00001d021446","7",152372379,152379941,7562
"5545","Zm00001d021447","7",152381542,152384274,2732
"5546","Zm00001d021448","7",152385950,152390797,4847
"5547","Zm00001d021450","7",152444914,152447392,2478
"5548","Zm00001d021451","7",152520041,152520553,512
"5549","Zm00001d021452","7",152567607,152573313,5706
"5550","Zm00001d021453","7",152605084,152608082,2998
"5551","Zm00001d021456","7",152644791,152645267,476
"5552","Zm00001d021459","7",152719949,152720386,437
"5553","Zm00001d021462","7",152744845,152756833,11988
"5554","Zm00001d021464","7",152793032,152797189,4157
"5555","Zm00001d021465","7",152802563,152803452,889
"5556","Zm00001d021467","7",152926221,152935720,9499
"5557","Zm00001d021469","7",153018015,153030585,12570
"5558","Zm00001d021470","7",153075349,153079559,4210
"5559","Zm00001d021473","7",153177327,153198945,21618
"5560","Zm00001d021476","7",153197028,153197101,73
"5561","Zm00001d021477","7",153335991,153336302,311
"5562","Zm00001d021480","7",153348678,153355461,6783
"5563","Zm00001d021481","7",153359951,153363462,3511
"5564","Zm00001d021484","7",153509816,153516662,6846
"5565","Zm00001d021485","7",153509816,153516604,6788
"5566","Zm00001d021486","7",153554768,153557927,3159
"5567","Zm00001d021487","7",153736670,153739072,2402
"5568","Zm00001d021488","7",153824987,153861598,36611
"5569","Zm00001d021490","7",153920007,153923619,3612
"5570","Zm00001d021491","7",153938883,153943526,4643
"5571","Zm00001d021492","7",153974161,153988559,14398
"5572","Zm00001d021494","7",154089912,154092986,3074
"5573","Zm00001d021498","7",154121091,154131385,10294
"5574","Zm00001d021500","7",154161679,154168113,6434
"5575","Zm00001d021504","7",154246089,154246537,448
"5576","Zm00001d021505","7",154271170,154278697,7527
"5577","Zm00001d021506","7",154416323,154419080,2757
"5578","Zm00001d021507","7",154419410,154425081,5671
"5579","Zm00001d021508","7",154481841,154484342,2501
"5580","Zm00001d021509","7",154583500,154584690,1190
"5581","Zm00001d021511","7",154590413,154592259,1846
"5582","Zm00001d021512","7",154609186,154616951,7765
"5583","Zm00001d021513","7",154682758,154684482,1724
"5584","Zm00001d021514","7",154730754,154731556,802
"5585","Zm00001d021515","7",154782638,154784305,1667
"5586","Zm00001d021516","7",154821346,154840399,19053
"5587","Zm00001d021517","7",154950057,154954788,4731
"5588","Zm00001d021518","7",154954926,154961956,7030
"5589","Zm00001d021519","7",154989542,154995305,5763
"5590","Zm00001d021520","7",154995449,154999093,3644
"5591","Zm00001d021521","7",155089387,155091425,2038
"5592","Zm00001d021522","7",155092264,155097289,5025
"5593","Zm00001d021524","7",155139091,155151352,12261
"5594","Zm00001d021525","7",155151530,155153566,2036
"5595","Zm00001d021526","7",155153847,155156140,2293
"5596","Zm00001d021528","7",155175215,155183115,7900
"5597","Zm00001d021529","7",155183894,155186161,2267
"5598","Zm00001d021532","7",155246635,155252267,5632
"5599","Zm00001d021534","7",155262075,155266341,4266
"5600","Zm00001d021535","7",155278714,155283440,4726
"5601","Zm00001d021536","7",155283654,155287662,4008
"5602","Zm00001d021540","7",155401002,155403922,2920
"5603","Zm00001d021541","7",155404186,155420422,16236
"5604","Zm00001d021542","7",155445924,155447228,1304
"5605","Zm00001d021544","7",155503583,155504602,1019
"5606","Zm00001d021545","7",155507985,155512108,4123
"5607","Zm00001d021546","7",155518816,155528949,10133
"5608","Zm00001d021551","7",155647955,155651800,3845
"5609","Zm00001d021552","7",155686393,155697641,11248
"5610","Zm00001d021553","7",155738042,155748698,10656
"5611","Zm00001d021554","7",155779197,155787322,8125
"5612","Zm00001d021557","7",155895169,155897978,2809
"5613","Zm00001d021558","7",155979744,156001862,22118
"5614","Zm00001d021564","7",156178438,156179268,830
"5615","Zm00001d021565","7",156178576,156211394,32818
"5616","Zm00001d021566","7",156211865,156221817,9952
"5617","Zm00001d021567","7",156223168,156230159,6991
"5618","Zm00001d021568","7",156276136,156289375,13239
"5619","Zm00001d021569","7",156294946,156300431,5485
"5620","Zm00001d021570","7",156405337,156416482,11145
"5621","Zm00001d021571","7",156435498,156437554,2056
"5622","Zm00001d021572","7",156435644,156440415,4771
"5623","Zm00001d021573","7",156465329,156466981,1652
"5624","Zm00001d021574","7",156488961,156504047,15086
"5625","Zm00001d021576","7",156641990,156643471,1481
"5626","Zm00001d021577","7",156646623,156648065,1442
"5627","Zm00001d021579","7",156773195,156778425,5230
"5628","Zm00001d021580","7",156778841,156785489,6648
"5629","Zm00001d021582","7",156872048,156881616,9568
"5630","Zm00001d021583","7",156885893,156890748,4855
"5631","Zm00001d021584","7",157092806,157108976,16170
"5632","Zm00001d021585","7",157164149,157166625,2476
"5633","Zm00001d021587","7",157216178,157224292,8114
"5634","Zm00001d021588","7",157319980,157335608,15628
"5635","Zm00001d021589","7",157332896,157332965,69
"5636","Zm00001d021591","7",157433264,157434346,1082
"5637","Zm00001d021592","7",157525044,157533907,8863
"5638","Zm00001d021593","7",157530381,157530450,69
"5639","Zm00001d021595","7",157600128,157600988,860
"5640","Zm00001d021596","7",157694972,157698287,3315
"5641","Zm00001d023854","10",25085007,25085303,296
"5642","Zm00001d023856","10",25214019,25214375,356
"5643","Zm00001d023859","10",25283888,25287483,3595
"5644","Zm00001d023863","10",25367734,25368630,896
"5645","Zm00001d023865","10",25417359,25421335,3976
"5646","Zm00001d023867","10",25582979,25590172,7193
"5647","Zm00001d023868","10",25595490,25600235,4745
"5648","Zm00001d023874","10",25936465,25942972,6507
"5649","Zm00001d023877","10",26072811,26076587,3776
"5650","Zm00001d023880","10",26191828,26194467,2639
"5651","Zm00001d023881","10",26194543,26204316,9773
"5652","Zm00001d023882","10",26204689,26207745,3056
"5653","Zm00001d023885","10",26305370,26308988,3618
"5654","Zm00001d023887","10",26413254,26416496,3242
"5655","Zm00001d023888","10",26416953,26419954,3001
"5656","Zm00001d023889","10",26476932,26477408,476
"5657","Zm00001d023892","10",26542390,26547193,4803
"5658","Zm00001d023895","10",26718145,26724047,5902
"5659","Zm00001d023896","10",26772380,26775750,3370
"5660","Zm00001d023897","10",26984101,26996894,12793
"5661","Zm00001d023899","10",27167732,27171648,3916
"5662","Zm00001d023901","10",27251530,27252715,1185
"5663","Zm00001d023904","10",27313349,27316275,2926
"5664","Zm00001d023906","10",27456859,27465326,8467
"5665","Zm00001d023908","10",27502136,27505505,3369
"5666","Zm00001d023909","10",27559899,27560748,849
"5667","Zm00001d023910","10",27639022,27654657,15635
"5668","Zm00001d023912","10",27881681,27885933,4252
"5669","Zm00001d023914","10",27979618,27987242,7624
"5670","Zm00001d023915","10",28083135,28084982,1847
"5671","Zm00001d023916","10",28180538,28181374,836
"5672","Zm00001d023918","10",28212896,28215652,2756
"5673","Zm00001d023919","10",28240334,28243204,2870
"5674","Zm00001d023922","10",28388023,28391656,3633
"5675","Zm00001d023923","10",28420100,28422811,2711
"5676","Zm00001d023927","10",28693644,28695428,1784
"5677","Zm00001d023928","10",28812919,28813636,717
"5678","Zm00001d023929","10",29148234,29154174,5940
"5679","Zm00001d023933","10",29995808,29996959,1151
"5680","Zm00001d023934","10",29997630,30002284,4654
"5681","Zm00001d023936","10",30082820,30083380,560
"5682","Zm00001d023939","10",30314944,30317071,2127
"5683","Zm00001d023940","10",30400299,30400997,698
"5684","Zm00001d023941","10",30402000,30405639,3639
"5685","Zm00001d023943","10",30683334,30695018,11684
"5686","Zm00001d023944","10",30897430,30899575,2145
"5687","Zm00001d023945","10",30972520,30976307,3787
"5688","Zm00001d023946","10",30976716,30980257,3541
"5689","Zm00001d023950","10",31183136,31184065,929
"5690","Zm00001d023953","10",31457131,31460881,3750
"5691","Zm00001d023955","10",31669358,31673544,4186
"5692","Zm00001d023957","10",31821083,31827877,6794
"5693","Zm00001d023962","10",32089437,32094242,4805
"5694","Zm00001d023964","10",32323177,32326990,3813
"5695","Zm00001d023968","10",32563929,32567309,3380
"5696","Zm00001d023969","10",32585885,32588980,3095
"5697","Zm00001d023974","10",33362121,33363695,1574
"5698","Zm00001d023978","10",33717911,33721015,3104
"5699","Zm00001d023979","10",33922137,33926709,4572
"5700","Zm00001d023982","10",34214274,34227047,12773
"5701","Zm00001d023985","10",34330995,34334637,3642
"5702","Zm00001d023987","10",34453878,34465900,12022
"5703","Zm00001d023993","10",35139343,35141232,1889
"5704","Zm00001d023994","10",35174831,35179918,5087
"5705","Zm00001d023995","10",35301876,35306863,4987
"5706","Zm00001d023998","10",35441529,35448839,7310
"5707","Zm00001d024001","10",35707638,35708763,1125
"5708","Zm00001d024003","10",35842772,35856493,13721
"5709","Zm00001d024004","10",35858507,35864183,5676
"5710","Zm00001d024005","10",35922682,35924953,2271
"5711","Zm00001d024008","10",36379483,36384610,5127
"5712","Zm00001d024009","10",36528738,36535462,6724
"5713","Zm00001d024012","10",36873558,36877166,3608
"5714","Zm00001d024016","10",37077737,37083244,5507
"5715","Zm00001d024017","10",37082417,37086200,3783
"5716","Zm00001d024018","10",37085965,37102852,16887
"5717","Zm00001d024027","10",37879487,37880623,1136
"5718","Zm00001d024028","10",37894909,37899157,4248
"5719","Zm00001d024029","10",38039992,38043742,3750
"5720","Zm00001d024030","10",38227276,38228679,1403
"5721","Zm00001d024034","10",38698828,38720756,21928
"5722","Zm00001d024035","10",38787097,38794588,7491
"5723","Zm00001d024036","10",38795360,38821643,26283
"5724","Zm00001d024037","10",38844199,38849055,4856
"5725","Zm00001d024041","10",39073197,39078744,5547
"5726","Zm00001d024043","10",39109230,39113706,4476
"5727","Zm00001d024047","10",39664540,39669815,5275
"5728","Zm00001d024048","10",39712844,39724848,12004
"5729","Zm00001d024049","10",39765508,39781464,15956
"5730","Zm00001d024051","10",40111662,40115443,3781
"5731","Zm00001d024053","10",40250482,40256679,6197
"5732","Zm00001d024058","10",40477028,40481002,3974
"5733","Zm00001d024059","10",40715440,40719177,3737
"5734","Zm00001d024060","10",40747708,40752335,4627
"5735","Zm00001d024062","10",40787545,40788949,1404
"5736","Zm00001d024066","10",41073293,41087885,14592
"5737","Zm00001d024070","10",41419113,41423564,4451
"5738","Zm00001d024071","10",41457090,41458519,1429
"5739","Zm00001d024072","10",41643302,41644974,1672
"5740","Zm00001d024075","10",42074660,42079454,4794
"5741","Zm00001d024082","10",42493160,42494244,1084
"5742","Zm00001d024083","10",42507737,42511403,3666
"5743","Zm00001d024088","10",43222466,43225929,3463
"5744","Zm00001d024092","10",43766059,43771787,5728
"5745","Zm00001d024093","10",43772159,43777204,5045
"5746","Zm00001d024094","10",44110305,44115719,5414
"5747","Zm00001d024101","10",44982622,44984577,1955
"5748","Zm00001d024102","10",45051775,45053151,1376
"5749","Zm00001d024105","10",45703239,45704101,862
"5750","Zm00001d024109","10",46166547,46169418,2871
"5751","Zm00001d024112","10",46407305,46410671,3366
"5752","Zm00001d024113","10",46412379,46414046,1667
"5753","Zm00001d024115","10",46737424,46745141,7717
"5754","Zm00001d024120","10",47326176,47327585,1409
"5755","Zm00001d024125","10",48078973,48081721,2748
"5756","Zm00001d024126","10",48089572,48093645,4073
"5757","Zm00001d024128","10",48256777,48269920,13143
"5758","Zm00001d024134","10",48629599,48631479,1880
"5759","Zm00001d024135","10",48704467,48707614,3147
"5760","Zm00001d024138","10",49020418,49026280,5862
"5761","Zm00001d024140","10",49067757,49069364,1607
"5762","Zm00001d024141","10",49072650,49076807,4157
"5763","Zm00001d024143","10",49101829,49103014,1185
"5764","Zm00001d024151","10",49971629,49972114,485
"5765","Zm00001d024153","10",50348895,50359551,10656
"5766","Zm00001d024154","10",50349266,50362873,13607
"5767","Zm00001d024155","10",50392427,50394713,2286
"5768","Zm00001d024157","10",50584421,50586766,2345
"5769","Zm00001d024158","10",51121121,51133038,11917
"5770","Zm00001d024159","10",51231078,51241553,10475
"5771","Zm00001d024160","10",51315314,51327171,11857
"5772","Zm00001d024164","10",51618709,51619885,1176
"5773","Zm00001d024166","10",51900072,51900674,602
"5774","Zm00001d024169","10",52321108,52329461,8353
"5775","Zm00001d024170","10",52657634,52660741,3107
"5776","Zm00001d024171","10",52662145,52669708,7563
"5777","Zm00001d024187","10",54271062,54275105,4043
"5778","Zm00001d024192","10",54890273,54916259,25986
"5779","Zm00001d024193","10",54920198,54922076,1878
"5780","Zm00001d024194","10",54971219,54978845,7626
"5781","Zm00001d024195","10",54998993,54999382,389
"5782","Zm00001d024196","10",54999901,55001252,1351
"5783","Zm00001d024197","10",55002372,55004094,1722
"5784","Zm00001d024198","10",55151388,55151915,527
"5785","Zm00001d024199","10",55246275,55249896,3621
"5786","Zm00001d024200","10",55274175,55275011,836
"5787","Zm00001d024203","10",55739987,55744458,4471
"5788","Zm00001d024204","10",55985377,55988129,2752
"5789","Zm00001d024205","10",56256752,56275757,19005
"5790","Zm00001d024209","10",56568678,56569597,919
"5791","Zm00001d024212","10",56828755,56838148,9393
"5792","Zm00001d024213","10",56996605,56997874,1269
"5793","Zm00001d024220","10",57648579,57651264,2685
"5794","Zm00001d024222","10",58034393,58036920,2527
"5795","Zm00001d024225","10",58196315,58208268,11953
"5796","Zm00001d024229","10",58417186,58422086,4900
"5797","Zm00001d024230","10",58448599,58449354,755
"5798","Zm00001d024231","10",58449887,58454061,4174
"5799","Zm00001d024238","10",58940661,58959893,19232
"5800","Zm00001d024239","10",59002720,59005171,2451
"5801","Zm00001d024242","10",59229280,59230089,809
"5802","Zm00001d024243","10",59240906,59242285,1379
"5803","Zm00001d024244","10",59263359,59263667,308
"5804","Zm00001d024245","10",59264330,59271577,7247
"5805","Zm00001d024246","10",59323337,59324722,1385
"5806","Zm00001d024248","10",59441463,59446450,4987
"5807","Zm00001d024251","10",59639653,59641801,2148
"5808","Zm00001d024252","10",59715714,59716954,1240
"5809","Zm00001d024258","10",59906061,59918458,12397
"5810","Zm00001d024262","10",59950553,59956816,6263
"5811","Zm00001d024265","10",60015948,60017307,1359
"5812","Zm00001d024268","10",60226179,60228837,2658
"5813","Zm00001d024270","10",60598911,60606190,7279
"5814","Zm00001d024272","10",60726649,60729120,2471
"5815","Zm00001d024274","10",61030755,61038775,8020
"5816","Zm00001d024275","10",61181574,61189017,7443
"5817","Zm00001d024277","10",61390273,61396414,6141
"5818","Zm00001d024285","10",61712124,61716615,4491
"5819","Zm00001d024291","10",62300386,62308465,8079
"5820","Zm00001d024292","10",62317297,62320708,3411
"5821","Zm00001d024294","10",62512731,62514813,2082
"5822","Zm00001d024298","10",62684243,62685430,1187
"5823","Zm00001d024300","10",62829800,62835007,5207
"5824","Zm00001d024301","10",62895060,62902241,7181
"5825","Zm00001d024302","10",62902288,62903162,874
"5826","Zm00001d024305","10",63044232,63050120,5888
"5827","Zm00001d024306","10",63061548,63063353,1805
"5828","Zm00001d024307","10",63091728,63097838,6110
"5829","Zm00001d024310","10",63447121,63453995,6874
"5830","Zm00001d024311","10",63453244,63457463,4219
"5831","Zm00001d024314","10",63672420,63675196,2776
"5832","Zm00001d024317","10",63998482,64015910,17428
"5833","Zm00001d024318","10",64146988,64156247,9259
"5834","Zm00001d024319","10",64272530,64275570,3040
"5835","Zm00001d024320","10",64374343,64377804,3461
"5836","Zm00001d024321","10",64378201,64379576,1375
"5837","Zm00001d024322","10",64559410,64560171,761
"5838","Zm00001d024323","10",64612739,64613831,1092
"5839","Zm00001d024324","10",64620725,64621285,560
"5840","Zm00001d024325","10",64669622,64684686,15064
"5841","Zm00001d024327","10",64819539,64877233,57694
"5842","Zm00001d024333","10",65217636,65225489,7853
"5843","Zm00001d024338","10",65518390,65530091,11701
"5844","Zm00001d024339","10",65524284,65532891,8607
"5845","Zm00001d024340","10",65653740,65656426,2686
"5846","Zm00001d024342","10",65777201,65792002,14801
"5847","Zm00001d024343","10",65880914,65886361,5447
"5848","Zm00001d024344","10",65886692,65887828,1136
"5849","Zm00001d024345","10",65890768,65891820,1052
"5850","Zm00001d024347","10",65970347,65974404,4057
"5851","Zm00001d024348","10",65976164,65985734,9570
"5852","Zm00001d024350","10",66118492,66119148,656
"5853","Zm00001d024351","10",66123261,66124322,1061
"5854","Zm00001d024353","10",66260393,66261334,941
"5855","Zm00001d024354","10",66471477,66472334,857
"5856","Zm00001d024355","10",66563565,66564225,660
"5857","Zm00001d024356","10",66564122,66569277,5155
"5858","Zm00001d024357","10",66571406,66571900,494
"5859","Zm00001d024358","10",66581794,66581865,71
"5860","Zm00001d024363","10",66996150,66999187,3037
"5861","Zm00001d024364","10",67007013,67012130,5117
"5862","Zm00001d024365","10",67166621,67173531,6910
"5863","Zm00001d024367","10",67238307,67239064,757
"5864","Zm00001d024371","10",67591281,67591511,230
"5865","Zm00001d024372","10",67598558,67599387,829
"5866","Zm00001d024373","10",67656528,67659072,2544
"5867","Zm00001d024375","10",67788432,67788504,72
"5868","Zm00001d024376","10",67963922,67964857,935
"5869","Zm00001d024379","10",68164948,68165808,860
"5870","Zm00001d024384","10",68303992,68307589,3597
"5871","Zm00001d024386","10",68324451,68325959,1508
"5872","Zm00001d024390","10",68460502,68464995,4493
"5873","Zm00001d024393","10",68584698,68594748,10050
"5874","Zm00001d024394","10",68650435,68654502,4067
"5875","Zm00001d024396","10",68741027,68747136,6109
"5876","Zm00001d024397","10",68920396,68920830,434
"5877","Zm00001d024398","10",68924044,68928079,4035
"5878","Zm00001d024400","10",68966490,68969533,3043
"5879","Zm00001d024401","10",68993805,68994473,668
"5880","Zm00001d024403","10",69000124,69004820,4696
"5881","Zm00001d024406","10",69199906,69204296,4390
"5882","Zm00001d024407","10",69318521,69319274,753
"5883","Zm00001d024408","10",69366565,69372020,5455
"5884","Zm00001d024409","10",69419168,69422702,3534
"5885","Zm00001d024410","10",69483649,69484945,1296
"5886","Zm00001d024411","10",69487371,69498832,11461
"5887","Zm00001d024412","10",69674040,69680031,5991
"5888","Zm00001d024413","10",69712467,69715466,2999
"5889","Zm00001d024416","10",70055995,70057908,1913
"5890","Zm00001d024417","10",70110101,70110779,678
"5891","Zm00001d024418","10",70186132,70189912,3780
"5892","Zm00001d024420","10",70277489,70282890,5401
"5893","Zm00001d024421","10",70312679,70316041,3362
"5894","Zm00001d024423","10",70399874,70412898,13024
"5895","Zm00001d024424","10",70414238,70420011,5773
"5896","Zm00001d024425","10",70492332,70495711,3379
"5897","Zm00001d024427","10",70538568,70539790,1222
"5898","Zm00001d024429","10",70577739,70579793,2054
"5899","Zm00001d024430","10",70581048,70587119,6071
"5900","Zm00001d024431","10",70699714,70701228,1514
"5901","Zm00001d024432","10",70727429,70729161,1732
"5902","Zm00001d024439","10",70825279,70826738,1459
"5903","Zm00001d024441","10",70869052,70869823,771
"5904","Zm00001d024443","10",70969630,70970339,709
"5905","Zm00001d024444","10",71043508,71064293,20785
"5906","Zm00001d024450","10",71428956,71430173,1217
"5907","Zm00001d024457","10",71739147,71747481,8334
"5908","Zm00001d024461","10",71796844,71799614,2770
"5909","Zm00001d024462","10",71953333,71955151,1818
"5910","Zm00001d024463","10",71956367,71966054,9687
"5911","Zm00001d024464","10",71966048,71969342,3294
"5912","Zm00001d024466","10",72129360,72135148,5788
"5913","Zm00001d024467","10",72225291,72228591,3300
"5914","Zm00001d024468","10",72229235,72232453,3218
"5915","Zm00001d024470","10",72345216,72358785,13569
"5916","Zm00001d024471","10",72426672,72427733,1061
"5917","Zm00001d024474","10",72575132,72577927,2795
"5918","Zm00001d024475","10",72600343,72603299,2956
"5919","Zm00001d024477","10",72975072,72977686,2614
"5920","Zm00001d024482","10",73562385,73564416,2031
"5921","Zm00001d024485","10",73705518,73705591,73
"5922","Zm00001d024486","10",73708902,73712703,3801
"5923","Zm00001d024488","10",73839384,73843136,3752
"5924","Zm00001d024492","10",74052379,74054237,1858
"5925","Zm00001d024493","10",74093371,74099448,6077
"5926","Zm00001d024496","10",74143123,74144266,1143
"5927","Zm00001d024497","10",74153903,74159100,5197
"5928","Zm00001d024498","10",74314907,74316444,1537
"5929","Zm00001d024499","10",74394028,74403109,9081
"5930","Zm00001d024500","10",74401074,74401841,767
"5931","Zm00001d024505","10",74756584,74774103,17519
"5932","Zm00001d024509","10",74928701,74929729,1028
"5933","Zm00001d024510","10",74930192,74935116,4924
"5934","Zm00001d024511","10",74955857,74958288,2431
"5935","Zm00001d024512","10",75069687,75075183,5496
"5936","Zm00001d024516","10",75580964,75584778,3814
"5937","Zm00001d024518","10",75760691,75762808,2117
"5938","Zm00001d024519","10",75764386,75780299,15913
"5939","Zm00001d024520","10",75862661,75864082,1421
"5940","Zm00001d024521","10",75864894,75867823,2929
"5941","Zm00001d024523","10",75993828,76002912,9084
"5942","Zm00001d024525","10",76302295,76309059,6764
"5943","Zm00001d024527","10",76461961,76464163,2202
"5944","Zm00001d024528","10",76465805,76467972,2167
"5945","Zm00001d024530","10",76539255,76545947,6692
"5946","Zm00001d024531","10",76628321,76635128,6807
"5947","Zm00001d024532","10",76729754,76734531,4777
"5948","Zm00001d024533","10",76836394,76839591,3197
"5949","Zm00001d024534","10",76841341,76845268,3927
"5950","Zm00001d024536","10",76949485,76951690,2205
"5951","Zm00001d024538","10",77078388,77079341,953
"5952","Zm00001d024539","10",77080623,77087754,7131
"5953","Zm00001d024540","10",77144191,77149860,5669
"5954","Zm00001d024543","10",77529347,77533684,4337
"5955","Zm00001d024544","10",77538306,77543898,5592
"5956","Zm00001d024546","10",77700138,77703390,3252
"5957","Zm00001d024547","10",77722777,77724235,1458
"5958","Zm00001d024548","10",77772197,77772878,681
"5959","Zm00001d024549","10",77777088,77777751,663
"5960","Zm00001d024552","10",77961009,77965592,4583
"5961","Zm00001d024553","10",78048589,78051848,3259
"5962","Zm00001d024560","10",78246604,78252349,5745
"5963","Zm00001d024567","10",78539229,78549047,9818
"5964","Zm00001d024571","10",78696502,78699043,2541
"5965","Zm00001d024572","10",78703892,78707138,3246
"5966","Zm00001d024573","10",78798884,78799324,440
"5967","Zm00001d024574","10",78836368,78838011,1643
"5968","Zm00001d024583","10",79175479,79184510,9031
"5969","Zm00001d024587","10",79465955,79472158,6203
"5970","Zm00001d024588","10",79474689,79478403,3714
"5971","Zm00001d024591","10",79578452,79580065,1613
"5972","Zm00001d024593","10",79588608,79589422,814
"5973","Zm00001d024594","10",79726997,79731279,4282
"5974","Zm00001d024595","10",79813506,79821012,7506
"5975","Zm00001d024596","10",79830935,79838588,7653
"5976","Zm00001d024597","10",79896971,79904061,7090
"5977","Zm00001d024598","10",79908936,79913706,4770
"5978","Zm00001d024600","10",79991194,79997385,6191
"5979","Zm00001d024601","10",80002018,80033465,31447
"5980","Zm00001d024602","10",80081092,80085827,4735
"5981","Zm00001d024605","10",80137465,80140638,3173
"5982","Zm00001d024606","10",80156621,80159393,2772
"5983","Zm00001d024607","10",80160170,80160624,454
"5984","Zm00001d024608","10",80193417,80198259,4842
"5985","Zm00001d024610","10",80279185,80279870,685
"5986","Zm00001d024611","10",80310741,80311386,645
"5987","Zm00001d024612","10",80319653,80328964,9311
"5988","Zm00001d024613","10",80363189,80363784,595
"5989","Zm00001d024614","10",80366020,80367174,1154
"5990","Zm00001d024615","10",80376562,80377211,649
"5991","Zm00001d024617","10",80385879,80387306,1427
"5992","Zm00001d024619","10",80408875,80409683,808
"5993","Zm00001d024620","10",80551131,80554704,3573
"5994","Zm00001d024621","10",80562832,80565140,2308
"5995","Zm00001d024623","10",80764247,80764651,404
"5996","Zm00001d024624","10",80769666,80774901,5235
"5997","Zm00001d024625","10",80856442,80879275,22833
"5998","Zm00001d024627","10",81009835,81021978,12143
"5999","Zm00001d024630","10",81140535,81143186,2651
"6000","Zm00001d024631","10",81313003,81315686,2683
"6001","Zm00001d024632","10",81333941,81337901,3960
"6002","Zm00001d024633","10",81347903,81352638,4735
"6003","Zm00001d024635","10",81355519,81359449,3930
"6004","Zm00001d024637","10",81459381,81466000,6619
"6005","Zm00001d024640","10",81524653,81534673,10020
"6006","Zm00001d024643","10",81778828,81779889,1061
"6007","Zm00001d024644","10",81909922,81912952,3030
"6008","Zm00001d024645","10",82004050,82010075,6025
"6009","Zm00001d024646","10",82010624,82014234,3610
"6010","Zm00001d024647","10",82038496,82042897,4401
"6011","Zm00001d024648","10",82069582,82070175,593
"6012","Zm00001d024652","10",82136682,82138304,1622
"6013","Zm00001d024659","10",82482086,82482747,661
"6014","Zm00001d024660","10",82505158,82505709,551
"6015","Zm00001d024661","10",82540025,82546173,6148
"6016","Zm00001d024662","10",82550205,82553263,3058
"6017","Zm00001d024669","10",82923300,82925883,2583
"6018","Zm00001d024671","10",83032420,83036654,4234
"6019","Zm00001d024672","10",83125173,83126249,1076
"6020","Zm00001d024674","10",83251939,83254248,2309
"6021","Zm00001d024675","10",83281590,83288964,7374
"6022","Zm00001d024677","10",83366109,83371712,5603
"6023","Zm00001d024678","10",83375794,83380009,4215
"6024","Zm00001d024679","10",83443909,83447138,3229
"6025","Zm00001d024680","10",83504140,83504892,752
"6026","Zm00001d024681","10",83531295,83535827,4532
"6027","Zm00001d024682","10",83542072,83544101,2029
"6028","Zm00001d024687","10",83604546,83607822,3276
"6029","Zm00001d024695","10",83939608,83941521,1913
"6030","Zm00001d024697","10",83958343,83961453,3110
"6031","Zm00001d024698","10",83962005,83966353,4348
"6032","Zm00001d024699","10",84015105,84017555,2450
"6033","Zm00001d024701","10",84124039,84129119,5080
"6034","Zm00001d024702","10",84130306,84133108,2802
"6035","Zm00001d024703","10",84135184,84142738,7554
"6036","Zm00001d024704","10",84198500,84212285,13785
"6037","Zm00001d024708","10",84431354,84435330,3976
"6038","Zm00001d024709","10",84540352,84545986,5634
"6039","Zm00001d024710","10",84546907,84553633,6726
"6040","Zm00001d024711","10",84549485,84554071,4586
"6041","Zm00001d024712","10",84554486,84559654,5168
"6042","Zm00001d024713","10",84560055,84568649,8594
"6043","Zm00001d024715","10",84701374,84706220,4846
"6044","Zm00001d024716","10",84737818,84742552,4734
"6045","Zm00001d024718","10",84950249,84953025,2776
"6046","Zm00001d024719","10",84968157,84970062,1905
"6047","Zm00001d024722","10",85123160,85131753,8593
"6048","Zm00001d024723","10",85128123,85133157,5034
"6049","Zm00001d024725","10",85285499,85286719,1220
"6050","Zm00001d024729","10",85508260,85512046,3786
"6051","Zm00001d024732","10",85589259,85592180,2921
"6052","Zm00001d024733","10",85592812,85596617,3805
"6053","Zm00001d024734","10",85620431,85625034,4603
"6054","Zm00001d024735","10",85695716,85696928,1212
"6055","Zm00001d024739","10",85756586,85765328,8742
"6056","Zm00001d024744","10",85872249,85877606,5357
"6057","Zm00001d024752","10",86136391,86137413,1022
"6058","Zm00001d024753","10",86312505,86313524,1019
"6059","Zm00001d024754","10",86460332,86461525,1193
"6060","Zm00001d024755","10",86464826,86469049,4223
"6061","Zm00001d024756","10",86469146,86473935,4789
"6062","Zm00001d024757","10",86553758,86554777,1019
"6063","Zm00001d024759","10",86563313,86576507,13194
"6064","Zm00001d024760","10",86575066,86575988,922
"6065","Zm00001d024762","10",86732567,86742134,9567
"6066","Zm00001d024763","10",87102320,87104398,2078
"6067","Zm00001d024764","10",87125356,87129447,4091
"6068","Zm00001d024765","10",87211477,87213531,2054
"6069","Zm00001d024767","10",87218080,87221164,3084
"6070","Zm00001d024768","10",87223395,87228172,4777
"6071","Zm00001d024770","10",87265402,87267750,2348
"6072","Zm00001d024771","10",87291646,87292414,768
"6073","Zm00001d024772","10",87301613,87302477,864
"6074","Zm00001d024777","10",87362142,87363092,950
"6075","Zm00001d024778","10",87401369,87401545,176
"6076","Zm00001d024783","10",87873243,87875642,2399
"6077","Zm00001d024784","10",87973477,87976336,2859
"6078","Zm00001d024787","10",88361369,88366871,5502
"6079","Zm00001d024788","10",88367424,88377930,10506
"6080","Zm00001d024789","10",88437757,88439157,1400
"6081","Zm00001d024795","10",88557906,88561147,3241
"6082","Zm00001d024796","10",88564959,88571359,6400
"6083","Zm00001d024800","10",88699677,88699964,287
"6084","Zm00001d024802","10",88718249,88718494,245
"6085","Zm00001d024803","10",88741519,88753055,11536
"6086","Zm00001d024804","10",88761813,88768843,7030
"6087","Zm00001d024805","10",88769388,88769984,596
"6088","Zm00001d024806","10",88824825,88833384,8559
"6089","Zm00001d024807","10",88836429,88842405,5976
"6090","Zm00001d024808","10",88844039,88846874,2835
"6091","Zm00001d024809","10",88853062,88854141,1079
"6092","Zm00001d024810","10",88887562,88889100,1538
"6093","Zm00001d024813","10",89233958,89240358,6400
"6094","Zm00001d024814","10",89275166,89276263,1097
"6095","Zm00001d024815","10",89308209,89313475,5266
"6096","Zm00001d024816","10",89407915,89426926,19011
"6097","Zm00001d024819","10",89565254,89570746,5492
"6098","Zm00001d024821","10",89613645,89616637,2992
"6099","Zm00001d024823","10",89626222,89630017,3795
"6100","Zm00001d024824","10",89687263,89690813,3550
"6101","Zm00001d024825","10",89733156,89739279,6123
"6102","Zm00001d024827","10",89847489,89852336,4847
"6103","Zm00001d024828","10",89995765,90000359,4594
"6104","Zm00001d024830","10",90117995,90129224,11229
"6105","Zm00001d024831","10",90131666,90133501,1835
"6106","Zm00001d024832","10",90134129,90141743,7614
"6107","Zm00001d024833","10",90185901,90195212,9311
"6108","Zm00001d024835","10",90195370,90197131,1761
"6109","Zm00001d024838","10",90383507,90383851,344
"6110","Zm00001d024839","10",90384434,90385822,1388
"6111","Zm00001d024840","10",90387391,90399823,12432
"6112","Zm00001d024841","10",90403804,90415670,11866
"6113","Zm00001d024842","10",90452032,90455648,3616
"6114","Zm00001d024844","10",90482107,90484510,2403
"6115","Zm00001d024849","10",90559478,90560044,566
"6116","Zm00001d024853","10",90664003,90665073,1070
"6117","Zm00001d024854","10",90669584,90671414,1830
"6118","Zm00001d024855","10",90671654,90682705,11051
"6119","Zm00001d024857","10",90991479,90996675,5196
"6120","Zm00001d024858","10",90998277,91013374,15097
"6121","Zm00001d024859","10",91003188,91003261,73
"6122","Zm00001d024861","10",91044298,91048715,4417
"6123","Zm00001d024866","10",91320383,91321483,1100
"6124","Zm00001d024872","10",91598678,91600142,1464
"6125","Zm00001d024873","10",91636728,91646736,10008
"6126","Zm00001d024874","10",91752340,91764346,12006
"6127","Zm00001d024876","10",91818586,91820109,1523
"6128","Zm00001d024878","10",91887070,91894300,7230
"6129","Zm00001d024885","10",92330298,92332490,2192
"6130","Zm00001d024889","10",93008811,93023608,14797
"6131","Zm00001d024890","10",93052419,93060560,8141
"6132","Zm00001d024893","10",93373491,93373802,311
"6133","Zm00001d024894","10",93455728,93462424,6696
"6134","Zm00001d024903","10",93908317,93911235,2918
"6135","Zm00001d024904","10",94179848,94182817,2969
"6136","Zm00001d024905","10",94232837,94233649,812
"6137","Zm00001d024906","10",94248547,94249743,1196
"6138","Zm00001d024907","10",94269707,94271102,1395
"6139","Zm00001d024908","10",94274262,94281820,7558
"6140","Zm00001d024912","10",94650676,94652496,1820
"6141","Zm00001d024913","10",94657224,94657835,611
"6142","Zm00001d024914","10",94727018,94727649,631
"6143","Zm00001d024916","10",94904945,94907435,2490
"6144","Zm00001d024917","10",94910884,94911437,553
"6145","Zm00001d024918","10",94913396,94916114,2718
"6146","Zm00001d024919","10",94989364,94991623,2259
"6147","Zm00001d024924","10",95199922,95203758,3836
"6148","Zm00001d024925","10",95280553,95281923,1370
"6149","Zm00001d024926","10",95315410,95315850,440
"6150","Zm00001d024927","10",95363430,95366568,3138
"6151","Zm00001d024928","10",95451163,95473347,22184
"6152","Zm00001d024930","10",95463552,95465555,2003
"6153","Zm00001d024931","10",95541807,95543469,1662
"6154","Zm00001d024933","10",95587713,95593434,5721
"6155","Zm00001d024934","10",95624162,95627278,3116
"6156","Zm00001d024935","10",95666017,95669076,3059
"6157","Zm00001d024936","10",95794147,95805417,11270
"6158","Zm00001d024937","10",95806908,95811035,4127
"6159","Zm00001d024938","10",95848553,95864224,15671
"6160","Zm00001d024939","10",95933122,95935711,2589
"6161","Zm00001d024940","10",96012099,96015989,3890
"6162","Zm00001d024941","10",96015969,96019757,3788
"6163","Zm00001d024946","10",96325810,96327827,2017
"6164","Zm00001d024947","10",96358474,96363316,4842
"6165","Zm00001d024948","10",96502880,96504120,1240
"6166","Zm00001d024950","10",96569445,96576597,7152
"6167","Zm00001d024951","10",96577977,96581566,3589
"6168","Zm00001d024952","10",96586361,96592679,6318
"6169","Zm00001d024953","10",96630696,96658868,28172
"6170","Zm00001d024955","10",96773958,96774425,467
"6171","Zm00001d024958","10",96868196,96869084,888
"6172","Zm00001d024959","10",96880902,96881682,780
"6173","Zm00001d024960","10",96937750,96938641,891
"6174","Zm00001d024961","10",96948264,96950890,2626
"6175","Zm00001d024963","10",96969512,96970459,947
"6176","Zm00001d024965","10",97101650,97106765,5115
"6177","Zm00001d024966","10",97204693,97208271,3578
"6178","Zm00001d024967","10",97249804,97279351,29547
"6179","Zm00001d024968","10",97279497,97281637,2140
"6180","Zm00001d024973","10",97673568,97680486,6918
"6181","Zm00001d024974","10",97684039,97684791,752
"6182","Zm00001d024975","10",97685327,97689706,4379
"6183","Zm00001d024980","10",97827268,97828533,1265
"6184","Zm00001d024982","10",97882524,97885868,3344
"6185","Zm00001d024985","10",97994244,97996709,2465
"6186","Zm00001d024992","10",98189229,98189751,522
"6187","Zm00001d024994","10",98236755,98238985,2230
"6188","Zm00001d024996","10",98385298,98386222,924
"6189","Zm00001d024998","10",98541954,98563436,21482
"6190","Zm00001d024999","10",98626467,98629272,2805
"6191","Zm00001d025002","10",98768633,98772678,4045
"6192","Zm00001d025003","10",99104436,99134098,29662
"6193","Zm00001d025005","10",99217386,99219471,2085
"6194","Zm00001d025008","10",99428647,99432260,3613
"6195","Zm00001d025010","10",99533913,99544932,11019
"6196","Zm00001d025011","10",99635843,99638554,2711
"6197","Zm00001d025012","10",99642235,99660548,18313
"6198","Zm00001d025015","10",99806303,99812704,6401
"6199","Zm00001d025016","10",99815796,99824932,9136
"6200","Zm00001d025017","10",99817486,99819538,2052
"6201","Zm00001d025018","10",99917607,99918841,1234
"6202","Zm00001d025019","10",99972964,99975683,2719
"6203","Zm00001d025020","10",99992757,99998509,5752
"6204","Zm00001d025021","10",100002393,100008244,5851
"6205","Zm00001d025022","10",100051822,100054101,2279
"6206","Zm00001d025023","10",100055458,100060317,4859
"6207","Zm00001d025024","10",100210116,100246420,36304
"6208","Zm00001d025025","10",100278428,100281818,3390
"6209","Zm00001d025027","10",100381692,100393417,11725
"6210","Zm00001d025028","10",100507387,100508961,1574
"6211","Zm00001d025031","10",100543845,100549482,5637
"6212","Zm00001d025033","10",100593766,100594296,530
"6213","Zm00001d025034","10",100648946,100657147,8201
"6214","Zm00001d025035","10",100748577,100750979,2402
"6215","Zm00001d025036","10",100773356,100775278,1922
"6216","Zm00001d025037","10",100955562,100957474,1912
"6217","Zm00001d025038","10",100990840,100991898,1058
"6218","Zm00001d025039","10",100998231,101000685,2454
"6219","Zm00001d025041","10",101193709,101197563,3854
"6220","Zm00001d025043","10",101206922,101214479,7557
"6221","Zm00001d025044","10",101378979,101442082,63103
"6222","Zm00001d025046","10",101423233,101423304,71
"6223","Zm00001d025047","10",101525953,101527964,2011
"6224","Zm00001d025048","10",101561345,101582556,21211
"6225","Zm00001d025050","10",101678128,101682933,4805
"6226","Zm00001d025052","10",101802712,101807654,4942
"6227","Zm00001d025054","10",101809335,101815439,6104
"6228","Zm00001d025055","10",101885723,101890901,5178
"6229","Zm00001d025056","10",101921141,101923394,2253
"6230","Zm00001d025057","10",102026193,102028561,2368
"6231","Zm00001d025059","10",102054802,102055944,1142
"6232","Zm00001d025060","10",102183855,102201368,17513
"6233","Zm00001d025062","10",102246913,102250054,3141
"6234","Zm00001d025063","10",102254458,102258676,4218
"6235","Zm00001d025067","10",102424604,102432854,8250
"6236","Zm00001d025075","10",102770463,102774619,4156
"6237","Zm00001d025079","10",102821133,102823238,2105
"6238","Zm00001d025080","10",102828219,102829001,782
"6239","Zm00001d025081","10",102855786,102857533,1747
"6240","Zm00001d025082","10",102925323,102930804,5481
"6241","Zm00001d025085","10",103047049,103059527,12478
"6242","Zm00001d025086","10",103056256,103059527,3271
"6243","Zm00001d025089","10",103296025,103297278,1253
"6244","Zm00001d025090","10",103298536,103301500,2964
"6245","Zm00001d025094","10",103697583,103700217,2634
"6246","Zm00001d025098","10",103768672,103787574,18902
"6247","Zm00001d025100","10",104005267,104026749,21482
"6248","Zm00001d025103","10",104219161,104224390,5229
"6249","Zm00001d025104","10",104272691,104280111,7420
"6250","Zm00001d025105","10",104358643,104361481,2838
"6251","Zm00001d025106","10",104541550,104545518,3968
"6252","Zm00001d025107","10",104574417,104575544,1127
"6253","Zm00001d025108","10",104743938,104745122,1184
"6254","Zm00001d025111","10",104817352,104841697,24345
"6255","Zm00001d025115","10",105046350,105047745,1395
"6256","Zm00001d025116","10",105050722,105054454,3732
"6257","Zm00001d025117","10",105056013,105060537,4524
"6258","Zm00001d025118","10",105193046,105209430,16384
"6259","Zm00001d025120","10",105222089,105222574,485
"6260","Zm00001d025121","10",105224193,105224695,502
"6261","Zm00001d025124","10",105414302,105453243,38941
"6262","Zm00001d025125","10",105472286,105496243,23957
"6263","Zm00001d025126","10",105633063,105634956,1893
"6264","Zm00001d025128","10",105638368,105648955,10587
"6265","Zm00001d025129","10",105652923,105676382,23459
"6266","Zm00001d025130","10",105692426,105720443,28017
"6267","Zm00001d025131","10",105800908,105804404,3496
"6268","Zm00001d025132","10",105805029,105805469,440
"6269","Zm00001d025134","10",105948711,105977398,28687
"6270","Zm00001d025135","10",106024879,106026915,2036
"6271","Zm00001d025136","10",106035263,106040350,5087
"6272","Zm00001d025144","10",106479273,106495793,16520
"6273","Zm00001d025149","10",106629010,106638259,9249
"6274","Zm00001d025151","10",106725810,106726589,779
"6275","Zm00001d025152","10",106764011,106766200,2189
"6276","Zm00001d025153","10",106777076,106807515,30439
"6277","Zm00001d025154","10",106792690,106795236,2546
"6278","Zm00001d025155","10",106822941,106826054,3113
"6279","Zm00001d025156","10",106849972,106858473,8501
"6280","Zm00001d025160","10",106964303,106965933,1630
"6281","Zm00001d025161","10",107028162,107030458,2296
"6282","Zm00001d025165","10",107136495,107140951,4456
"6283","Zm00001d025166","10",107141907,107144555,2648
"6284","Zm00001d025167","10",107181381,107187909,6528
"6285","Zm00001d025170","10",107470951,107474926,3975
"6286","Zm00001d025171","10",107516183,107521020,4837
"6287","Zm00001d025174","10",107649554,107658355,8801
"6288","Zm00001d025175","10",107678368,107680629,2261
"6289","Zm00001d025178","10",107851799,107857271,5472
"6290","Zm00001d025180","10",107999211,108003428,4217
"6291","Zm00001d025182","10",108128003,108131484,3481
"6292","Zm00001d025185","10",108297253,108318568,21315
"6293","Zm00001d025186","10",108425498,108434020,8522
"6294","Zm00001d025188","10",108436438,108438116,1678
"6295","Zm00001d025190","10",108451310,108454336,3026
"6296","Zm00001d025191","10",108454705,108457901,3196
"6297","Zm00001d025193","10",108468387,108473191,4804
"6298","Zm00001d025195","10",108516688,108524894,8206
"6299","Zm00001d025196","10",108536113,108539163,3050
"6300","Zm00001d025199","10",108609859,108611603,1744
"6301","Zm00001d025201","10",108840806,108848622,7816
"6302","Zm00001d025202","10",108880082,108881427,1345
"6303","Zm00001d025203","10",108938341,108949550,11209
"6304","Zm00001d025204","10",109021465,109023516,2051
"6305","Zm00001d025206","10",109135804,109137912,2108
"6306","Zm00001d025207","10",109142174,109143177,1003
"6307","Zm00001d025208","10",109171895,109178235,6340
"6308","Zm00001d025209","10",109177952,109178976,1024
"6309","Zm00001d025210","10",109224790,109231836,7046
"6310","Zm00001d025213","10",109347119,109347953,834
"6311","Zm00001d025218","10",109657976,109659501,1525
"6312","Zm00001d025221","10",109828651,109831426,2775
"6313","Zm00001d025222","10",109967184,109969328,2144
"6314","Zm00001d025228","10",110194156,110198209,4053
"6315","Zm00001d025232","10",110229341,110236419,7078
"6316","Zm00001d025233","10",110237211,110238274,1063
"6317","Zm00001d025234","10",110338608,110344763,6155
"6318","Zm00001d025235","10",110432656,110441915,9259
"6319","Zm00001d025236","10",110442775,110445367,2592
"6320","Zm00001d025237","10",110564312,110569524,5212
"6321","Zm00001d025238","10",110572318,110574522,2204
"6322","Zm00001d025239","10",110579973,110588202,8229
"6323","Zm00001d025240","10",110657182,110663551,6369
"6324","Zm00001d025241","10",110753799,110756285,2486
"6325","Zm00001d025243","10",110767645,110768010,365
"6326","Zm00001d025246","10",110882625,110887986,5361
"6327","Zm00001d025249","10",111052327,111062223,9896
"6328","Zm00001d025251","10",111149589,111152196,2607
"6329","Zm00001d025252","10",111156938,111166083,9145
"6330","Zm00001d025253","10",111399535,111412064,12529
"6331","Zm00001d025255","10",111450959,111453781,2822
"6332","Zm00001d025258","10",111489726,111495229,5503
"6333","Zm00001d025262","10",111717816,111722054,4238
"6334","Zm00001d025263","10",111734229,111744673,10444
"6335","Zm00001d025264","10",111792673,111794363,1690
"6336","Zm00001d025267","10",111824838,111828519,3681
"6337","Zm00001d025268","10",111867459,111872204,4745
"6338","Zm00001d025271","10",112016686,112023339,6653
"6339","Zm00001d025273","10",112116864,112124493,7629
"6340","Zm00001d025274","10",112165803,112168114,2311
"6341","Zm00001d025275","10",112168325,112188744,20419
"6342","Zm00001d025278","10",112299570,112307718,8148
"6343","Zm00001d025279","10",112313641,112325551,11910
"6344","Zm00001d025280","10",112501132,112504248,3116
"6345","Zm00001d025281","10",112504950,112507200,2250
"6346","Zm00001d025282","10",112524703,112525362,659
"6347","Zm00001d025284","10",112581189,112583676,2487
"6348","Zm00001d025286","10",112660019,112662739,2720
"6349","Zm00001d025289","10",112746456,112748292,1836
"6350","Zm00001d025291","10",112919810,112922524,2714
"6351","Zm00001d025293","10",112932404,112932475,71
"6352","Zm00001d025294","10",112973342,112984868,11526
"6353","Zm00001d025296","10",113108194,113111598,3404
"6354","Zm00001d025297","10",113212123,113217501,5378
"6355","Zm00001d025299","10",113256247,113256966,719
"6356","Zm00001d025300","10",113290809,113298776,7967
"6357","Zm00001d025301","10",113304371,113318287,13916
"6358","Zm00001d025302","10",113389722,113398449,8727
"6359","Zm00001d025303","10",113464508,113470236,5728
"6360","Zm00001d025304","10",113471249,113475000,3751
"6361","Zm00001d025305","10",113480669,113484076,3407
"6362","Zm00001d025307","10",113605145,113609868,4723
"6363","Zm00001d025308","10",113713986,113714453,467
"6364","Zm00001d025310","10",113838140,113839870,1730
"6365","Zm00001d025319","10",114036152,114037488,1336
"6366","Zm00001d025322","10",114051149,114052377,1228
"6367","Zm00001d025323","10",114052762,114058481,5719
"6368","Zm00001d025324","10",114125068,114128392,3324
"6369","Zm00001d025326","10",114247261,114255287,8026
"6370","Zm00001d025327","10",114294296,114295555,1259
"6371","Zm00001d025330","10",114337276,114339155,1879
"6372","Zm00001d025333","10",114461652,114462911,1259
"6373","Zm00001d025337","10",114691400,114692437,1037
"6374","Zm00001d025338","10",114698888,114700369,1481
"6375","Zm00001d025339","10",114701647,114705196,3549
"6376","Zm00001d025340","10",114734216,114741281,7065
"6377","Zm00001d025342","10",114817295,114821325,4030
"6378","Zm00001d025349","10",115137425,115143490,6065
"6379","Zm00001d025352","10",115194757,115195221,464
"6380","Zm00001d025353","10",115197316,115205461,8145
"6381","Zm00001d025354","10",115243957,115246970,3013
"6382","Zm00001d025355","10",115297049,115299501,2452
"6383","Zm00001d025359","10",115505590,115511924,6334
"6384","Zm00001d025360","10",115526039,115526965,926
"6385","Zm00001d025361","10",115668682,115669017,335
"6386","Zm00001d025362","10",115708853,115710913,2060
"6387","Zm00001d025365","10",115746320,115747301,981
"6388","Zm00001d025367","10",115788295,115788507,212
"6389","Zm00001d025369","10",115865914,115869725,3811
"6390","Zm00001d025373","10",115983810,115986401,2591
"6391","Zm00001d025374","10",116159439,116160239,800
"6392","Zm00001d025375","10",116183302,116188328,5026
"6393","Zm00001d025377","10",116400600,116400836,236
"6394","Zm00001d025379","10",116471862,116473196,1334
"6395","Zm00001d025380","10",116495636,116503536,7900
"6396","Zm00001d025381","10",116549727,116550765,1038
"6397","Zm00001d025383","10",116602656,116605064,2408
"6398","Zm00001d025397","10",116910281,116918062,7781
"6399","Zm00001d025398","10",116994247,117004498,10251
"6400","Zm00001d025399","10",117006854,117007538,684
"6401","Zm00001d025400","10",117015014,117016890,1876
"6402","Zm00001d025401","10",117126777,117127673,896
"6403","Zm00001d025404","10",117395751,117396956,1205
"6404","Zm00001d025406","10",117441376,117441837,461
"6405","Zm00001d025407","10",117683619,117686883,3264
"6406","Zm00001d025409","10",117748319,117749080,761
"6407","Zm00001d025410","10",117750753,117752648,1895
"6408","Zm00001d025412","10",117864859,117874556,9697
"6409","Zm00001d025413","10",117927675,117931068,3393
"6410","Zm00001d025414","10",117933309,117935123,1814
"6411","Zm00001d025416","10",117962173,117964181,2008
"6412","Zm00001d025417","10",117967333,117970137,2804
"6413","Zm00001d025419","10",118105919,118109881,3962
"6414","Zm00001d025420","10",118110565,118111819,1254
"6415","Zm00001d025421","10",118144783,118151559,6776
"6416","Zm00001d025422","10",118145613,118145688,75
"6417","Zm00001d025425","10",118293926,118295084,1158
"6418","Zm00001d025427","10",118308977,118309732,755
"6419","Zm00001d025428","10",118316531,118317861,1330
"6420","Zm00001d025430","10",118524767,118525381,614
"6421","Zm00001d025431","10",118602247,118606546,4299
"6422","Zm00001d025433","10",118612121,118615983,3862
"6423","Zm00001d025434","10",118616454,118618580,2126
"6424","Zm00001d025435","10",118619416,118620958,1542
"6425","Zm00001d025436","10",118679111,118679767,656
"6426","Zm00001d025437","10",118681357,118686385,5028
"6427","Zm00001d025444","10",118819063,118819380,317
"6428","Zm00001d025445","10",118846883,118849706,2823
"6429","Zm00001d025446","10",118852748,118859926,7178
"6430","Zm00001d025449","10",118888454,118897515,9061
"6431","Zm00001d025450","10",118965079,118969622,4543
"6432","Zm00001d025451","10",118988358,118988867,509
"6433","Zm00001d025452","10",119056861,119059431,2570
"6434","Zm00001d025453","10",119060827,119068182,7355
"6435","Zm00001d025454","10",119068562,119070419,1857
"6436","Zm00001d025455","10",119077238,119081245,4007
"6437","Zm00001d025456","10",119082076,119083221,1145
"6438","Zm00001d025460","10",119207603,119213288,5685
"6439","Zm00001d025461","10",119220775,119232248,11473
"6440","Zm00001d025463","10",119743657,119745792,2135
"6441","Zm00001d025465","10",119805260,119819142,13882
"6442","Zm00001d025468","10",119862404,119865124,2720
"6443","Zm00001d025469","10",119875877,119878890,3013
"6444","Zm00001d025470","10",119884116,119893950,9834
"6445","Zm00001d025472","10",119894515,119896773,2258
"6446","Zm00001d025474","10",119967321,119981337,14016
"6447","Zm00001d025477","10",120040997,120041623,626
"6448","Zm00001d025479","10",120092000,120093934,1934
"6449","Zm00001d025484","10",120222171,120229249,7078
"6450","Zm00001d025490","10",120429945,120430385,440
"6451","Zm00001d025502","10",120602232,120603382,1150
"6452","Zm00001d025507","10",120795646,120808976,13330
"6453","Zm00001d025509","10",120876061,120876869,808
"6454","Zm00001d025513","10",120955175,120959570,4395
"6455","Zm00001d025514","10",120969085,120970263,1178
"6456","Zm00001d025517","10",121027429,121032089,4660
"6457","Zm00001d025519","10",121061028,121062528,1500
"6458","Zm00001d025520","10",121082402,121084106,1704
"6459","Zm00001d025522","10",121168118,121172140,4022
"6460","Zm00001d025524","10",121268606,121272616,4010
"6461","Zm00001d025526","10",121359009,121363755,4746
"6462","Zm00001d025528","10",121509129,121526342,17213
"6463","Zm00001d025531","10",121527400,121528174,774
"6464","Zm00001d025538","10",121718740,121726333,7593
"6465","Zm00001d025539","10",121727843,121731496,3653
"6466","Zm00001d025541","10",121757459,121758886,1427
"6467","Zm00001d025542","10",121760585,121762717,2132
"6468","Zm00001d025544","10",121844880,121845467,587
"6469","Zm00001d025545","10",121846235,121850530,4295
"6470","Zm00001d025548","10",121921907,121926936,5029
"6471","Zm00001d025550","10",122005480,122017271,11791
"6472","Zm00001d025551","10",122019302,122026030,6728
"6473","Zm00001d025557","10",122317131,122325516,8385
"6474","Zm00001d025564","10",122405745,122406727,982
"6475","Zm00001d025566","10",122509798,122511588,1790
"6476","Zm00001d025567","10",122515167,122515565,398
"6477","Zm00001d025568","10",122547752,122549122,1370
"6478","Zm00001d025570","10",122602824,122612949,10125
"6479","Zm00001d025571","10",122637949,122641587,3638
"6480","Zm00001d025572","10",122641857,122645133,3276
"6481","Zm00001d025574","10",122791789,122795379,3590
"6482","Zm00001d025575","10",122821714,122833327,11613
"6483","Zm00001d025576","10",122835505,122836158,653
"6484","Zm00001d025579","10",122853293,122854830,1537
"6485","Zm00001d025580","10",122855595,122861043,5448
"6486","Zm00001d025581","10",122918234,122920021,1787
"6487","Zm00001d025583","10",123000957,123002129,1172
"6488","Zm00001d025584","10",123043508,123045709,2201
"6489","Zm00001d025585","10",123203770,123205971,2201
"6490","Zm00001d025586","10",123295278,123297912,2634
"6491","Zm00001d025587","10",123297388,123299277,1889
"6492","Zm00001d025589","10",123303091,123307977,4886
"6493","Zm00001d025590","10",123321362,123328119,6757
"6494","Zm00001d025604","10",123694833,123697805,2972
"6495","Zm00001d025610","10",123859063,123860436,1373
"6496","Zm00001d025612","10",123896700,123897435,735
"6497","Zm00001d025616","10",124037257,124039095,1838
"6498","Zm00001d025617","10",124144806,124148744,3938
"6499","Zm00001d025619","10",124227762,124229007,1245
"6500","Zm00001d025620","10",124229711,124233765,4054
"6501","Zm00001d025622","10",124263585,124264328,743
"6502","Zm00001d025623","10",124266698,124269223,2525
"6503","Zm00001d025624","10",124380367,124383628,3261
"6504","Zm00001d025625","10",124407255,124409576,2321
"6505","Zm00001d025626","10",124409879,124415115,5236
"6506","Zm00001d025628","10",124513574,124517653,4079
"6507","Zm00001d025633","10",124645929,124662204,16275
"6508","Zm00001d025639","10",124749908,124758178,8270
"6509","Zm00001d025640","10",124760949,124764322,3373
"6510","Zm00001d025642","10",124769206,124769689,483
"6511","Zm00001d025644","10",124859033,124862961,3928
"6512","Zm00001d025646","10",124868056,124869592,1536
"6513","Zm00001d025647","10",124897591,124901710,4119
"6514","Zm00001d025650","10",124927383,124928855,1472
"6515","Zm00001d025651","10",125013169,125020527,7358
"6516","Zm00001d025652","10",125102974,125107740,4766
"6517","Zm00001d025653","10",125107974,125113328,5354
"6518","Zm00001d025654","10",125148713,125149748,1035
"6519","Zm00001d025656","10",125206872,125209697,2825
"6520","Zm00001d025657","10",125211002,125215696,4694
"6521","Zm00001d025658","10",125254612,125261724,7112
"6522","Zm00001d025659","10",125277608,125279663,2055
"6523","Zm00001d025660","10",125342471,125344978,2507
"6524","Zm00001d025661","10",125345461,125347269,1808
"6525","Zm00001d025663","10",125363945,125369623,5678
"6526","Zm00001d025664","10",125369798,125371471,1673
"6527","Zm00001d025665","10",125373155,125379315,6160
"6528","Zm00001d025666","10",125439324,125445687,6363
"6529","Zm00001d025667","10",125488390,125491008,2618
"6530","Zm00001d025668","10",125572844,125579987,7143
"6531","Zm00001d025669","10",125756452,125761608,5156
"6532","Zm00001d025670","10",125787665,125792972,5307
"6533","Zm00001d025672","10",125816403,125817230,827
"6534","Zm00001d025673","10",125893015,125901899,8884
"6535","Zm00001d025674","10",125986664,125989972,3308
"6536","Zm00001d025675","10",125999213,126000706,1493
"6537","Zm00001d025679","10",126089661,126095930,6269
"6538","Zm00001d025680","10",126096965,126110392,13427
"6539","Zm00001d025681","10",126111325,126114597,3272
"6540","Zm00001d025682","10",126118595,126120725,2130
"6541","Zm00001d025684","10",126186003,126189175,3172
"6542","Zm00001d025685","10",126196300,126201711,5411
"6543","Zm00001d025686","10",126198156,126203199,5043
"6544","Zm00001d025687","10",126206150,126211865,5715
"6545","Zm00001d025689","10",126291063,126294862,3799
"6546","Zm00001d025690","10",126319920,126323617,3697
"6547","Zm00001d025692","10",126420989,126425176,4187
"6548","Zm00001d025694","10",126527371,126529992,2621
"6549","Zm00001d025695","10",126530158,126532242,2084
"6550","Zm00001d025696","10",126532005,126537113,5108
"6551","Zm00001d025697","10",126601226,126609111,7885
"6552","Zm00001d025698","10",126604796,126605766,970
"6553","Zm00001d025699","10",126708804,126710162,1358
"6554","Zm00001d025700","10",126772727,126775435,2708
"6555","Zm00001d025701","10",126776580,126778346,1766
"6556","Zm00001d025703","10",126789244,126793900,4656
"6557","Zm00001d025704","10",126794136,126795161,1025
"6558","Zm00001d025705","10",126856805,126878792,21987
"6559","Zm00001d025706","10",126880549,126888843,8294
"6560","Zm00001d025707","10",126903970,126906191,2221
"6561","Zm00001d025709","10",126927635,126928758,1123
"6562","Zm00001d025710","10",126946639,126951605,4966
"6563","Zm00001d025711","10",126996928,126997912,984
"6564","Zm00001d025712","10",126998464,127006041,7577
"6565","Zm00001d025713","10",127154778,127159945,5167
"6566","Zm00001d025714","10",127160289,127165558,5269
"6567","Zm00001d025715","10",127294441,127299500,5059
"6568","Zm00001d025716","10",127318068,127321356,3288
"6569","Zm00001d025717","10",127360555,127364032,3477
"6570","Zm00001d025718","10",127367089,127369910,2821
"6571","Zm00001d025720","10",127515419,127518791,3372
"6572","Zm00001d025721","10",127518803,127520726,1923
"6573","Zm00001d025722","10",127556445,127565804,9359
"6574","Zm00001d025724","10",127578165,127583188,5023
"6575","Zm00001d025726","10",127609718,127611616,1898
"6576","Zm00001d025727","10",127668399,127678365,9966
"6577","Zm00001d025734","10",127905113,127929830,24717
"6578","Zm00001d025735","10",127934025,127936164,2139
"6579","Zm00001d025737","10",127951568,127954961,3393
"6580","Zm00001d025738","10",127957093,127963022,5929
"6581","Zm00001d025739","10",128021608,128027534,5926
"6582","Zm00001d025740","10",128079456,128090847,11391
"6583","Zm00001d025745","10",128265758,128268623,2865
"6584","Zm00001d025746","10",128270580,128272580,2000
"6585","Zm00001d025747","10",128273093,128275437,2344
"6586","Zm00001d025749","10",128281743,128287294,5551
"6587","Zm00001d025750","10",128369466,128379796,10330
"6588","Zm00001d025751","10",128387089,128391211,4122
"6589","Zm00001d025752","10",128391683,128395889,4206
"6590","Zm00001d025753","10",128400712,128402032,1320
"6591","Zm00001d025756","10",128574603,128578751,4148
"6592","Zm00001d025757","10",128605358,128610245,4887
"6593","Zm00001d025761","10",128644589,128648111,3522
"6594","Zm00001d025762","10",128649921,128650496,575
"6595","Zm00001d025763","10",128651685,128657893,6208
"6596","Zm00001d025764","10",128932136,128934935,2799
"6597","Zm00001d025765","10",128934892,128936806,1914
"6598","Zm00001d025767","10",128984695,128990744,6049
"6599","Zm00001d025769","10",129028025,129035383,7358
"6600","Zm00001d025771","10",129060817,129063853,3036
"6601","Zm00001d025772","10",129098708,129101552,2844
"6602","Zm00001d025773","10",129108410,129115766,7356
"6603","Zm00001d025774","10",129119828,129135482,15654
"6604","Zm00001d025776","10",129145379,129150948,5569
"6605","Zm00001d025777","10",129239384,129245248,5864
"6606","Zm00001d025778","10",129394473,129395380,907
"6607","Zm00001d025784","10",129516699,129519156,2457
"6608","Zm00001d025786","10",129532763,129536073,3310
"6609","Zm00001d025788","10",129673527,129674867,1340
"6610","Zm00001d025789","10",129676622,129683792,7170
"6611","Zm00001d025790","10",129704194,129704267,73
"6612","Zm00001d025793","10",129804930,129812444,7514
"6613","Zm00001d025794","10",129812817,129815752,2935
"6614","Zm00001d025795","10",129817569,129851935,34366
"6615","Zm00001d025796","10",129829314,129830251,937
"6616","Zm00001d025797","10",129855497,129872386,16889
"6617","Zm00001d025798","10",129877161,129881515,4354
"6618","Zm00001d025799","10",129941666,129946475,4809
"6619","Zm00001d025801","10",130013516,130019645,6129
"6620","Zm00001d025802","10",130018222,130018293,71
"6621","Zm00001d025803","10",130080151,130085418,5267
"6622","Zm00001d025804","10",130101367,130103013,1646
"6623","Zm00001d025805","10",130103676,130106438,2762
"6624","Zm00001d025807","10",130123665,130125293,1628
"6625","Zm00001d025808","10",130145464,130148492,3028
"6626","Zm00001d025809","10",130151166,130153001,1835
"6627","Zm00001d025812","10",130257427,130259239,1812
"6628","Zm00001d025815","10",130395071,130396518,1447
"6629","Zm00001d025816","10",130399900,130438506,38606
"6630","Zm00001d025817","10",130522455,130537454,14999
"6631","Zm00001d025818","10",130620785,130623971,3186
"6632","Zm00001d025819","10",130624314,130626396,2082
"6633","Zm00001d025820","10",130664658,130670443,5785
"6634","Zm00001d025821","10",130675274,130678309,3035
"6635","Zm00001d025822","10",130718242,130719958,1716
"6636","Zm00001d025824","10",130916981,130918740,1759
"6637","Zm00001d025825","10",130921096,130929124,8028
"6638","Zm00001d025827","10",131080689,131103919,23230
"6639","Zm00001d025828","10",131121586,131122874,1288
"6640","Zm00001d025829","10",131124061,131125333,1272
"6641","Zm00001d025830","10",131181940,131237004,55064
"6642","Zm00001d025831","10",131243971,131245467,1496
"6643","Zm00001d025833","10",131304078,131306002,1924
"6644","Zm00001d025834","10",131395394,131399206,3812
"6645","Zm00001d025836","10",131415084,131417619,2535
"6646","Zm00001d025837","10",131419324,131425149,5825
"6647","Zm00001d025838","10",131427993,131428418,425
"6648","Zm00001d025844","10",131468002,131469765,1763
"6649","Zm00001d025845","10",131472723,131474482,1759
"6650","Zm00001d025846","10",131474854,131478746,3892
"6651","Zm00001d025847","10",131489756,131495677,5921
"6652","Zm00001d025848","10",131497998,131500944,2946
"6653","Zm00001d025851","10",131505987,131507148,1161
"6654","Zm00001d025853","10",131518170,131523882,5712
"6655","Zm00001d025855","10",131547301,131554470,7169
"6656","Zm00001d025857","10",131577849,131579681,1832
"6657","Zm00001d025859","10",131636162,131638435,2273
"6658","Zm00001d025860","10",131691269,131694141,2872
"6659","Zm00001d025861","10",131797076,131799846,2770
"6660","Zm00001d025862","10",131802312,131805026,2714
"6661","Zm00001d025864","10",131914989,131917182,2193
"6662","Zm00001d025865","10",131993604,132007438,13834
"6663","Zm00001d025866","10",132009297,132012863,3566
"6664","Zm00001d025867","10",132084448,132087460,3012
"6665","Zm00001d025868","10",132094786,132098109,3323
"6666","Zm00001d025869","10",132099365,132104510,5145
"6667","Zm00001d025870","10",132102174,132108037,5863
"6668","Zm00001d025872","10",132198541,132199083,542
"6669","Zm00001d025873","10",132238491,132239276,785
"6670","Zm00001d025874","10",132243700,132247155,3455
"6671","Zm00001d025875","10",132297753,132300224,2471
"6672","Zm00001d025877","10",132437730,132438584,854
"6673","Zm00001d025878","10",132464677,132466272,1595
"6674","Zm00001d025884","10",132881662,132883539,1877
"6675","Zm00001d025885","10",133022288,133031500,9212
"6676","Zm00001d025886","10",133084610,133086324,1714
"6677","Zm00001d025887","10",133094068,133097996,3928
"6678","Zm00001d025888","10",133098210,133101984,3774
"6679","Zm00001d025889","10",133103780,133106556,2776
"6680","Zm00001d025891","10",133171586,133172368,782
"6681","Zm00001d025892","10",133211005,133217035,6030
"6682","Zm00001d025893","10",133218764,133222199,3435
"6683","Zm00001d025894","10",133222842,133243011,20169
"6684","Zm00001d025895","10",133226511,133226582,71
"6685","Zm00001d025899","10",133314417,133319808,5391
"6686","Zm00001d025900","10",133321693,133323074,1381
"6687","Zm00001d025901","10",133326341,133328048,1707
"6688","Zm00001d025903","10",133417078,133421611,4533
"6689","Zm00001d025904","10",133421472,133424984,3512
"6690","Zm00001d025905","10",133424697,133429751,5054
"6691","Zm00001d025907","10",133447186,133450161,2975
"6692","Zm00001d025908","10",133462026,133464286,2260
"6693","Zm00001d025910","10",133559160,133560374,1214
"6694","Zm00001d025911","10",133607600,133612629,5029
"6695","Zm00001d025912","10",133635901,133637295,1394
"6696","Zm00001d025913","10",133665354,133665806,452
"6697","Zm00001d025914","10",133728878,133732604,3726
"6698","Zm00001d025915","10",133733079,133739911,6832
"6699","Zm00001d025917","10",133750731,133751762,1031
"6700","Zm00001d025919","10",133759486,133767792,8306
"6701","Zm00001d025920","10",133768161,133770170,2009
"6702","Zm00001d025921","10",133772841,133780821,7980
"6703","Zm00001d025923","10",133837382,133838958,1576
"6704","Zm00001d025924","10",133844872,133846261,1389
"6705","Zm00001d025927","10",133907474,133913017,5543
"6706","Zm00001d025930","10",133977640,133978998,1358
"6707","Zm00001d025931","10",134023690,134029024,5334
"6708","Zm00001d025932","10",134081639,134098842,17203
"6709","Zm00001d025933","10",134109816,134112217,2401
"6710","Zm00001d025938","10",134152838,134158958,6120
"6711","Zm00001d025939","10",134160823,134164469,3646
"6712","Zm00001d025940","10",134168606,134169597,991
"6713","Zm00001d025941","10",134172888,134175566,2678
"6714","Zm00001d025943","10",134290813,134294851,4038
"6715","Zm00001d025944","10",134353026,134355488,2462
"6716","Zm00001d025946","10",134457486,134477101,19615
"6717","Zm00001d025948","10",134519364,134523011,3647
"6718","Zm00001d025950","10",134553869,134559580,5711
"6719","Zm00001d025951","10",134563080,134575911,12831
"6720","Zm00001d025952","10",134584596,134585561,965
"6721","Zm00001d025953","10",134612927,134615457,2530
"6722","Zm00001d025955","10",134652242,134657270,5028
"6723","Zm00001d025957","10",134741085,134742626,1541
"6724","Zm00001d025958","10",134775133,134779422,4289
"6725","Zm00001d025959","10",134818605,134819660,1055
"6726","Zm00001d025960","10",134919047,134922822,3775
"6727","Zm00001d025962","10",134948589,134952020,3431
"6728","Zm00001d025963","10",134955202,134961784,6582
"6729","Zm00001d025964","10",134976903,134978448,1545
"6730","Zm00001d025966","10",134986888,134991306,4418
"6731","Zm00001d025967","10",134992932,134993567,635
"6732","Zm00001d025971","10",135003490,135014450,10960
"6733","Zm00001d025973","10",135020925,135022469,1544
"6734","Zm00001d025974","10",135046273,135046752,479
"6735","Zm00001d025977","10",135065680,135068785,3105
"6736","Zm00001d025979","10",135124957,135134224,9267
"6737","Zm00001d025980","10",135233565,135243356,9791
"6738","Zm00001d025981","10",135279805,135291483,11678
"6739","Zm00001d025982","10",135288740,135290102,1362
"6740","Zm00001d025983","10",135289993,135295917,5924
"6741","Zm00001d025984","10",135302916,135307138,4222
"6742","Zm00001d025985","10",135307124,135309001,1877
"6743","Zm00001d025988","10",135344276,135347905,3629
"6744","Zm00001d025989","10",135487493,135492026,4533
"6745","Zm00001d025991","10",135568286,135572664,4378
"6746","Zm00001d025992","10",135574512,135578931,4419
"6747","Zm00001d025993","10",135595744,135596526,782
"6748","Zm00001d025996","10",135673223,135674440,1217
"6749","Zm00001d025997","10",135684027,135687837,3810
"6750","Zm00001d025998","10",135688446,135692128,3682
"6751","Zm00001d026000","10",135741659,135750296,8637
"6752","Zm00001d026004","10",135832420,135834891,2471
"6753","Zm00001d026005","10",135849250,135850464,1214
"6754","Zm00001d026010","10",135896388,135908452,12064
"6755","Zm00001d026012","10",135966636,135967690,1054
"6756","Zm00001d026014","10",136038819,136049423,10604
"6757","Zm00001d026015","10",136050474,136050785,311
"6758","Zm00001d026016","10",136072033,136073276,1243
"6759","Zm00001d026017","10",136073204,136075724,2520
"6760","Zm00001d026018","10",136174872,136179753,4881
"6761","Zm00001d026019","10",136223082,136227424,4342
"6762","Zm00001d026020","10",136228251,136231070,2819
"6763","Zm00001d026022","10",136253289,136260329,7040
"6764","Zm00001d026025","10",136295659,136298978,3319
"6765","Zm00001d026026","10",136307170,136309172,2002
"6766","Zm00001d026028","10",136365019,136365309,290
"6767","Zm00001d026029","10",136369632,136369946,314
"6768","Zm00001d026030","10",136396307,136404366,8059
"6769","Zm00001d026031","10",136405187,136407606,2419
"6770","Zm00001d026035","10",136503442,136504374,932
"6771","Zm00001d026036","10",136545479,136549919,4440
"6772","Zm00001d026038","10",136636938,136638908,1970
"6773","Zm00001d026039","10",136639221,136646792,7571
"6774","Zm00001d026040","10",136648713,136650056,1343
"6775","Zm00001d026043","10",136818062,136827037,8975
"6776","Zm00001d026046","10",136883275,136886894,3619
"6777","Zm00001d026047","10",136891564,136893726,2162
"6778","Zm00001d026050","10",137005720,137007591,1871
"6779","Zm00001d026051","10",137105334,137107748,2414
"6780","Zm00001d026055","10",137223044,137225822,2778
"6781","Zm00001d026056","10",137257366,137260572,3206
"6782","Zm00001d026057","10",137266163,137268745,2582
"6783","Zm00001d026060","10",137296427,137304511,8084
"6784","Zm00001d026061","10",137306305,137307456,1151
"6785","Zm00001d026063","10",137333892,137337401,3509
"6786","Zm00001d026064","10",137389956,137394809,4853
"6787","Zm00001d026066","10",137455971,137457804,1833
"6788","Zm00001d026067","10",137485444,137487821,2377
"6789","Zm00001d026068","10",137510088,137512421,2333
"6790","Zm00001d026069","10",137512705,137515431,2726
"6791","Zm00001d026070","10",137651412,137671484,20072
"6792","Zm00001d026072","10",137692991,137693383,392
"6793","Zm00001d026073","10",137727995,137728803,808
"6794","Zm00001d026078","10",137917308,137920458,3150
"6795","Zm00001d026079","10",137925928,137929631,3703
"6796","Zm00001d026083","10",138054130,138057959,3829
"6797","Zm00001d026084","10",138077230,138079896,2666
"6798","Zm00001d026086","10",138088865,138090175,1310
"6799","Zm00001d026088","10",138129427,138138311,8884
"6800","Zm00001d026089","10",138139152,138145141,5989
"6801","Zm00001d026090","10",138156324,138156905,581
"6802","Zm00001d026091","10",138160694,138165120,4426
"6803","Zm00001d026094","10",138304690,138305939,1249
"6804","Zm00001d026095","10",138306613,138307260,647
"6805","Zm00001d026096","10",138350501,138351571,1070
"6806","Zm00001d026097","10",138393420,138400044,6624
"6807","Zm00001d026099","10",138485506,138488238,2732
"6808","Zm00001d026103","10",138505840,138514371,8531
"6809","Zm00001d026104","10",138534395,138535885,1490
"6810","Zm00001d026106","10",138569154,138572986,3832
"6811","Zm00001d026109","10",138678061,138680423,2362
"6812","Zm00001d026111","10",138699397,138708217,8820
"6813","Zm00001d026113","10",138719539,138725394,5855
"6814","Zm00001d026117","10",138801251,138808831,7580
"6815","Zm00001d026118","10",138832710,138862665,29955
"6816","Zm00001d026119","10",138868868,138870806,1938
"6817","Zm00001d026120","10",138884177,138886680,2503
"6818","Zm00001d026121","10",138895014,138896501,1487
"6819","Zm00001d026122","10",138963838,138968153,4315
"6820","Zm00001d026124","10",138973767,138976226,2459
"6821","Zm00001d026126","10",139063429,139066366,2937
"6822","Zm00001d026127","10",139138426,139205090,66664
"6823","Zm00001d026128","10",139268233,139272680,4447
"6824","Zm00001d026129","10",139294768,139298735,3967
"6825","Zm00001d026130","10",139299512,139303908,4396
"6826","Zm00001d026131","10",139320952,139323275,2323
"6827","Zm00001d026132","10",139324321,139327689,3368
"6828","Zm00001d026137","10",139479815,139481556,1741
"6829","Zm00001d026139","10",139500504,139503230,2726
"6830","Zm00001d026140","10",139505527,139507905,2378
"6831","Zm00001d026141","10",139551628,139551999,371
"6832","Zm00001d026142","10",139553052,139554813,1761
"6833","Zm00001d026143","10",139606075,139608052,1977
"6834","Zm00001d026144","10",139666878,139673623,6745
"6835","Zm00001d026147","10",139780968,139790276,9308
"6836","Zm00001d026148","10",139803834,139806665,2831
"6837","Zm00001d026152","10",139912222,139914393,2171
"6838","Zm00001d026153","10",139917557,139924348,6791
"6839","Zm00001d026154","10",139926048,139927942,1894
"6840","Zm00001d026156","10",139980859,139983545,2686
"6841","Zm00001d026158","10",140012416,140014572,2156
"6842","Zm00001d026159","10",140033774,140034453,679
"6843","Zm00001d026160","10",140066627,140067028,401
"6844","Zm00001d026162","10",140119312,140119716,404
"6845","Zm00001d026164","10",140160681,140165357,4676
"6846","Zm00001d026165","10",140169659,140174926,5267
"6847","Zm00001d026166","10",140249480,140256535,7055
"6848","Zm00001d026173","10",140305035,140306156,1121
"6849","Zm00001d026175","10",140333912,140336785,2873
"6850","Zm00001d026176","10",140370348,140375825,5477
"6851","Zm00001d026177","10",140377176,140378531,1355
"6852","Zm00001d026180","10",140449245,140450986,1741
"6853","Zm00001d026182","10",140513369,140513983,614
"6854","Zm00001d026185","10",140536234,140541062,4828
"6855","Zm00001d026186","10",140542121,140544170,2049
"6856","Zm00001d026187","10",140544510,140545281,771
"6857","Zm00001d026188","10",140548621,140549856,1235
"6858","Zm00001d026189","10",140556885,140559471,2586
"6859","Zm00001d026190","10",140561973,140565170,3197
"6860","Zm00001d026191","10",140619551,140620363,812
"6861","Zm00001d026192","10",140675801,140685728,9927
"6862","Zm00001d026193","10",140677876,140680877,3001
"6863","Zm00001d026194","10",140686240,140689007,2767
"6864","Zm00001d026195","10",140696583,140704624,8041
"6865","Zm00001d026197","10",140757698,140759098,1400
"6866","Zm00001d026199","10",140831972,140832784,812
"6867","Zm00001d026200","10",140835506,140836343,837
"6868","Zm00001d026203","10",140869750,140871173,1423
"6869","Zm00001d026205","10",140893734,140894665,931
"6870","Zm00001d026206","10",140895681,140899119,3438
"6871","Zm00001d026207","10",140946552,140949521,2969
"6872","Zm00001d026211","10",140995440,141000793,5353
"6873","Zm00001d026212","10",141035340,141038053,2713
"6874","Zm00001d026213","10",141041899,141053154,11255
"6875","Zm00001d026214","10",141182614,141188938,6324
"6876","Zm00001d026222","10",141445403,141450718,5315
"6877","Zm00001d026223","10",141450912,141452580,1668
"6878","Zm00001d026224","10",141455631,141456351,720
"6879","Zm00001d026225","10",141463259,141463483,224
"6880","Zm00001d026226","10",141464988,141465430,442
"6881","Zm00001d026231","10",141561862,141564767,2905
"6882","Zm00001d026235","10",141655206,141657151,1945
"6883","Zm00001d026236","10",141665493,141667275,1782
"6884","Zm00001d026237","10",141669523,141675761,6238
"6885","Zm00001d026239","10",141705335,141710281,4946
"6886","Zm00001d026240","10",141714589,141718409,3820
"6887","Zm00001d026243","10",141735511,141738663,3152
"6888","Zm00001d026244","10",141740263,141743415,3152
"6889","Zm00001d026245","10",141743929,141746414,2485
"6890","Zm00001d026246","10",141781998,141789379,7381
"6891","Zm00001d026248","10",141805246,141808514,3268
"6892","Zm00001d026252","10",142052895,142054459,1564
"6893","Zm00001d026253","10",142057742,142080822,23080
"6894","Zm00001d026254","10",142134479,142136691,2212
"6895","Zm00001d026255","10",142140533,142140760,227
"6896","Zm00001d026257","10",142147684,142154633,6949
"6897","Zm00001d026258","10",142157661,142162299,4638
"6898","Zm00001d026259","10",142269137,142269586,449
"6899","Zm00001d026260","10",142285582,142291449,5867
"6900","Zm00001d026261","10",142291677,142296479,4802
"6901","Zm00001d026262","10",142339502,142340011,509
"6902","Zm00001d026263","10",142347105,142359053,11948
"6903","Zm00001d026265","10",142361347,142368169,6822
"6904","Zm00001d026267","10",142376205,142380294,4089
"6905","Zm00001d026268","10",142399024,142400904,1880
"6906","Zm00001d026269","10",142406258,142407949,1691
"6907","Zm00001d026270","10",142437417,142472462,35045
"6908","Zm00001d026271","10",142611393,142612061,668
"6909","Zm00001d026273","10",142618005,142622387,4382
"6910","Zm00001d026277","10",142707254,142721455,14201
"6911","Zm00001d026278","10",142737422,142739168,1746
"6912","Zm00001d026280","10",142742171,142747858,5687
"6913","Zm00001d026282","10",142759486,142759971,485
"6914","Zm00001d026283","10",142760846,142765876,5030
"6915","Zm00001d026284","10",142767423,142768557,1134
"6916","Zm00001d026285","10",142830921,142833263,2342
"6917","Zm00001d026286","10",142863674,142866331,2657
"6918","Zm00001d026287","10",142866476,142870798,4322
"6919","Zm00001d026288","10",142887361,142891016,3655
"6920","Zm00001d026289","10",142956463,142961794,5331
"6921","Zm00001d026290","10",142970716,142981629,10913
"6922","Zm00001d026291","10",142982967,142990366,7399
"6923","Zm00001d026293","10",143077541,143089471,11930
"6924","Zm00001d026294","10",143095590,143097811,2221
"6925","Zm00001d026295","10",143128213,143138549,10336
"6926","Zm00001d026296","10",143156312,143161817,5505
"6927","Zm00001d026297","10",143164305,143165139,834
"6928","Zm00001d026298","10",143168656,143170119,1463
"6929","Zm00001d026300","10",143197942,143203163,5221
"6930","Zm00001d026301","10",143204083,143209377,5294
"6931","Zm00001d026302","10",143209576,143212715,3139
"6932","Zm00001d026303","10",143231316,143239636,8320
"6933","Zm00001d026304","10",143264003,143264923,920
"6934","Zm00001d026305","10",143264094,143272292,8198
"6935","Zm00001d026306","10",143271399,143283473,12074
"6936","Zm00001d026307","10",143304025,143307489,3464
"6937","Zm00001d026308","10",143309469,143309843,374
"6938","Zm00001d026310","10",143361789,143362886,1097
"6939","Zm00001d026311","10",143365795,143369286,3491
"6940","Zm00001d026312","10",143369710,143373664,3954
"6941","Zm00001d026313","10",143375559,143380908,5349
"6942","Zm00001d026317","10",143490316,143494748,4432
"6943","Zm00001d026318","10",143503776,143504957,1181
"6944","Zm00001d026319","10",143558820,143563786,4966
"6945","Zm00001d026321","10",143570399,143571745,1346
"6946","Zm00001d026322","10",143572991,143576712,3721
"6947","Zm00001d026325","10",143588470,143589138,668
"6948","Zm00001d026326","10",143599140,143600834,1694
"6949","Zm00001d026329","10",143622658,143623730,1072
"6950","Zm00001d026331","10",143632251,143644255,12004
"6951","Zm00001d026333","10",143647928,143649894,1966
"6952","Zm00001d026334","10",143652486,143657784,5298
"6953","Zm00001d026335","10",143747463,143750718,3255
"6954","Zm00001d026337","10",143786832,143796162,9330
"6955","Zm00001d026338","10",143808214,143808285,71
"6956","Zm00001d026339","10",143810583,143811198,615
"6957","Zm00001d026343","10",143879828,143880241,413
"6958","Zm00001d026344","10",143883390,143887047,3657
"6959","Zm00001d026345","10",143890795,143894261,3466
"6960","Zm00001d026346","10",143957324,143961926,4602
"6961","Zm00001d026347","10",143968635,143973630,4995
"6962","Zm00001d026348","10",143979495,143982889,3394
"6963","Zm00001d026350","10",144091288,144093948,2660
"6964","Zm00001d026351","10",144099075,144105329,6254
"6965","Zm00001d026352","10",144132680,144133357,677
"6966","Zm00001d026353","10",144152298,144156481,4183
"6967","Zm00001d026355","10",144165524,144168971,3447
"6968","Zm00001d026357","10",144191354,144192970,1616
"6969","Zm00001d026358","10",144194271,144197480,3209
"6970","Zm00001d026359","10",144198484,144208442,9958
"6971","Zm00001d026361","10",144215376,144219165,3789
"6972","Zm00001d026362","10",144222451,144249626,27175
"6973","Zm00001d026363","10",144369745,144382245,12500
"6974","Zm00001d026364","10",144374073,144375746,1673
"6975","Zm00001d026366","10",144415204,144421773,6569
"6976","Zm00001d026368","10",144424159,144426437,2278
"6977","Zm00001d026369","10",144444247,144447064,2817
"6978","Zm00001d026370","10",144452263,144458167,5904
"6979","Zm00001d026374","10",144605146,144613330,8184
"6980","Zm00001d026375","10",144614770,144619504,4734
"6981","Zm00001d026377","10",144637101,144640154,3053
"6982","Zm00001d026379","10",144776845,144780116,3271
"6983","Zm00001d026381","10",144810240,144816007,5767
"6984","Zm00001d026382","10",144818522,144822103,3581
"6985","Zm00001d026383","10",144823842,144827200,3358
"6986","Zm00001d026385","10",144854136,144855075,939
"6987","Zm00001d026386","10",144857193,144861500,4307
"6988","Zm00001d026387","10",144881978,144892402,10424
"6989","Zm00001d026388","10",144896623,144898409,1786
"6990","Zm00001d026390","10",144990951,144991196,245
"6991","Zm00001d026391","10",144991865,144994560,2695
"6992","Zm00001d026392","10",144995255,145002117,6862
"6993","Zm00001d026393","10",145126653,145131892,5239
"6994","Zm00001d026394","10",145133662,145136374,2712
"6995","Zm00001d026395","10",145136658,145139764,3106
"6996","Zm00001d026396","10",145140791,145148851,8060
"6997","Zm00001d026397","10",145157330,145158895,1565
"6998","Zm00001d026398","10",145211405,145218613,7208
"6999","Zm00001d026399","10",145256836,145257953,1117
"7000","Zm00001d026402","10",145302797,145311603,8806
"7001","Zm00001d026403","10",145308528,145308599,71
"7002","Zm00001d026404","10",145313977,145314876,899
"7003","Zm00001d026405","10",145315798,145319169,3371
"7004","Zm00001d026407","10",145326151,145327468,1317
"7005","Zm00001d026413","10",145391311,145392264,953
"7006","Zm00001d026414","10",145394601,145395407,806
"7007","Zm00001d026415","10",145395974,145401877,5903
"7008","Zm00001d026421","10",145450797,145461255,10458
"7009","Zm00001d026422","10",145472125,145494737,22612
"7010","Zm00001d026425","10",145556564,145561470,4906
"7011","Zm00001d026426","10",145633928,145641425,7497
"7012","Zm00001d026427","10",145650303,145652282,1979
"7013","Zm00001d026429","10",145713940,145718508,4568
"7014","Zm00001d026431","10",145720480,145722209,1729
"7015","Zm00001d026432","10",145732222,145734725,2503
"7016","Zm00001d026434","10",145756681,145759431,2750
"7017","Zm00001d026435","10",145793619,145794944,1325
"7018","Zm00001d026436","10",145797717,145798331,614
"7019","Zm00001d026437","10",145821443,145826784,5341
"7020","Zm00001d026438","10",145874106,145877597,3491
"7021","Zm00001d026439","10",145882413,145897009,14596
"7022","Zm00001d026442","10",145903057,145906518,3461
"7023","Zm00001d026445","10",145970289,145976752,6463
"7024","Zm00001d026446","10",145978827,145981979,3152
"7025","Zm00001d026447","10",145983350,145983982,632
"7026","Zm00001d026448","10",146059085,146062110,3025
"7027","Zm00001d026451","10",146093787,146096629,2842
"7028","Zm00001d026452","10",146098952,146102717,3765
"7029","Zm00001d026454","10",146117284,146117613,329
"7030","Zm00001d026457","10",146225848,146226322,474
"7031","Zm00001d026458","10",146241809,146245690,3881
"7032","Zm00001d026459","10",146249015,146249765,750
"7033","Zm00001d026460","10",146257808,146261085,3277
"7034","Zm00001d026463","10",146324020,146327524,3504
"7035","Zm00001d026464","10",146330909,146331355,446
"7036","Zm00001d026465","10",146390292,146400543,10251
"7037","Zm00001d026467","10",146439215,146440716,1501
"7038","Zm00001d026469","10",146515760,146519994,4234
"7039","Zm00001d026472","10",146562821,146566812,3991
"7040","Zm00001d026473","10",146567118,146568109,991
"7041","Zm00001d026475","10",146663667,146667358,3691
"7042","Zm00001d026476","10",146668145,146675537,7392
"7043","Zm00001d026477","10",146705762,146709602,3840
"7044","Zm00001d026478","10",146709454,146711583,2129
"7045","Zm00001d026479","10",146713592,146719187,5595
"7046","Zm00001d026480","10",146721094,146722100,1006
"7047","Zm00001d026483","10",146795024,146816445,21421
"7048","Zm00001d026484","10",146871265,146873306,2041
"7049","Zm00001d026485","10",146872939,146890622,17683
"7050","Zm00001d026486","10",146894287,146895167,880
"7051","Zm00001d026487","10",146895594,146903010,7416
"7052","Zm00001d026490","10",146954113,146960946,6833
"7053","Zm00001d026492","10",147106136,147107401,1265
"7054","Zm00001d026493","10",147113271,147114086,815
"7055","Zm00001d026495","10",147115022,147116956,1934
"7056","Zm00001d026500","10",147239494,147240389,895
"7057","Zm00001d026501","10",147240629,147249381,8752
"7058","Zm00001d026505","10",147307733,147308281,548
"7059","Zm00001d026507","10",147322270,147329437,7167
"7060","Zm00001d026508","10",147330514,147331026,512
"7061","Zm00001d026509","10",147354476,147354799,323
"7062","Zm00001d026510","10",147364599,147365225,626
"7063","Zm00001d026511","10",147370578,147387613,17035
"7064","Zm00001d026512","10",147430706,147433738,3032
"7065","Zm00001d026514","10",147437436,147441371,3935
"7066","Zm00001d026515","10",147456386,147460691,4305
"7067","Zm00001d026516","10",147462770,147465833,3063
"7068","Zm00001d026517","10",147469298,147474320,5022
"7069","Zm00001d026518","10",147474669,147476975,2306
"7070","Zm00001d026519","10",147477161,147478119,958
"7071","Zm00001d026520","10",147481259,147481886,627
"7072","Zm00001d026521","10",147481845,147487342,5497
"7073","Zm00001d026522","10",147504707,147524137,19430
"7074","Zm00001d026523","10",147513529,147515605,2076
"7075","Zm00001d026524","10",147528614,147532136,3522
"7076","Zm00001d026528","10",147615753,147620708,4955
"7077","Zm00001d026530","10",147743187,147743636,449
"7078","Zm00001d026531","10",147769191,147773447,4256
"7079","Zm00001d026532","10",147796659,147804756,8097
"7080","Zm00001d026533","10",147807220,147811660,4440
"7081","Zm00001d026535","10",147812908,147818605,5697
"7082","Zm00001d026536","10",147843856,147850295,6439
"7083","Zm00001d026540","10",147919136,147925555,6419
"7084","Zm00001d026541","10",147936532,147941050,4518
"7085","Zm00001d026542","10",147942412,147945498,3086
"7086","Zm00001d026543","10",147949565,147957914,8349
"7087","Zm00001d026544","10",147964647,147967404,2757
"7088","Zm00001d026547","10",147985161,147988097,2936
"7089","Zm00001d026548","10",147989288,148003202,13914
"7090","Zm00001d026549","10",148006440,148015145,8705
"7091","Zm00001d026551","10",148015757,148021551,5794
"7092","Zm00001d026552","10",148021486,148023414,1928
"7093","Zm00001d026553","10",148036664,148039343,2679
"7094","Zm00001d026554","10",148042045,148043345,1300
"7095","Zm00001d026555","10",148046875,148053047,6172
"7096","Zm00001d026556","10",148051418,148057446,6028
"7097","Zm00001d026557","10",148112845,148114736,1891
"7098","Zm00001d026559","10",148123201,148125066,1865
"7099","Zm00001d026560","10",148129450,148133915,4465
"7100","Zm00001d026562","10",148133688,148137515,3827
"7101","Zm00001d026563","10",148154979,148155515,536
"7102","Zm00001d026567","10",148175926,148178873,2947
"7103","Zm00001d026568","10",148186110,148194115,8005
"7104","Zm00001d026571","10",148195276,148199381,4105
"7105","Zm00001d026572","10",148200915,148202755,1840
"7106","Zm00001d026573","10",148202959,148206353,3394
"7107","Zm00001d026575","10",148249658,148253209,3551
"7108","Zm00001d026576","10",148260149,148261444,1295
"7109","Zm00001d026577","10",148261491,148265297,3806
"7110","Zm00001d026578","10",148267758,148269932,2174
"7111","Zm00001d026579","10",148322351,148342651,20300
"7112","Zm00001d026580","10",148343086,148346303,3217
"7113","Zm00001d026581","10",148370335,148374043,3708
"7114","Zm00001d026582","10",148376426,148383157,6731
"7115","Zm00001d026584","10",148384227,148387093,2866
"7116","Zm00001d026585","10",148388156,148395355,7199
"7117","Zm00001d026586","10",148397982,148402287,4305
"7118","Zm00001d026587","10",148406795,148411190,4395
"7119","Zm00001d026588","10",148412856,148415405,2549
"7120","Zm00001d026589","10",148509628,148511293,1665
"7121","Zm00001d026590","10",148523746,148532791,9045
"7122","Zm00001d026591","10",148626427,148628853,2426
"7123","Zm00001d026592","10",148633857,148636016,2159
"7124","Zm00001d026593","10",148637522,148656835,19313
"7125","Zm00001d026594","10",148669998,148671302,1304
"7126","Zm00001d026597","10",148680741,148681670,929
"7127","Zm00001d026598","10",148710854,148712556,1702
"7128","Zm00001d026599","10",148715856,148717059,1203
"7129","Zm00001d026600","10",148722106,148724784,2678
"7130","Zm00001d026603","10",148758023,148764012,5989
"7131","Zm00001d026604","10",148806601,148809757,3156
"7132","Zm00001d026606","10",148901809,148903746,1937
"7133","Zm00001d026607","10",148903998,148909780,5782
"7134","Zm00001d026608","10",148913230,148914804,1574
"7135","Zm00001d026609","10",148914774,148919060,4286
"7136","Zm00001d026610","10",148918576,148922432,3856
"7137","Zm00001d026611","10",148923923,148924600,677
"7138","Zm00001d026612","10",148925850,148932210,6360
"7139","Zm00001d026614","10",148995156,149000603,5447
"7140","Zm00001d026617","10",149043190,149044740,1550
"7141","Zm00001d026618","10",149045202,149048903,3701
"7142","Zm00001d026619","10",149049346,149053822,4476
"7143","Zm00001d026620","10",149083031,149083450,419
"7144","Zm00001d026621","10",149083648,149097057,13409
"7145","Zm00001d026623","10",149113706,149116474,2768
"7146","Zm00001d026625","10",149117610,149118763,1153
"7147","Zm00001d026627","10",149173023,149177036,4013
"7148","Zm00001d026628","10",149177141,149178387,1246
"7149","Zm00001d026629","10",149182623,149185920,3297
"7150","Zm00001d026630","10",149187927,149191706,3779
"7151","Zm00001d026631","10",149189365,149189434,69
"7152","Zm00001d026632","10",149192883,149193680,797
"7153","Zm00001d026633","10",149198714,149200759,2045
"7154","Zm00001d026634","10",149201365,149204601,3236
"7155","Zm00001d026635","10",149245574,149250456,4882
"7156","Zm00001d026636","10",149249863,149251541,1678
"7157","Zm00001d026637","10",149252085,149253004,919
"7158","Zm00001d026638","10",149256534,149258518,1984
"7159","Zm00001d026639","10",149258519,149261157,2638
"7160","Zm00001d026640","10",149269862,149271718,1856
"7161","Zm00001d026641","10",149273828,149277821,3993
"7162","Zm00001d026642","10",149278822,149280179,1357
"7163","Zm00001d026643","10",149288249,149292670,4421
"7164","Zm00001d026645","10",149326566,149340249,13683
"7165","Zm00001d026647","10",149345776,149364298,18522
"7166","Zm00001d026649","10",149382212,149384169,1957
"7167","Zm00001d026650","10",149387703,149390780,3077
"7168","Zm00001d026651","10",149391978,149392502,524
"7169","Zm00001d026652","10",149393077,149397563,4486
"7170","Zm00001d026653","10",149459106,149486790,27684
"7171","Zm00001d026654","10",149493855,149501735,7880
"7172","Zm00001d026655","10",149517376,149519238,1862
"7173","Zm00001d026662","10",149592543,149593163,620
"7174","Zm00001d026663","10",149603978,149604751,773
"7175","Zm00001d026664","10",149609177,149610110,933
"7176","Zm00001d026665","10",149623243,149624040,797
"7177","Zm00001d026668","10",149652422,149656130,3708
"7178","Zm00001d026669","10",149696142,149699827,3685
"7179","Zm00001d026670","10",149700787,149704379,3592
"7180","Zm00001d026671","10",149704637,149706805,2168
"7181","Zm00001d026672","10",149707696,149709357,1661
"7182","Zm00001d026675","10",149745849,149749481,3632
"7183","Zm00001d026676","10",149749417,149751185,1768
"7184","Zm00001d026677","10",149751381,149758192,6811
"7185","Zm00001d026678","10",149762509,149763738,1229
"7186","Zm00001d026680","10",149773133,149776018,2885
"7187","Zm00001d026681","10",149805350,149806567,1217
"7188","Zm00001d026682","10",149809548,149811521,1973
"7189","Zm00001d026683","10",149852402,149853787,1385
"7190","Zm00001d026684","10",149857632,149859149,1517
"7191","Zm00001d026685","10",149859061,149861755,2694
"7192","Zm00001d026689","10",150020463,150023661,3198
"7193","Zm00001d026690","10",150050330,150051860,1530
"7194","Zm00001d026691","10",150051955,150061708,9753
"7195","Zm00001d026692","10",150061895,150067187,5292
"7196","Zm00001d026695","10",150135232,150143184,7952
"7197","Zm00001d026696","10",150180000,150204009,24009
"7198","Zm00001d026697","10",150284617,150285015,398
"7199","Zm00001d026698","10",150307587,150319013,11426
"7200","Zm00001d026700","10",150353627,150355852,2225
"7201","Zm00001d026701","10",150356284,150357965,1681
"7202","Zm00001d026702","10",150488543,150490777,2234
"7203","Zm00001d026703","10",150491550,150493423,1873
"7204","Zm00001d026704","10",150493718,150494858,1140
"7205","Zm00001d026705","10",150494633,150497195,2562
"7206","Zm00001d026706","10",150556801,150562630,5829
"7207","Zm00001d026712","10",150831479,150833783,2304
"7208","Zm00001d027230","1",44289,49837,5548
"7209","Zm00001d027231","1",50877,55716,4839
"7210","Zm00001d027233","1",111655,118312,6657
"7211","Zm00001d027234","1",118683,119739,1056
"7212","Zm00001d027235","1",122120,122614,494
"7213","Zm00001d027236","1",138378,139043,665
"7214","Zm00001d027239","1",196942,199159,2217
"7215","Zm00001d027240","1",199345,205715,6370
"7216","Zm00001d027242","1",209979,215403,5424
"7217","Zm00001d027250","1",337772,338047,275
"7218","Zm00001d027252","1",374034,374106,72
"7219","Zm00001d027254","1",426764,432130,5366
"7220","Zm00001d027256","1",559525,560974,1449
"7221","Zm00001d027257","1",560956,568038,7082
"7222","Zm00001d027258","1",689056,689704,648
"7223","Zm00001d027259","1",689483,716826,27343
"7224","Zm00001d027263","1",866251,867030,779
"7225","Zm00001d027265","1",1012255,1023640,11385
"7226","Zm00001d027266","1",1027058,1030126,3068
"7227","Zm00001d027267","1",1031786,1036456,4670
"7228","Zm00001d027268","1",1034777,1037365,2588
"7229","Zm00001d027269","1",1044482,1044694,212
"7230","Zm00001d027271","1",1067813,1073269,5456
"7231","Zm00001d027273","1",1198058,1206947,8889
"7232","Zm00001d027275","1",1213077,1216127,3050
"7233","Zm00001d027276","1",1226063,1236227,10164
"7234","Zm00001d027277","1",1231545,1236335,4790
"7235","Zm00001d027278","1",1492439,1533158,40719
"7236","Zm00001d027280","1",1580261,1580781,520
"7237","Zm00001d027281","1",1610483,1611686,1203
"7238","Zm00001d027283","1",1715993,1716949,956
"7239","Zm00001d027285","1",1816514,1818676,2162
"7240","Zm00001d027286","1",1834232,1835383,1151
"7241","Zm00001d027288","1",1841722,1843589,1867
"7242","Zm00001d027289","1",1921679,1936497,14818
"7243","Zm00001d027290","1",1938725,1939294,569
"7244","Zm00001d027291","1",1942161,1942595,434
"7245","Zm00001d027292","1",2019934,2021379,1445
"7246","Zm00001d027293","1",2026825,2034154,7329
"7247","Zm00001d027295","1",2104761,2106624,1863
"7248","Zm00001d027296","1",2109189,2113478,4289
"7249","Zm00001d027298","1",2154232,2156387,2155
"7250","Zm00001d027299","1",2157230,2170332,13102
"7251","Zm00001d027300","1",2233954,2241438,7484
"7252","Zm00001d027302","1",2284852,2289401,4549
"7253","Zm00001d027304","1",2298093,2302943,4850
"7254","Zm00001d027307","1",2523140,2531089,7949
"7255","Zm00001d027308","1",2562283,2565147,2864
"7256","Zm00001d027309","1",2629289,2635834,6545
"7257","Zm00001d027310","1",2650836,2653089,2253
"7258","Zm00001d027311","1",2746424,2749031,2607
"7259","Zm00001d027312","1",2774054,2780630,6576
"7260","Zm00001d027313","1",2781142,2782403,1261
"7261","Zm00001d027314","1",2809751,2811917,2166
"7262","Zm00001d027315","1",2812496,2813750,1254
"7263","Zm00001d027317","1",2818955,2826611,7656
"7264","Zm00001d027318","1",2827035,2829836,2801
"7265","Zm00001d027319","1",2869707,2878262,8555
"7266","Zm00001d027320","1",2878535,2889452,10917
"7267","Zm00001d027321","1",2883539,2892612,9073
"7268","Zm00001d027322","1",2894775,2897548,2773
"7269","Zm00001d027323","1",2934269,2934775,506
"7270","Zm00001d027324","1",2959502,2972168,12666
"7271","Zm00001d027325","1",2974258,2976935,2677
"7272","Zm00001d027326","1",2977014,2997162,20148
"7273","Zm00001d027329","1",3031993,3036913,4920
"7274","Zm00001d027330","1",3051538,3052986,1448
"7275","Zm00001d027332","1",3095308,3095604,296
"7276","Zm00001d027333","1",3104159,3122867,18708
"7277","Zm00001d027334","1",3124648,3135817,11169
"7278","Zm00001d027335","1",3172313,3176736,4423
"7279","Zm00001d027337","1",3224423,3230647,6224
"7280","Zm00001d027338","1",3231117,3231836,719
"7281","Zm00001d027339","1",3232396,3233834,1438
"7282","Zm00001d027340","1",3272230,3288228,15998
"7283","Zm00001d027342","1",3292884,3294726,1842
"7284","Zm00001d027343","1",3368268,3369884,1616
"7285","Zm00001d027344","1",3371324,3374866,3542
"7286","Zm00001d027345","1",3377702,3378405,703
"7287","Zm00001d027346","1",3379341,3380308,967
"7288","Zm00001d027347","1",3380644,3385523,4879
"7289","Zm00001d027348","1",3441886,3443394,1508
"7290","Zm00001d027349","1",3443598,3446350,2752
"7291","Zm00001d027350","1",3448500,3452123,3623
"7292","Zm00001d027351","1",3482848,3487232,4384
"7293","Zm00001d027352","1",3489406,3491807,2401
"7294","Zm00001d027353","1",3495121,3497148,2027
"7295","Zm00001d027354","1",3544521,3549369,4848
"7296","Zm00001d027355","1",3573479,3575207,1728
"7297","Zm00001d027359","1",3651033,3661251,10218
"7298","Zm00001d027361","1",3741739,3744408,2669
"7299","Zm00001d027362","1",3772168,3775082,2914
"7300","Zm00001d027363","1",3775217,3778050,2833
"7301","Zm00001d027365","1",3799515,3801185,1670
"7302","Zm00001d027366","1",3805137,3807525,2388
"7303","Zm00001d027367","1",3807343,3810146,2803
"7304","Zm00001d027368","1",3811533,3812285,752
"7305","Zm00001d027369","1",3842248,3847295,5047
"7306","Zm00001d027370","1",3849540,3854486,4946
"7307","Zm00001d027371","1",3912856,3917063,4207
"7308","Zm00001d027373","1",3960300,3964921,4621
"7309","Zm00001d027374","1",3966724,3968357,1633
"7310","Zm00001d027375","1",3971512,3972133,621
"7311","Zm00001d027376","1",3974143,3987696,13553
"7312","Zm00001d027377","1",3978929,3979000,71
"7313","Zm00001d027378","1",3979593,3979662,69
"7314","Zm00001d027380","1",3988430,3996967,8537
"7315","Zm00001d027383","1",4110011,4114671,4660
"7316","Zm00001d027384","1",4115013,4117719,2706
"7317","Zm00001d027385","1",4118697,4120755,2058
"7318","Zm00001d027386","1",4121780,4126391,4611
"7319","Zm00001d027387","1",4133373,4135619,2246
"7320","Zm00001d027388","1",4143058,4147651,4593
"7321","Zm00001d027389","1",4149732,4149992,260
"7322","Zm00001d027392","1",4220852,4296236,75384
"7323","Zm00001d027393","1",4317978,4319270,1292
"7324","Zm00001d027394","1",4340135,4340790,655
"7325","Zm00001d027395","1",4341041,4351530,10489
"7326","Zm00001d027399","1",4402312,4404440,2128
"7327","Zm00001d027400","1",4405004,4406685,1681
"7328","Zm00001d027401","1",4417538,4425832,8294
"7329","Zm00001d027403","1",4494975,4499451,4476
"7330","Zm00001d027404","1",4532388,4535448,3060
"7331","Zm00001d027405","1",4536701,4538190,1489
"7332","Zm00001d027409","1",4661492,4662475,983
"7333","Zm00001d027411","1",4718946,4722343,3397
"7334","Zm00001d027412","1",4724456,4736832,12376
"7335","Zm00001d027415","1",4832874,4838381,5507
"7336","Zm00001d027416","1",4840100,4842684,2584
"7337","Zm00001d027419","1",4891941,4894990,3049
"7338","Zm00001d027421","1",4900834,4903371,2537
"7339","Zm00001d027422","1",4907157,4909468,2311
"7340","Zm00001d027423","1",4909652,4914685,5033
"7341","Zm00001d027425","1",4979131,4994850,15719
"7342","Zm00001d027427","1",5095291,5098140,2849
"7343","Zm00001d027429","1",5106818,5108654,1836
"7344","Zm00001d027430","1",5111247,5116316,5069
"7345","Zm00001d027431","1",5123182,5127784,4602
"7346","Zm00001d027434","1",5159303,5161741,2438
"7347","Zm00001d027435","1",5202748,5208577,5829
"7348","Zm00001d027436","1",5328311,5330875,2564
"7349","Zm00001d027439","1",5412144,5413568,1424
"7350","Zm00001d027440","1",5422920,5423669,749
"7351","Zm00001d027441","1",5431259,5434466,3207
"7352","Zm00001d027442","1",5434308,5435871,1563
"7353","Zm00001d027443","1",5463952,5466250,2298
"7354","Zm00001d027444","1",5469651,5477988,8337
"7355","Zm00001d027445","1",5481138,5487574,6436
"7356","Zm00001d027446","1",5491481,5495299,3818
"7357","Zm00001d027447","1",5496540,5500644,4104
"7358","Zm00001d027448","1",5518494,5523341,4847
"7359","Zm00001d027449","1",5525424,5526840,1416
"7360","Zm00001d027450","1",5528958,5535135,6177
"7361","Zm00001d027451","1",5537112,5540505,3393
"7362","Zm00001d027454","1",5603127,5604467,1340
"7363","Zm00001d027455","1",5610415,5614949,4534
"7364","Zm00001d027457","1",5698898,5699272,374
"7365","Zm00001d027458","1",5701680,5704055,2375
"7366","Zm00001d027460","1",5799244,5810862,11618
"7367","Zm00001d027461","1",5816871,5819671,2800
"7368","Zm00001d027462","1",5819752,5825029,5277
"7369","Zm00001d027463","1",5883718,5886868,3150
"7370","Zm00001d027464","1",5886936,5888408,1472
"7371","Zm00001d027466","1",5893819,5906194,12375
"7372","Zm00001d027467","1",5908533,5913510,4977
"7373","Zm00001d027468","1",5943755,5947624,3869
"7374","Zm00001d027469","1",6020779,6023318,2539
"7375","Zm00001d027470","1",6027852,6032982,5130
"7376","Zm00001d027471","1",6034724,6035902,1178
"7377","Zm00001d027472","1",6068283,6161610,93327
"7378","Zm00001d027474","1",6125778,6145963,20185
"7379","Zm00001d027475","1",6154221,6161610,7389
"7380","Zm00001d027477","1",6237666,6238642,976
"7381","Zm00001d027478","1",6239823,6246616,6793
"7382","Zm00001d027479","1",6246862,6251356,4494
"7383","Zm00001d027480","1",6270311,6275109,4798
"7384","Zm00001d027481","1",6274095,6277349,3254
"7385","Zm00001d027483","1",6293847,6294413,566
"7386","Zm00001d027484","1",6296235,6300940,4705
"7387","Zm00001d027485","1",6307711,6310327,2616
"7388","Zm00001d027486","1",6310322,6313633,3311
"7389","Zm00001d027487","1",6319205,6328780,9575
"7390","Zm00001d027488","1",6407153,6409815,2662
"7391","Zm00001d027489","1",6419426,6422501,3075
"7392","Zm00001d027492","1",6524381,6529577,5196
"7393","Zm00001d027493","1",6542791,6543117,326
"7394","Zm00001d027495","1",6556059,6558427,2368
"7395","Zm00001d027499","1",6771571,6773307,1736
"7396","Zm00001d027500","1",6797799,6798604,805
"7397","Zm00001d027502","1",6825834,6829116,3282
"7398","Zm00001d027503","1",6829809,6840626,10817
"7399","Zm00001d027504","1",6907596,6912220,4624
"7400","Zm00001d027505","1",6915078,6918536,3458
"7401","Zm00001d027506","1",7028338,7034080,5742
"7402","Zm00001d027508","1",7064043,7068106,4063
"7403","Zm00001d027509","1",7072426,7074524,2098
"7404","Zm00001d027510","1",7075161,7079887,4726
"7405","Zm00001d027511","1",7144392,7146668,2276
"7406","Zm00001d027512","1",7148372,7152568,4196
"7407","Zm00001d027514","1",7177670,7183179,5509
"7408","Zm00001d027515","1",7238508,7259024,20516
"7409","Zm00001d027516","1",7292688,7296937,4249
"7410","Zm00001d027517","1",7297900,7300800,2900
"7411","Zm00001d027519","1",7339915,7346200,6285
"7412","Zm00001d027520","1",7356309,7358599,2290
"7413","Zm00001d027523","1",7394984,7399582,4598
"7414","Zm00001d027524","1",7401558,7403097,1539
"7415","Zm00001d027525","1",7404965,7406223,1258
"7416","Zm00001d027527","1",7457235,7459538,2303
"7417","Zm00001d027530","1",7490367,7492305,1938
"7418","Zm00001d027532","1",7558685,7564087,5402
"7419","Zm00001d027533","1",7564459,7567651,3192
"7420","Zm00001d027535","1",7598105,7602501,4396
"7421","Zm00001d027536","1",7686285,7701265,14980
"7422","Zm00001d027540","1",7878334,7879915,1581
"7423","Zm00001d027542","1",7885525,7886863,1338
"7424","Zm00001d027544","1",7978897,7991204,12307
"7425","Zm00001d027548","1",8046302,8047417,1115
"7426","Zm00001d027550","1",8055744,8056160,416
"7427","Zm00001d027551","1",8058918,8065189,6271
"7428","Zm00001d027554","1",8114840,8115307,467
"7429","Zm00001d027555","1",8115891,8118284,2393
"7430","Zm00001d027556","1",8119828,8122747,2919
"7431","Zm00001d027557","1",8129042,8130156,1114
"7432","Zm00001d027558","1",8152458,8164250,11792
"7433","Zm00001d027566","1",8229144,8232742,3598
"7434","Zm00001d027570","1",8280558,8285255,4697
"7435","Zm00001d027571","1",8286848,8291232,4384
"7436","Zm00001d027572","1",8302347,8308349,6002
"7437","Zm00001d027573","1",8308824,8312491,3667
"7438","Zm00001d027576","1",8333074,8336362,3288
"7439","Zm00001d027577","1",8339277,8357146,17869
"7440","Zm00001d027580","1",8369095,8371979,2884
"7441","Zm00001d027581","1",8372150,8373610,1460
"7442","Zm00001d027582","1",8373817,8376354,2537
"7443","Zm00001d027583","1",8414357,8418081,3724
"7444","Zm00001d027585","1",8485866,8489268,3402
"7445","Zm00001d027587","1",8496660,8498315,1655
"7446","Zm00001d027588","1",8552388,8557230,4842
"7447","Zm00001d027589","1",8572245,8574091,1846
"7448","Zm00001d027590","1",8573955,8577898,3943
"7449","Zm00001d027593","1",8596506,8599611,3105
"7450","Zm00001d027595","1",8661846,8665065,3219
"7451","Zm00001d027596","1",8666871,8671854,4983
"7452","Zm00001d027597","1",8675905,8676846,941
"7453","Zm00001d027598","1",8677635,8679500,1865
"7454","Zm00001d027599","1",8701300,8702856,1556
"7455","Zm00001d027603","1",8790903,8794629,3726
"7456","Zm00001d027606","1",8916341,8917933,1592
"7457","Zm00001d027607","1",8919684,8921767,2083
"7458","Zm00001d027610","1",8979876,8981567,1691
"7459","Zm00001d027611","1",8981882,8983387,1505
"7460","Zm00001d027612","1",9008951,9013386,4435
"7461","Zm00001d027613","1",9015345,9016646,1301
"7462","Zm00001d027616","1",9108126,9111252,3126
"7463","Zm00001d027618","1",9112947,9115668,2721
"7464","Zm00001d027619","1",9119707,9122688,2981
"7465","Zm00001d027621","1",9160553,9163106,2553
"7466","Zm00001d027622","1",9228763,9233305,4542
"7467","Zm00001d027624","1",9341530,9344789,3259
"7468","Zm00001d027625","1",9346098,9353496,7398
"7469","Zm00001d027626","1",9404918,9411381,6463
"7470","Zm00001d027630","1",9488000,9492140,4140
"7471","Zm00001d027633","1",9547625,9612900,65275
"7472","Zm00001d027634","1",9594720,9594793,73
"7473","Zm00001d027637","1",9638241,9644168,5927
"7474","Zm00001d027642","1",9775794,9777248,1454
"7475","Zm00001d027646","1",9986510,9996961,10451
"7476","Zm00001d027648","1",10061602,10064837,3235
"7477","Zm00001d027649","1",10105590,10109563,3973
"7478","Zm00001d027652","1",10150836,10152891,2055
"7479","Zm00001d027655","1",10257667,10258752,1085
"7480","Zm00001d027656","1",10261506,10265855,4349
"7481","Zm00001d027657","1",10318849,10322079,3230
"7482","Zm00001d027659","1",10349113,10358254,9141
"7483","Zm00001d027662","1",10425445,10427529,2084
"7484","Zm00001d027665","1",10492323,10572503,80180
"7485","Zm00001d027667","1",10614579,10622700,8121
"7486","Zm00001d027671","1",10681229,10686519,5290
"7487","Zm00001d027672","1",10687116,10690173,3057
"7488","Zm00001d027673","1",10752127,10754142,2015
"7489","Zm00001d027674","1",10755659,10757365,1706
"7490","Zm00001d027675","1",10758933,10761622,2689
"7491","Zm00001d027676","1",10854296,10857324,3028
"7492","Zm00001d027677","1",10875911,10878329,2418
"7493","Zm00001d027678","1",10986933,10988125,1192
"7494","Zm00001d027680","1",11011198,11015865,4667
"7495","Zm00001d027681","1",11065460,11065705,245
"7496","Zm00001d027682","1",11066056,11069126,3070
"7497","Zm00001d027683","1",11126731,11130713,3982
"7498","Zm00001d027684","1",11137397,11138338,941
"7499","Zm00001d027688","1",11158115,11165247,7132
"7500","Zm00001d027691","1",11207688,11225217,17529
"7501","Zm00001d027694","1",11299491,11303586,4095
"7502","Zm00001d027699","1",11358826,11365515,6689
"7503","Zm00001d027701","1",11432184,11438681,6497
"7504","Zm00001d027702","1",11490592,11492813,2221
"7505","Zm00001d027703","1",11493216,11495046,1830
"7506","Zm00001d027706","1",11584062,11590167,6105
"7507","Zm00001d027707","1",11591119,11595660,4541
"7508","Zm00001d027708","1",11664783,11666908,2125
"7509","Zm00001d027709","1",11671171,11678446,7275
"7510","Zm00001d027710","1",11715889,11717774,1885
"7511","Zm00001d027711","1",11719840,11725110,5270
"7512","Zm00001d027713","1",11783331,11784682,1351
"7513","Zm00001d027714","1",11881252,11887552,6300
"7514","Zm00001d027715","1",11952380,11984542,32162
"7515","Zm00001d027719","1",12103775,12105421,1646
"7516","Zm00001d027721","1",12140948,12146615,5667
"7517","Zm00001d027722","1",12170863,12175121,4258
"7518","Zm00001d027723","1",12176198,12182441,6243
"7519","Zm00001d027726","1",12288610,12296582,7972
"7520","Zm00001d027727","1",12330534,12331811,1277
"7521","Zm00001d027728","1",12335763,12340666,4903
"7522","Zm00001d027729","1",12340668,12342288,1620
"7523","Zm00001d027731","1",12354762,12359640,4878
"7524","Zm00001d027732","1",12364471,12371991,7520
"7525","Zm00001d027734","1",12374888,12378539,3651
"7526","Zm00001d027739","1",12400468,12401019,551
"7527","Zm00001d027740","1",12442621,12443983,1362
"7528","Zm00001d027741","1",12444329,12446126,1797
"7529","Zm00001d027742","1",12448970,12449458,488
"7530","Zm00001d027743","1",12502776,12510591,7815
"7531","Zm00001d027744","1",12510999,12511508,509
"7532","Zm00001d027745","1",12528993,12531966,2973
"7533","Zm00001d027746","1",12532781,12533074,293
"7534","Zm00001d027748","1",12538562,12543035,4473
"7535","Zm00001d027749","1",12546659,12552109,5450
"7536","Zm00001d027751","1",12621185,12624879,3694
"7537","Zm00001d027752","1",12628889,12640144,11255
"7538","Zm00001d027755","1",12675736,12681850,6114
"7539","Zm00001d027756","1",12708983,12713231,4248
"7540","Zm00001d027757","1",12714065,12716389,2324
"7541","Zm00001d027758","1",12768360,12771997,3637
"7542","Zm00001d027760","1",13023613,13024482,869
"7543","Zm00001d027762","1",13028955,13030569,1614
"7544","Zm00001d027763","1",13052386,13053952,1566
"7545","Zm00001d027764","1",13059219,13060512,1293
"7546","Zm00001d027766","1",13137072,13140293,3221
"7547","Zm00001d027767","1",13143086,13145452,2366
"7548","Zm00001d027768","1",13166917,13176199,9282
"7549","Zm00001d027769","1",13177255,13183634,6379
"7550","Zm00001d027773","1",13253409,13258417,5008
"7551","Zm00001d027788","1",13475153,13483253,8100
"7552","Zm00001d027789","1",13528222,13533144,4922
"7553","Zm00001d027790","1",13576388,13580832,4444
"7554","Zm00001d027791","1",13592625,13600205,7580
"7555","Zm00001d027794","1",13666924,13673869,6945
"7556","Zm00001d027799","1",13758931,13762071,3140
"7557","Zm00001d027800","1",13809656,13811605,1949
"7558","Zm00001d027801","1",13815367,13827552,12185
"7559","Zm00001d027802","1",13863300,13867102,3802
"7560","Zm00001d027803","1",13905218,13911405,6187
"7561","Zm00001d027805","1",13965284,13968673,3389
"7562","Zm00001d027807","1",14012690,14030730,18040
"7563","Zm00001d027809","1",14207663,14212490,4827
"7564","Zm00001d027811","1",14311486,14318456,6970
"7565","Zm00001d027812","1",14319418,14320918,1500
"7566","Zm00001d027813","1",14321650,14323311,1661
"7567","Zm00001d027815","1",14329827,14333803,3976
"7568","Zm00001d027816","1",14361469,14365136,3667
"7569","Zm00001d027819","1",14448014,14448412,398
"7570","Zm00001d027820","1",14479050,14479445,395
"7571","Zm00001d027821","1",14492187,14492564,377
"7572","Zm00001d027823","1",14576869,14577916,1047
"7573","Zm00001d027824","1",14585540,14587374,1834
"7574","Zm00001d027826","1",14606179,14611811,5632
"7575","Zm00001d027827","1",14612107,14616020,3913
"7576","Zm00001d027831","1",14651572,14651835,263
"7577","Zm00001d027834","1",14665693,14671725,6032
"7578","Zm00001d027835","1",14689445,14692321,2876
"7579","Zm00001d027838","1",14705335,14706969,1634
"7580","Zm00001d027839","1",14754184,14757028,2844
"7581","Zm00001d027840","1",14759168,14762218,3050
"7582","Zm00001d027841","1",14831571,14846630,15059
"7583","Zm00001d027842","1",14882458,14891319,8861
"7584","Zm00001d027843","1",14989245,14990987,1742
"7585","Zm00001d027844","1",15012548,15013896,1348
"7586","Zm00001d027845","1",15013950,15018699,4749
"7587","Zm00001d027846","1",15060190,15063033,2843
"7588","Zm00001d027847","1",15065545,15072521,6976
"7589","Zm00001d027848","1",15120744,15125845,5101
"7590","Zm00001d027850","1",15156918,15162289,5371
"7591","Zm00001d027851","1",15175214,15177892,2678
"7592","Zm00001d027852","1",15193281,15196077,2796
"7593","Zm00001d027854","1",15301583,15306925,5342
"7594","Zm00001d027856","1",15401478,15402767,1289
"7595","Zm00001d027859","1",15500226,15501662,1436
"7596","Zm00001d027860","1",15530277,15532211,1934
"7597","Zm00001d027861","1",15582763,15585986,3223
"7598","Zm00001d027862","1",15669005,15673015,4010
"7599","Zm00001d027868","1",15763100,15768449,5349
"7600","Zm00001d027869","1",15961983,15975352,13369
"7601","Zm00001d027871","1",16007197,16010258,3061
"7602","Zm00001d027872","1",16011197,16017413,6216
"7603","Zm00001d027873","1",16018915,16019115,200
"7604","Zm00001d027874","1",16038734,16042002,3268
"7605","Zm00001d027875","1",16140364,16141359,995
"7606","Zm00001d027876","1",16227533,16235054,7521
"7607","Zm00001d027877","1",16284218,16285168,950
"7608","Zm00001d027878","1",16356238,16360518,4280
"7609","Zm00001d027879","1",16414023,16415818,1795
"7610","Zm00001d027880","1",16436908,16447108,10200
"7611","Zm00001d027881","1",16562282,16562617,335
"7612","Zm00001d027882","1",16629251,16630156,905
"7613","Zm00001d027883","1",16706388,16707032,644
"7614","Zm00001d027884","1",16707201,16714717,7516
"7615","Zm00001d027885","1",16721226,16722692,1466
"7616","Zm00001d027886","1",16722714,16730676,7962
"7617","Zm00001d027887","1",16744340,16746866,2526
"7618","Zm00001d027888","1",16748760,16752406,3646
"7619","Zm00001d027890","1",16810190,16810882,692
"7620","Zm00001d027892","1",16843024,16848595,5571
"7621","Zm00001d027893","1",16948608,16955122,6514
"7622","Zm00001d027894","1",16961016,16961405,389
"7623","Zm00001d027895","1",16968886,16977186,8300
"7624","Zm00001d027896","1",16977162,16980228,3066
"7625","Zm00001d027897","1",16999913,17001529,1616
"7626","Zm00001d027898","1",17059579,17063351,3772
"7627","Zm00001d027899","1",17141137,17141631,494
"7628","Zm00001d027900","1",17147073,17148511,1438
"7629","Zm00001d027901","1",17156322,17156867,545
"7630","Zm00001d027902","1",17160524,17161113,589
"7631","Zm00001d027903","1",17163385,17164632,1247
"7632","Zm00001d027904","1",17186476,17190166,3690
"7633","Zm00001d027907","1",17314485,17317861,3376
"7634","Zm00001d027908","1",17362175,17365193,3018
"7635","Zm00001d027911","1",17368177,17370245,2068
"7636","Zm00001d027915","1",17406705,17409156,2451
"7637","Zm00001d027916","1",17533781,17553169,19388
"7638","Zm00001d027918","1",17609594,17615130,5536
"7639","Zm00001d027919","1",17615562,17626036,10474
"7640","Zm00001d027920","1",17617359,17621852,4493
"7641","Zm00001d027921","1",17697601,17709046,11445
"7642","Zm00001d027922","1",17722776,17726155,3379
"7643","Zm00001d027924","1",17775779,17777344,1565
"7644","Zm00001d027925","1",17807124,17808643,1519
"7645","Zm00001d027928","1",17833120,17833935,815
"7646","Zm00001d027929","1",17839868,17840788,920
"7647","Zm00001d027934","1",17945836,17961550,15714
"7648","Zm00001d027935","1",17954328,17956187,1859
"7649","Zm00001d027936","1",17962828,17975699,12871
"7650","Zm00001d027937","1",17977813,17985594,7781
"7651","Zm00001d027938","1",17999743,18003647,3904
"7652","Zm00001d027939","1",18004874,18006730,1856
"7653","Zm00001d027941","1",18019104,18021737,2633
"7654","Zm00001d027943","1",18039259,18047225,7966
"7655","Zm00001d027944","1",18050316,18050693,377
"7656","Zm00001d027945","1",18054769,18057866,3097
"7657","Zm00001d027948","1",18147157,18148937,1780
"7658","Zm00001d027950","1",18185512,18190288,4776
"7659","Zm00001d027951","1",18249160,18254729,5569
"7660","Zm00001d027954","1",18274522,18280277,5755
"7661","Zm00001d027957","1",18299864,18321135,21271
"7662","Zm00001d027958","1",18324501,18326246,1745
"7663","Zm00001d027962","1",18451773,18457720,5947
"7664","Zm00001d027963","1",18460171,18462291,2120
"7665","Zm00001d027965","1",18511901,18513196,1295
"7666","Zm00001d027966","1",18514177,18522465,8288
"7667","Zm00001d027967","1",18522679,18525819,3140
"7668","Zm00001d027968","1",18526350,18531383,5033
"7669","Zm00001d027969","1",18597035,18617718,20683
"7670","Zm00001d027971","1",18761417,18771095,9678
"7671","Zm00001d027973","1",18907931,18909955,2024
"7672","Zm00001d027974","1",18914972,18919323,4351
"7673","Zm00001d027975","1",18954240,18956944,2704
"7674","Zm00001d027976","1",19023016,19025659,2643
"7675","Zm00001d027980","1",19271131,19289779,18648
"7676","Zm00001d027982","1",19312947,19319926,6979
"7677","Zm00001d027983","1",19323604,19324692,1088
"7678","Zm00001d027987","1",19433159,19435672,2513
"7679","Zm00001d027988","1",19437480,19437875,395
"7680","Zm00001d027991","1",19584556,19586616,2060
"7681","Zm00001d027992","1",19594960,19595493,533
"7682","Zm00001d027995","1",19655485,19665448,9963
"7683","Zm00001d027996","1",19699532,19702323,2791
"7684","Zm00001d027997","1",19761914,19767203,5289
"7685","Zm00001d027998","1",19887017,19887754,737
"7686","Zm00001d027999","1",19906136,19909038,2902
"7687","Zm00001d028000","1",19919247,19942038,22791
"7688","Zm00001d028001","1",19943200,19946803,3603
"7689","Zm00001d028002","1",19961083,19963559,2476
"7690","Zm00001d028003","1",19962836,19963318,482
"7691","Zm00001d028004","1",19965956,19969415,3459
"7692","Zm00001d028005","1",20022494,20026685,4191
"7693","Zm00001d028006","1",20028789,20032918,4129
"7694","Zm00001d028007","1",20105976,20131237,25261
"7695","Zm00001d028008","1",20133912,20136948,3036
"7696","Zm00001d028009","1",20219977,20230817,10840
"7697","Zm00001d028010","1",20263677,20268913,5236
"7698","Zm00001d028011","1",20291775,20293058,1283
"7699","Zm00001d028012","1",20300349,20303168,2819
"7700","Zm00001d028013","1",20304479,20310840,6361
"7701","Zm00001d028014","1",20320621,20320902,281
"7702","Zm00001d028017","1",20410911,20411813,902
"7703","Zm00001d028018","1",20422195,20426539,4344
"7704","Zm00001d028020","1",20533271,20539413,6142
"7705","Zm00001d028021","1",20540461,20546803,6342
"7706","Zm00001d028022","1",20604487,20614451,9964
"7707","Zm00001d028024","1",20740613,20741926,1313
"7708","Zm00001d028025","1",20833688,20836416,2728
"7709","Zm00001d028026","1",20836619,20851026,14407
"7710","Zm00001d028032","1",20926194,20930043,3849
"7711","Zm00001d028034","1",20930892,20939295,8403
"7712","Zm00001d028038","1",21187278,21200544,13266
"7713","Zm00001d028039","1",21287190,21292030,4840
"7714","Zm00001d028040","1",21293997,21296983,2986
"7715","Zm00001d028041","1",21373352,21373999,647
"7716","Zm00001d028043","1",21388224,21388658,434
"7717","Zm00001d028045","1",21501810,21527021,25211
"7718","Zm00001d028046","1",21513845,21553331,39486
"7719","Zm00001d028047","1",21551923,21555136,3213
"7720","Zm00001d028050","1",21680697,21686575,5878
"7721","Zm00001d028053","1",21761959,21767021,5062
"7722","Zm00001d028054","1",21770615,21773945,3330
"7723","Zm00001d028055","1",21774547,21776554,2007
"7724","Zm00001d028056","1",21777050,21779928,2878
"7725","Zm00001d028062","1",21842237,21860574,18337
"7726","Zm00001d028063","1",21859906,21860232,326
"7727","Zm00001d028064","1",21883821,21884689,868
"7728","Zm00001d028071","1",21979236,21982123,2887
"7729","Zm00001d028072","1",21983106,21985275,2169
"7730","Zm00001d028073","1",21990180,22006881,16701
"7731","Zm00001d028074","1",22016444,22018586,2142
"7732","Zm00001d028075","1",22053545,22070105,16560
"7733","Zm00001d028076","1",22092101,22095372,3271
"7734","Zm00001d028077","1",22183541,22185661,2120
"7735","Zm00001d028083","1",22219133,22221566,2433
"7736","Zm00001d028084","1",22263332,22274326,10994
"7737","Zm00001d028086","1",22485343,22489595,4252
"7738","Zm00001d028088","1",22599568,22606524,6956
"7739","Zm00001d028089","1",22608980,22613235,4255
"7740","Zm00001d028092","1",22729803,22732019,2216
"7741","Zm00001d028093","1",22735266,22740921,5655
"7742","Zm00001d028094","1",22841793,22844037,2244
"7743","Zm00001d028096","1",22880022,22891698,11676
"7744","Zm00001d028097","1",22891760,22894405,2645
"7745","Zm00001d028098","1",22960075,22971879,11804
"7746","Zm00001d028100","1",22995810,23004923,9113
"7747","Zm00001d028102","1",23004511,23008536,4025
"7748","Zm00001d028103","1",23014401,23018862,4461
"7749","Zm00001d028104","1",23019510,23022873,3363
"7750","Zm00001d028105","1",23022557,23026960,4403
"7751","Zm00001d028107","1",23030904,23033285,2381
"7752","Zm00001d028109","1",23110479,23114096,3617
"7753","Zm00001d028110","1",23114397,23116894,2497
"7754","Zm00001d028111","1",23118720,23122921,4201
"7755","Zm00001d028112","1",23147728,23150781,3053
"7756","Zm00001d028113","1",23243301,23250772,7471
"7757","Zm00001d028114","1",23265205,23270017,4812
"7758","Zm00001d028117","1",23321794,23325398,3604
"7759","Zm00001d028118","1",23362248,23363688,1440
"7760","Zm00001d028119","1",23365556,23371277,5721
"7761","Zm00001d028122","1",23497185,23499077,1892
"7762","Zm00001d028125","1",23561220,23562368,1148
"7763","Zm00001d028128","1",23601341,23609376,8035
"7764","Zm00001d028129","1",23625801,23627370,1569
"7765","Zm00001d028130","1",23628624,23634749,6125
"7766","Zm00001d028138","1",23950399,23952029,1630
"7767","Zm00001d028139","1",23959615,23962773,3158
"7768","Zm00001d028140","1",23975834,23981932,6098
"7769","Zm00001d028141","1",23991806,23994379,2573
"7770","Zm00001d028143","1",24000830,24011578,10748
"7771","Zm00001d028151","1",24296413,24298623,2210
"7772","Zm00001d028152","1",24310500,24314120,3620
"7773","Zm00001d028153","1",24328898,24333096,4198
"7774","Zm00001d028154","1",24416953,24417897,944
"7775","Zm00001d028160","1",24589853,24593712,3859
"7776","Zm00001d028161","1",24673011,24673466,455
"7777","Zm00001d028162","1",24771608,24778825,7217
"7778","Zm00001d028164","1",24946609,24951403,4794
"7779","Zm00001d028165","1",24963473,24967985,4512
"7780","Zm00001d028167","1",25047706,25050015,2309
"7781","Zm00001d028168","1",25094816,25099163,4347
"7782","Zm00001d028169","1",25107834,25110428,2594
"7783","Zm00001d028170","1",25116199,25117425,1226
"7784","Zm00001d028171","1",25153513,25154838,1325
"7785","Zm00001d028173","1",25305829,25316655,10826
"7786","Zm00001d028174","1",25495853,25498760,2907
"7787","Zm00001d028177","1",25545505,25566335,20830
"7788","Zm00001d028179","1",25577402,25578107,705
"7789","Zm00001d028180","1",25632515,25636718,4203
"7790","Zm00001d028181","1",25715085,25717227,2142
"7791","Zm00001d028182","1",25720877,25723883,3006
"7792","Zm00001d028183","1",25725534,25732327,6793
"7793","Zm00001d028184","1",25734022,25737544,3522
"7794","Zm00001d028185","1",25738664,25741208,2544
"7795","Zm00001d028186","1",25742203,25745382,3179
"7796","Zm00001d028187","1",25755280,25759748,4468
"7797","Zm00001d028188","1",25760320,25767012,6692
"7798","Zm00001d028189","1",25769858,25774094,4236
"7799","Zm00001d028191","1",25791635,25805381,13746
"7800","Zm00001d028193","1",25916570,25919479,2909
"7801","Zm00001d028194","1",25921625,25926361,4736
"7802","Zm00001d028195","1",25927770,25930520,2750
"7803","Zm00001d028197","1",25933439,25936325,2886
"7804","Zm00001d028198","1",25961222,25988127,26905
"7805","Zm00001d028199","1",26001772,26009085,7313
"7806","Zm00001d028201","1",26041525,26045818,4293
"7807","Zm00001d028203","1",26130882,26140505,9623
"7808","Zm00001d028204","1",26173773,26181115,7342
"7809","Zm00001d028205","1",26182226,26187030,4804
"7810","Zm00001d028206","1",26188806,26189613,807
"7811","Zm00001d028207","1",26334264,26346936,12672
"7812","Zm00001d028208","1",26428405,26434744,6339
"7813","Zm00001d028210","1",26517879,26521293,3414
"7814","Zm00001d028211","1",26525210,26529825,4615
"7815","Zm00001d028213","1",26605799,26609755,3956
"7816","Zm00001d028214","1",26610563,26614024,3461
"7817","Zm00001d028216","1",26771165,26776231,5066
"7818","Zm00001d028217","1",26873846,26883816,9970
"7819","Zm00001d028218","1",26887363,26899704,12341
"7820","Zm00001d028219","1",26903676,26908356,4680
"7821","Zm00001d028220","1",27042552,27048152,5600
"7822","Zm00001d028221","1",27049419,27051494,2075
"7823","Zm00001d028222","1",27085759,27086718,959
"7824","Zm00001d028225","1",27256288,27266967,10679
"7825","Zm00001d028227","1",27280055,27286285,6230
"7826","Zm00001d028228","1",27284568,27293763,9195
"7827","Zm00001d028229","1",27301799,27306634,4835
"7828","Zm00001d028230","1",27307350,27313346,5996
"7829","Zm00001d028231","1",27407335,27410561,3226
"7830","Zm00001d028232","1",27413617,27420137,6520
"7831","Zm00001d028233","1",27420468,27422652,2184
"7832","Zm00001d028235","1",27500580,27502910,2330
"7833","Zm00001d028237","1",27571849,27577275,5426
"7834","Zm00001d028238","1",27581992,27600885,18893
"7835","Zm00001d028239","1",27587168,27587239,71
"7836","Zm00001d028240","1",27695825,27697683,1858
"7837","Zm00001d028241","1",27700703,27702800,2097
"7838","Zm00001d028243","1",27817413,27821834,4421
"7839","Zm00001d028244","1",27828333,27839904,11571
"7840","Zm00001d028249","1",27990681,27995535,4854
"7841","Zm00001d028252","1",28052353,28059866,7513
"7842","Zm00001d028255","1",28066027,28076562,10535
"7843","Zm00001d028256","1",28086258,28102920,16662
"7844","Zm00001d028257","1",28103034,28104556,1522
"7845","Zm00001d028258","1",28108217,28109776,1559
"7846","Zm00001d028260","1",28169233,28171917,2684
"7847","Zm00001d028261","1",28226067,28235042,8975
"7848","Zm00001d028262","1",28392801,28405146,12345
"7849","Zm00001d028263","1",28482921,28485437,2516
"7850","Zm00001d028264","1",28568675,28577849,9174
"7851","Zm00001d028265","1",28609279,28614414,5135
"7852","Zm00001d028266","1",28615299,28617125,1826
"7853","Zm00001d028267","1",28638545,28642886,4341
"7854","Zm00001d028269","1",28714876,28733871,18995
"7855","Zm00001d028270","1",28733920,28741221,7301
"7856","Zm00001d028271","1",28753746,28755604,1858
"7857","Zm00001d028272","1",28789870,28800586,10716
"7858","Zm00001d028273","1",28802882,28804087,1205
"7859","Zm00001d028274","1",28825530,28829211,3681
"7860","Zm00001d028275","1",28835340,28836758,1418
"7861","Zm00001d028277","1",28936381,28939268,2887
"7862","Zm00001d028278","1",28959783,28961321,1538
"7863","Zm00001d028279","1",28996699,29002980,6281
"7864","Zm00001d028280","1",29046582,29052596,6014
"7865","Zm00001d028282","1",29125756,29127204,1448
"7866","Zm00001d028284","1",29163500,29167598,4098
"7867","Zm00001d028285","1",29171324,29180599,9275
"7868","Zm00001d028286","1",29234777,29236687,1910
"7869","Zm00001d028287","1",29239110,29240679,1569
"7870","Zm00001d028288","1",29240997,29241737,740
"7871","Zm00001d028293","1",29407035,29412655,5620
"7872","Zm00001d028294","1",29450944,29452323,1379
"7873","Zm00001d028295","1",29497242,29504081,6839
"7874","Zm00001d028296","1",29508943,29510385,1442
"7875","Zm00001d028297","1",29513368,29517917,4549
"7876","Zm00001d028298","1",29611603,29617384,5781
"7877","Zm00001d028299","1",29671337,29676427,5090
"7878","Zm00001d028302","1",29770419,29781683,11264
"7879","Zm00001d028303","1",29785411,29788053,2642
"7880","Zm00001d028304","1",29830012,29832203,2191
"7881","Zm00001d028307","1",29957661,29960895,3234
"7882","Zm00001d028308","1",29985961,29988114,2153
"7883","Zm00001d028309","1",30017030,30019564,2534
"7884","Zm00001d028311","1",30090857,30092572,1715
"7885","Zm00001d028313","1",30342336,30344337,2001
"7886","Zm00001d028315","1",30363759,30364166,407
"7887","Zm00001d028317","1",30517819,30521296,3477
"7888","Zm00001d028319","1",30559316,30563559,4243
"7889","Zm00001d028320","1",30599349,30609154,9805
"7890","Zm00001d028323","1",30655198,30657801,2603
"7891","Zm00001d028325","1",30793737,30799897,6160
"7892","Zm00001d028328","1",30969605,30971412,1807
"7893","Zm00001d028330","1",31041489,31049951,8462
"7894","Zm00001d028331","1",31049530,31051714,2184
"7895","Zm00001d028332","1",31051822,31060753,8931
"7896","Zm00001d028335","1",31084458,31090595,6137
"7897","Zm00001d028336","1",31097278,31101111,3833
"7898","Zm00001d028337","1",31103531,31114482,10951
"7899","Zm00001d028338","1",31190849,31194494,3645
"7900","Zm00001d028339","1",31208608,31218917,10309
"7901","Zm00001d028340","1",31306395,31307591,1196
"7902","Zm00001d028341","1",31323288,31328862,5574
"7903","Zm00001d028344","1",31351458,31356305,4847
"7904","Zm00001d028348","1",31548999,31551114,2115
"7905","Zm00001d028349","1",31555841,31557666,1825
"7906","Zm00001d028352","1",31683717,31688115,4398
"7907","Zm00001d028354","1",31745664,31750226,4562
"7908","Zm00001d028355","1",31794590,31806747,12157
"7909","Zm00001d028358","1",31888102,31908777,20675
"7910","Zm00001d028359","1",32043753,32048554,4801
"7911","Zm00001d028360","1",32049647,32052463,2816
"7912","Zm00001d028361","1",32068552,32072460,3908
"7913","Zm00001d028362","1",32137771,32138313,542
"7914","Zm00001d028363","1",32145180,32150879,5699
"7915","Zm00001d028365","1",32245893,32249856,3963
"7916","Zm00001d028366","1",32270365,32274160,3795
"7917","Zm00001d028367","1",32294525,32297240,2715
"7918","Zm00001d028368","1",32324768,32327736,2968
"7919","Zm00001d028369","1",32354777,32360308,5531
"7920","Zm00001d028370","1",32363713,32367026,3313
"7921","Zm00001d028371","1",32428519,32429178,659
"7922","Zm00001d028372","1",32433751,32442505,8754
"7923","Zm00001d028373","1",32472096,32478283,6187
"7924","Zm00001d028374","1",32502433,32503776,1343
"7925","Zm00001d028375","1",32602769,32606650,3881
"7926","Zm00001d028377","1",32606648,32607667,1019
"7927","Zm00001d028378","1",32646827,32647222,395
"7928","Zm00001d028380","1",32678385,32692019,13634
"7929","Zm00001d028382","1",32771811,32783919,12108
"7930","Zm00001d028384","1",32801911,32809405,7494
"7931","Zm00001d028385","1",32816668,32820422,3754
"7932","Zm00001d028386","1",32857622,32861798,4176
"7933","Zm00001d028388","1",32948302,32950299,1997
"7934","Zm00001d028389","1",33035884,33036654,770
"7935","Zm00001d028391","1",33115669,33118053,2384
"7936","Zm00001d028392","1",33147676,33150346,2670
"7937","Zm00001d028393","1",33164527,33166953,2426
"7938","Zm00001d028394","1",33167117,33168214,1097
"7939","Zm00001d028395","1",33168640,33169312,672
"7940","Zm00001d028396","1",33303345,33310707,7362
"7941","Zm00001d028397","1",33440965,33448136,7171
"7942","Zm00001d028398","1",33451482,33454805,3323
"7943","Zm00001d028399","1",33544073,33546571,2498
"7944","Zm00001d028400","1",33597142,33600523,3381
"7945","Zm00001d028401","1",33647427,33651594,4167
"7946","Zm00001d028404","1",33738878,33739350,472
"7947","Zm00001d028405","1",33744708,33745907,1199
"7948","Zm00001d028406","1",33752854,33754497,1643
"7949","Zm00001d028408","1",33789050,33790182,1132
"7950","Zm00001d028409","1",33800139,33804188,4049
"7951","Zm00001d028410","1",33850280,33852910,2630
"7952","Zm00001d028412","1",34030313,34038303,7990
"7953","Zm00001d028413","1",34109298,34111567,2269
"7954","Zm00001d028414","1",34138159,34143845,5686
"7955","Zm00001d028415","1",34144566,34150213,5647
"7956","Zm00001d028416","1",34211830,34214257,2427
"7957","Zm00001d028417","1",34216191,34223589,7398
"7958","Zm00001d028422","1",34508764,34510317,1553
"7959","Zm00001d028423","1",34540138,34541979,1841
"7960","Zm00001d028424","1",34542493,34546543,4050
"7961","Zm00001d028425","1",34589914,34593828,3914
"7962","Zm00001d028426","1",34649020,34655072,6052
"7963","Zm00001d028427","1",34657783,34659222,1439
"7964","Zm00001d028428","1",34690471,34704954,14483
"7965","Zm00001d028429","1",34709436,34713166,3730
"7966","Zm00001d028433","1",34919688,34921312,1624
"7967","Zm00001d028436","1",34959814,34966593,6779
"7968","Zm00001d028437","1",34966683,34970269,3586
"7969","Zm00001d028438","1",34970608,34979598,8990
"7970","Zm00001d028439","1",35020494,35022539,2045
"7971","Zm00001d028440","1",35118009,35119004,995
"7972","Zm00001d028441","1",35124835,35125719,884
"7973","Zm00001d028443","1",35131038,35136000,4962
"7974","Zm00001d028445","1",35204318,35205343,1025
"7975","Zm00001d028447","1",35263025,35264614,1589
"7976","Zm00001d028450","1",35276821,35278948,2127
"7977","Zm00001d028451","1",35300769,35301761,992
"7978","Zm00001d028452","1",35373160,35374902,1742
"7979","Zm00001d028453","1",35465775,35476235,10460
"7980","Zm00001d028454","1",35467852,35469731,1879
"7981","Zm00001d028456","1",35502775,35505397,2622
"7982","Zm00001d028457","1",35508417,35510031,1614
"7983","Zm00001d028458","1",35511389,35511664,275
"7984","Zm00001d028463","1",35712410,35717428,5018
"7985","Zm00001d028464","1",35718861,35785612,66751
"7986","Zm00001d028465","1",35816377,35817554,1177
"7987","Zm00001d028469","1",35933885,35934520,635
"7988","Zm00001d028471","1",35960441,35964750,4309
"7989","Zm00001d028472","1",35965499,35970651,5152
"7990","Zm00001d028473","1",36041162,36047534,6372
"7991","Zm00001d028474","1",36140572,36147440,6868
"7992","Zm00001d028475","1",36211949,36216035,4086
"7993","Zm00001d028477","1",36246226,36256685,10459
"7994","Zm00001d028478","1",36254761,36254834,73
"7995","Zm00001d028480","1",36337818,36338422,604
"7996","Zm00001d028481","1",36474424,36485449,11025
"7997","Zm00001d028482","1",36508912,36510926,2014
"7998","Zm00001d028484","1",36588522,36592955,4433
"7999","Zm00001d028485","1",36671835,36684456,12621
"8000","Zm00001d028486","1",36754520,36755618,1098
"8001","Zm00001d028488","1",36769460,36771004,1544
"8002","Zm00001d028490","1",36826368,36843555,17187
"8003","Zm00001d028493","1",36894428,36899646,5218
"8004","Zm00001d028495","1",37166917,37168941,2024
"8005","Zm00001d028498","1",37218931,37220831,1900
"8006","Zm00001d028500","1",37241399,37245007,3608
"8007","Zm00001d028504","1",37284320,37286411,2091
"8008","Zm00001d028505","1",37343077,37345202,2125
"8009","Zm00001d028509","1",37475856,37481112,5256
"8010","Zm00001d028510","1",37501237,37502382,1145
"8011","Zm00001d028511","1",37580598,37594480,13882
"8012","Zm00001d028512","1",37678345,37682334,3989
"8013","Zm00001d028513","1",37762852,37767856,5004
"8014","Zm00001d028514","1",37841039,37846575,5536
"8015","Zm00001d028515","1",37916605,37927253,10648
"8016","Zm00001d028522","1",38045919,38047692,1773
"8017","Zm00001d028524","1",38080422,38081126,704
"8018","Zm00001d028525","1",38120752,38126640,5888
"8019","Zm00001d028527","1",38215481,38232937,17456
"8020","Zm00001d028528","1",38234408,38242664,8256
"8021","Zm00001d028529","1",38255155,38258570,3415
"8022","Zm00001d028530","1",38320615,38323024,2409
"8023","Zm00001d028531","1",38338679,38342235,3556
"8024","Zm00001d028532","1",38393485,38403506,10021
"8025","Zm00001d028533","1",38404713,38407235,2522
"8026","Zm00001d028534","1",38449782,38457129,7347
"8027","Zm00001d028535","1",38516176,38520014,3838
"8028","Zm00001d028536","1",38520831,38526529,5698
"8029","Zm00001d028537","1",38582039,38583427,1388
"8030","Zm00001d028538","1",38586289,38599861,13572
"8031","Zm00001d028539","1",38638860,38643914,5054
"8032","Zm00001d028540","1",38644815,38647346,2531
"8033","Zm00001d028541","1",38683757,38684321,564
"8034","Zm00001d028542","1",38685403,38697325,11922
"8035","Zm00001d028543","1",38734079,38737199,3120
"8036","Zm00001d028546","1",38902998,38914734,11736
"8037","Zm00001d028547","1",38915529,38915936,407
"8038","Zm00001d028548","1",38916237,38917464,1227
"8039","Zm00001d028549","1",38968714,38972965,4251
"8040","Zm00001d028550","1",38975759,38978074,2315
"8041","Zm00001d028552","1",38985184,38986051,867
"8042","Zm00001d028554","1",38993551,38998358,4807
"8043","Zm00001d028556","1",39084598,39085294,696
"8044","Zm00001d028557","1",39085728,39086204,476
"8045","Zm00001d028558","1",39099230,39105322,6092
"8046","Zm00001d028560","1",39154936,39163793,8857
"8047","Zm00001d028561","1",39214417,39214896,479
"8048","Zm00001d028563","1",39218835,39220465,1630
"8049","Zm00001d028564","1",39219196,39219834,638
"8050","Zm00001d028565","1",39236494,39239663,3169
"8051","Zm00001d028566","1",39242181,39247183,5002
"8052","Zm00001d028567","1",39386655,39389622,2967
"8053","Zm00001d028568","1",39393998,39401889,7891
"8054","Zm00001d028569","1",39402992,39408469,5477
"8055","Zm00001d028570","1",39410431,39417092,6661
"8056","Zm00001d028571","1",39418149,39423804,5655
"8057","Zm00001d028572","1",39461169,39464573,3404
"8058","Zm00001d028574","1",39490113,39492146,2033
"8059","Zm00001d028575","1",39563411,39569231,5820
"8060","Zm00001d028576","1",39587411,39593209,5798
"8061","Zm00001d028577","1",39677011,39677832,821
"8062","Zm00001d028579","1",39746224,39755459,9235
"8063","Zm00001d028584","1",39957851,39958327,476
"8064","Zm00001d028586","1",40092188,40097279,5091
"8065","Zm00001d028587","1",40098704,40100074,1370
"8066","Zm00001d028588","1",40100220,40103763,3543
"8067","Zm00001d028590","1",40108125,40108961,836
"8068","Zm00001d028591","1",40117200,40118564,1364
"8069","Zm00001d028593","1",40162847,40168804,5957
"8070","Zm00001d028596","1",40240031,40250055,10024
"8071","Zm00001d028597","1",40253344,40260838,7494
"8072","Zm00001d028598","1",40268286,40268585,299
"8073","Zm00001d028599","1",40283742,40287068,3326
"8074","Zm00001d028601","1",40428759,40431019,2260
"8075","Zm00001d028603","1",40510526,40516015,5489
"8076","Zm00001d028604","1",40561826,40563132,1306
"8077","Zm00001d028606","1",40594616,40599175,4559
"8078","Zm00001d028608","1",40713008,40718506,5498
"8079","Zm00001d028609","1",40765847,40768228,2381
"8080","Zm00001d028611","1",40777725,40780020,2295
"8081","Zm00001d028612","1",40781478,40787295,5817
"8082","Zm00001d028613","1",40787502,40790508,3006
"8083","Zm00001d028615","1",40886065,40889048,2983
"8084","Zm00001d028616","1",40942152,40945320,3168
"8085","Zm00001d028617","1",40994501,40995457,956
"8086","Zm00001d028619","1",41016994,41022002,5008
"8087","Zm00001d028620","1",41086669,41088588,1919
"8088","Zm00001d028621","1",41091131,41112110,20979
"8089","Zm00001d028622","1",41158763,41162190,3427
"8090","Zm00001d028623","1",41163185,41168227,5042
"8091","Zm00001d028625","1",41269098,41270850,1752
"8092","Zm00001d028627","1",41306017,41327056,21039
"8093","Zm00001d028630","1",41454240,41456420,2180
"8094","Zm00001d028631","1",41456759,41459625,2866
"8095","Zm00001d028639","1",41569484,41573603,4119
"8096","Zm00001d028641","1",41589278,41590864,1586
"8097","Zm00001d028642","1",41591107,41596895,5788
"8098","Zm00001d028643","1",41696883,41698484,1601
"8099","Zm00001d028647","1",41725195,41726068,873
"8100","Zm00001d028649","1",41792756,41796270,3514
"8101","Zm00001d028653","1",41833738,41838204,4466
"8102","Zm00001d028654","1",41844935,41848759,3824
"8103","Zm00001d028655","1",41897894,41901694,3800
"8104","Zm00001d028656","1",42051353,42054601,3248
"8105","Zm00001d028657","1",42055800,42056585,785
"8106","Zm00001d028660","1",42116981,42126702,9721
"8107","Zm00001d028661","1",42128655,42129990,1335
"8108","Zm00001d028662","1",42229599,42239557,9958
"8109","Zm00001d028664","1",42281902,42284171,2269
"8110","Zm00001d028665","1",42291247,42292050,803
"8111","Zm00001d028668","1",42435721,42438109,2388
"8112","Zm00001d028669","1",42440888,42454789,13901
"8113","Zm00001d028671","1",42457173,42465916,8743
"8114","Zm00001d028672","1",42563870,42580521,16651
"8115","Zm00001d028675","1",42746694,42748113,1419
"8116","Zm00001d028676","1",42757820,42761547,3727
"8117","Zm00001d028678","1",42769094,42770249,1155
"8118","Zm00001d028679","1",42783762,42786862,3100
"8119","Zm00001d028680","1",42788600,42791622,3022
"8120","Zm00001d028685","1",43042365,43043297,932
"8121","Zm00001d028686","1",43080647,43083202,2555
"8122","Zm00001d028687","1",43083284,43088852,5568
"8123","Zm00001d028689","1",43282276,43284648,2372
"8124","Zm00001d028690","1",43285358,43291990,6632
"8125","Zm00001d028691","1",43312091,43316577,4486
"8126","Zm00001d028692","1",43328452,43334856,6404
"8127","Zm00001d028693","1",43343008,43345059,2051
"8128","Zm00001d028695","1",43355977,43359324,3347
"8129","Zm00001d028696","1",43359353,43361346,1993
"8130","Zm00001d028697","1",43371703,43373490,1787
"8131","Zm00001d028698","1",43439526,43446781,7255
"8132","Zm00001d028699","1",43566683,43581725,15042
"8133","Zm00001d028701","1",43615021,43621153,6132
"8134","Zm00001d028702","1",43646003,43646671,668
"8135","Zm00001d028704","1",43713184,43724218,11034
"8136","Zm00001d028705","1",43725600,43726910,1310
"8137","Zm00001d028707","1",43825133,43832815,7682
"8138","Zm00001d028708","1",43891995,43892168,173
"8139","Zm00001d028709","1",43901180,43904278,3098
"8140","Zm00001d028711","1",43908553,43911257,2704
"8141","Zm00001d028712","1",43999111,44006680,7569
"8142","Zm00001d028713","1",44009629,44012885,3256
"8143","Zm00001d028714","1",44013642,44016256,2614
"8144","Zm00001d028715","1",44168660,44172559,3899
"8145","Zm00001d028718","1",44179372,44180241,869
"8146","Zm00001d028720","1",44244619,44246925,2306
"8147","Zm00001d028721","1",44340623,44341737,1114
"8148","Zm00001d028725","1",44361606,44365357,3751
"8149","Zm00001d028726","1",44373879,44382034,8155
"8150","Zm00001d028727","1",44512777,44518048,5271
"8151","Zm00001d028728","1",44521225,44532226,11001
"8152","Zm00001d028730","1",44532354,44536303,3949
"8153","Zm00001d028731","1",44536542,44539529,2987
"8154","Zm00001d028733","1",44554395,44560803,6408
"8155","Zm00001d028735","1",44718501,44719536,1035
"8156","Zm00001d028736","1",44721407,44722183,776
"8157","Zm00001d028737","1",44733389,44733898,509
"8158","Zm00001d028738","1",44765885,44768411,2526
"8159","Zm00001d028739","1",44836475,44837783,1308
"8160","Zm00001d028740","1",44843630,44844552,922
"8161","Zm00001d028741","1",44865682,44866604,922
"8162","Zm00001d028742","1",44975070,44978277,3207
"8163","Zm00001d028745","1",45169934,45171167,1233
"8164","Zm00001d028746","1",45171565,45179033,7468
"8165","Zm00001d028748","1",45261729,45268817,7088
"8166","Zm00001d028749","1",45270666,45281429,10763
"8167","Zm00001d028750","1",45286331,45290076,3745
"8168","Zm00001d028751","1",45508893,45512288,3395
"8169","Zm00001d028752","1",45537884,45539961,2077
"8170","Zm00001d028753","1",45571871,45574484,2613
"8171","Zm00001d028754","1",45596914,45598386,1472
"8172","Zm00001d028755","1",45602342,45605011,2669
"8173","Zm00001d028757","1",45718296,45723331,5035
"8174","Zm00001d028759","1",45724685,45729020,4335
"8175","Zm00001d028760","1",45800846,45801498,652
"8176","Zm00001d028761","1",45864595,45867995,3400
"8177","Zm00001d028762","1",45868763,45896495,27732
"8178","Zm00001d028763","1",45881566,45883965,2399
"8179","Zm00001d028766","1",45936873,45940038,3165
"8180","Zm00001d028768","1",45981264,45982037,773
"8181","Zm00001d028769","1",46006891,46011253,4362
"8182","Zm00001d028770","1",46011526,46014654,3128
"8183","Zm00001d028771","1",46017582,46024037,6455
"8184","Zm00001d028773","1",46156410,46170403,13993
"8185","Zm00001d028774","1",46171809,46175164,3355
"8186","Zm00001d028775","1",46181362,46183620,2258
"8187","Zm00001d028776","1",46187281,46189614,2333
"8188","Zm00001d028777","1",46189691,46192097,2406
"8189","Zm00001d028778","1",46192688,46194446,1758
"8190","Zm00001d028779","1",46196145,46197931,1786
"8191","Zm00001d028780","1",46200328,46201633,1305
"8192","Zm00001d028782","1",46316119,46319693,3574
"8193","Zm00001d028783","1",46327873,46334046,6173
"8194","Zm00001d028784","1",46374276,46377587,3311
"8195","Zm00001d028785","1",46379532,46380892,1360
"8196","Zm00001d028786","1",46381297,46384012,2715
"8197","Zm00001d028787","1",46389553,46393554,4001
"8198","Zm00001d028788","1",46470270,46475798,5528
"8199","Zm00001d028793","1",46498733,46499395,662
"8200","Zm00001d028796","1",46667081,46670026,2945
"8201","Zm00001d028797","1",46672702,46675540,2838
"8202","Zm00001d028801","1",46819355,46823093,3738
"8203","Zm00001d028802","1",46826505,46831989,5484
"8204","Zm00001d028803","1",46852702,46858687,5985
"8205","Zm00001d028804","1",46898667,46903474,4807
"8206","Zm00001d028806","1",46955327,46956671,1344
"8207","Zm00001d028807","1",46964052,46965897,1845
"8208","Zm00001d028808","1",47025643,47026431,788
"8209","Zm00001d028809","1",47129751,47131445,1694
"8210","Zm00001d028810","1",47141802,47151051,9249
"8211","Zm00001d028811","1",47152651,47153994,1343
"8212","Zm00001d028812","1",47211776,47217612,5836
"8213","Zm00001d028813","1",47398578,47403781,5203
"8214","Zm00001d028814","1",47417314,47418300,986
"8215","Zm00001d028815","1",47440048,47441026,978
"8216","Zm00001d028816","1",47445913,47446888,975
"8217","Zm00001d028818","1",47566046,47589502,23456
"8218","Zm00001d028819","1",47589891,47591591,1700
"8219","Zm00001d028820","1",47593455,47595021,1566
"8220","Zm00001d028823","1",47656747,47657982,1235
"8221","Zm00001d028824","1",47729285,47730406,1121
"8222","Zm00001d028825","1",47748642,47754005,5363
"8223","Zm00001d028826","1",47787874,47789877,2003
"8224","Zm00001d028827","1",47792436,47800509,8073
"8225","Zm00001d028829","1",47880745,47883443,2698
"8226","Zm00001d028830","1",47982359,47988628,6269
"8227","Zm00001d028834","1",48128232,48128960,728
"8228","Zm00001d028835","1",48144847,48146062,1215
"8229","Zm00001d028836","1",48280481,48281402,921
"8230","Zm00001d028837","1",48282040,48282929,889
"8231","Zm00001d028838","1",48287887,48288669,782
"8232","Zm00001d028839","1",48330999,48331432,433
"8233","Zm00001d028840","1",48333284,48337489,4205
"8234","Zm00001d028841","1",48337931,48338995,1064
"8235","Zm00001d028855","1",48617654,48623952,6298
"8236","Zm00001d028856","1",48625761,48627434,1673
"8237","Zm00001d028861","1",48754653,48756047,1394
"8238","Zm00001d028862","1",48853966,48855453,1487
"8239","Zm00001d028863","1",48930452,48937928,7476
"8240","Zm00001d028866","1",48956482,48959493,3011
"8241","Zm00001d028867","1",49060954,49063784,2830
"8242","Zm00001d028868","1",49087869,49093033,5164
"8243","Zm00001d028871","1",49267598,49268126,528
"8244","Zm00001d028872","1",49274472,49276941,2469
"8245","Zm00001d028873","1",49279038,49280540,1502
"8246","Zm00001d028875","1",49355748,49389986,34238
"8247","Zm00001d028880","1",49535063,49535443,380
"8248","Zm00001d028885","1",49597329,49601184,3855
"8249","Zm00001d028886","1",49605409,49606601,1192
"8250","Zm00001d028889","1",49802519,49804621,2102
"8251","Zm00001d028890","1",49809777,49823368,13591
"8252","Zm00001d028894","1",49987804,49990811,3007
"8253","Zm00001d028895","1",49992905,49996375,3470
"8254","Zm00001d028896","1",50024922,50033603,8681
"8255","Zm00001d028898","1",50140349,50144895,4546
"8256","Zm00001d028901","1",50190087,50200187,10100
"8257","Zm00001d028902","1",50201483,50230198,28715
"8258","Zm00001d028903","1",50231399,50235984,4585
"8259","Zm00001d028904","1",50355866,50360668,4802
"8260","Zm00001d028905","1",50443216,50455013,11797
"8261","Zm00001d028906","1",50505948,50506710,762
"8262","Zm00001d028907","1",50514018,50524361,10343
"8263","Zm00001d028909","1",50719302,50721399,2097
"8264","Zm00001d028910","1",50775179,50786550,11371
"8265","Zm00001d028915","1",51076671,51160417,83746
"8266","Zm00001d028916","1",51361873,51362499,626
"8267","Zm00001d028918","1",51462257,51464279,2022
"8268","Zm00001d028919","1",51465066,51470982,5916
"8269","Zm00001d028920","1",51491053,51497733,6680
"8270","Zm00001d028921","1",51589142,51593606,4464
"8271","Zm00001d028922","1",51602498,51603012,514
"8272","Zm00001d028923","1",51720934,51725330,4396
"8273","Zm00001d028924","1",51726622,51727890,1268
"8274","Zm00001d028925","1",51729487,51730402,915
"8275","Zm00001d028926","1",51754552,51764566,10014
"8276","Zm00001d028928","1",51814805,51816926,2121
"8277","Zm00001d028929","1",51817955,51820623,2668
"8278","Zm00001d028930","1",51839504,51841800,2296
"8279","Zm00001d028931","1",51977839,51979551,1712
"8280","Zm00001d028935","1",52162848,52164968,2120
"8281","Zm00001d028936","1",52167612,52173614,6002
"8282","Zm00001d028946","1",52499430,52509398,9968
"8283","Zm00001d028947","1",52515222,52517115,1893
"8284","Zm00001d028948","1",52518690,52523101,4411
"8285","Zm00001d028949","1",52582858,52587987,5129
"8286","Zm00001d028950","1",52644689,52645454,765
"8287","Zm00001d028951","1",52645733,52648243,2510
"8288","Zm00001d028952","1",52672158,52680876,8718
"8289","Zm00001d028954","1",52836664,52841244,4580
"8290","Zm00001d028955","1",52850182,52853358,3176
"8291","Zm00001d028956","1",52851926,52852000,74
"8292","Zm00001d028957","1",52860772,52861856,1084
"8293","Zm00001d028958","1",52873169,52879776,6607
"8294","Zm00001d028960","1",52938630,52945326,6696
"8295","Zm00001d028962","1",53030837,53032126,1289
"8296","Zm00001d028963","1",53142425,53144911,2486
"8297","Zm00001d028964","1",53145602,53154854,9252
"8298","Zm00001d028965","1",53169397,53176921,7524
"8299","Zm00001d028966","1",53177235,53181012,3777
"8300","Zm00001d028967","1",53183379,53188438,5059
"8301","Zm00001d028968","1",53190337,53190834,497
"8302","Zm00001d028971","1",53292747,53300706,7959
"8303","Zm00001d028972","1",53302218,53303096,878
"8304","Zm00001d028973","1",53309064,53309600,536
"8305","Zm00001d028974","1",53368438,53370381,1943
"8306","Zm00001d028975","1",53393407,53405238,11831
"8307","Zm00001d028976","1",53415528,53416657,1129
"8308","Zm00001d028977","1",53417301,53424648,7347
"8309","Zm00001d028980","1",53451859,53454849,2990
"8310","Zm00001d028981","1",53456181,53461952,5771
"8311","Zm00001d028984","1",53531029,53533986,2957
"8312","Zm00001d028986","1",53579645,53583324,3679
"8313","Zm00001d028987","1",53748822,53754082,5260
"8314","Zm00001d028988","1",53759429,53763250,3821
"8315","Zm00001d028989","1",53771917,53776759,4842
"8316","Zm00001d028992","1",53883358,53885907,2549
"8317","Zm00001d028994","1",53953064,53959267,6203
"8318","Zm00001d028995","1",54034211,54036320,2109
"8319","Zm00001d028996","1",54038696,54044869,6173
"8320","Zm00001d028998","1",54251798,54253443,1645
"8321","Zm00001d028999","1",54263185,54265683,2498
"8322","Zm00001d029004","1",54451904,54484683,32779
"8323","Zm00001d029008","1",54577150,54580933,3783
"8324","Zm00001d029009","1",54624061,54639249,15188
"8325","Zm00001d029010","1",54753176,54756798,3622
"8326","Zm00001d029011","1",54822256,54826599,4343
"8327","Zm00001d029012","1",54928187,54933748,5561
"8328","Zm00001d029014","1",54937514,54940747,3233
"8329","Zm00001d029015","1",54941440,54943661,2221
"8330","Zm00001d029020","1",55053507,55060129,6622
"8331","Zm00001d029023","1",55108882,55115021,6139
"8332","Zm00001d029025","1",55178515,55181462,2947
"8333","Zm00001d029027","1",55241838,55244510,2672
"8334","Zm00001d029028","1",55246805,55247371,566
"8335","Zm00001d029030","1",55369898,55371351,1453
"8336","Zm00001d029031","1",55371816,55378351,6535
"8337","Zm00001d029033","1",55450359,55453794,3435
"8338","Zm00001d029034","1",55454318,55483990,29672
"8339","Zm00001d029035","1",55558413,55560877,2464
"8340","Zm00001d029036","1",55560773,55565406,4633
"8341","Zm00001d029038","1",55696857,55698513,1656
"8342","Zm00001d029039","1",55700209,55704962,4753
"8343","Zm00001d029040","1",55709486,55715009,5523
"8344","Zm00001d029041","1",55779845,55785436,5591
"8345","Zm00001d029042","1",55793069,55793605,536
"8346","Zm00001d029044","1",55927611,55936044,8433
"8347","Zm00001d029045","1",55934926,55934997,71
"8348","Zm00001d029046","1",56029931,56037966,8035
"8349","Zm00001d029047","1",56040100,56042760,2660
"8350","Zm00001d029048","1",56094245,56104240,9995
"8351","Zm00001d029050","1",56107554,56110129,2575
"8352","Zm00001d029051","1",56143995,56146719,2724
"8353","Zm00001d029052","1",56147717,56148196,479
"8354","Zm00001d029053","1",56214309,56220473,6164
"8355","Zm00001d029055","1",56383258,56404978,21720
"8356","Zm00001d029056","1",56681471,56700079,18608
"8357","Zm00001d029057","1",56682667,56682740,73
"8358","Zm00001d029059","1",56743156,56747187,4031
"8359","Zm00001d029060","1",56811457,56816453,4996
"8360","Zm00001d029062","1",56855736,56858177,2441
"8361","Zm00001d029064","1",56911430,56916805,5375
"8362","Zm00001d029065","1",56919001,56921369,2368
"8363","Zm00001d029066","1",56975151,56982711,7560
"8364","Zm00001d029067","1",56999172,57000011,839
"8365","Zm00001d029072","1",57132195,57138858,6663
"8366","Zm00001d029074","1",57250815,57254236,3421
"8367","Zm00001d029075","1",57258183,57259499,1316
"8368","Zm00001d029077","1",57261612,57266206,4594
"8369","Zm00001d029078","1",57267805,57269655,1850
"8370","Zm00001d029080","1",57300175,57301834,1659
"8371","Zm00001d029083","1",57394910,57397707,2797
"8372","Zm00001d029084","1",57446546,57452595,6049
"8373","Zm00001d029087","1",57457546,57464810,7264
"8374","Zm00001d029091","1",57485976,57493258,7282
"8375","Zm00001d029093","1",57594777,57598573,3796
"8376","Zm00001d029095","1",57648248,57697308,49060
"8377","Zm00001d029096","1",57821697,57828028,6331
"8378","Zm00001d029098","1",57988733,57991597,2864
"8379","Zm00001d029100","1",58018569,58018889,320
"8380","Zm00001d029102","1",58055249,58057968,2719
"8381","Zm00001d029104","1",58176945,58182237,5292
"8382","Zm00001d029105","1",58197901,58201581,3680
"8383","Zm00001d029106","1",58272364,58278067,5703
"8384","Zm00001d029107","1",58280350,58280825,475
"8385","Zm00001d029114","1",58377787,58380792,3005
"8386","Zm00001d029118","1",58534876,58540001,5125
"8387","Zm00001d029120","1",58742447,58753879,11432
"8388","Zm00001d029121","1",58944824,58953954,9130
"8389","Zm00001d029122","1",59021967,59022404,437
"8390","Zm00001d029123","1",59023014,59027798,4784
"8391","Zm00001d029124","1",59028004,59030626,2622
"8392","Zm00001d029125","1",59070431,59071868,1437
"8393","Zm00001d029126","1",59132630,59134681,2051
"8394","Zm00001d029129","1",59406804,59421124,14320
"8395","Zm00001d029130","1",59439362,59445017,5655
"8396","Zm00001d029133","1",59759933,59786192,26259
"8397","Zm00001d029134","1",59846904,59876808,29904
"8398","Zm00001d029135","1",59948045,59951123,3078
"8399","Zm00001d029137","1",60112886,60116740,3854
"8400","Zm00001d029138","1",60182624,60186722,4098
"8401","Zm00001d029139","1",60187028,60190201,3173
"8402","Zm00001d029140","1",60225658,60228992,3334
"8403","Zm00001d029141","1",60322950,60326019,3069
"8404","Zm00001d029142","1",60327258,60337774,10516
"8405","Zm00001d029143","1",60338845,60344732,5887
"8406","Zm00001d029144","1",60427117,60431202,4085
"8407","Zm00001d029148","1",60520942,60525017,4075
"8408","Zm00001d029149","1",60531179,60535397,4218
"8409","Zm00001d029150","1",60631458,60632663,1205
"8410","Zm00001d029151","1",60743343,60747986,4643
"8411","Zm00001d029152","1",60781649,60788101,6452
"8412","Zm00001d029157","1",60838632,60844331,5699
"8413","Zm00001d029161","1",60862510,60868940,6430
"8414","Zm00001d029163","1",60869629,60871045,1416
"8415","Zm00001d029164","1",60874573,60876557,1984
"8416","Zm00001d029165","1",60879438,60888390,8952
"8417","Zm00001d029168","1",60919076,60923232,4156
"8418","Zm00001d029169","1",60926351,60927317,966
"8419","Zm00001d029170","1",60930751,60934311,3560
"8420","Zm00001d029173","1",60948835,60951140,2305
"8421","Zm00001d029174","1",60996905,60999925,3020
"8422","Zm00001d029177","1",61041496,61045956,4460
"8423","Zm00001d029179","1",61191144,61192225,1081
"8424","Zm00001d029180","1",61214711,61233546,18835
"8425","Zm00001d029184","1",61494251,61495965,1714
"8426","Zm00001d029185","1",61532067,61532456,389
"8427","Zm00001d029188","1",61566224,61570528,4304
"8428","Zm00001d029189","1",61571718,61574795,3077
"8429","Zm00001d029190","1",61638930,61642292,3362
"8430","Zm00001d029191","1",61642456,61663754,21298
"8431","Zm00001d029192","1",61646122,61648831,2709
"8432","Zm00001d029193","1",61664668,61668706,4038
"8433","Zm00001d029195","1",61777103,61783441,6338
"8434","Zm00001d029196","1",61783914,61789718,5804
"8435","Zm00001d029197","1",61898636,61901310,2674
"8436","Zm00001d029198","1",61904101,61906749,2648
"8437","Zm00001d029200","1",62026473,62031559,5086
"8438","Zm00001d029201","1",62065593,62069082,3489
"8439","Zm00001d029202","1",62213773,62214369,596
"8440","Zm00001d029203","1",62216791,62220497,3706
"8441","Zm00001d029205","1",62293811,62296945,3134
"8442","Zm00001d029206","1",62408710,62417139,8429
"8443","Zm00001d029207","1",62417036,62418643,1607
"8444","Zm00001d029208","1",62419477,62427352,7875
"8445","Zm00001d029209","1",62462278,62466731,4453
"8446","Zm00001d029211","1",62490387,62493912,3525
"8447","Zm00001d029212","1",62494272,62507307,13035
"8448","Zm00001d029214","1",62510497,62516067,5570
"8449","Zm00001d029215","1",62728602,62739088,10486
"8450","Zm00001d029216","1",62739706,62742756,3050
"8451","Zm00001d029217","1",62743193,62743990,797
"8452","Zm00001d029218","1",62747068,62748525,1457
"8453","Zm00001d029223","1",63025344,63042076,16732
"8454","Zm00001d029226","1",63127214,63131372,4158
"8455","Zm00001d029227","1",63131993,63142494,10501
"8456","Zm00001d029228","1",63142997,63153057,10060
"8457","Zm00001d029229","1",63204439,63204717,278
"8458","Zm00001d029231","1",63222181,63234373,12192
"8459","Zm00001d029233","1",63272548,63273003,455
"8460","Zm00001d029234","1",63275727,63280169,4442
"8461","Zm00001d029237","1",63318026,63324928,6902
"8462","Zm00001d029238","1",63325315,63328026,2711
"8463","Zm00001d029243","1",63574227,63576200,1973
"8464","Zm00001d029246","1",63586080,63588689,2609
"8465","Zm00001d029247","1",63590574,63593240,2666
"8466","Zm00001d029248","1",63708680,63711620,2940
"8467","Zm00001d029249","1",63744994,63752712,7718
"8468","Zm00001d029250","1",63811849,63813987,2138
"8469","Zm00001d029251","1",63834316,63858602,24286
"8470","Zm00001d029254","1",63859845,63864152,4307
"8471","Zm00001d029255","1",63865739,63867379,1640
"8472","Zm00001d029256","1",63867544,63873593,6049
"8473","Zm00001d029257","1",63916533,63917166,633
"8474","Zm00001d029258","1",63928318,63930254,1936
"8475","Zm00001d029260","1",63980014,63987394,7380
"8476","Zm00001d029262","1",63994352,63994867,515
"8477","Zm00001d029263","1",64042656,64045687,3031
"8478","Zm00001d029264","1",64207240,64216522,9282
"8479","Zm00001d029266","1",64354033,64357203,3170
"8480","Zm00001d029269","1",64402662,64402988,326
"8481","Zm00001d029270","1",64404103,64407052,2949
"8482","Zm00001d029272","1",64438231,64479765,41534
"8483","Zm00001d029281","1",64728727,64735149,6422
"8484","Zm00001d029283","1",64766283,64766363,80
"8485","Zm00001d029285","1",64841576,64846984,5408
"8486","Zm00001d029286","1",64849409,64853265,3856
"8487","Zm00001d029287","1",64853687,64854838,1151
"8488","Zm00001d029288","1",64856366,64858852,2486
"8489","Zm00001d029289","1",64917056,64919569,2513
"8490","Zm00001d029290","1",64986056,64988212,2156
"8491","Zm00001d029293","1",65078005,65079230,1225
"8492","Zm00001d029297","1",65308658,65317095,8437
"8493","Zm00001d029300","1",65439370,65443562,4192
"8494","Zm00001d029303","1",65496452,65501448,4996
"8495","Zm00001d029307","1",65560691,65565363,4672
"8496","Zm00001d029314","1",65618909,65621774,2865
"8497","Zm00001d029324","1",65941276,65945017,3741
"8498","Zm00001d029325","1",65991013,65992879,1866
"8499","Zm00001d029328","1",66120056,66126500,6444
"8500","Zm00001d029329","1",66242685,66248638,5953
"8501","Zm00001d029330","1",66249983,66251264,1281
"8502","Zm00001d029331","1",66251597,66255370,3773
"8503","Zm00001d029333","1",66318625,66337105,18480
"8504","Zm00001d029336","1",66388200,66393060,4860
"8505","Zm00001d029337","1",66484843,66507855,23012
"8506","Zm00001d029339","1",66569893,66572838,2945
"8507","Zm00001d029340","1",66592542,66594846,2304
"8508","Zm00001d029341","1",66635784,66637299,1515
"8509","Zm00001d029342","1",66637359,66648456,11097
"8510","Zm00001d029343","1",66648726,66655094,6368
"8511","Zm00001d029352","1",67038607,67043886,5279
"8512","Zm00001d029356","1",67228813,67231314,2501
"8513","Zm00001d029357","1",67296852,67298387,1535
"8514","Zm00001d029359","1",67311965,67314047,2082
"8515","Zm00001d029361","1",67435966,67442277,6311
"8516","Zm00001d029365","1",67595337,67598412,3075
"8517","Zm00001d029366","1",67604993,67609141,4148
"8518","Zm00001d029371","1",67927389,67929661,2272
"8519","Zm00001d029372","1",67961562,67965995,4433
"8520","Zm00001d029373","1",67969019,67973213,4194
"8521","Zm00001d029374","1",67973762,67976455,2693
"8522","Zm00001d029375","1",68088360,68098674,10314
"8523","Zm00001d029376","1",68217683,68221562,3879
"8524","Zm00001d029377","1",68224611,68226753,2142
"8525","Zm00001d029378","1",68244474,68250776,6302
"8526","Zm00001d029380","1",68392423,68396629,4206
"8527","Zm00001d029383","1",68460719,68463139,2420
"8528","Zm00001d029385","1",68534055,68537475,3420
"8529","Zm00001d029386","1",68537971,68540134,2163
"8530","Zm00001d029389","1",68587963,68589883,1920
"8531","Zm00001d029390","1",68592325,68597747,5422
"8532","Zm00001d029391","1",68665582,68667909,2327
"8533","Zm00001d029392","1",68668722,68675980,7258
"8534","Zm00001d029393","1",68678959,68683422,4463
"8535","Zm00001d029394","1",68805980,68808399,2419
"8536","Zm00001d029395","1",68809509,68810660,1151
"8537","Zm00001d029396","1",68890355,68892811,2456
"8538","Zm00001d029397","1",68934359,68938239,3880
"8539","Zm00001d029400","1",69009947,69012985,3038
"8540","Zm00001d029402","1",69015049,69017291,2242
"8541","Zm00001d029407","1",69168608,69171384,2776
"8542","Zm00001d029408","1",69295860,69299198,3338
"8543","Zm00001d029409","1",69302141,69303331,1190
"8544","Zm00001d029410","1",69320905,69324756,3851
"8545","Zm00001d029415","1",69604756,69609617,4861
"8546","Zm00001d029416","1",69619304,69624861,5557
"8547","Zm00001d029417","1",69624781,69628628,3847
"8548","Zm00001d029418","1",69732293,69734824,2531
"8549","Zm00001d029419","1",69743529,69747782,4253
"8550","Zm00001d029420","1",69749777,69753725,3948
"8551","Zm00001d029422","1",69844292,69855894,11602
"8552","Zm00001d029424","1",69909438,69910768,1330
"8553","Zm00001d029425","1",69918378,69918448,70
"8554","Zm00001d029426","1",70063291,70069406,6115
"8555","Zm00001d029427","1",70117826,70118962,1136
"8556","Zm00001d029428","1",70124289,70126529,2240
"8557","Zm00001d029429","1",70211480,70219160,7680
"8558","Zm00001d029430","1",70218082,70218153,71
"8559","Zm00001d029431","1",70220796,70221773,977
"8560","Zm00001d029432","1",70227975,70231727,3752
"8561","Zm00001d029435","1",70296564,70298312,1748
"8562","Zm00001d029437","1",70442356,70448204,5848
"8563","Zm00001d029438","1",70501931,70502683,752
"8564","Zm00001d029442","1",70784191,70785951,1760
"8565","Zm00001d029443","1",70817727,70829834,12107
"8566","Zm00001d029446","1",70972486,70974851,2365
"8567","Zm00001d029447","1",71155736,71156329,593
"8568","Zm00001d029448","1",71161670,71164215,2545
"8569","Zm00001d029454","1",71428751,71437172,8421
"8570","Zm00001d029455","1",71518886,71523950,5064
"8571","Zm00001d029457","1",71670964,71675538,4574
"8572","Zm00001d029459","1",71770258,71773654,3396
"8573","Zm00001d029460","1",71820234,71820986,752
"8574","Zm00001d029461","1",71830422,71834236,3814
"8575","Zm00001d029462","1",71833704,71849570,15866
"8576","Zm00001d029464","1",71981682,71987438,5756
"8577","Zm00001d029466","1",72004069,72004902,833
"8578","Zm00001d029467","1",72008124,72009552,1428
"8579","Zm00001d029468","1",72028770,72032820,4050
"8580","Zm00001d029473","1",72294486,72300404,5918
"8581","Zm00001d029474","1",72302363,72303943,1580
"8582","Zm00001d029475","1",72345031,72345957,926
"8583","Zm00001d029476","1",72405711,72410458,4747
"8584","Zm00001d029478","1",72423918,72427230,3312
"8585","Zm00001d029482","1",72598357,72602773,4416
"8586","Zm00001d029483","1",72602928,72605955,3027
"8587","Zm00001d029486","1",72780661,72786980,6319
"8588","Zm00001d029487","1",72828318,72836027,7709
"8589","Zm00001d029488","1",72870584,72874612,4028
"8590","Zm00001d029489","1",72880539,72887083,6544
"8591","Zm00001d029490","1",72889642,72909600,19958
"8592","Zm00001d029495","1",73080404,73081606,1202
"8593","Zm00001d029497","1",73243641,73246778,3137
"8594","Zm00001d029498","1",73364611,73369802,5191
"8595","Zm00001d029499","1",73370780,73373210,2430
"8596","Zm00001d029504","1",73565439,73575651,10212
"8597","Zm00001d029505","1",73576189,73576857,668
"8598","Zm00001d029506","1",73706673,73707614,941
"8599","Zm00001d029507","1",73753509,73757673,4164
"8600","Zm00001d029508","1",73763001,73764221,1220
"8601","Zm00001d029511","1",73861756,73865273,3517
"8602","Zm00001d029512","1",73971569,73973965,2396
"8603","Zm00001d029515","1",74095473,74102001,6528
"8604","Zm00001d029516","1",74158653,74164282,5629
"8605","Zm00001d029519","1",74249436,74251275,1839
"8606","Zm00001d029524","1",74639062,74640102,1040
"8607","Zm00001d029525","1",74653797,74658730,4933
"8608","Zm00001d029526","1",74783210,74785241,2031
"8609","Zm00001d029527","1",74787607,74790957,3350
"8610","Zm00001d029529","1",74918081,74921222,3141
"8611","Zm00001d029530","1",75041778,75049211,7433
"8612","Zm00001d029531","1",75094561,75101160,6599
"8613","Zm00001d029534","1",75283292,75289737,6445
"8614","Zm00001d029538","1",75324026,75324829,803
"8615","Zm00001d029539","1",75377980,75379495,1515
"8616","Zm00001d029540","1",75404341,75406495,2154
"8617","Zm00001d029542","1",75636490,75642893,6403
"8618","Zm00001d029543","1",75646209,75648062,1853
"8619","Zm00001d029544","1",75649423,75659170,9747
"8620","Zm00001d029545","1",75662193,75664203,2010
"8621","Zm00001d029548","1",75699185,75711640,12455
"8622","Zm00001d029550","1",75797114,75806603,9489
"8623","Zm00001d029552","1",75899277,75902405,3128
"8624","Zm00001d029553","1",75904497,75905537,1040
"8625","Zm00001d029555","1",76050551,76055119,4568
"8626","Zm00001d029557","1",76065155,76078721,13566
"8627","Zm00001d029559","1",76180529,76181281,752
"8628","Zm00001d029560","1",76209755,76212824,3069
"8629","Zm00001d029561","1",76215206,76224302,9096
"8630","Zm00001d029562","1",76238126,76238812,686
"8631","Zm00001d029563","1",76518613,76526416,7803
"8632","Zm00001d029564","1",76584638,76589606,4968
"8633","Zm00001d029566","1",76607988,76612585,4597
"8634","Zm00001d029567","1",76613896,76617755,3859
"8635","Zm00001d029569","1",76738648,76741308,2660
"8636","Zm00001d029570","1",76771828,76773600,1772
"8637","Zm00001d029571","1",76848049,76858595,10546
"8638","Zm00001d029572","1",76869097,76877072,7975
"8639","Zm00001d029573","1",77065338,77070098,4760
"8640","Zm00001d029575","1",77122775,77123626,851
"8641","Zm00001d029576","1",77168840,77175146,6306
"8642","Zm00001d029577","1",77398644,77401233,2589
"8643","Zm00001d029578","1",77449634,77455875,6241
"8644","Zm00001d029579","1",77559841,77561051,1210
"8645","Zm00001d029580","1",77668566,77669771,1205
"8646","Zm00001d029582","1",77813906,77815328,1422
"8647","Zm00001d029583","1",77839833,77840687,854
"8648","Zm00001d029590","1",78107028,78113337,6309
"8649","Zm00001d029594","1",78239819,78241044,1225
"8650","Zm00001d029595","1",78348953,78351415,2462
"8651","Zm00001d029597","1",78379499,78391111,11612
"8652","Zm00001d029598","1",78391061,78405511,14450
"8653","Zm00001d029599","1",78539089,78540472,1383
"8654","Zm00001d029601","1",78654675,78656117,1442
"8655","Zm00001d029603","1",78752783,78763899,11116
"8656","Zm00001d029604","1",78770081,78773320,3239
"8657","Zm00001d029605","1",78863290,78866016,2726
"8658","Zm00001d029606","1",78909786,78911160,1374
"8659","Zm00001d029607","1",79004272,79006164,1892
"8660","Zm00001d029608","1",79094881,79118107,23226
"8661","Zm00001d029611","1",79333091,79336790,3699
"8662","Zm00001d029613","1",79506307,79508357,2050
"8663","Zm00001d029618","1",79829911,79830843,932
"8664","Zm00001d029620","1",79984693,79986558,1865
"8665","Zm00001d029625","1",80178770,80181075,2305
"8666","Zm00001d029626","1",80234015,80259023,25008
"8667","Zm00001d029627","1",80555017,80559987,4970
"8668","Zm00001d029628","1",80600855,80601549,694
"8669","Zm00001d029629","1",80604100,80609775,5675
"8670","Zm00001d029630","1",80665246,80665596,350
"8671","Zm00001d029631","1",80672733,80673116,383
"8672","Zm00001d029632","1",80760581,80766373,5792
"8673","Zm00001d029636","1",80857354,80859952,2598
"8674","Zm00001d029637","1",80861686,80862310,624
"8675","Zm00001d029639","1",80882357,80882949,592
"8676","Zm00001d029640","1",80886197,80899164,12967
"8677","Zm00001d029643","1",80923614,80925142,1528
"8678","Zm00001d029644","1",80924894,80926549,1655
"8679","Zm00001d029646","1",80963908,80970474,6566
"8680","Zm00001d029647","1",80970556,80976208,5652
"8681","Zm00001d029648","1",81308232,81312047,3815
"8682","Zm00001d029649","1",81312293,81321165,8872
"8683","Zm00001d029650","1",81321642,81337174,15532
"8684","Zm00001d029651","1",81338597,81343775,5178
"8685","Zm00001d029652","1",81357683,81361453,3770
"8686","Zm00001d029653","1",81455004,81458989,3985
"8687","Zm00001d029654","1",81612748,81617458,4710
"8688","Zm00001d029656","1",81672414,81676391,3977
"8689","Zm00001d029657","1",81675775,81704357,28582
"8690","Zm00001d029658","1",81677345,81678423,1078
"8691","Zm00001d029662","1",81793904,81795995,2091
"8692","Zm00001d029663","1",81796157,81800824,4667
"8693","Zm00001d029664","1",81803033,81807676,4643
"8694","Zm00001d029672","1",82097005,82099710,2705
"8695","Zm00001d029673","1",82101246,82103796,2550
"8696","Zm00001d029674","1",82234517,82237350,2833
"8697","Zm00001d029675","1",82273478,82278371,4893
"8698","Zm00001d029676","1",82279259,82279444,185
"8699","Zm00001d029680","1",82523781,82527259,3478
"8700","Zm00001d029684","1",82569590,82575849,6259
"8701","Zm00001d029686","1",82711001,82713262,2261
"8702","Zm00001d029688","1",82827141,82831219,4078
"8703","Zm00001d029693","1",82889295,82890302,1007
"8704","Zm00001d029696","1",82924832,82926012,1180
"8705","Zm00001d029697","1",83036895,83045156,8261
"8706","Zm00001d029699","1",83058555,83059659,1104
"8707","Zm00001d029704","1",83198362,83199180,818
"8708","Zm00001d029705","1",83199590,83208877,9287
"8709","Zm00001d029706","1",83226938,83228043,1105
"8710","Zm00001d029707","1",83264283,83265235,952
"8711","Zm00001d029708","1",83411025,83411720,695
"8712","Zm00001d029710","1",83500401,83501877,1476
"8713","Zm00001d029711","1",83544940,83547374,2434
"8714","Zm00001d029714","1",83647801,83656803,9002
"8715","Zm00001d029715","1",83658962,83662343,3381
"8716","Zm00001d029716","1",83791692,83792855,1163
"8717","Zm00001d029717","1",83804679,83805639,960
"8718","Zm00001d029719","1",84025755,84035792,10037
"8719","Zm00001d029720","1",84035920,84036564,644
"8720","Zm00001d029721","1",84037187,84040069,2882
"8721","Zm00001d029722","1",84139123,84145156,6033
"8722","Zm00001d029723","1",84157846,84158853,1007
"8723","Zm00001d029725","1",84224821,84227369,2548
"8724","Zm00001d029726","1",84228888,84232398,3510
"8725","Zm00001d029729","1",84332806,84333761,955
"8726","Zm00001d029733","1",84357815,84359846,2031
"8727","Zm00001d029738","1",84664818,84666506,1688
"8728","Zm00001d029740","1",84849115,84851294,2179
"8729","Zm00001d029741","1",84866141,84867131,990
"8730","Zm00001d029742","1",84992627,84993265,638
"8731","Zm00001d029743","1",84994689,84996769,2080
"8732","Zm00001d029744","1",85068069,85072051,3982
"8733","Zm00001d029745","1",85097979,85099597,1618
"8734","Zm00001d029747","1",85172704,85174464,1760
"8735","Zm00001d029749","1",85320646,85321467,821
"8736","Zm00001d029750","1",85465506,85472221,6715
"8737","Zm00001d029752","1",85474834,85477147,2313
"8738","Zm00001d029753","1",85506043,85509564,3521
"8739","Zm00001d029754","1",85552331,85560838,8507
"8740","Zm00001d029755","1",85773606,85775424,1818
"8741","Zm00001d029756","1",85778009,85779548,1539
"8742","Zm00001d029757","1",85781466,85782473,1007
"8743","Zm00001d029758","1",86001408,86007071,5663
"8744","Zm00001d029760","1",86031012,86032992,1980
"8745","Zm00001d029761","1",86062903,86065425,2522
"8746","Zm00001d029762","1",86130014,86134531,4517
"8747","Zm00001d029763","1",86136740,86137516,776
"8748","Zm00001d029764","1",86152046,86157931,5885
"8749","Zm00001d029768","1",86261116,86266872,5756
"8750","Zm00001d029771","1",86329863,86331329,1466
"8751","Zm00001d029772","1",86352222,86355516,3294
"8752","Zm00001d029773","1",86389151,86389666,515
"8753","Zm00001d029775","1",86455254,86455759,505
"8754","Zm00001d029777","1",86480374,86481381,1007
"8755","Zm00001d029778","1",86529694,86530424,730
"8756","Zm00001d029782","1",86636234,86641408,5174
"8757","Zm00001d029783","1",86734087,86736135,2048
"8758","Zm00001d029784","1",86745009,86745950,941
"8759","Zm00001d029785","1",86770300,86776371,6071
"8760","Zm00001d029787","1",86784260,86785341,1081
"8761","Zm00001d029794","1",87314979,87316146,1167
"8762","Zm00001d029797","1",87442443,87443667,1224
"8763","Zm00001d029801","1",87469723,87475392,5669
"8764","Zm00001d029802","1",87532164,87532547,383
"8765","Zm00001d029803","1",87586799,87591619,4820
"8766","Zm00001d029804","1",87657945,87662786,4841
"8767","Zm00001d029806","1",87745831,87748178,2347
"8768","Zm00001d029808","1",87835101,87838643,3542
"8769","Zm00001d029809","1",87838311,87841671,3360
"8770","Zm00001d029810","1",88015144,88023582,8438
"8771","Zm00001d029811","1",88024924,88032862,7938
"8772","Zm00001d029815","1",88272871,88273650,779
"8773","Zm00001d029818","1",88440568,88462988,22420
"8774","Zm00001d029820","1",88468178,88468588,410
"8775","Zm00001d029822","1",88696531,88703297,6766
"8776","Zm00001d029823","1",88801806,88802468,662
"8777","Zm00001d029826","1",89004569,89011482,6913
"8778","Zm00001d029827","1",89015335,89016583,1248
"8779","Zm00001d029828","1",89043977,89045196,1219
"8780","Zm00001d029829","1",89157703,89163658,5955
"8781","Zm00001d029832","1",89260097,89271027,10930
"8782","Zm00001d029833","1",89356091,89363713,7622
"8783","Zm00001d029834","1",89472879,89473774,895
"8784","Zm00001d029839","1",89562549,89567492,4943
"8785","Zm00001d029840","1",89587618,89589865,2247
"8786","Zm00001d029842","1",89643144,89645830,2686
"8787","Zm00001d029846","1",89860313,89863306,2993
"8788","Zm00001d029847","1",89925889,89928127,2238
"8789","Zm00001d029848","1",89930073,89935999,5926
"8790","Zm00001d029849","1",89947372,89952516,5144
"8791","Zm00001d029850","1",89958471,89961843,3372
"8792","Zm00001d029851","1",90087215,90088432,1217
"8793","Zm00001d029852","1",90292761,90297408,4647
"8794","Zm00001d029853","1",90315517,90318180,2663
"8795","Zm00001d029855","1",90443929,90445866,1937
"8796","Zm00001d029856","1",90494694,90507232,12538
"8797","Zm00001d029858","1",90524506,90524934,428
"8798","Zm00001d029859","1",90820008,90820409,401
"8799","Zm00001d029860","1",90857432,90869865,12433
"8800","Zm00001d029861","1",90928628,90936923,8295
"8801","Zm00001d029862","1",90963400,90964767,1367
"8802","Zm00001d029863","1",90965218,90965288,70
"8803","Zm00001d029864","1",90965548,90965618,70
"8804","Zm00001d029865","1",90965701,90968044,2343
"8805","Zm00001d029868","1",91135733,91139783,4050
"8806","Zm00001d029872","1",91251568,91258234,6666
"8807","Zm00001d029875","1",91421593,91425126,3533
"8808","Zm00001d029878","1",91625270,91627450,2180
"8809","Zm00001d029879","1",91814773,91819708,4935
"8810","Zm00001d029881","1",91831167,91832237,1070
"8811","Zm00001d029883","1",91987577,91988973,1396
"8812","Zm00001d029884","1",91990667,91991467,800
"8813","Zm00001d029886","1",92222078,92224093,2015
"8814","Zm00001d029887","1",92228035,92232678,4643
"8815","Zm00001d029888","1",92327821,92333275,5454
"8816","Zm00001d029889","1",92552607,92564979,12372
"8817","Zm00001d029891","1",92682108,92682713,605
"8818","Zm00001d029895","1",92848119,92851941,3822
"8819","Zm00001d029896","1",92897029,92898887,1858
"8820","Zm00001d029899","1",93193094,93195786,2692
"8821","Zm00001d029901","1",93282552,93286175,3623
"8822","Zm00001d029903","1",93424792,93426256,1464
"8823","Zm00001d029906","1",93520069,93521826,1757
"8824","Zm00001d029909","1",93696265,93701038,4773
"8825","Zm00001d029910","1",93744451,93750150,5699
"8826","Zm00001d029913","1",93847218,93848525,1307
"8827","Zm00001d029916","1",94180761,94183368,2607
"8828","Zm00001d029917","1",94202204,94203229,1025
"8829","Zm00001d029918","1",94336239,94343520,7281
"8830","Zm00001d029919","1",94344537,94348781,4244
"8831","Zm00001d029920","1",94346625,94349899,3274
"8832","Zm00001d029921","1",94473957,94476161,2204
"8833","Zm00001d029922","1",94478791,94481263,2472
"8834","Zm00001d029923","1",94574574,94575251,677
"8835","Zm00001d029924","1",94651061,94653582,2521
"8836","Zm00001d029929","1",94856063,94858803,2740
"8837","Zm00001d029931","1",94938570,94939328,758
"8838","Zm00001d029932","1",94940936,94945167,4231
"8839","Zm00001d029934","1",95220121,95221774,1653
"8840","Zm00001d029937","1",95421201,95422724,1523
"8841","Zm00001d029938","1",95642045,95656709,14664
"8842","Zm00001d029946","1",95962495,95966999,4504
"8843","Zm00001d029948","1",96084382,96087383,3001
"8844","Zm00001d029950","1",96145951,96147477,1526
"8845","Zm00001d029963","1",96573408,96575415,2007
"8846","Zm00001d029964","1",96639688,96641941,2253
"8847","Zm00001d029965","1",96701518,96704228,2710
"8848","Zm00001d029966","1",96702497,96702578,81
"8849","Zm00001d029968","1",96900888,96902992,2104
"8850","Zm00001d029969","1",96905186,96905818,632
"8851","Zm00001d029970","1",97044621,97046748,2127
"8852","Zm00001d029972","1",97092721,97097566,4845
"8853","Zm00001d029973","1",97097237,97100691,3454
"8854","Zm00001d029974","1",97104476,97105441,965
"8855","Zm00001d029975","1",97112730,97116269,3539
"8856","Zm00001d029976","1",97209569,97214377,4808
"8857","Zm00001d029978","1",97311624,97317291,5667
"8858","Zm00001d029979","1",97322758,97327037,4279
"8859","Zm00001d029980","1",97331766,97337093,5327
"8860","Zm00001d029983","1",97416254,97419693,3439
"8861","Zm00001d029987","1",97698097,97698974,877
"8862","Zm00001d029988","1",97704275,97706222,1947
"8863","Zm00001d029991","1",97887934,97889041,1107
"8864","Zm00001d029992","1",97989715,98012316,22601
"8865","Zm00001d029997","1",98382117,98384521,2404
"8866","Zm00001d029999","1",98390539,98392128,1589
"8867","Zm00001d030005","1",98585427,98594780,9353
"8868","Zm00001d030006","1",98793288,98794243,955
"8869","Zm00001d030007","1",98891019,98893883,2864
"8870","Zm00001d030008","1",98939104,98942980,3876
"8871","Zm00001d030009","1",98960515,98962408,1893
"8872","Zm00001d030010","1",98966769,98969288,2519
"8873","Zm00001d030011","1",99113829,99118558,4729
"8874","Zm00001d030012","1",99314880,99319254,4374
"8875","Zm00001d030014","1",99420958,99424537,3579
"8876","Zm00001d030016","1",99772449,99776664,4215
"8877","Zm00001d030018","1",99937288,99940239,2951
"8878","Zm00001d030019","1",99940331,99944552,4221
"8879","Zm00001d030020","1",99945344,99950682,5338
"8880","Zm00001d030021","1",100085601,100090561,4960
"8881","Zm00001d030023","1",100385980,100387952,1972
"8882","Zm00001d030026","1",100613958,100647262,33304
"8883","Zm00001d030028","1",100650752,100652869,2117
"8884","Zm00001d030030","1",100657980,100662543,4563
"8885","Zm00001d030031","1",100836103,100840993,4890
"8886","Zm00001d030032","1",101087719,101089690,1971
"8887","Zm00001d030034","1",101177296,101179297,2001
"8888","Zm00001d030037","1",101375207,101379033,3826
"8889","Zm00001d030038","1",101381149,101382079,930
"8890","Zm00001d030040","1",101466317,101468065,1748
"8891","Zm00001d030045","1",101898451,101899089,638
"8892","Zm00001d030046","1",101996063,102012658,16595
"8893","Zm00001d030048","1",102060297,102063588,3291
"8894","Zm00001d030051","1",102215687,102221905,6218
"8895","Zm00001d030053","1",102359351,102363384,4033
"8896","Zm00001d030055","1",102366092,102372405,6313
"8897","Zm00001d030061","1",102710038,102723105,13067
"8898","Zm00001d030062","1",102953025,102967621,14596
"8899","Zm00001d030063","1",102955110,102957336,2226
"8900","Zm00001d030068","1",103202199,103204660,2461
"8901","Zm00001d030069","1",103280320,103286276,5956
"8902","Zm00001d030073","1",103631545,103632715,1170
"8903","Zm00001d030074","1",103634381,103637965,3584
"8904","Zm00001d030077","1",104096505,104097569,1064
"8905","Zm00001d030079","1",104118705,104119586,881
"8906","Zm00001d030080","1",104119711,104120879,1168
"8907","Zm00001d030083","1",104172633,104173661,1028
"8908","Zm00001d030086","1",104416569,104417982,1413
"8909","Zm00001d030087","1",104669720,104674047,4327
"8910","Zm00001d030090","1",104849146,104852816,3670
"8911","Zm00001d030091","1",105035216,105041237,6021
"8912","Zm00001d030094","1",105181711,105186026,4315
"8913","Zm00001d030096","1",105529115,105532226,3111
"8914","Zm00001d030098","1",105553409,105554335,926
"8915","Zm00001d030099","1",105647014,105648033,1019
"8916","Zm00001d030101","1",105700155,105702010,1855
"8917","Zm00001d030102","1",105807559,105812770,5211
"8918","Zm00001d030103","1",105862947,105867700,4753
"8919","Zm00001d030105","1",105944592,105948305,3713
"8920","Zm00001d030106","1",106122816,106129515,6699
"8921","Zm00001d030108","1",106180425,106186974,6549
"8922","Zm00001d030109","1",106376178,106378884,2706
"8923","Zm00001d030110","1",106378899,106383615,4716
"8924","Zm00001d030114","1",106840123,106842310,2187
"8925","Zm00001d030116","1",107042927,107056687,13760
"8926","Zm00001d030117","1",107088822,107096192,7370
"8927","Zm00001d030121","1",107181209,107185354,4145
"8928","Zm00001d030123","1",107336969,107338846,1877
"8929","Zm00001d030126","1",107682051,107686329,4278
"8930","Zm00001d030127","1",107762967,107765646,2679
"8931","Zm00001d030129","1",107865921,107867117,1196
"8932","Zm00001d030130","1",107993630,108004988,11358
"8933","Zm00001d030131","1",108193722,108197646,3924
"8934","Zm00001d030132","1",108199942,108209147,9205
"8935","Zm00001d030133","1",108282883,108288994,6111
"8936","Zm00001d030134","1",108360901,108369330,8429
"8937","Zm00001d030138","1",108425304,108427389,2085
"8938","Zm00001d030143","1",108592134,108595742,3608
"8939","Zm00001d030146","1",108663640,108666094,2454
"8940","Zm00001d030148","1",108714459,108717659,3200
"8941","Zm00001d030149","1",108717575,108726921,9346
"8942","Zm00001d030150","1",108954398,108954927,529
"8943","Zm00001d030152","1",109046445,109047845,1400
"8944","Zm00001d030153","1",109048438,109048917,479
"8945","Zm00001d030154","1",109218162,109224977,6815
"8946","Zm00001d030155","1",109359801,109361667,1866
"8947","Zm00001d030157","1",109410589,109413669,3080
"8948","Zm00001d030158","1",109418604,109421962,3358
"8949","Zm00001d030159","1",109469384,109473198,3814
"8950","Zm00001d030161","1",109710093,109710714,621
"8951","Zm00001d030163","1",109742559,109745194,2635
"8952","Zm00001d030164","1",109844576,109871086,26510
"8953","Zm00001d030165","1",109910640,109911650,1010
"8954","Zm00001d030166","1",110002061,110007926,5865
"8955","Zm00001d030167","1",110010761,110013627,2866
"8956","Zm00001d030171","1",110297474,110299921,2447
"8957","Zm00001d030172","1",110342608,110348109,5501
"8958","Zm00001d030173","1",110378372,110389224,10852
"8959","Zm00001d030179","1",110823196,110824905,1709
"8960","Zm00001d030181","1",111081054,111082160,1106
"8961","Zm00001d030183","1",111117544,111123936,6392
"8962","Zm00001d030184","1",111872707,111923924,51217
"8963","Zm00001d030185","1",111904156,111905818,1662
"8964","Zm00001d030191","1",112125984,112127811,1827
"8965","Zm00001d030193","1",112389810,112390904,1094
"8966","Zm00001d030194","1",112579258,112586085,6827
"8967","Zm00001d030198","1",112883089,112885224,2135
"8968","Zm00001d030199","1",112977908,112980275,2367
"8969","Zm00001d030207","1",113121805,113124364,2559
"8970","Zm00001d030212","1",113399321,113402153,2832
"8971","Zm00001d030213","1",113434606,113438057,3451
"8972","Zm00001d030214","1",113477268,113478896,1628
"8973","Zm00001d030216","1",113613327,113617911,4584
"8974","Zm00001d030217","1",113696772,113712522,15750
"8975","Zm00001d030220","1",113769645,113772634,2989
"8976","Zm00001d030222","1",114052702,114073743,21041
"8977","Zm00001d030223","1",114094770,114096277,1507
"8978","Zm00001d030230","1",114671981,114679939,7958
"8979","Zm00001d030231","1",114871271,114880505,9234
"8980","Zm00001d030234","1",115148363,115150637,2274
"8981","Zm00001d030235","1",115181093,115183515,2422
"8982","Zm00001d030236","1",115306970,115307682,712
"8983","Zm00001d030239","1",115448353,115461162,12809
"8984","Zm00001d030250","1",116773992,116777183,3191
"8985","Zm00001d030253","1",116931237,116932947,1710
"8986","Zm00001d030255","1",116942840,116943186,346
"8987","Zm00001d030256","1",117002474,117006192,3718
"8988","Zm00001d030261","1",117216448,117216960,512
"8989","Zm00001d030262","1",117245700,117246281,581
"8990","Zm00001d030264","1",117368825,117372541,3716
"8991","Zm00001d030266","1",117619933,117695083,75150
"8992","Zm00001d030267","1",117873517,117874098,581
"8993","Zm00001d030270","1",118102744,118125713,22969
"8994","Zm00001d030277","1",118415047,118417551,2504
"8995","Zm00001d030280","1",118773039,118775628,2589
"8996","Zm00001d030282","1",118828597,118879142,50545
"8997","Zm00001d030285","1",119480815,119493835,13020
"8998","Zm00001d030290","1",119840788,119847803,7015
"8999","Zm00001d030295","1",120059292,120060691,1399
"9000","Zm00001d030299","1",120673742,120686381,12639
"9001","Zm00001d030300","1",120740105,120741735,1630
"9002","Zm00001d030301","1",120802390,120812980,10590
"9003","Zm00001d030303","1",121005848,121008389,2541
"9004","Zm00001d030304","1",121172256,121174236,1980
"9005","Zm00001d030305","1",121211811,121213196,1385
"9006","Zm00001d030306","1",121223566,121228452,4886
"9007","Zm00001d030308","1",121352960,121354912,1952
"9008","Zm00001d030310","1",121458401,121462310,3909
"9009","Zm00001d030312","1",121800630,121814864,14234
"9010","Zm00001d030314","1",121820597,121821836,1239
"9011","Zm00001d030316","1",122018879,122020803,1924
"9012","Zm00001d030323","1",122199005,122202892,3887
"9013","Zm00001d030328","1",122695681,122697988,2307
"9014","Zm00001d030329","1",122753347,122753682,335
"9015","Zm00001d030330","1",122754466,122756273,1807
"9016","Zm00001d030338","1",123276181,123277143,962
"9017","Zm00001d030339","1",123359112,123359663,551
"9018","Zm00001d030340","1",123383744,123433372,49628
"9019","Zm00001d030341","1",123440640,123463706,23066
"9020","Zm00001d030342","1",123464937,123467804,2867
"9021","Zm00001d030345","1",123930193,123931383,1190
"9022","Zm00001d030346","1",124047279,124048368,1089
"9023","Zm00001d030347","1",124329795,124347302,17507
"9024","Zm00001d030348","1",124401613,124405459,3846
"9025","Zm00001d030357","1",125658990,125678568,19578
"9026","Zm00001d030358","1",125671539,125671610,71
"9027","Zm00001d030362","1",126245362,126246229,867
"9028","Zm00001d030363","1",126440825,126441344,519
"9029","Zm00001d030364","1",126597854,126599207,1353
"9030","Zm00001d030366","1",126625958,126667073,41115
"9031","Zm00001d030368","1",126765557,126768033,2476
"9032","Zm00001d030370","1",126797519,126800598,3079
"9033","Zm00001d030372","1",126990768,126997787,7019
"9034","Zm00001d030373","1",127221590,127227817,6227
"9035","Zm00001d030376","1",127344674,127353195,8521
"9036","Zm00001d030379","1",127537249,127540620,3371
"9037","Zm00001d030380","1",127549696,127552596,2900
"9038","Zm00001d030381","1",127553498,127556739,3241
"9039","Zm00001d030385","1",127955212,127967875,12663
"9040","Zm00001d030395","1",129144257,129145763,1506
"9041","Zm00001d030398","1",129227423,129274590,47167
"9042","Zm00001d030401","1",129739491,129741365,1874
"9043","Zm00001d030402","1",129889303,129891523,2220
"9044","Zm00001d030406","1",130029430,130045459,16029
"9045","Zm00001d030407","1",130108807,130109525,718
"9046","Zm00001d030408","1",130193509,130194335,826
"9047","Zm00001d030409","1",130328301,130345471,17170
"9048","Zm00001d030411","1",130366507,130366881,374
"9049","Zm00001d030412","1",130367380,130370495,3115
"9050","Zm00001d030419","1",131264267,131265717,1450
"9051","Zm00001d030420","1",131268161,131269577,1416
"9052","Zm00001d030421","1",131281887,131300922,19035
"9053","Zm00001d030422","1",131287609,131288720,1111
"9054","Zm00001d030426","1",131875688,131877322,1634
"9055","Zm00001d030446","1",133177172,133177684,512
"9056","Zm00001d030453","1",133432270,133433048,778
"9057","Zm00001d030461","1",134045735,134045808,73
"9058","Zm00001d030470","1",135199904,135200188,284
"9059","Zm00001d030471","1",135204206,135245514,41308
"9060","Zm00001d030479","1",136610641,136612155,1514
"9061","Zm00001d030494","1",137947283,137948557,1274
"9062","Zm00001d030496","1",138703292,138711961,8669
"9063","Zm00001d030498","1",139331871,139332113,242
"9064","Zm00001d030500","1",139651718,139653346,1628
"9065","Zm00001d030501","1",139697429,139699434,2005
"9066","Zm00001d030502","1",139699065,139701480,2415
"9067","Zm00001d030506","1",140052049,140055625,3576
"9068","Zm00001d030508","1",140235550,140243657,8107
"9069","Zm00001d030509","1",140364656,140376186,11530
"9070","Zm00001d030512","1",140623586,140623664,78
"9071","Zm00001d030515","1",140799885,140800758,873
"9072","Zm00001d030516","1",140848955,140851172,2217
"9073","Zm00001d030518","1",140875083,140886542,11459
"9074","Zm00001d030523","1",141151918,141161050,9132
"9075","Zm00001d030526","1",141705734,141709496,3762
"9076","Zm00001d030527","1",141837963,141840802,2839
"9077","Zm00001d030529","1",142030972,142031706,734
"9078","Zm00001d030530","1",142031879,142032262,383
"9079","Zm00001d030532","1",142193026,142194949,1923
"9080","Zm00001d030533","1",142260864,142278394,17530
"9081","Zm00001d030534","1",142275171,142276870,1699
"9082","Zm00001d030537","1",142487080,142487673,593
"9083","Zm00001d030544","1",142961537,142965543,4006
"9084","Zm00001d030548","1",143163535,143165480,1945
"9085","Zm00001d030549","1",143230400,143232667,2267
"9086","Zm00001d030550","1",143283392,143284877,1485
"9087","Zm00001d030551","1",143317201,143322716,5515
"9088","Zm00001d030553","1",143419484,143422469,2985
"9089","Zm00001d030554","1",143495759,143510908,15149
"9090","Zm00001d030556","1",143750002,143752321,2319
"9091","Zm00001d030557","1",143971165,143976422,5257
"9092","Zm00001d030558","1",143986813,143988302,1489
"9093","Zm00001d030559","1",143990727,143994327,3600
"9094","Zm00001d030561","1",144149596,144156576,6980
"9095","Zm00001d030572","1",144844137,144850901,6764
"9096","Zm00001d030573","1",144856407,144878212,21805
"9097","Zm00001d030575","1",144967166,144967510,344
"9098","Zm00001d030577","1",145543611,145545618,2007
"9099","Zm00001d030578","1",145680160,145680700,540
"9100","Zm00001d030579","1",145820512,145824791,4279
"9101","Zm00001d030581","1",146069754,146080187,10433
"9102","Zm00001d030584","1",146389914,146397654,7740
"9103","Zm00001d030587","1",146601933,146603737,1804
"9104","Zm00001d030588","1",146631961,146632800,839
"9105","Zm00001d030591","1",146989290,146991727,2437
"9106","Zm00001d030593","1",147206043,147223612,17569
"9107","Zm00001d030598","1",147514973,147540407,25434
"9108","Zm00001d030601","1",147622995,147641527,18532
"9109","Zm00001d030603","1",147913601,147916107,2506
"9110","Zm00001d030609","1",148162035,148190548,28513
"9111","Zm00001d030612","1",148420982,148425811,4829
"9112","Zm00001d030613","1",148632020,148635396,3376
"9113","Zm00001d030614","1",148687296,148692171,4875
"9114","Zm00001d030617","1",148806103,148807147,1044
"9115","Zm00001d030618","1",148822878,148823223,345
"9116","Zm00001d030620","1",148968958,148978546,9588
"9117","Zm00001d030623","1",149354547,149359154,4607
"9118","Zm00001d030624","1",149517794,149522592,4798
"9119","Zm00001d030626","1",149605257,149616644,11387
"9120","Zm00001d030627","1",149688164,149696743,8579
"9121","Zm00001d030638","1",150127232,150129938,2706
"9122","Zm00001d030639","1",150130069,150133395,3326
"9123","Zm00001d030640","1",150287615,150295914,8299
"9124","Zm00001d030644","1",150483395,150485385,1990
"9125","Zm00001d030652","1",151023944,151029791,5847
"9126","Zm00001d030656","1",151221229,151225821,4592
"9127","Zm00001d030657","1",151227616,151234595,6979
"9128","Zm00001d030659","1",151464303,151472649,8346
"9129","Zm00001d030661","1",151627586,151634045,6459
"9130","Zm00001d030662","1",151668078,151669645,1567
"9131","Zm00001d030665","1",151874653,151884858,10205
"9132","Zm00001d030666","1",152032065,152040608,8543
"9133","Zm00001d030669","1",152132894,152134510,1616
"9134","Zm00001d030672","1",152352454,152355522,3068
"9135","Zm00001d030675","1",152400814,152405347,4533
"9136","Zm00001d030676","1",152409706,152410402,696
"9137","Zm00001d030677","1",152629439,152642557,13118
"9138","Zm00001d030678","1",152667851,152669369,1518
"9139","Zm00001d030682","1",152817120,152818589,1469
"9140","Zm00001d030683","1",152852768,152854605,1837
"9141","Zm00001d030688","1",152992024,152995476,3452
"9142","Zm00001d030690","1",153223874,153227226,3352
"9143","Zm00001d030691","1",153357400,153359291,1891
"9144","Zm00001d030694","1",153742904,153749377,6473
"9145","Zm00001d030697","1",154088591,154092627,4036
"9146","Zm00001d030698","1",154144314,154144817,503
"9147","Zm00001d030701","1",154400174,154406420,6246
"9148","Zm00001d030707","1",154854396,154857054,2658
"9149","Zm00001d030710","1",154951601,154977455,25854
"9150","Zm00001d030712","1",155196623,155201582,4959
"9151","Zm00001d030713","1",155201685,155203922,2237
"9152","Zm00001d030717","1",155480309,155481276,967
"9153","Zm00001d030720","1",155599277,155601949,2672
"9154","Zm00001d030724","1",155802410,155804958,2548
"9155","Zm00001d030725","1",155959518,155963384,3866
"9156","Zm00001d030726","1",156047635,156049640,2005
"9157","Zm00001d030727","1",156208993,156211073,2080
"9158","Zm00001d030732","1",156409808,156421643,11835
"9159","Zm00001d030733","1",156692386,156700482,8096
"9160","Zm00001d030735","1",156787629,156788017,388
"9161","Zm00001d030736","1",156846891,156848686,1795
"9162","Zm00001d030737","1",156875930,156877042,1112
"9163","Zm00001d030739","1",157118914,157125507,6593
"9164","Zm00001d030741","1",157310472,157315669,5197
"9165","Zm00001d030742","1",157497130,157511072,13942
"9166","Zm00001d030743","1",157518568,157519321,753
"9167","Zm00001d030744","1",157566433,157567911,1478
"9168","Zm00001d030748","1",158031934,158032197,263
"9169","Zm00001d030750","1",158117469,158117690,221
"9170","Zm00001d030751","1",158118006,158120990,2984
"9171","Zm00001d030754","1",158242145,158244917,2772
"9172","Zm00001d030755","1",158275893,158278516,2623
"9173","Zm00001d030759","1",158390476,158392548,2072
"9174","Zm00001d030760","1",158436910,158446284,9374
"9175","Zm00001d030761","1",158663738,158666141,2403
"9176","Zm00001d030762","1",158943124,158944072,948
"9177","Zm00001d030764","1",158953015,158953884,869
"9178","Zm00001d030765","1",158954900,158958936,4036
"9179","Zm00001d030766","1",159018373,159022893,4520
"9180","Zm00001d030767","1",159023195,159024457,1262
"9181","Zm00001d030770","1",159024989,159029990,5001
"9182","Zm00001d030772","1",159066629,159067242,613
"9183","Zm00001d030773","1",159067789,159070059,2270
"9184","Zm00001d030774","1",159112614,159127146,14532
"9185","Zm00001d030775","1",159139619,159140641,1022
"9186","Zm00001d030777","1",159291664,159299959,8295
"9187","Zm00001d030780","1",159379143,159381634,2491
"9188","Zm00001d030781","1",159403240,159403947,707
"9189","Zm00001d030782","1",159423056,159433779,10723
"9190","Zm00001d030784","1",159576278,159582102,5824
"9191","Zm00001d030786","1",159716363,159727649,11286
"9192","Zm00001d030790","1",159877875,159884491,6616
"9193","Zm00001d030791","1",159884602,159889326,4724
"9194","Zm00001d030795","1",160029616,160033712,4096
"9195","Zm00001d030796","1",160087365,160092610,5245
"9196","Zm00001d030801","1",160336523,160338525,2002
"9197","Zm00001d030806","1",160783862,160786896,3034
"9198","Zm00001d030809","1",161199365,161204231,4866
"9199","Zm00001d030812","1",161356525,161357539,1014
"9200","Zm00001d030813","1",161365968,161384996,19028
"9201","Zm00001d030814","1",161427099,161429557,2458
"9202","Zm00001d030815","1",161474185,161477711,3526
"9203","Zm00001d030821","1",161943350,161947143,3793
"9204","Zm00001d030827","1",162050269,162052045,1776
"9205","Zm00001d030828","1",162055365,162056000,635
"9206","Zm00001d030832","1",162231719,162233777,2058
"9207","Zm00001d030833","1",162240102,162241109,1007
"9208","Zm00001d030834","1",162279664,162280982,1318
"9209","Zm00001d030837","1",162455095,162458202,3107
"9210","Zm00001d030841","1",162684142,162686159,2017
"9211","Zm00001d030843","1",162767578,162769472,1894
"9212","Zm00001d030845","1",162877934,162879729,1795
"9213","Zm00001d030846","1",162956258,162960613,4355
"9214","Zm00001d030849","1",163154468,163156940,2472
"9215","Zm00001d030850","1",163161092,163161700,608
"9216","Zm00001d030851","1",163238999,163241090,2091
"9217","Zm00001d030856","1",163637977,163639965,1988
"9218","Zm00001d030858","1",163697126,163697959,833
"9219","Zm00001d030859","1",163875186,163880577,5391
"9220","Zm00001d030860","1",164016950,164031018,14068
"9221","Zm00001d030861","1",164018781,164019062,281
"9222","Zm00001d030863","1",164037038,164042167,5129
"9223","Zm00001d030864","1",164072998,164077720,4722
"9224","Zm00001d030865","1",164103708,164104312,604
"9225","Zm00001d030866","1",164103856,164108695,4839
"9226","Zm00001d030867","1",164148405,164151412,3007
"9227","Zm00001d030868","1",164196407,164205410,9003
"9228","Zm00001d030870","1",164365589,164368297,2708
"9229","Zm00001d030879","1",165078840,165083962,5122
"9230","Zm00001d030888","1",165741227,165745488,4261
"9231","Zm00001d030891","1",166009842,166012367,2525
"9232","Zm00001d030892","1",166128618,166133279,4661
"9233","Zm00001d030893","1",166141957,166148221,6264
"9234","Zm00001d030894","1",166194776,166197012,2236
"9235","Zm00001d030895","1",166287332,166290184,2852
"9236","Zm00001d030900","1",166624511,166627207,2696
"9237","Zm00001d030901","1",166628878,166630410,1532
"9238","Zm00001d030902","1",166630765,166633673,2908
"9239","Zm00001d030906","1",166694466,166694789,323
"9240","Zm00001d030907","1",166741910,166744810,2900
"9241","Zm00001d030908","1",166746593,166757849,11256
"9242","Zm00001d030909","1",166747356,166749594,2238
"9243","Zm00001d030910","1",166757465,166766864,9399
"9244","Zm00001d030914","1",166903822,166924697,20875
"9245","Zm00001d030915","1",167087181,167087501,320
"9246","Zm00001d030916","1",167088410,167093959,5549
"9247","Zm00001d030920","1",167480539,167521571,41032
"9248","Zm00001d030923","1",167499546,167499791,245
"9249","Zm00001d030927","1",167518119,167519799,1680
"9250","Zm00001d030932","1",167662991,167663236,245
"9251","Zm00001d030933","1",167677692,167677937,245
"9252","Zm00001d030934","1",167682892,167687081,4189
"9253","Zm00001d030935","1",168021607,168091886,70279
"9254","Zm00001d030936","1",168183026,168185314,2288
"9255","Zm00001d030937","1",168391020,168397836,6816
"9256","Zm00001d030939","1",168399558,168404587,5029
"9257","Zm00001d030940","1",168453787,168458127,4340
"9258","Zm00001d030942","1",168488339,168493704,5365
"9259","Zm00001d030944","1",168495355,168497554,2199
"9260","Zm00001d030947","1",168612673,168630489,17816
"9261","Zm00001d030950","1",168632484,168634076,1592
"9262","Zm00001d030951","1",168634818,168645497,10679
"9263","Zm00001d030952","1",168646071,168649959,3888
"9264","Zm00001d030953","1",168697730,168709504,11774
"9265","Zm00001d030954","1",168741764,168745611,3847
"9266","Zm00001d030955","1",168915204,168928386,13182
"9267","Zm00001d030958","1",169037521,169044042,6521
"9268","Zm00001d030960","1",169229481,169239762,10281
"9269","Zm00001d030962","1",169327810,169330606,2796
"9270","Zm00001d030965","1",169557995,169558465,470
"9271","Zm00001d030967","1",169596826,169609280,12454
"9272","Zm00001d030968","1",169609308,169615972,6664
"9273","Zm00001d030969","1",169641684,169643906,2222
"9274","Zm00001d030971","1",170169839,170174596,4757
"9275","Zm00001d030973","1",170237244,170238095,851
"9276","Zm00001d030976","1",170450302,170451750,1448
"9277","Zm00001d030981","1",171564539,171568092,3553
"9278","Zm00001d030982","1",171818548,171823296,4748
"9279","Zm00001d030984","1",172056749,172058475,1726
"9280","Zm00001d030985","1",172065913,172071656,5743
"9281","Zm00001d030987","1",172154286,172155845,1559
"9282","Zm00001d030989","1",172181723,172183926,2203
"9283","Zm00001d030990","1",172352530,172357352,4822
"9284","Zm00001d030992","1",172397326,172400269,2943
"9285","Zm00001d030993","1",172413967,172415265,1298
"9286","Zm00001d030994","1",172446566,172449101,2535
"9287","Zm00001d030995","1",172452608,172457478,4870
"9288","Zm00001d030996","1",172559275,172567962,8687
"9289","Zm00001d030998","1",172695821,172722797,26976
"9290","Zm00001d030999","1",172720285,172725171,4886
"9291","Zm00001d031000","1",172785823,172786919,1096
"9292","Zm00001d031002","1",172832218,172839410,7192
"9293","Zm00001d031005","1",172956483,172964147,7664
"9294","Zm00001d031008","1",173135204,173140452,5248
"9295","Zm00001d031009","1",173165434,173190178,24744
"9296","Zm00001d031013","1",173396175,173402763,6588
"9297","Zm00001d031014","1",173441034,173445839,4805
"9298","Zm00001d031017","1",173658523,173659395,872
"9299","Zm00001d031018","1",173681223,173708331,27108
"9300","Zm00001d031019","1",173937105,173940807,3702
"9301","Zm00001d031020","1",173943638,173944196,558
"9302","Zm00001d031023","1",174044025,174046144,2119
"9303","Zm00001d031024","1",174046270,174052289,6019
"9304","Zm00001d031026","1",174112352,174114291,1939
"9305","Zm00001d031027","1",174118447,174125812,7365
"9306","Zm00001d031028","1",174127485,174133094,5609
"9307","Zm00001d031032","1",174319622,174320513,891
"9308","Zm00001d031033","1",174328138,174334273,6135
"9309","Zm00001d031037","1",174657813,174661816,4003
"9310","Zm00001d031040","1",174739638,174747699,8061
"9311","Zm00001d031041","1",174748246,174754584,6338
"9312","Zm00001d031042","1",174777439,174792059,14620
"9313","Zm00001d031044","1",174811257,174813790,2533
"9314","Zm00001d031049","1",174839919,174844064,4145
"9315","Zm00001d031050","1",174872589,174876413,3824
"9316","Zm00001d031053","1",174882516,174885087,2571
"9317","Zm00001d031056","1",175036078,175037888,1810
"9318","Zm00001d031058","1",175149398,175154334,4936
"9319","Zm00001d031059","1",175156310,175162258,5948
"9320","Zm00001d031060","1",175163704,175169767,6063
"9321","Zm00001d031061","1",175170463,175176066,5603
"9322","Zm00001d031062","1",175258666,175260443,1777
"9323","Zm00001d031063","1",175263789,175269072,5283
"9324","Zm00001d031064","1",175371170,175379288,8118
"9325","Zm00001d031065","1",175602323,175609344,7021
"9326","Zm00001d031068","1",175807851,175809432,1581
"9327","Zm00001d031070","1",175958631,175968210,9579
"9328","Zm00001d031071","1",175969709,175971563,1854
"9329","Zm00001d031072","1",175972206,175977764,5558
"9330","Zm00001d031073","1",175980669,175983357,2688
"9331","Zm00001d031074","1",175985334,175996008,10674
"9332","Zm00001d031081","1",176353803,176359878,6075
"9333","Zm00001d031085","1",176430042,176430541,499
"9334","Zm00001d031088","1",176622337,176632882,10545
"9335","Zm00001d031089","1",176628540,176628608,68
"9336","Zm00001d031090","1",176657208,176661126,3918
"9337","Zm00001d031091","1",176782700,176787696,4996
"9338","Zm00001d031092","1",176869959,176875893,5934
"9339","Zm00001d031093","1",176923146,176926098,2952
"9340","Zm00001d031094","1",176987913,176988938,1025
"9341","Zm00001d031098","1",177158122,177163096,4974
"9342","Zm00001d031099","1",177231869,177233915,2046
"9343","Zm00001d031101","1",177235739,177243001,7262
"9344","Zm00001d031104","1",177428041,177432794,4753
"9345","Zm00001d031109","1",177577710,177583959,6249
"9346","Zm00001d031114","1",177789387,177789677,290
"9347","Zm00001d031115","1",177821450,177829359,7909
"9348","Zm00001d031118","1",177976720,177983073,6353
"9349","Zm00001d031119","1",177983756,177987442,3686
"9350","Zm00001d031120","1",178020480,178025593,5113
"9351","Zm00001d031126","1",178553061,178553878,817
"9352","Zm00001d031127","1",178717020,178719023,2003
"9353","Zm00001d031128","1",178799384,178803593,4209
"9354","Zm00001d031129","1",178803787,178805508,1721
"9355","Zm00001d031130","1",178917351,178919435,2084
"9356","Zm00001d031131","1",178922269,178923900,1631
"9357","Zm00001d031132","1",178992773,178997888,5115
"9358","Zm00001d031133","1",178996108,178997250,1142
"9359","Zm00001d031134","1",178998581,179001994,3413
"9360","Zm00001d031135","1",179005355,179009556,4201
"9361","Zm00001d031136","1",179010347,179015072,4725
"9362","Zm00001d031146","1",179600373,179600708,335
"9363","Zm00001d031149","1",179744678,179749229,4551
"9364","Zm00001d031159","1",180196546,180218147,21601
"9365","Zm00001d031161","1",180277456,180290942,13486
"9366","Zm00001d031163","1",180291502,180295682,4180
"9367","Zm00001d031164","1",180369693,180371167,1474
"9368","Zm00001d031168","1",180447018,180448137,1119
"9369","Zm00001d031170","1",180462112,180463468,1356
"9370","Zm00001d031171","1",180490442,180495243,4801
"9371","Zm00001d031175","1",181154824,181156369,1545
"9372","Zm00001d031178","1",181310179,181314255,4076
"9373","Zm00001d031179","1",181314460,181317451,2991
"9374","Zm00001d031180","1",181338652,181340600,1948
"9375","Zm00001d031182","1",181575354,181579654,4300
"9376","Zm00001d031183","1",181580507,181584714,4207
"9377","Zm00001d031184","1",181585445,181586170,725
"9378","Zm00001d031186","1",181630809,181632504,1695
"9379","Zm00001d031187","1",181633974,181636095,2121
"9380","Zm00001d031191","1",181717545,181718015,470
"9381","Zm00001d031194","1",181836162,181836725,563
"9382","Zm00001d031196","1",181859731,181860228,497
"9383","Zm00001d031197","1",181874386,181874802,416
"9384","Zm00001d031199","1",181910734,181911738,1004
"9385","Zm00001d031200","1",181951854,181954505,2651
"9386","Zm00001d031201","1",181968293,181971430,3137
"9387","Zm00001d031202","1",181977632,181978147,515
"9388","Zm00001d031203","1",181978320,181979932,1612
"9389","Zm00001d031204","1",181980151,181983844,3693
"9390","Zm00001d031205","1",182002231,182006778,4547
"9391","Zm00001d031206","1",182008344,182010877,2533
"9392","Zm00001d031208","1",182119199,182120549,1350
"9393","Zm00001d031209","1",182293107,182294953,1846
"9394","Zm00001d031210","1",182329561,182336739,7178
"9395","Zm00001d031211","1",182336147,182340221,4074
"9396","Zm00001d031212","1",182379167,182384473,5306
"9397","Zm00001d031213","1",182385065,182386594,1529
"9398","Zm00001d031216","1",182480607,182484830,4223
"9399","Zm00001d031217","1",182484848,182492517,7669
"9400","Zm00001d031220","1",182574839,182578580,3741
"9401","Zm00001d031221","1",182579405,182580994,1589
"9402","Zm00001d031222","1",182596026,182597609,1583
"9403","Zm00001d031223","1",182657007,182661933,4926
"9404","Zm00001d031224","1",182662543,182663088,545
"9405","Zm00001d031227","1",182704313,182705449,1136
"9406","Zm00001d031229","1",182801962,182803223,1261
"9407","Zm00001d031230","1",182805322,182808465,3143
"9408","Zm00001d031231","1",182805413,182827505,22092
"9409","Zm00001d031232","1",182925112,182945175,20063
"9410","Zm00001d031233","1",182947174,182951362,4188
"9411","Zm00001d031236","1",183190439,183200564,10125
"9412","Zm00001d031239","1",183229237,183244599,15362
"9413","Zm00001d031241","1",183287978,183295572,7594
"9414","Zm00001d031243","1",183367514,183368556,1042
"9415","Zm00001d031244","1",183455011,183455957,946
"9416","Zm00001d031248","1",183599535,183602698,3163
"9417","Zm00001d031249","1",183610068,183614950,4882
"9418","Zm00001d031250","1",183612334,183615871,3537
"9419","Zm00001d031253","1",183880314,183892062,11748
"9420","Zm00001d031254","1",183895158,183901422,6264
"9421","Zm00001d031256","1",184086535,184104528,17993
"9422","Zm00001d031257","1",184106568,184107742,1174
"9423","Zm00001d031258","1",184110087,184113451,3364
"9424","Zm00001d031259","1",184113625,184115681,2056
"9425","Zm00001d031260","1",184153032,184161955,8923
"9426","Zm00001d031261","1",184229339,184230472,1133
"9427","Zm00001d031262","1",184233670,184234892,1222
"9428","Zm00001d031264","1",184285253,184286332,1079
"9429","Zm00001d031265","1",184286253,184295887,9634
"9430","Zm00001d031266","1",184358938,184359897,959
"9431","Zm00001d031267","1",184397570,184400001,2431
"9432","Zm00001d031268","1",184422806,184436805,13999
"9433","Zm00001d031269","1",184545305,184548977,3672
"9434","Zm00001d031271","1",184629579,184634811,5232
"9435","Zm00001d031273","1",184641867,184642736,869
"9436","Zm00001d031275","1",184817129,184819486,2357
"9437","Zm00001d031278","1",184859499,184860221,722
"9438","Zm00001d031279","1",184897760,184900636,2876
"9439","Zm00001d031280","1",184903195,184904973,1778
"9440","Zm00001d031281","1",184924382,184926172,1790
"9441","Zm00001d031286","1",185105070,185105288,218
"9442","Zm00001d031287","1",185120590,185122949,2359
"9443","Zm00001d031288","1",185175760,185177518,1758
"9444","Zm00001d031289","1",185319207,185332363,13156
"9445","Zm00001d031290","1",185334136,185334576,440
"9446","Zm00001d031291","1",185472894,185477491,4597
"9447","Zm00001d031292","1",185477807,185478616,809
"9448","Zm00001d031293","1",185504257,185504918,661
"9449","Zm00001d031296","1",185533157,185536651,3494
"9450","Zm00001d031300","1",185589046,185592963,3917
"9451","Zm00001d031303","1",185700379,185710906,10527
"9452","Zm00001d031308","1",185839155,185840307,1152
"9453","Zm00001d031309","1",185840864,185842897,2033
"9454","Zm00001d031310","1",185845156,185845758,602
"9455","Zm00001d031311","1",185849377,185850081,704
"9456","Zm00001d031312","1",185850815,185852753,1938
"9457","Zm00001d031314","1",185867617,185867688,71
"9458","Zm00001d031315","1",185871254,185874831,3577
"9459","Zm00001d031316","1",185876713,185882166,5453
"9460","Zm00001d031317","1",185911720,185913708,1988
"9461","Zm00001d031318","1",185915536,185921483,5947
"9462","Zm00001d031321","1",185960624,185962003,1379
"9463","Zm00001d031322","1",185965373,185968480,3107
"9464","Zm00001d031323","1",185977739,185981604,3865
"9465","Zm00001d031325","1",186052724,186053956,1232
"9466","Zm00001d031326","1",186054718,186062670,7952
"9467","Zm00001d031327","1",186062762,186075460,12698
"9468","Zm00001d031328","1",186081296,186085558,4262
"9469","Zm00001d031329","1",186194755,186199511,4756
"9470","Zm00001d031331","1",186314543,186324863,10320
"9471","Zm00001d031332","1",186376331,186380883,4552
"9472","Zm00001d031334","1",186514492,186515016,524
"9473","Zm00001d031338","1",186729080,186739316,10236
"9474","Zm00001d031344","1",186836238,186837506,1268
"9475","Zm00001d031348","1",187040656,187041156,500
"9476","Zm00001d031352","1",187068910,187076465,7555
"9477","Zm00001d031355","1",187098827,187114428,15601
"9478","Zm00001d031362","1",187358597,187359766,1169
"9479","Zm00001d031363","1",187376459,187377145,686
"9480","Zm00001d031369","1",187492856,187495345,2489
"9481","Zm00001d031370","1",187563113,187564209,1096
"9482","Zm00001d031377","1",187718812,187721184,2372
"9483","Zm00001d031384","1",187952116,187953827,1711
"9484","Zm00001d031392","1",188711968,188717046,5078
"9485","Zm00001d031395","1",188816032,188820327,4295
"9486","Zm00001d031398","1",188861239,188863578,2339
"9487","Zm00001d031399","1",188931491,188932672,1181
"9488","Zm00001d031400","1",189164379,189164951,572
"9489","Zm00001d031404","1",189203216,189203629,413
"9490","Zm00001d031407","1",189257836,189261763,3927
"9491","Zm00001d031408","1",189263612,189264352,740
"9492","Zm00001d031412","1",189290752,189294828,4076
"9493","Zm00001d031413","1",189318543,189320561,2018
"9494","Zm00001d031415","1",189358631,189362122,3491
"9495","Zm00001d031416","1",189440085,189443079,2994
"9496","Zm00001d031418","1",189511676,189514775,3099
"9497","Zm00001d031419","1",189514811,189515143,332
"9498","Zm00001d031420","1",189574082,189577299,3217
"9499","Zm00001d031422","1",189580903,189591158,10255
"9500","Zm00001d031423","1",189593205,189593937,732
"9501","Zm00001d031426","1",189631780,189633108,1328
"9502","Zm00001d031428","1",189808671,189811445,2774
"9503","Zm00001d031429","1",189856343,189862099,5756
"9504","Zm00001d031430","1",189862644,189867912,5268
"9505","Zm00001d031431","1",189876139,189876501,362
"9506","Zm00001d031434","1",190080839,190081984,1145
"9507","Zm00001d031435","1",190085948,190089333,3385
"9508","Zm00001d031436","1",190176192,190179802,3610
"9509","Zm00001d031437","1",190179856,190183037,3181
"9510","Zm00001d031439","1",190215777,190218891,3114
"9511","Zm00001d031441","1",190232595,190235627,3032
"9512","Zm00001d031443","1",190264315,190265262,947
"9513","Zm00001d031444","1",190266395,190269706,3311
"9514","Zm00001d031445","1",190274859,190276757,1898
"9515","Zm00001d031447","1",190284563,190291949,7386
"9516","Zm00001d031450","1",190370386,190373502,3116
"9517","Zm00001d031451","1",190382866,190386589,3723
"9518","Zm00001d031453","1",190556791,190558314,1523
"9519","Zm00001d031454","1",190649919,190653721,3802
"9520","Zm00001d031455","1",190793372,190793926,554
"9521","Zm00001d031457","1",190910668,190943061,32393
"9522","Zm00001d031458","1",190927319,190930337,3018
"9523","Zm00001d031459","1",190964811,190978369,13558
"9524","Zm00001d031460","1",191032599,191034959,2360
"9525","Zm00001d031462","1",191059764,191062054,2290
"9526","Zm00001d031463","1",191081875,191084627,2752
"9527","Zm00001d031464","1",191125198,191125689,491
"9528","Zm00001d031465","1",191126509,191126940,431
"9529","Zm00001d031466","1",191167286,191172311,5025
"9530","Zm00001d031469","1",191229531,191230114,583
"9531","Zm00001d031470","1",191263840,191267976,4136
"9532","Zm00001d031471","1",191269980,191275295,5315
"9533","Zm00001d031473","1",191327828,191332219,4391
"9534","Zm00001d031475","1",191370598,191372391,1793
"9535","Zm00001d031476","1",191373405,191374899,1494
"9536","Zm00001d031480","1",191518541,191521006,2465
"9537","Zm00001d031481","1",191521128,191523748,2620
"9538","Zm00001d031482","1",191554665,191555908,1243
"9539","Zm00001d031483","1",191558458,191559611,1153
"9540","Zm00001d031484","1",191582403,191584575,2172
"9541","Zm00001d031485","1",191586051,191588335,2284
"9542","Zm00001d031486","1",191639760,191644954,5194
"9543","Zm00001d031487","1",191766320,191771809,5489
"9544","Zm00001d031488","1",191775035,191776945,1910
"9545","Zm00001d031489","1",191775183,191781020,5837
"9546","Zm00001d031490","1",191819199,191824621,5422
"9547","Zm00001d031494","1",191908229,191910980,2751
"9548","Zm00001d031495","1",191994766,191996827,2061
"9549","Zm00001d031496","1",192002834,192004606,1772
"9550","Zm00001d031498","1",192005744,192006331,587
"9551","Zm00001d031499","1",192022614,192023222,608
"9552","Zm00001d031500","1",192040042,192040576,534
"9553","Zm00001d031501","1",192063299,192064027,728
"9554","Zm00001d031502","1",192122013,192126968,4955
"9555","Zm00001d031505","1",192252489,192255152,2663
"9556","Zm00001d031510","1",192357371,192358661,1290
"9557","Zm00001d031511","1",192366141,192367785,1644
"9558","Zm00001d031514","1",192436661,192437457,796
"9559","Zm00001d031517","1",192568842,192569462,620
"9560","Zm00001d031518","1",192615422,192622594,7172
"9561","Zm00001d031519","1",192670032,192675121,5089
"9562","Zm00001d031520","1",192675721,192679397,3676
"9563","Zm00001d031521","1",192679623,192679695,72
"9564","Zm00001d031522","1",192746884,192762316,15432
"9565","Zm00001d031523","1",192799114,192800514,1400
"9566","Zm00001d031524","1",192826347,192827797,1450
"9567","Zm00001d031525","1",192892598,192897923,5325
"9568","Zm00001d031526","1",192898539,192899528,989
"9569","Zm00001d031527","1",192952026,192956458,4432
"9570","Zm00001d031528","1",192957133,192959320,2187
"9571","Zm00001d031529","1",192960961,192972116,11155
"9572","Zm00001d031530","1",192976559,192979894,3335
"9573","Zm00001d031531","1",192992193,192996753,4560
"9574","Zm00001d031532","1",193249982,193256980,6998
"9575","Zm00001d031533","1",193316763,193318712,1949
"9576","Zm00001d031534","1",193343064,193348037,4973
"9577","Zm00001d031535","1",193452711,193455986,3275
"9578","Zm00001d031536","1",193620437,193622803,2366
"9579","Zm00001d031539","1",193693869,193697232,3363
"9580","Zm00001d031540","1",193698635,193701525,2890
"9581","Zm00001d031541","1",193750496,193751623,1127
"9582","Zm00001d031542","1",193753195,193766058,12863
"9583","Zm00001d031543","1",193767746,193780529,12783
"9584","Zm00001d031545","1",193834072,193835680,1608
"9585","Zm00001d031546","1",193839225,193839605,380
"9586","Zm00001d031548","1",193849007,193849590,583
"9587","Zm00001d031549","1",193854782,193874626,19844
"9588","Zm00001d031554","1",194112919,194119847,6928
"9589","Zm00001d031555","1",194120554,194122562,2008
"9590","Zm00001d031556","1",194157336,194158112,776
"9591","Zm00001d031558","1",194162557,194176389,13832
"9592","Zm00001d031560","1",194266307,194270465,4158
"9593","Zm00001d031561","1",194339694,194342403,2709
"9594","Zm00001d031562","1",194370600,194371395,795
"9595","Zm00001d031568","1",194606659,194607393,734
"9596","Zm00001d031569","1",194687973,194691805,3832
"9597","Zm00001d031570","1",194692157,194696937,4780
"9598","Zm00001d031571","1",194764720,194766698,1978
"9599","Zm00001d031572","1",194778144,194780073,1929
"9600","Zm00001d031575","1",195067278,195068835,1557
"9601","Zm00001d031576","1",195077708,195078109,401
"9602","Zm00001d031577","1",195092276,195093628,1352
"9603","Zm00001d031578","1",195116930,195128043,11113
"9604","Zm00001d031580","1",195291757,195294291,2534
"9605","Zm00001d031581","1",195388615,195402490,13875
"9606","Zm00001d031586","1",195523691,195524443,752
"9607","Zm00001d031587","1",195526969,195533151,6182
"9608","Zm00001d031588","1",195607301,195608107,806
"9609","Zm00001d031589","1",195608214,195611534,3320
"9610","Zm00001d031593","1",195672265,195678558,6293
"9611","Zm00001d031597","1",195867646,195869138,1492
"9612","Zm00001d031599","1",195873413,195875927,2514
"9613","Zm00001d031600","1",195876042,195877707,1665
"9614","Zm00001d031602","1",195958619,195965889,7270
"9615","Zm00001d031604","1",196088873,196089526,653
"9616","Zm00001d031605","1",196089342,196090150,808
"9617","Zm00001d031611","1",196150569,196153475,2906
"9618","Zm00001d031614","1",196188046,196189851,1805
"9619","Zm00001d031617","1",196224574,196228047,3473
"9620","Zm00001d031618","1",196228023,196229672,1649
"9621","Zm00001d031619","1",196232433,196236937,4504
"9622","Zm00001d031620","1",196372442,196380539,8097
"9623","Zm00001d031621","1",196575044,196584218,9174
"9624","Zm00001d031625","1",196773083,196773325,242
"9625","Zm00001d031627","1",196865024,196868008,2984
"9626","Zm00001d031632","1",196894836,196908058,13222
"9627","Zm00001d031633","1",196910694,196914075,3381
"9628","Zm00001d031634","1",196930708,196940546,9838
"9629","Zm00001d031635","1",196944233,196947143,2910
"9630","Zm00001d031636","1",197046358,197048201,1843
"9631","Zm00001d031637","1",197049256,197052349,3093
"9632","Zm00001d031638","1",197063890,197066757,2867
"9633","Zm00001d031639","1",197105593,197108840,3247
"9634","Zm00001d031640","1",197108702,197111394,2692
"9635","Zm00001d031641","1",197111866,197115583,3717
"9636","Zm00001d031642","1",197116320,197131078,14758
"9637","Zm00001d031643","1",197133007,197142004,8997
"9638","Zm00001d031646","1",197194904,197195296,392
"9639","Zm00001d031647","1",197308955,197311791,2836
"9640","Zm00001d031648","1",197351130,197355424,4294
"9641","Zm00001d031651","1",197393450,197395554,2104
"9642","Zm00001d031653","1",197494482,197499476,4994
"9643","Zm00001d031655","1",197545631,197549052,3421
"9644","Zm00001d031657","1",197692665,197700005,7340
"9645","Zm00001d031659","1",197760195,197776370,16175
"9646","Zm00001d031660","1",197840680,197849444,8764
"9647","Zm00001d031662","1",197918030,197921539,3509
"9648","Zm00001d031665","1",198078399,198080869,2470
"9649","Zm00001d031666","1",198113791,198116973,3182
"9650","Zm00001d031667","1",198119172,198130785,11613
"9651","Zm00001d031668","1",198133295,198135983,2688
"9652","Zm00001d031669","1",198137582,198141658,4076
"9653","Zm00001d031670","1",198158299,198163378,5079
"9654","Zm00001d031671","1",198157946,198164050,6104
"9655","Zm00001d031674","1",198267827,198271992,4165
"9656","Zm00001d031676","1",198291706,198304950,13244
"9657","Zm00001d031677","1",198453958,198455760,1802
"9658","Zm00001d031678","1",198531549,198538490,6941
"9659","Zm00001d031684","1",198609064,198620174,11110
"9660","Zm00001d031685","1",198621130,198627245,6115
"9661","Zm00001d031688","1",198649578,198653105,3527
"9662","Zm00001d031689","1",198655372,198659835,4463
"9663","Zm00001d031690","1",198659947,198660820,873
"9664","Zm00001d031691","1",198667935,198671896,3961
"9665","Zm00001d031694","1",198706330,198713467,7137
"9666","Zm00001d031696","1",198748082,198750106,2024
"9667","Zm00001d031697","1",198774832,198777673,2841
"9668","Zm00001d031699","1",198828635,198829665,1030
"9669","Zm00001d031700","1",198833249,198838390,5141
"9670","Zm00001d031701","1",198847487,198849568,2081
"9671","Zm00001d031702","1",198850941,198866978,16037
"9672","Zm00001d031703","1",198955378,198957377,1999
"9673","Zm00001d031705","1",199015599,199019446,3847
"9674","Zm00001d031706","1",199023409,199026623,3214
"9675","Zm00001d031707","1",199074702,199078961,4259
"9676","Zm00001d031712","1",199132108,199139506,7398
"9677","Zm00001d031719","1",199411819,199414727,2908
"9678","Zm00001d031720","1",199415229,199417577,2348
"9679","Zm00001d031723","1",199502427,199506388,3961
"9680","Zm00001d031724","1",199517587,199526569,8982
"9681","Zm00001d031725","1",199651976,199653028,1052
"9682","Zm00001d031726","1",199707996,199710074,2078
"9683","Zm00001d031727","1",199715758,199718643,2885
"9684","Zm00001d031728","1",199720829,199721512,683
"9685","Zm00001d031729","1",199827411,199829671,2260
"9686","Zm00001d031730","1",199913788,199915380,1592
"9687","Zm00001d031731","1",200023769,200025791,2022
"9688","Zm00001d031732","1",200052338,200054134,1796
"9689","Zm00001d031734","1",200077843,200082258,4415
"9690","Zm00001d031736","1",200197812,200199489,1677
"9691","Zm00001d031737","1",200260170,200262141,1971
"9692","Zm00001d031738","1",200303755,200305654,1899
"9693","Zm00001d031739","1",200307874,200308906,1032
"9694","Zm00001d031740","1",200312199,200315515,3316
"9695","Zm00001d031741","1",200422094,200422981,887
"9696","Zm00001d031743","1",200572724,200575450,2726
"9697","Zm00001d031747","1",200675571,200679396,3825
"9698","Zm00001d031749","1",200686322,200689932,3610
"9699","Zm00001d031750","1",200707269,200708767,1498
"9700","Zm00001d031751","1",200708821,200711986,3165
"9701","Zm00001d031753","1",200737709,200739807,2098
"9702","Zm00001d031754","1",200814954,200816242,1288
"9703","Zm00001d031759","1",200944200,200947414,3214
"9704","Zm00001d031760","1",201015465,201016943,1478
"9705","Zm00001d031764","1",201106050,201111798,5748
"9706","Zm00001d031766","1",201189628,201191621,1993
"9707","Zm00001d031769","1",201195222,201199817,4595
"9708","Zm00001d031771","1",201315011,201316276,1265
"9709","Zm00001d031773","1",201397643,201398823,1180
"9710","Zm00001d031774","1",201436036,201436377,341
"9711","Zm00001d031777","1",201510972,201513199,2227
"9712","Zm00001d031778","1",201515268,201517431,2163
"9713","Zm00001d031782","1",201730231,201732456,2225
"9714","Zm00001d031783","1",201735779,201737876,2097
"9715","Zm00001d031784","1",201757780,201763642,5862
"9716","Zm00001d031785","1",201799808,201802246,2438
"9717","Zm00001d031789","1",201868285,201873117,4832
"9718","Zm00001d031790","1",201947175,201952222,5047
"9719","Zm00001d031792","1",201964854,201966053,1199
"9720","Zm00001d031793","1",202076092,202089121,13029
"9721","Zm00001d031795","1",202095698,202096720,1022
"9722","Zm00001d031797","1",202170793,202171441,648
"9723","Zm00001d031799","1",202175993,202181535,5542
"9724","Zm00001d031800","1",202182454,202182942,488
"9725","Zm00001d031801","1",202184534,202185601,1067
"9726","Zm00001d031802","1",202214939,202217025,2086
"9727","Zm00001d031804","1",202297008,202297994,986
"9728","Zm00001d031805","1",202330757,202332503,1746
"9729","Zm00001d031807","1",202456321,202462069,5748
"9730","Zm00001d031808","1",202464156,202467819,3663
"9731","Zm00001d031809","1",202468442,202472613,4171
"9732","Zm00001d031815","1",202686992,202690272,3280
"9733","Zm00001d031816","1",202751686,202757066,5380
"9734","Zm00001d031817","1",202884656,202896386,11730
"9735","Zm00001d031819","1",202907478,202908879,1401
"9736","Zm00001d031820","1",202909714,202911057,1343
"9737","Zm00001d031822","1",202981539,202982307,768
"9738","Zm00001d031824","1",202983117,202992232,9115
"9739","Zm00001d031825","1",202992962,202996130,3168
"9740","Zm00001d031826","1",203010395,203011279,884
"9741","Zm00001d031827","1",203014514,203029359,14845
"9742","Zm00001d031829","1",203032400,203038983,6583
"9743","Zm00001d031830","1",203041801,203043392,1591
"9744","Zm00001d031832","1",203118551,203127762,9211
"9745","Zm00001d031833","1",203133495,203134475,980
"9746","Zm00001d031835","1",203191238,203192635,1397
"9747","Zm00001d031837","1",203221978,203225256,3278
"9748","Zm00001d031839","1",203326138,203327986,1848
"9749","Zm00001d031840","1",203354978,203355904,926
"9750","Zm00001d031841","1",203398594,203399369,775
"9751","Zm00001d031843","1",203676257,203677108,851
"9752","Zm00001d031844","1",203695884,203699106,3222
"9753","Zm00001d031845","1",203911284,203917374,6090
"9754","Zm00001d031846","1",203934648,203935478,830
"9755","Zm00001d031847","1",203973238,203990097,16859
"9756","Zm00001d031848","1",203990154,203991662,1508
"9757","Zm00001d031849","1",203993172,203996773,3601
"9758","Zm00001d031850","1",204132855,204133635,780
"9759","Zm00001d031851","1",204134344,204138811,4467
"9760","Zm00001d031852","1",204140568,204140852,284
"9761","Zm00001d031853","1",204145139,204149948,4809
"9762","Zm00001d031854","1",204236527,204241415,4888
"9763","Zm00001d031855","1",204241497,204242651,1154
"9764","Zm00001d031856","1",204243279,204248168,4889
"9765","Zm00001d031858","1",204348028,204349986,1958
"9766","Zm00001d031860","1",204433977,204438771,4794
"9767","Zm00001d031861","1",204458557,204459636,1079
"9768","Zm00001d031863","1",204518458,204537518,19060
"9769","Zm00001d031864","1",204547857,204548477,620
"9770","Zm00001d031866","1",204668605,204670641,2036
"9771","Zm00001d031867","1",204677117,204680173,3056
"9772","Zm00001d031868","1",204737534,204738454,920
"9773","Zm00001d031869","1",204740208,204743258,3050
"9774","Zm00001d031870","1",204744332,204746298,1966
"9775","Zm00001d031871","1",204748411,204755635,7224
"9776","Zm00001d031872","1",204948169,204956506,8337
"9777","Zm00001d031873","1",204962467,204987181,24714
"9778","Zm00001d031875","1",205091435,205093066,1631
"9779","Zm00001d031876","1",205126581,205135409,8828
"9780","Zm00001d031878","1",205166704,205167543,839
"9781","Zm00001d031880","1",205241191,205242150,959
"9782","Zm00001d031882","1",205250102,205251502,1400
"9783","Zm00001d031883","1",205253220,205256933,3713
"9784","Zm00001d031888","1",205336690,205337790,1100
"9785","Zm00001d031891","1",205429718,205442392,12674
"9786","Zm00001d031892","1",205442994,205443842,848
"9787","Zm00001d031893","1",205617823,205620362,2539
"9788","Zm00001d031894","1",205693708,205696793,3085
"9789","Zm00001d031898","1",205925213,205930258,5045
"9790","Zm00001d031899","1",205992135,205996030,3895
"9791","Zm00001d031901","1",206063578,206072875,9297
"9792","Zm00001d031902","1",206146765,206153923,7158
"9793","Zm00001d031903","1",206152188,206155096,2908
"9794","Zm00001d031908","1",206405716,206408991,3275
"9795","Zm00001d031911","1",206533163,206537215,4052
"9796","Zm00001d031913","1",206640378,206642606,2228
"9797","Zm00001d031918","1",206664320,206665664,1344
"9798","Zm00001d031923","1",206917642,206923152,5510
"9799","Zm00001d031925","1",206932526,206934498,1972
"9800","Zm00001d031926","1",206982602,206985131,2529
"9801","Zm00001d031927","1",207061888,207081049,19161
"9802","Zm00001d031928","1",207098114,207099390,1276
"9803","Zm00001d031929","1",207099867,207105197,5330
"9804","Zm00001d031930","1",207130514,207131870,1356
"9805","Zm00001d031932","1",207233991,207236556,2565
"9806","Zm00001d031933","1",207276632,207281619,4987
"9807","Zm00001d031934","1",207282233,207283474,1241
"9808","Zm00001d031937","1",207438528,207441291,2763
"9809","Zm00001d031938","1",207474094,207480770,6676
"9810","Zm00001d031939","1",207515536,207517495,1959
"9811","Zm00001d031940","1",207526463,207529592,3129
"9812","Zm00001d031941","1",207588117,207591806,3689
"9813","Zm00001d031942","1",207636608,207639711,3103
"9814","Zm00001d031943","1",207690177,207696620,6443
"9815","Zm00001d031944","1",207696703,207697275,572
"9816","Zm00001d031945","1",207697841,207701019,3178
"9817","Zm00001d031946","1",207701153,207705140,3987
"9818","Zm00001d031948","1",207754045,207757465,3420
"9819","Zm00001d031949","1",207788455,207799885,11430
"9820","Zm00001d031952","1",207855994,207859754,3760
"9821","Zm00001d031953","1",207932227,207935640,3413
"9822","Zm00001d031954","1",207946264,207949970,3706
"9823","Zm00001d031956","1",207955044,207958736,3692
"9824","Zm00001d031958","1",208010722,208014853,4131
"9825","Zm00001d031961","1",208050358,208053463,3105
"9826","Zm00001d031962","1",208072495,208073445,950
"9827","Zm00001d031963","1",208073597,208078429,4832
"9828","Zm00001d031967","1",208218165,208223089,4924
"9829","Zm00001d031969","1",208240913,208243090,2177
"9830","Zm00001d031970","1",208243571,208247579,4008
"9831","Zm00001d031971","1",208252891,208254322,1431
"9832","Zm00001d031973","1",208328135,208356985,28850
"9833","Zm00001d031974","1",208332579,208332652,73
"9834","Zm00001d031975","1",208357440,208359412,1972
"9835","Zm00001d031976","1",208381831,208384444,2613
"9836","Zm00001d031977","1",208387893,208392229,4336
"9837","Zm00001d031979","1",208400551,208401401,850
"9838","Zm00001d031981","1",208507191,208517368,10177
"9839","Zm00001d031985","1",208668619,208669116,497
"9840","Zm00001d031986","1",208746944,208754876,7932
"9841","Zm00001d031987","1",208751063,208754709,3646
"9842","Zm00001d031988","1",208835364,208839440,4076
"9843","Zm00001d031991","1",208936535,208939125,2590
"9844","Zm00001d031992","1",208942917,208950782,7865
"9845","Zm00001d031993","1",208982124,208986152,4028
"9846","Zm00001d031995","1",209023193,209027377,4184
"9847","Zm00001d031996","1",209091746,209096011,4265
"9848","Zm00001d031997","1",209095982,209098528,2546
"9849","Zm00001d032000","1",209166877,209167593,716
"9850","Zm00001d032003","1",209210225,209211202,977
"9851","Zm00001d032004","1",209250225,209252198,1973
"9852","Zm00001d032010","1",209338030,209341591,3561
"9853","Zm00001d032012","1",209384220,209384639,419
"9854","Zm00001d032013","1",209386287,209386709,422
"9855","Zm00001d032016","1",209549016,209554713,5697
"9856","Zm00001d032019","1",209574119,209576739,2620
"9857","Zm00001d032022","1",209620860,209625239,4379
"9858","Zm00001d032023","1",209628481,209628804,323
"9859","Zm00001d032024","1",209721047,209722443,1396
"9860","Zm00001d032025","1",209767377,209768625,1248
"9861","Zm00001d032027","1",209851567,209853560,1993
"9862","Zm00001d032029","1",209942746,209947996,5250
"9863","Zm00001d032030","1",209949067,209949613,546
"9864","Zm00001d032031","1",209984017,209988153,4136
"9865","Zm00001d032032","1",209992350,209997511,5161
"9866","Zm00001d032035","1",210088187,210090275,2088
"9867","Zm00001d032036","1",210137790,210138853,1063
"9868","Zm00001d032040","1",210206509,210211370,4861
"9869","Zm00001d032042","1",210344733,210347136,2403
"9870","Zm00001d032044","1",210445252,210451544,6292
"9871","Zm00001d032045","1",210458385,210460255,1870
"9872","Zm00001d032046","1",210548810,210553536,4726
"9873","Zm00001d032049","1",210749060,210752906,3846
"9874","Zm00001d032052","1",210826979,210827707,728
"9875","Zm00001d032055","1",210913869,210916020,2151
"9876","Zm00001d032056","1",210966210,210973774,7564
"9877","Zm00001d032057","1",211041986,211046442,4456
"9878","Zm00001d032058","1",211054138,211060475,6337
"9879","Zm00001d032060","1",211112193,211116480,4287
"9880","Zm00001d032063","1",211138964,211139964,1000
"9881","Zm00001d032066","1",211186934,211188751,1817
"9882","Zm00001d032069","1",211229817,211232389,2572
"9883","Zm00001d032070","1",211247689,211248141,452
"9884","Zm00001d032072","1",211385712,211390492,4780
"9885","Zm00001d032073","1",211494652,211497588,2936
"9886","Zm00001d032075","1",211566333,211568228,1895
"9887","Zm00001d032076","1",211709321,211711127,1806
"9888","Zm00001d032078","1",211772301,211796592,24291
"9889","Zm00001d032079","1",211796761,211802432,5671
"9890","Zm00001d032081","1",211943365,211946180,2815
"9891","Zm00001d032085","1",212120273,212124691,4418
"9892","Zm00001d032090","1",212238638,212245323,6685
"9893","Zm00001d032091","1",212248940,212249338,398
"9894","Zm00001d032094","1",212314858,212315259,401
"9895","Zm00001d032095","1",212364322,212366865,2543
"9896","Zm00001d032096","1",212544489,212560643,16154
"9897","Zm00001d032098","1",212613867,212614897,1030
"9898","Zm00001d032099","1",212671142,212697676,26534
"9899","Zm00001d032100","1",212823128,212826208,3080
"9900","Zm00001d032101","1",212826023,212863575,37552
"9901","Zm00001d032102","1",213017762,213018352,590
"9902","Zm00001d032104","1",213129148,213132671,3523
"9903","Zm00001d032105","1",213134966,213136307,1341
"9904","Zm00001d032106","1",213138788,213140938,2150
"9905","Zm00001d032107","1",213151287,213157154,5867
"9906","Zm00001d032109","1",213250008,213254980,4972
"9907","Zm00001d032111","1",213313344,213321498,8154
"9908","Zm00001d032112","1",213424465,213434939,10474
"9909","Zm00001d032114","1",213508794,213513171,4377
"9910","Zm00001d032115","1",213530295,213530831,536
"9911","Zm00001d032116","1",213635320,213644930,9610
"9912","Zm00001d032118","1",213709256,213712753,3497
"9913","Zm00001d032120","1",213778926,213779774,848
"9914","Zm00001d032123","1",213820013,213822888,2875
"9915","Zm00001d032126","1",213878646,213879350,704
"9916","Zm00001d032127","1",213895961,213901572,5611
"9917","Zm00001d032128","1",213904619,213907090,2471
"9918","Zm00001d032130","1",213957721,213959642,1921
"9919","Zm00001d032131","1",213971572,213974101,2529
"9920","Zm00001d032139","1",214255636,214259163,3527
"9921","Zm00001d032142","1",214314919,214320679,5760
"9922","Zm00001d032144","1",214378154,214380573,2419
"9923","Zm00001d032146","1",214436611,214438401,1790
"9924","Zm00001d032148","1",214491081,214496190,5109
"9925","Zm00001d032152","1",214573739,214579407,5668
"9926","Zm00001d032153","1",214578151,214584860,6709
"9927","Zm00001d032154","1",214587763,214587836,73
"9928","Zm00001d032155","1",214591041,214592387,1346
"9929","Zm00001d032156","1",214671368,214678913,7545
"9930","Zm00001d032157","1",214720669,214725043,4374
"9931","Zm00001d032158","1",214729933,214731327,1394
"9932","Zm00001d032160","1",214976377,214992924,16547
"9933","Zm00001d032162","1",215112584,215113607,1023
"9934","Zm00001d032163","1",215117483,215125708,8225
"9935","Zm00001d032164","1",215220355,215221569,1214
"9936","Zm00001d032165","1",215245297,215249999,4702
"9937","Zm00001d032166","1",215348087,215367330,19243
"9938","Zm00001d032167","1",215376236,215379191,2955
"9939","Zm00001d032168","1",215396120,215403793,7673
"9940","Zm00001d032170","1",215420258,215425774,5516
"9941","Zm00001d032172","1",215551746,215556493,4747
"9942","Zm00001d032175","1",215598100,215599221,1121
"9943","Zm00001d032176","1",215603021,215603781,760
"9944","Zm00001d032178","1",215896905,215898543,1638
"9945","Zm00001d032181","1",216009436,216011564,2128
"9946","Zm00001d032183","1",216037845,216042486,4641
"9947","Zm00001d032184","1",216043555,216047590,4035
"9948","Zm00001d032185","1",216162798,216165577,2779
"9949","Zm00001d032186","1",216168360,216169854,1494
"9950","Zm00001d032187","1",216170771,216171955,1184
"9951","Zm00001d032188","1",216280294,216286285,5991
"9952","Zm00001d032189","1",216309382,216310438,1056
"9953","Zm00001d032190","1",216310588,216316345,5757
"9954","Zm00001d032192","1",216390881,216396455,5574
"9955","Zm00001d032194","1",216643340,216646707,3367
"9956","Zm00001d032198","1",216773235,216782201,8966
"9957","Zm00001d032199","1",216855137,216856299,1162
"9958","Zm00001d032200","1",216906544,216907368,824
"9959","Zm00001d032201","1",217006031,217008493,2462
"9960","Zm00001d032204","1",217014652,217015746,1094
"9961","Zm00001d032206","1",217042533,217044651,2118
"9962","Zm00001d032209","1",217181039,217182735,1696
"9963","Zm00001d032210","1",217245050,217250259,5209
"9964","Zm00001d032212","1",217252895,217258238,5343
"9965","Zm00001d032213","1",217293260,217296215,2955
"9966","Zm00001d032214","1",217341050,217343352,2302
"9967","Zm00001d032215","1",217379952,217386795,6843
"9968","Zm00001d032217","1",217455034,217455756,722
"9969","Zm00001d032220","1",217631090,217658099,27009
"9970","Zm00001d032221","1",217698465,217704350,5885
"9971","Zm00001d032222","1",217812762,217822354,9592
"9972","Zm00001d032223","1",217837369,217838681,1312
"9973","Zm00001d032224","1",217877924,217882338,4414
"9974","Zm00001d032225","1",217881333,217884547,3214
"9975","Zm00001d032226","1",217935240,217940439,5199
"9976","Zm00001d032227","1",217946906,217947872,966
"9977","Zm00001d032229","1",218000408,218005083,4675
"9978","Zm00001d032231","1",218057653,218061017,3364
"9979","Zm00001d032232","1",218081962,218088153,6191
"9980","Zm00001d032233","1",218157346,218158260,914
"9981","Zm00001d032238","1",218358529,218366044,7515
"9982","Zm00001d032239","1",218500155,218501623,1468
"9983","Zm00001d032240","1",218510675,218511967,1292
"9984","Zm00001d032242","1",218581174,218582804,1630
"9985","Zm00001d032245","1",218620388,218626605,6217
"9986","Zm00001d032249","1",218790654,218795894,5240
"9987","Zm00001d032250","1",218946249,218949077,2828
"9988","Zm00001d032253","1",219089997,219092203,2206
"9989","Zm00001d032256","1",219157413,219174593,17180
"9990","Zm00001d032257","1",219226773,219232499,5726
"9991","Zm00001d032260","1",219248901,219250308,1407
"9992","Zm00001d032261","1",219333374,219346185,12811
"9993","Zm00001d032262","1",219482430,219484802,2372
"9994","Zm00001d032263","1",219629525,219630314,789
"9995","Zm00001d032264","1",219659820,219661541,1721
"9996","Zm00001d032265","1",219763429,219764430,1001
"9997","Zm00001d032266","1",219764889,219772132,7243
"9998","Zm00001d032267","1",219821587,219829798,8211
"9999","Zm00001d032268","1",219850205,219860643,10438
"10000","Zm00001d032269","1",219853205,219856024,2819
"10001","Zm00001d032270","1",219863855,219870282,6427
"10002","Zm00001d032271","1",219873959,219876805,2846
"10003","Zm00001d032272","1",219876842,219879383,2541
"10004","Zm00001d032274","1",219947690,219952769,5079
"10005","Zm00001d032275","1",219957894,219959123,1229
"10006","Zm00001d032279","1",220036840,220043811,6971
"10007","Zm00001d032280","1",220119646,220124983,5337
"10008","Zm00001d032282","1",220213723,220251567,37844
"10009","Zm00001d032283","1",220368811,220372532,3721
"10010","Zm00001d032284","1",220400255,220402862,2607
"10011","Zm00001d032285","1",220441211,220441984,773
"10012","Zm00001d032287","1",220469097,220469879,782
"10013","Zm00001d032290","1",220497777,220497847,70
"10014","Zm00001d032292","1",220640969,220642533,1564
"10015","Zm00001d032293","1",220711403,220723144,11741
"10016","Zm00001d032295","1",220776886,220777674,788
"10017","Zm00001d032297","1",220858595,220858939,344
"10018","Zm00001d032298","1",220971335,220973749,2414
"10019","Zm00001d032299","1",221079602,221082180,2578
"10020","Zm00001d032300","1",221083224,221085513,2289
"10021","Zm00001d032301","1",221117789,221131935,14146
"10022","Zm00001d032303","1",221288907,221296871,7964
"10023","Zm00001d034527","1",295685533,295686417,884
"10024","Zm00001d034528","1",295707225,295710471,3246
"10025","Zm00001d034529","1",295713001,295716380,3379
"10026","Zm00001d034530","1",295746232,295746945,713
"10027","Zm00001d034531","1",295750532,295760489,9957
"10028","Zm00001d034532","1",295767868,295772497,4629
"10029","Zm00001d034533","1",295778554,295782540,3986
"10030","Zm00001d034534","1",295789807,295791193,1386
"10031","Zm00001d034536","1",295853517,295853873,356
"10032","Zm00001d034537","1",295854827,295875739,20912
"10033","Zm00001d034543","1",295923427,295924026,599
"10034","Zm00001d034547","1",295996848,295998888,2040
"10035","Zm00001d034550","1",296028286,296030453,2167
"10036","Zm00001d034551","1",296036999,296045917,8918
"10037","Zm00001d034553","1",296072136,296078144,6008
"10038","Zm00001d034555","1",296175631,296185070,9439
"10039","Zm00001d034558","1",296303849,296305238,1389
"10040","Zm00001d034559","1",296317213,296319077,1864
"10041","Zm00001d034560","1",296362258,296363690,1432
"10042","Zm00001d034561","1",296363993,296366195,2202
"10043","Zm00001d034562","1",296437168,296441398,4230
"10044","Zm00001d034563","1",296443576,296444124,548
"10045","Zm00001d034564","1",296458782,296462896,4114
"10046","Zm00001d034565","1",296464261,296472088,7827
"10047","Zm00001d034568","1",296485583,296489077,3494
"10048","Zm00001d034569","1",296489820,296491595,1775
"10049","Zm00001d034571","1",296596877,296600683,3806
"10050","Zm00001d034572","1",296603347,296604114,767
"10051","Zm00001d034573","1",296609991,296611334,1343
"10052","Zm00001d034575","1",296750495,296755871,5376
"10053","Zm00001d034577","1",296865348,296871683,6335
"10054","Zm00001d034578","1",296914952,296930870,15918
"10055","Zm00001d034581","1",297039554,297047940,8386
"10056","Zm00001d034582","1",297049820,297072520,22700
"10057","Zm00001d034586","1",297171528,297188267,16739
"10058","Zm00001d034588","1",297243182,297244057,875
"10059","Zm00001d034590","1",297307679,297316251,8572
"10060","Zm00001d034591","1",297382217,297386554,4337
"10061","Zm00001d034594","1",297407254,297414623,7369
"10062","Zm00001d034595","1",297417890,297419492,1602
"10063","Zm00001d034596","1",297421545,297422826,1281
"10064","Zm00001d034597","1",297445060,297449584,4524
"10065","Zm00001d034598","1",297473677,297474069,392
"10066","Zm00001d034600","1",297593232,297596522,3290
"10067","Zm00001d034601","1",297601946,297603764,1818
"10068","Zm00001d034602","1",297605177,297611407,6230
"10069","Zm00001d034604","1",297614826,297618473,3647
"10070","Zm00001d034605","1",297620879,297621595,716
"10071","Zm00001d034606","1",297653338,297656301,2963
"10072","Zm00001d034607","1",297658231,297671159,12928
"10073","Zm00001d034608","1",297744154,297748093,3939
"10074","Zm00001d034609","1",297759749,297762863,3114
"10075","Zm00001d034610","1",297799649,297803579,3930
"10076","Zm00001d034615","1",297858445,297859673,1228
"10077","Zm00001d034616","1",297863276,297876107,12831
"10078","Zm00001d034617","1",297877086,297882893,5807
"10079","Zm00001d034618","1",297932748,297939999,7251
"10080","Zm00001d034620","1",298045580,298050390,4810
"10081","Zm00001d034621","1",298057974,298062686,4712
"10082","Zm00001d034622","1",298180647,298181981,1334
"10083","Zm00001d034624","1",298189987,298238898,48911
"10084","Zm00001d034627","1",298407976,298412063,4087
"10085","Zm00001d034628","1",298412338,298414927,2589
"10086","Zm00001d034629","1",298422859,298427050,4191
"10087","Zm00001d034630","1",298527321,298536055,8734
"10088","Zm00001d034633","1",298548893,298572907,24014
"10089","Zm00001d034634","1",298573878,298575017,1139
"10090","Zm00001d034635","1",298580972,298582430,1458
"10091","Zm00001d034636","1",298592574,298596045,3471
"10092","Zm00001d034638","1",298677159,298680740,3581
"10093","Zm00001d034640","1",298682827,298693357,10530
"10094","Zm00001d034641","1",298696773,298697294,521
"10095","Zm00001d034642","1",298700432,298700869,437
"10096","Zm00001d034643","1",298704379,298705314,935
"10097","Zm00001d034644","1",298705539,298708107,2568
"10098","Zm00001d034646","1",298726650,298734070,7420
"10099","Zm00001d034649","1",298761458,298764905,3447
"10100","Zm00001d034650","1",298808277,298816782,8505
"10101","Zm00001d034652","1",298897452,298899145,1693
"10102","Zm00001d034655","1",298994999,298998450,3451
"10103","Zm00001d034659","1",299111288,299113821,2533
"10104","Zm00001d034662","1",299188693,299193386,4693
"10105","Zm00001d034663","1",299194181,299196764,2583
"10106","Zm00001d034664","1",299204252,299206111,1859
"10107","Zm00001d034665","1",299210476,299212684,2208
"10108","Zm00001d034666","1",299212811,299215143,2332
"10109","Zm00001d034667","1",299308121,299311210,3089
"10110","Zm00001d034668","1",299311424,299313518,2094
"10111","Zm00001d034669","1",299321980,299323654,1674
"10112","Zm00001d034670","1",299438171,299441658,3487
"10113","Zm00001d034673","1",299503736,299505297,1561
"10114","Zm00001d034675","1",299603375,299608703,5328
"10115","Zm00001d034676","1",299606219,299608703,2484
"10116","Zm00001d034677","1",299617924,299618295,371
"10117","Zm00001d034678","1",299619441,299623771,4330
"10118","Zm00001d034679","1",299640924,299643142,2218
"10119","Zm00001d034680","1",299646950,299647240,290
"10120","Zm00001d034682","1",299670183,299673346,3163
"10121","Zm00001d034688","1",300052846,300055171,2325
"10122","Zm00001d034689","1",300057445,300062985,5540
"10123","Zm00001d034690","1",300083387,300085808,2421
"10124","Zm00001d034692","1",300145669,300147246,1577
"10125","Zm00001d034698","1",300196498,300198969,2471
"10126","Zm00001d034699","1",300199124,300207782,8658
"10127","Zm00001d034700","1",300208996,300210414,1418
"10128","Zm00001d034701","1",300239123,300249012,9889
"10129","Zm00001d034702","1",300265094,300268087,2993
"10130","Zm00001d034703","1",300277335,300280466,3131
"10131","Zm00001d034705","1",300345623,300345976,353
"10132","Zm00001d034706","1",300346551,300349807,3256
"10133","Zm00001d034710","1",300423240,300426736,3496
"10134","Zm00001d034711","1",300433186,300446993,13807
"10135","Zm00001d034713","1",300502986,300509397,6411
"10136","Zm00001d034714","1",300523648,300526448,2800
"10137","Zm00001d034715","1",300526733,300527389,656
"10138","Zm00001d034717","1",300607639,300610410,2771
"10139","Zm00001d034718","1",300613074,300615633,2559
"10140","Zm00001d034719","1",300615968,300619520,3552
"10141","Zm00001d034721","1",300730265,300737926,7661
"10142","Zm00001d034724","1",300787677,300789731,2054
"10143","Zm00001d034725","1",300790094,300803516,13422
"10144","Zm00001d034726","1",300808420,300811355,2935
"10145","Zm00001d034727","1",300812534,300816835,4301
"10146","Zm00001d034728","1",300852126,300852206,80
"10147","Zm00001d034729","1",300852251,300854480,2229
"10148","Zm00001d034730","1",300925472,300932654,7182
"10149","Zm00001d034733","1",300954125,300961062,6937
"10150","Zm00001d034734","1",300963200,300969299,6099
"10151","Zm00001d034735","1",300973286,300979402,6116
"10152","Zm00001d034736","1",300979516,300987458,7942
"10153","Zm00001d034738","1",300991818,300995223,3405
"10154","Zm00001d034739","1",301037532,301040854,3322
"10155","Zm00001d034740","1",301042431,301052478,10047
"10156","Zm00001d034749","1",301292516,301293945,1429
"10157","Zm00001d034750","1",301294415,301300276,5861
"10158","Zm00001d034751","1",301301000,301302433,1433
"10159","Zm00001d034752","1",301368751,301374143,5392
"10160","Zm00001d034754","1",301379862,301384541,4679
"10161","Zm00001d034755","1",301473105,301476569,3464
"10162","Zm00001d034756","1",301479326,301479550,224
"10163","Zm00001d034757","1",301487722,301492737,5015
"10164","Zm00001d034758","1",301493011,301499561,6550
"10165","Zm00001d034759","1",301498813,301507653,8840
"10166","Zm00001d034760","1",301511660,301512118,458
"10167","Zm00001d034761","1",301513634,301517295,3661
"10168","Zm00001d034763","1",301648441,301649091,650
"10169","Zm00001d034764","1",301652253,301663297,11044
"10170","Zm00001d034765","1",301663423,301667397,3974
"10171","Zm00001d034766","1",301668048,301674553,6505
"10172","Zm00001d034767","1",301670562,301672235,1673
"10173","Zm00001d034768","1",301674705,301677768,3063
"10174","Zm00001d034769","1",301678066,301679914,1848
"10175","Zm00001d034770","1",301722755,301728981,6226
"10176","Zm00001d034771","1",301729871,301734996,5125
"10177","Zm00001d034772","1",301737379,301745945,8566
"10178","Zm00001d034773","1",301813401,301817696,4295
"10179","Zm00001d034776","1",301956046,301960341,4295
"10180","Zm00001d034777","1",302038413,302052740,14327
"10181","Zm00001d034778","1",302094745,302097912,3167
"10182","Zm00001d034779","1",302131899,302140148,8249
"10183","Zm00001d034781","1",302141835,302144393,2558
"10184","Zm00001d034782","1",302188639,302191274,2635
"10185","Zm00001d034783","1",302248572,302249757,1185
"10186","Zm00001d034784","1",302249936,302255526,5590
"10187","Zm00001d034786","1",302260422,302261451,1029
"10188","Zm00001d034787","1",302327912,302328268,356
"10189","Zm00001d034788","1",302328675,302332694,4019
"10190","Zm00001d034789","1",302343321,302354045,10724
"10191","Zm00001d034790","1",302359166,302360795,1629
"10192","Zm00001d034793","1",302370318,302373835,3517
"10193","Zm00001d034795","1",302374919,302378019,3100
"10194","Zm00001d034796","1",302378485,302387299,8814
"10195","Zm00001d034797","1",302387959,302392251,4292
"10196","Zm00001d034799","1",302426741,302443706,16965
"10197","Zm00001d034800","1",302439971,302442199,2228
"10198","Zm00001d034802","1",302452574,302453711,1137
"10199","Zm00001d034803","1",302454681,302456022,1341
"10200","Zm00001d034804","1",302468902,302475499,6597
"10201","Zm00001d034805","1",302475601,302480366,4765
"10202","Zm00001d034807","1",302526883,302530155,3272
"10203","Zm00001d034808","1",302533836,302535390,1554
"10204","Zm00001d034809","1",302535593,302541414,5821
"10205","Zm00001d034810","1",302660432,302670600,10168
"10206","Zm00001d034813","1",302791729,302795556,3827
"10207","Zm00001d034814","1",302796292,302800087,3795
"10208","Zm00001d034815","1",302807392,302811840,4448
"10209","Zm00001d034817","1",302864305,302869515,5210
"10210","Zm00001d034818","1",302869321,302871471,2150
"10211","Zm00001d034819","1",302901136,302931115,29979
"10212","Zm00001d034820","1",302902039,302905454,3415
"10213","Zm00001d034822","1",302960088,302960468,380
"10214","Zm00001d034823","1",302960680,302983520,22840
"10215","Zm00001d034824","1",303002514,303005849,3335
"10216","Zm00001d034826","1",303088440,303107650,19210
"10217","Zm00001d034828","1",303240120,303243318,3198
"10218","Zm00001d034829","1",303243570,303245421,1851
"10219","Zm00001d034832","1",303279392,303289233,9841
"10220","Zm00001d034833","1",303290870,303296987,6117
"10221","Zm00001d034834","1",303356686,303362830,6144
"10222","Zm00001d034835","1",303405547,303411273,5726
"10223","Zm00001d034837","1",303457380,303464429,7049
"10224","Zm00001d034838","1",303465803,303469125,3322
"10225","Zm00001d034839","1",303573712,303576362,2650
"10226","Zm00001d034840","1",303626153,303630953,4800
"10227","Zm00001d034841","1",303631232,303633793,2561
"10228","Zm00001d034842","1",303635045,303640977,5932
"10229","Zm00001d034844","1",303656953,303658077,1124
"10230","Zm00001d034847","1",303729513,303730689,1176
"10231","Zm00001d034849","1",303792655,303793395,740
"10232","Zm00001d034851","1",303807485,303811541,4056
"10233","Zm00001d034852","1",303812821,303814256,1435
"10234","Zm00001d034853","1",303814428,303823171,8743
"10235","Zm00001d034854","1",303819736,303820083,347
"10236","Zm00001d034855","1",303826078,303828317,2239
"10237","Zm00001d034856","1",303903433,303908535,5102
"10238","Zm00001d034857","1",303909143,303913644,4501
"10239","Zm00001d034858","1",303927049,303933356,6307
"10240","Zm00001d034859","1",303989634,303999266,9632
"10241","Zm00001d034861","1",304048000,304050468,2468
"10242","Zm00001d034862","1",304066276,304071752,5476
"10243","Zm00001d034863","1",304072241,304074510,2269
"10244","Zm00001d034865","1",304197047,304201731,4684
"10245","Zm00001d034866","1",304245991,304249075,3084
"10246","Zm00001d034867","1",304250018,304253134,3116
"10247","Zm00001d034868","1",304297227,304304164,6937
"10248","Zm00001d034869","1",304307771,304308706,935
"10249","Zm00001d034870","1",304364836,304366540,1704
"10250","Zm00001d034871","1",304367515,304374498,6983
"10251","Zm00001d034872","1",304416011,304432351,16340
"10252","Zm00001d034874","1",304504591,304505238,647
"10253","Zm00001d034875","1",304506320,304508029,1709
"10254","Zm00001d034876","1",304508433,304511777,3344
"10255","Zm00001d034877","1",304523485,304527283,3798
"10256","Zm00001d034878","1",304528151,304532805,4654
"10257","Zm00001d034879","1",304583080,304585959,2879
"10258","Zm00001d034880","1",304586358,304588432,2074
"10259","Zm00001d034881","1",304634792,304634863,71
"10260","Zm00001d034882","1",304635949,304637841,1892
"10261","Zm00001d034883","1",304654639,304663130,8491
"10262","Zm00001d034884","1",304663940,304664545,605
"10263","Zm00001d034885","1",304665327,304670409,5082
"10264","Zm00001d034886","1",304715056,304719918,4862
"10265","Zm00001d034887","1",304719959,304724455,4496
"10266","Zm00001d034888","1",304812196,304817687,5491
"10267","Zm00001d034890","1",304868663,304870630,1967
"10268","Zm00001d034891","1",304942283,304943362,1079
"10269","Zm00001d034892","1",304951395,304953545,2150
"10270","Zm00001d034893","1",304954443,304956251,1808
"10271","Zm00001d034894","1",304956316,304965176,8860
"10272","Zm00001d034896","1",305008203,305016567,8364
"10273","Zm00001d034897","1",305016972,305017895,923
"10274","Zm00001d034898","1",305074531,305075830,1299
"10275","Zm00001d034900","1",305107084,305114359,7275
"10276","Zm00001d034901","1",305155510,305156325,815
"10277","Zm00001d034902","1",305164541,305174371,9830
"10278","Zm00001d034903","1",305187879,305194236,6357
"10279","Zm00001d034904","1",305196308,305215804,19496
"10280","Zm00001d034914","1",305341236,305352529,11293
"10281","Zm00001d034915","1",305480111,305488179,8068
"10282","Zm00001d034916","1",305500618,305502078,1460
"10283","Zm00001d034917","1",305581369,305583763,2394
"10284","Zm00001d034918","1",305584149,305593344,9195
"10285","Zm00001d034919","1",305598350,305602628,4278
"10286","Zm00001d034926","1",305709868,305711289,1421
"10287","Zm00001d034927","1",305714286,305755159,40873
"10288","Zm00001d034929","1",305907516,305922174,14658
"10289","Zm00001d034930","1",305980365,305984258,3893
"10290","Zm00001d034931","1",306058017,306071684,13667
"10291","Zm00001d034932","1",306072454,306079843,7389
"10292","Zm00001d034933","1",306079959,306082079,2120
"10293","Zm00001d034934","1",306090107,306097264,7157
"10294","Zm00001d034935","1",306096938,306104725,7787
"10295","Zm00001d034937","1",306104647,306106885,2238
"10296","Zm00001d034939","1",306109761,306110705,944
"10297","Zm00001d034940","1",306164038,306173049,9011
"10298","Zm00001d034941","1",306278603,306290988,12385
"10299","Zm00001d034944","1",306357091,306362992,5901
"10300","Zm00001d034948","1",306476631,306490356,13725
"10301","Zm00001d034949","1",306490318,306502810,12492
"10302","Zm00001d034951","1",306507953,306512709,4756
"10303","Zm00001d034954","1",306615432,306619937,4505
"10304","Zm00001d034956","1",306759808,306765061,5253
"10305","Zm00001d034957","1",306770166,306782324,12158
"10306","Zm00001d034958","1",306780813,306780884,71
"10307","Zm00001d034961","1",306881094,306895296,14202
"10308","Zm00001d034962","1",306901992,306921360,19368
"10309","Zm00001d034964","6",168702,179846,11144
"10310","Zm00001d034965","6",290046,293456,3410
"10311","Zm00001d034967","6",378466,379260,794
"10312","Zm00001d034968","6",379629,385466,5837
"10313","Zm00001d034969","6",387465,388055,590
"10314","Zm00001d034970","6",388280,393342,5062
"10315","Zm00001d034971","6",394181,394622,441
"10316","Zm00001d034972","6",395120,395632,512
"10317","Zm00001d034976","6",639235,639876,641
"10318","Zm00001d034977","6",663669,664313,644
"10319","Zm00001d034978","6",669527,670473,946
"10320","Zm00001d034983","6",786226,787774,1548
"10321","Zm00001d034987","6",1186173,1188041,1868
"10322","Zm00001d034989","6",1276197,1278370,2173
"10323","Zm00001d034990","6",1282754,1285886,3132
"10324","Zm00001d034991","6",1288136,1289143,1007
"10325","Zm00001d034994","6",1298039,1299943,1904
"10326","Zm00001d034995","6",1301118,1301916,798
"10327","Zm00001d034996","6",1302166,1309663,7497
"10328","Zm00001d034998","6",1386203,1390125,3922
"10329","Zm00001d035000","6",1390494,1390883,389
"10330","Zm00001d035001","6",1392078,1392530,452
"10331","Zm00001d035003","6",1425009,1425431,422
"10332","Zm00001d035004","6",1571189,1578809,7620
"10333","Zm00001d035005","6",1580635,1581624,989
"10334","Zm00001d035007","6",1587121,1589211,2090
"10335","Zm00001d035008","6",1589350,1593458,4108
"10336","Zm00001d035012","6",1757035,1760133,3098
"10337","Zm00001d035014","6",1838710,1842269,3559
"10338","Zm00001d035015","6",1843376,1848804,5428
"10339","Zm00001d035016","6",1849044,1850408,1364
"10340","Zm00001d035018","6",1944121,1945548,1427
"10341","Zm00001d035019","6",1974388,1978132,3744
"10342","Zm00001d035020","6",1979873,1980595,722
"10343","Zm00001d035023","6",2023761,2029181,5420
"10344","Zm00001d035024","6",2029427,2030407,980
"10345","Zm00001d035027","6",2121872,2122879,1007
"10346","Zm00001d035029","6",2395367,2400258,4891
"10347","Zm00001d035030","6",2402490,2409609,7119
"10348","Zm00001d035031","6",2448389,2453527,5138
"10349","Zm00001d035032","6",2454457,2462132,7675
"10350","Zm00001d035033","6",2457269,2461309,4040
"10351","Zm00001d035034","6",2462763,2465579,2816
"10352","Zm00001d035035","6",2629622,2632216,2594
"10353","Zm00001d035037","6",2749867,2752420,2553
"10354","Zm00001d035038","6",2749869,2752983,3114
"10355","Zm00001d035039","6",2915191,2918505,3314
"10356","Zm00001d035040","6",2922110,2930058,7948
"10357","Zm00001d035041","6",2930352,2945593,15241
"10358","Zm00001d035044","6",3023414,3028818,5404
"10359","Zm00001d035046","6",3073940,3078802,4862
"10360","Zm00001d035047","6",3079206,3085065,5859
"10361","Zm00001d035048","6",3086730,3108794,22064
"10362","Zm00001d035049","6",3099877,3101179,1302
"10363","Zm00001d035050","6",3217441,3223266,5825
"10364","Zm00001d035051","6",3226476,3230772,4296
"10365","Zm00001d035052","6",3230939,3233671,2732
"10366","Zm00001d035053","6",3271721,3274263,2542
"10367","Zm00001d035054","6",3285705,3286769,1064
"10368","Zm00001d035056","6",3352342,3357658,5316
"10369","Zm00001d035061","6",3460509,3462191,1682
"10370","Zm00001d035063","6",3469975,3471537,1562
"10371","Zm00001d035065","6",3644758,3653000,8242
"10372","Zm00001d035066","6",3697990,3701900,3910
"10373","Zm00001d035067","6",3702448,3703809,1361
"10374","Zm00001d035070","6",3733815,3735288,1473
"10375","Zm00001d035072","6",3828452,3832726,4274
"10376","Zm00001d035079","6",4023664,4024023,359
"10377","Zm00001d035081","6",4037971,4039290,1319
"10378","Zm00001d035082","6",4052637,4054293,1656
"10379","Zm00001d035086","6",4484147,4489968,5821
"10380","Zm00001d035087","6",4639411,4640898,1487
"10381","Zm00001d035088","6",4651758,4659867,8109
"10382","Zm00001d035089","6",4680671,4738066,57395
"10383","Zm00001d035090","6",4848921,4853314,4393
"10384","Zm00001d035091","6",4886853,4890981,4128
"10385","Zm00001d035092","6",4891397,4894111,2714
"10386","Zm00001d035093","6",4928001,4934917,6916
"10387","Zm00001d035094","6",4936802,4938697,1895
"10388","Zm00001d035095","6",4940987,4941433,446
"10389","Zm00001d035097","6",5178432,5182053,3621
"10390","Zm00001d035098","6",5182910,5186989,4079
"10391","Zm00001d035113","6",5768605,5775689,7084
"10392","Zm00001d035115","6",5904499,5909575,5076
"10393","Zm00001d035119","6",6131054,6133096,2042
"10394","Zm00001d035124","6",6263975,6266626,2651
"10395","Zm00001d035127","6",6313716,6315756,2040
"10396","Zm00001d035130","6",6496546,6500773,4227
"10397","Zm00001d035131","6",6508662,6511580,2918
"10398","Zm00001d035132","6",6529948,6531022,1074
"10399","Zm00001d035133","6",6531539,6534487,2948
"10400","Zm00001d035134","6",6607237,6608610,1373
"10401","Zm00001d035135","6",6610861,6611724,863
"10402","Zm00001d035136","6",6620118,6623924,3806
"10403","Zm00001d035139","6",6672824,6678678,5854
"10404","Zm00001d035140","6",6799751,6803506,3755
"10405","Zm00001d035141","6",6853985,6855853,1868
"10406","Zm00001d035143","6",6884406,6891194,6788
"10407","Zm00001d035145","6",6901070,6907660,6590
"10408","Zm00001d035147","6",6922741,6924499,1758
"10409","Zm00001d035151","6",7062012,7065762,3750
"10410","Zm00001d035153","6",7125784,7140658,14874
"10411","Zm00001d035154","6",7194856,7195790,934
"10412","Zm00001d035156","6",7238033,7242155,4122
"10413","Zm00001d035157","6",7246875,7250944,4069
"10414","Zm00001d035161","6",7394931,7396934,2003
"10415","Zm00001d035162","6",7402215,7405017,2802
"10416","Zm00001d035166","6",7479108,7485895,6787
"10417","Zm00001d035167","6",7486918,7493035,6117
"10418","Zm00001d035168","6",7509306,7511675,2369
"10419","Zm00001d035169","6",7512647,7517103,4456
"10420","Zm00001d035170","6",7517294,7521650,4356
"10421","Zm00001d035171","6",7522119,7522793,674
"10422","Zm00001d035172","6",7609917,7612666,2749
"10423","Zm00001d035174","6",7777229,7778628,1399
"10424","Zm00001d035182","6",8508247,8512593,4346
"10425","Zm00001d035183","6",8514154,8561029,46875
"10426","Zm00001d035184","6",8532240,8535334,3094
"10427","Zm00001d035185","6",8562525,8568023,5498
"10428","Zm00001d035186","6",8568669,8572990,4321
"10429","Zm00001d035187","6",8604693,8614098,9405
"10430","Zm00001d035191","6",8696067,8700892,4825
"10431","Zm00001d035194","6",8811527,8823988,12461
"10432","Zm00001d035195","6",9103154,9104875,1721
"10433","Zm00001d035197","6",9555507,9559749,4242
"10434","Zm00001d035198","6",9592817,9598393,5576
"10435","Zm00001d035199","6",9598517,9602960,4443
"10436","Zm00001d035200","6",9608412,9611522,3110
"10437","Zm00001d035201","6",9611943,9614439,2496
"10438","Zm00001d035203","6",9886843,9887571,728
"10439","Zm00001d035205","6",9894892,9898049,3157
"10440","Zm00001d035206","6",9899027,9902389,3362
"10441","Zm00001d035207","6",9902165,9905067,2902
"10442","Zm00001d035208","6",9905774,9910868,5094
"10443","Zm00001d035209","6",9955603,9963747,8144
"10444","Zm00001d035211","6",10030184,10032712,2528
"10445","Zm00001d035212","6",10035680,10040260,4580
"10446","Zm00001d035214","6",10070049,10071716,1667
"10447","Zm00001d035215","6",10273734,10275321,1587
"10448","Zm00001d035217","6",10796872,10800007,3135
"10449","Zm00001d035222","6",13560156,13560807,651
"10450","Zm00001d035223","6",14840977,14841850,873
"10451","Zm00001d035224","6",14927596,14930694,3098
"10452","Zm00001d035226","6",15067955,15073521,5566
"10453","Zm00001d035228","6",15529973,15536315,6342
"10454","Zm00001d035229","6",15530206,15536423,6217
"10455","Zm00001d035230","6",15651139,15656858,5719
"10456","Zm00001d035233","6",15856602,15857420,818
"10457","Zm00001d035234","6",15908223,15911138,2915
"10458","Zm00001d035235","6",16089925,16093478,3553
"10459","Zm00001d035238","6",16209897,16210569,672
"10460","Zm00001d035243","6",16653132,16655500,2368
"10461","Zm00001d035247","6",17131320,17132878,1558
"10462","Zm00001d035253","6",17370147,17373221,3074
"10463","Zm00001d035254","6",17432744,17436513,3769
"10464","Zm00001d035256","6",17759389,17765846,6457
"10465","Zm00001d035265","6",18506310,18512656,6346
"10466","Zm00001d035266","6",18673737,18675956,2219
"10467","Zm00001d035267","6",18771626,18781091,9465
"10468","Zm00001d035270","6",18835384,18859581,24197
"10469","Zm00001d035272","6",18876921,18881933,5012
"10470","Zm00001d035277","6",18983813,18992571,8758
"10471","Zm00001d035282","6",19123350,19126973,3623
"10472","Zm00001d035285","6",19340069,19371142,31073
"10473","Zm00001d035286","6",19371307,19372534,1227
"10474","Zm00001d035288","6",19435950,19439086,3136
"10475","Zm00001d035292","6",19565187,19578045,12858
"10476","Zm00001d035295","6",19729794,19731113,1319
"10477","Zm00001d035297","6",19825441,19828506,3065
"10478","Zm00001d035298","6",20153344,20157157,3813
"10479","Zm00001d035300","6",20188276,20191916,3640
"10480","Zm00001d035302","6",20202492,20204651,2159
"10481","Zm00001d035303","6",20251536,20254777,3241
"10482","Zm00001d035304","6",20284434,20286443,2009
"10483","Zm00001d035308","6",20483349,20484802,1453
"10484","Zm00001d035309","6",20496866,20498915,2049
"10485","Zm00001d035312","6",20659538,20661422,1884
"10486","Zm00001d035313","6",20661472,20668061,6589
"10487","Zm00001d035316","6",20920294,20923478,3184
"10488","Zm00001d035317","6",21025043,21027063,2020
"10489","Zm00001d035318","6",21027078,21031220,4142
"10490","Zm00001d035319","6",21080138,21084105,3967
"10491","Zm00001d035320","6",21080833,21082955,2122
"10492","Zm00001d035321","6",21256645,21260184,3539
"10493","Zm00001d035322","6",21261630,21262670,1040
"10494","Zm00001d035323","6",21265695,21270357,4662
"10495","Zm00001d035324","6",21486382,21487838,1456
"10496","Zm00001d035327","6",21498495,21499851,1356
"10497","Zm00001d035331","6",21637975,21638871,896
"10498","Zm00001d035333","6",21731801,21733345,1544
"10499","Zm00001d035336","6",21911375,21912966,1591
"10500","Zm00001d035337","6",22131705,22136034,4329
"10501","Zm00001d035342","6",22541950,22547738,5788
"10502","Zm00001d035343","6",22590673,22592360,1687
"10503","Zm00001d035345","6",22712369,22715419,3050
"10504","Zm00001d035346","6",22716458,22744646,28188
"10505","Zm00001d035352","6",22881829,22885514,3685
"10506","Zm00001d035353","6",22893510,22897636,4126
"10507","Zm00001d035355","6",22916653,22917279,626
"10508","Zm00001d035356","6",22919577,22924317,4740
"10509","Zm00001d035361","6",23197365,23197934,569
"10510","Zm00001d035363","6",23249144,23250184,1040
"10511","Zm00001d035367","6",23489630,23490985,1355
"10512","Zm00001d035370","6",23533386,23543798,10412
"10513","Zm00001d035373","6",23598971,23600643,1672
"10514","Zm00001d035376","6",23625541,23627815,2274
"10515","Zm00001d035378","6",23702809,23703670,861
"10516","Zm00001d035380","6",23741615,23759660,18045
"10517","Zm00001d035381","6",23814150,23826050,11900
"10518","Zm00001d035383","6",23855551,23859413,3862
"10519","Zm00001d035384","6",23863047,23864551,1504
"10520","Zm00001d035385","6",23869436,23871569,2133
"10521","Zm00001d035388","6",23985993,23989396,3403
"10522","Zm00001d035390","6",24034207,24035363,1156
"10523","Zm00001d035394","6",24085988,24086621,633
"10524","Zm00001d035395","6",24184508,24189866,5358
"10525","Zm00001d035396","6",24239055,24239666,611
"10526","Zm00001d035399","6",24382650,24383348,698
"10527","Zm00001d035400","6",24389981,24393065,3084
"10528","Zm00001d035401","6",24413321,24417330,4009
"10529","Zm00001d035405","6",24545079,24550005,4926
"10530","Zm00001d035408","6",24597448,24602772,5324
"10531","Zm00001d035409","6",24606673,24607624,951
"10532","Zm00001d035411","6",24619825,24620448,623
"10533","Zm00001d035412","6",24622541,24623056,515
"10534","Zm00001d035413","6",24624255,24626622,2367
"10535","Zm00001d035416","6",24679308,24680201,893
"10536","Zm00001d035420","6",24798510,24811775,13265
"10537","Zm00001d035421","6",24808273,24808344,71
"10538","Zm00001d035425","6",25085565,25087524,1959
"10539","Zm00001d035428","6",25148734,25158121,9387
"10540","Zm00001d035429","6",25236764,25238668,1904
"10541","Zm00001d035432","6",25296476,25297576,1100
"10542","Zm00001d035436","6",25379199,25381589,2390
"10543","Zm00001d035439","6",25561769,25573225,11456
"10544","Zm00001d035440","6",25657757,25658164,407
"10545","Zm00001d035442","6",25692879,25694442,1563
"10546","Zm00001d035443","6",25695036,25697069,2033
"10547","Zm00001d035444","6",25699705,25702944,3239
"10548","Zm00001d035445","6",25930825,25935845,5020
"10549","Zm00001d035447","6",25987801,25991237,3436
"10550","Zm00001d035454","6",26665268,26667442,2174
"10551","Zm00001d035455","6",26712933,26714735,1802
"10552","Zm00001d035457","6",27101237,27102244,1007
"10553","Zm00001d035459","6",27552329,27553452,1123
"10554","Zm00001d035460","6",27592072,27592829,757
"10555","Zm00001d035461","6",27593378,27604272,10894
"10556","Zm00001d035462","6",27973065,27977307,4242
"10557","Zm00001d035465","6",28058154,28062105,3951
"10558","Zm00001d035466","6",28062742,28064462,1720
"10559","Zm00001d035467","6",28070797,28073319,2522
"10560","Zm00001d035468","6",28113842,28124886,11044
"10561","Zm00001d035470","6",28271626,28278463,6837
"10562","Zm00001d035473","6",28367590,28369394,1804
"10563","Zm00001d035474","6",28423443,28424771,1328
"10564","Zm00001d035475","6",28512487,28520162,7675
"10565","Zm00001d035476","6",28516750,28525006,8256
"10566","Zm00001d035480","6",28848312,28852083,3771
"10567","Zm00001d035481","6",28892826,28895114,2288
"10568","Zm00001d035486","6",28935061,28936266,1205
"10569","Zm00001d035487","6",28937404,28984699,47295
"10570","Zm00001d035491","6",29350755,29354204,3449
"10571","Zm00001d035492","6",29354372,29358451,4079
"10572","Zm00001d035494","6",29418421,29421817,3396
"10573","Zm00001d035495","6",29421477,29421860,383
"10574","Zm00001d035496","6",29547936,29556968,9032
"10575","Zm00001d035500","6",29602357,29604686,2329
"10576","Zm00001d035501","6",29604686,29608198,3512
"10577","Zm00001d035503","6",29659076,29671285,12209
"10578","Zm00001d035505","6",29708148,29709035,887
"10579","Zm00001d035506","6",29709357,29715541,6184
"10580","Zm00001d035512","6",30481710,30486777,5067
"10581","Zm00001d035514","6",30749990,30753788,3798
"10582","Zm00001d035515","6",30753913,30769215,15302
"10583","Zm00001d035516","6",30787286,30789384,2098
"10584","Zm00001d035519","6",30807740,30811745,4005
"10585","Zm00001d035522","6",30888098,30889674,1576
"10586","Zm00001d035526","6",31115181,31121906,6725
"10587","Zm00001d035527","6",31122714,31126829,4115
"10588","Zm00001d035534","6",31463453,31467628,4175
"10589","Zm00001d035538","6",31606612,31609526,2914
"10590","Zm00001d035539","6",31609619,31611749,2130
"10591","Zm00001d035540","6",31625578,31629872,4294
"10592","Zm00001d035541","6",31644207,31644798,591
"10593","Zm00001d035542","6",31728237,31733132,4895
"10594","Zm00001d035543","6",31734049,31736839,2790
"10595","Zm00001d035548","6",32695621,32699342,3721
"10596","Zm00001d035551","6",32902155,32905929,3774
"10597","Zm00001d035552","6",32906724,32909899,3175
"10598","Zm00001d035553","6",32910876,32913020,2144
"10599","Zm00001d035557","6",33055662,33060512,4850
"10600","Zm00001d035560","6",33142628,33144237,1609
"10601","Zm00001d035561","6",33193521,33195150,1629
"10602","Zm00001d035562","6",33367726,33369350,1624
"10603","Zm00001d035563","6",33376853,33381556,4703
"10604","Zm00001d035567","6",33951007,33954056,3049
"10605","Zm00001d035568","6",33981923,33982906,983
"10606","Zm00001d035569","6",33989345,33991999,2654
"10607","Zm00001d035570","6",34068043,34075550,7507
"10608","Zm00001d035574","6",34421939,34431541,9602
"10609","Zm00001d035575","6",34433351,34437380,4029
"10610","Zm00001d035578","6",34503115,34512232,9117
"10611","Zm00001d035579","6",34690701,34694611,3910
"10612","Zm00001d035584","6",34898454,34898858,404
"10613","Zm00001d035588","6",35148537,35151188,2651
"10614","Zm00001d035589","6",35389579,35396535,6956
"10615","Zm00001d035590","6",35399137,35405862,6725
"10616","Zm00001d035591","6",35490880,35493263,2383
"10617","Zm00001d035592","6",35639437,35640924,1487
"10618","Zm00001d035593","6",35734296,35738812,4516
"10619","Zm00001d035595","6",35975616,35978715,3099
"10620","Zm00001d035597","6",35983967,35985927,1960
"10621","Zm00001d035598","6",35987763,36000363,12600
"10622","Zm00001d035599","6",36057149,36059885,2736
"10623","Zm00001d035600","6",36065994,36068882,2888
"10624","Zm00001d035601","6",36080326,36100552,20226
"10625","Zm00001d035603","6",36123335,36125771,2436
"10626","Zm00001d035605","6",36427345,36428954,1609
"10627","Zm00001d035608","6",36528925,36534931,6006
"10628","Zm00001d035610","6",36648271,36648597,326
"10629","Zm00001d035616","6",37235178,37239054,3876
"10630","Zm00001d035621","6",37468979,37471351,2372
"10631","Zm00001d035624","6",37478852,37482504,3652
"10632","Zm00001d035625","6",37482838,37483682,844
"10633","Zm00001d035628","6",37505306,37508965,3659
"10634","Zm00001d035629","6",37509032,37510146,1114
"10635","Zm00001d035631","6",37793506,37814621,21115
"10636","Zm00001d035634","6",37855733,37858713,2980
"10637","Zm00001d035637","6",38040736,38040906,170
"10638","Zm00001d035638","6",38044840,38046538,1698
"10639","Zm00001d035647","6",38173734,38174721,987
"10640","Zm00001d035649","6",38354047,38355769,1722
"10641","Zm00001d035651","6",38682464,38684890,2426
"10642","Zm00001d035652","6",38761353,38763146,1793
"10643","Zm00001d035654","6",39233989,39234821,832
"10644","Zm00001d035656","6",39271522,39272045,523
"10645","Zm00001d035657","6",39658985,39661441,2456
"10646","Zm00001d035658","6",39822203,39823723,1520
"10647","Zm00001d035659","6",39829333,39830358,1025
"10648","Zm00001d035660","6",39836550,39839484,2934
"10649","Zm00001d035662","6",39843896,39844782,886
"10650","Zm00001d035664","6",39874420,39878122,3702
"10651","Zm00001d035665","6",40025475,40027678,2203
"10652","Zm00001d035666","6",40027149,40033684,6535
"10653","Zm00001d035668","6",40159721,40164875,5154
"10654","Zm00001d035669","6",40164959,40167221,2262
"10655","Zm00001d035670","6",40169888,40172068,2180
"10656","Zm00001d035671","6",40181265,40183145,1880
"10657","Zm00001d035672","6",40185464,40187237,1773
"10658","Zm00001d035677","6",40570676,40571722,1046
"10659","Zm00001d035679","6",40852837,40860379,7542
"10660","Zm00001d035688","6",41121034,41122205,1171
"10661","Zm00001d035689","6",41139965,41141457,1492
"10662","Zm00001d035693","6",41341177,41342608,1431
"10663","Zm00001d035695","6",41471658,41476812,5154
"10664","Zm00001d035696","6",41488410,41492614,4204
"10665","Zm00001d035698","6",41672018,41676772,4754
"10666","Zm00001d035700","6",41696312,41698431,2119
"10667","Zm00001d035701","6",41698476,41703037,4561
"10668","Zm00001d035702","6",41777881,41783123,5242
"10669","Zm00001d035703","6",41834803,41836453,1650
"10670","Zm00001d035704","6",41836585,41839002,2417
"10671","Zm00001d035706","6",41922351,41927561,5210
"10672","Zm00001d035713","6",42066918,42068999,2081
"10673","Zm00001d035715","6",42371956,42377078,5122
"10674","Zm00001d035717","6",42705454,42708241,2787
"10675","Zm00001d035718","6",42803905,42807668,3763
"10676","Zm00001d035720","6",42943938,42947112,3174
"10677","Zm00001d035721","6",42946898,42949902,3004
"10678","Zm00001d035722","6",43059977,43062859,2882
"10679","Zm00001d035723","6",43293215,43297233,4018
"10680","Zm00001d035731","6",43838390,43846359,7969
"10681","Zm00001d035736","6",44288172,44292160,3988
"10682","Zm00001d035737","6",44300291,44304215,3924
"10683","Zm00001d035741","6",44431908,44435502,3594
"10684","Zm00001d035747","6",44780803,44789355,8552
"10685","Zm00001d035748","6",44950051,44955272,5221
"10686","Zm00001d035750","6",45230933,45235975,5042
"10687","Zm00001d035751","6",45350374,45356168,5794
"10688","Zm00001d035752","6",45356441,45358855,2414
"10689","Zm00001d035757","6",45715257,45726111,10854
"10690","Zm00001d035758","6",45719805,45719874,69
"10691","Zm00001d035759","6",46086182,46086394,212
"10692","Zm00001d035760","6",46129120,46129656,536
"10693","Zm00001d035761","6",46130267,46133225,2958
"10694","Zm00001d035762","6",46161567,46166532,4965
"10695","Zm00001d035763","6",46340883,46349622,8739
"10696","Zm00001d035764","6",46349538,46353764,4226
"10697","Zm00001d035765","6",46354121,46356647,2526
"10698","Zm00001d035766","6",46356804,46358180,1376
"10699","Zm00001d035769","6",46863730,46864754,1024
"10700","Zm00001d035770","6",46875091,46882203,7112
"10701","Zm00001d035772","6",46915644,46919621,3977
"10702","Zm00001d035773","6",47324925,47339439,14514
"10703","Zm00001d035774","6",47428911,47432469,3558
"10704","Zm00001d035775","6",47635702,47641108,5406
"10705","Zm00001d035776","6",48040384,48053188,12804
"10706","Zm00001d035777","6",48101050,48101842,792
"10707","Zm00001d035783","6",48489279,48491246,1967
"10708","Zm00001d035787","6",48971439,48972583,1144
"10709","Zm00001d035789","6",49258154,49261935,3781
"10710","Zm00001d035791","6",50126440,50127438,998
"10711","Zm00001d035797","6",50384171,50388783,4612
"10712","Zm00001d035802","6",50779463,50790449,10986
"10713","Zm00001d035812","6",51702104,51706431,4327
"10714","Zm00001d035814","6",51725030,51725850,820
"10715","Zm00001d035815","6",52063289,52064242,953
"10716","Zm00001d035816","6",52255974,52256566,592
"10717","Zm00001d035817","6",52272151,52289829,17678
"10718","Zm00001d035818","6",52783826,52789408,5582
"10719","Zm00001d035820","6",53199448,53201936,2488
"10720","Zm00001d035824","6",53501050,53502867,1817
"10721","Zm00001d035825","6",53510508,53512606,2098
"10722","Zm00001d035829","6",53793433,53795747,2314
"10723","Zm00001d035832","6",54018920,54018992,72
"10724","Zm00001d035833","6",54111958,54113813,1855
"10725","Zm00001d035835","6",54257239,54258228,989
"10726","Zm00001d035838","6",54311637,54312577,940
"10727","Zm00001d035841","6",54772197,54798925,26728
"10728","Zm00001d035842","6",54827414,54832596,5182
"10729","Zm00001d035844","6",55321293,55329245,7952
"10730","Zm00001d035845","6",55459829,55461636,1807
"10731","Zm00001d035846","6",55462393,55466921,4528
"10732","Zm00001d035854","6",56296566,56304522,7956
"10733","Zm00001d035855","6",56381514,56382662,1148
"10734","Zm00001d035859","6",56821519,56821986,467
"10735","Zm00001d035862","6",57387932,57398301,10369
"10736","Zm00001d035863","6",57433498,57434139,641
"10737","Zm00001d035864","6",57471044,57472645,1601
"10738","Zm00001d035865","6",57504894,57506321,1427
"10739","Zm00001d035867","6",57639827,57640624,797
"10740","Zm00001d035869","6",57749681,57755938,6257
"10741","Zm00001d035870","6",57862444,57866419,3975
"10742","Zm00001d035871","6",57904243,57906517,2274
"10743","Zm00001d035872","6",57907271,57912196,4925
"10744","Zm00001d035874","6",58024628,58029923,5295
"10745","Zm00001d035875","6",58228914,58237829,8915
"10746","Zm00001d035876","6",58233514,58238587,5073
"10747","Zm00001d035877","6",58266168,58267275,1107
"10748","Zm00001d035878","6",58271035,58276115,5080
"10749","Zm00001d035879","6",58287125,58287934,809
"10750","Zm00001d035881","6",58307418,58308332,914
"10751","Zm00001d035887","6",58469238,58480578,11340
"10752","Zm00001d035889","6",58509568,58519484,9916
"10753","Zm00001d035898","6",58726248,58736714,10466
"10754","Zm00001d035899","6",58736545,58738571,2026
"10755","Zm00001d035901","6",58857759,58859957,2198
"10756","Zm00001d035910","6",59697631,59699153,1522
"10757","Zm00001d035912","6",59865255,59866231,976
"10758","Zm00001d035913","6",59903519,59909972,6453
"10759","Zm00001d035915","6",60128223,60132490,4267
"10760","Zm00001d035918","6",60271741,60272826,1085
"10761","Zm00001d035920","6",60308108,60311445,3337
"10762","Zm00001d035921","6",60326793,60328417,1624
"10763","Zm00001d035922","6",60326794,60331273,4479
"10764","Zm00001d035924","6",60481020,60482014,994
"10765","Zm00001d035925","6",60489299,60491983,2684
"10766","Zm00001d035926","6",60492174,60497096,4922
"10767","Zm00001d035927","6",60713827,60727160,13333
"10768","Zm00001d035933","6",61046505,61053692,7187
"10769","Zm00001d035934","6",61207143,61214618,7475
"10770","Zm00001d035935","6",61216955,61219470,2515
"10771","Zm00001d035937","6",61319459,61324306,4847
"10772","Zm00001d035945","6",61615982,61616833,851
"10773","Zm00001d035947","6",61617490,61622052,4562
"10774","Zm00001d035948","6",61624150,61626088,1938
"10775","Zm00001d035952","6",61729972,61737484,7512
"10776","Zm00001d035953","6",61832098,61848309,16211
"10777","Zm00001d035954","6",61885363,61887624,2261
"10778","Zm00001d035957","6",62162953,62164854,1901
"10779","Zm00001d035960","6",62647186,62672875,25689
"10780","Zm00001d035962","6",62954327,62957508,3181
"10781","Zm00001d035963","6",62958250,62958990,740
"10782","Zm00001d035964","6",62961816,62967802,5986
"10783","Zm00001d035965","6",62968941,62972074,3133
"10784","Zm00001d035969","6",63517496,63518039,543
"10785","Zm00001d035973","6",63721756,63733465,11709
"10786","Zm00001d035974","6",63764140,63769331,5191
"10787","Zm00001d035975","6",63921812,63926812,5000
"10788","Zm00001d035980","6",64328543,64329202,659
"10789","Zm00001d035984","6",64659326,64671466,12140
"10790","Zm00001d035989","6",64968486,64975065,6579
"10791","Zm00001d035990","6",64975900,64984945,9045
"10792","Zm00001d035992","6",65101474,65106753,5279
"10793","Zm00001d035993","6",65161702,65163282,1580
"10794","Zm00001d035994","6",65164556,65165566,1010
"10795","Zm00001d035999","6",65217358,65219351,1993
"10796","Zm00001d036000","6",65226988,65229647,2659
"10797","Zm00001d036001","6",65313239,65315468,2229
"10798","Zm00001d036002","6",65319552,65320753,1201
"10799","Zm00001d036003","6",65322473,65323171,698
"10800","Zm00001d036004","6",65324773,65335323,10550
"10801","Zm00001d036006","6",65374441,65376839,2398
"10802","Zm00001d036008","6",65514626,65517557,2931
"10803","Zm00001d036010","6",65519482,65524396,4914
"10804","Zm00001d036013","6",66085498,66090825,5327
"10805","Zm00001d036018","6",66392949,66397775,4826
"10806","Zm00001d036020","6",66587806,66594109,6303
"10807","Zm00001d036023","6",66747951,66752670,4719
"10808","Zm00001d036024","6",66752688,66763432,10744
"10809","Zm00001d036025","6",66926696,66929998,3302
"10810","Zm00001d036026","6",66938426,66943967,5541
"10811","Zm00001d036031","6",67349219,67356033,6814
"10812","Zm00001d036035","6",67523590,67524538,948
"10813","Zm00001d036036","6",67784534,67785534,1000
"10814","Zm00001d036044","6",68203800,68205848,2048
"10815","Zm00001d036046","6",68433795,68434769,974
"10816","Zm00001d036048","6",68893398,68899590,6192
"10817","Zm00001d036050","6",68998881,69001722,2841
"10818","Zm00001d036051","6",69070304,69072421,2117
"10819","Zm00001d036054","6",69177791,69181830,4039
"10820","Zm00001d036055","6",69311444,69319711,8267
"10821","Zm00001d036056","6",69321935,69324116,2181
"10822","Zm00001d036057","6",69406424,69409545,3121
"10823","Zm00001d036058","6",69602207,69603673,1466
"10824","Zm00001d036062","6",69644296,69647043,2747
"10825","Zm00001d036063","6",69686600,69687959,1359
"10826","Zm00001d036072","6",70419011,70421326,2315
"10827","Zm00001d036073","6",70605117,70616708,11591
"10828","Zm00001d036077","6",70919110,70924393,5283
"10829","Zm00001d036078","6",70922199,70922270,71
"10830","Zm00001d036079","6",70988040,70992940,4900
"10831","Zm00001d036080","6",71040195,71041379,1184
"10832","Zm00001d036084","6",71123570,71130979,7409
"10833","Zm00001d036086","6",71144043,71147933,3890
"10834","Zm00001d036090","6",71683552,71697623,14071
"10835","Zm00001d036091","6",71737372,71738505,1133
"10836","Zm00001d036092","6",71924402,71928562,4160
"10837","Zm00001d036098","6",72196278,72199124,2846
"10838","Zm00001d036101","6",72312932,72314547,1615
"10839","Zm00001d036102","6",72342423,72350634,8211
"10840","Zm00001d036103","6",72363462,72364610,1148
"10841","Zm00001d036107","6",72485617,72487228,1611
"10842","Zm00001d036108","6",72487379,72490876,3497
"10843","Zm00001d036110","6",72620452,72624281,3829
"10844","Zm00001d036112","6",72649200,72653023,3823
"10845","Zm00001d036118","6",72944758,72946052,1294
"10846","Zm00001d036121","6",73080762,73083300,2538
"10847","Zm00001d036122","6",73247503,73249382,1879
"10848","Zm00001d036123","6",73400997,73403872,2875
"10849","Zm00001d036125","6",73478014,73479134,1120
"10850","Zm00001d036126","6",73723857,73733079,9222
"10851","Zm00001d036129","6",73780322,73784110,3788
"10852","Zm00001d036131","6",73847683,73858041,10358
"10853","Zm00001d036132","6",73850279,73852060,1781
"10854","Zm00001d036135","6",73863295,73874255,10960
"10855","Zm00001d036136","6",73926957,73928900,1943
"10856","Zm00001d036137","6",74136937,74141609,4672
"10857","Zm00001d036138","6",74179578,74183116,3538
"10858","Zm00001d036143","6",74386108,74390459,4351
"10859","Zm00001d036144","6",74389585,74390214,629
"10860","Zm00001d036145","6",74424332,74428321,3989
"10861","Zm00001d036148","6",74547569,74550576,3007
"10862","Zm00001d036151","6",74662764,74663198,434
"10863","Zm00001d036152","6",74734107,74736295,2188
"10864","Zm00001d036155","6",74849403,74850173,770
"10865","Zm00001d036161","6",75124440,75153277,28837
"10866","Zm00001d036162","6",75210144,75210697,553
"10867","Zm00001d036167","6",75649225,75650793,1568
"10868","Zm00001d036168","6",75651514,75655252,3738
"10869","Zm00001d036169","6",75660189,75660743,554
"10870","Zm00001d036170","6",75662843,75663423,580
"10871","Zm00001d036173","6",75665452,75666779,1327
"10872","Zm00001d036176","6",75716735,75722025,5290
"10873","Zm00001d036177","6",75725163,75730258,5095
"10874","Zm00001d036178","6",75753504,75756598,3094
"10875","Zm00001d036181","6",76046440,76061571,15131
"10876","Zm00001d036192","6",76624470,76627265,2795
"10877","Zm00001d036194","6",76699323,76705030,5707
"10878","Zm00001d036195","6",76704816,76726930,22114
"10879","Zm00001d036196","6",76728367,76733964,5597
"10880","Zm00001d036197","6",76734856,76736271,1415
"10881","Zm00001d036200","6",76874961,76877723,2762
"10882","Zm00001d036201","6",76919305,76921460,2155
"10883","Zm00001d036202","6",76921384,76922991,1607
"10884","Zm00001d036206","6",77076826,77086653,9827
"10885","Zm00001d036207","6",77176413,77177228,815
"10886","Zm00001d036210","6",77189212,77191713,2501
"10887","Zm00001d036211","6",77190077,77193354,3277
"10888","Zm00001d036213","6",77268316,77270830,2514
"10889","Zm00001d036214","6",77322780,77327461,4681
"10890","Zm00001d036215","6",77510982,77515737,4755
"10891","Zm00001d036216","6",77518951,77521071,2120
"10892","Zm00001d036221","6",77801669,77802163,494
"10893","Zm00001d036222","6",77840137,77849436,9299
"10894","Zm00001d036226","6",77963439,77965579,2140
"10895","Zm00001d036228","6",77985437,77990162,4725
"10896","Zm00001d036229","6",78015273,78015737,464
"10897","Zm00001d036230","6",78253106,78258445,5339
"10898","Zm00001d036233","6",78373473,78381861,8388
"10899","Zm00001d036234","6",78449587,78450909,1322
"10900","Zm00001d036235","6",78455671,78457036,1365
"10901","Zm00001d036237","6",78461540,78462933,1393
"10902","Zm00001d036238","6",78463989,78465795,1806
"10903","Zm00001d036240","6",78616639,78622934,6295
"10904","Zm00001d036241","6",78623619,78626256,2637
"10905","Zm00001d036242","6",79177907,79179890,1983
"10906","Zm00001d036245","6",79482133,79488929,6796
"10907","Zm00001d036247","6",79796450,79805142,8692
"10908","Zm00001d036250","6",79853753,79854163,410
"10909","Zm00001d036251","6",79944763,79945710,947
"10910","Zm00001d036261","6",80468750,80482998,14248
"10911","Zm00001d036262","6",80670944,80672955,2011
"10912","Zm00001d036266","6",81045583,81045858,275
"10913","Zm00001d036267","6",81087241,81089743,2502
"10914","Zm00001d036269","6",81177903,81180478,2575
"10915","Zm00001d036270","6",81182124,81184649,2525
"10916","Zm00001d036272","6",81274477,81276339,1862
"10917","Zm00001d036274","6",81291980,81293650,1670
"10918","Zm00001d036275","6",81295649,81297738,2089
"10919","Zm00001d036277","6",81476838,81477565,727
"10920","Zm00001d036278","6",81479564,81481649,2085
"10921","Zm00001d036280","6",81597933,81614196,16263
"10922","Zm00001d036281","6",81610656,81611427,771
"10923","Zm00001d036283","6",81809428,81812765,3337
"10924","Zm00001d036285","6",81823214,81826948,3734
"10925","Zm00001d036288","6",81895895,81897524,1629
"10926","Zm00001d036291","6",82112341,82113275,934
"10927","Zm00001d036293","6",82193275,82194916,1641
"10928","Zm00001d036294","6",82219059,82220646,1587
"10929","Zm00001d036296","6",82463657,82474161,10504
"10930","Zm00001d036297","6",82503281,82506008,2727
"10931","Zm00001d036298","6",82562696,82563229,533
"10932","Zm00001d036300","6",83035170,83037588,2418
"10933","Zm00001d036301","6",83171217,83187583,16366
"10934","Zm00001d036304","6",83476337,83478479,2142
"10935","Zm00001d036305","6",83674293,83683920,9627
"10936","Zm00001d036306","6",83685783,83686856,1073
"10937","Zm00001d036307","6",83725262,83735547,10285
"10938","Zm00001d036308","6",83756287,83756986,699
"10939","Zm00001d036310","6",83873145,83873981,836
"10940","Zm00001d036312","6",83902126,83912711,10585
"10941","Zm00001d036313","6",83937200,83938094,894
"10942","Zm00001d036315","6",83941114,83943990,2876
"10943","Zm00001d036316","6",83966089,83968097,2008
"10944","Zm00001d036318","6",83982753,83999484,16731
"10945","Zm00001d036319","6",84001793,84002545,752
"10946","Zm00001d036322","6",84112004,84117155,5151
"10947","Zm00001d036324","6",84206463,84214221,7758
"10948","Zm00001d036328","6",84474290,84479106,4816
"10949","Zm00001d036331","6",84657683,84665068,7385
"10950","Zm00001d036334","6",84736095,84742496,6401
"10951","Zm00001d036337","6",84750176,84756971,6795
"10952","Zm00001d036338","6",84763765,84765776,2011
"10953","Zm00001d036339","6",84773604,84774833,1229
"10954","Zm00001d036340","6",84776706,84778799,2093
"10955","Zm00001d036341","6",84964785,84966134,1349
"10956","Zm00001d036342","6",85008997,85010625,1628
"10957","Zm00001d036343","6",85011739,85018649,6910
"10958","Zm00001d036345","6",85061295,85065182,3887
"10959","Zm00001d036346","6",85065660,85075694,10034
"10960","Zm00001d036348","6",85083609,85084175,566
"10961","Zm00001d036350","6",85119079,85120467,1388
"10962","Zm00001d036351","6",85213378,85230505,17127
"10963","Zm00001d036356","6",85555310,85558301,2991
"10964","Zm00001d036359","6",85619900,85628099,8199
"10965","Zm00001d036360","6",85712835,85716668,3833
"10966","Zm00001d036361","6",85717705,85721431,3726
"10967","Zm00001d036363","6",85772731,85773825,1094
"10968","Zm00001d036371","6",86007940,86011821,3881
"10969","Zm00001d036382","6",86301797,86303702,1905
"10970","Zm00001d036384","6",86339692,86340326,634
"10971","Zm00001d036386","6",86342993,86346003,3010
"10972","Zm00001d036387","6",86348564,86354695,6131
"10973","Zm00001d036388","6",86354659,86356906,2247
"10974","Zm00001d036389","6",86377781,86378389,608
"10975","Zm00001d036390","6",86551259,86555797,4538
"10976","Zm00001d036392","6",86656485,86658128,1643
"10977","Zm00001d036395","6",86726395,86732776,6381
"10978","Zm00001d036396","6",86737071,86740900,3829
"10979","Zm00001d036398","6",86796848,86798136,1288
"10980","Zm00001d036400","6",86826580,86827383,803
"10981","Zm00001d036401","6",86902776,86908235,5459
"10982","Zm00001d036402","6",86950406,86955764,5358
"10983","Zm00001d036403","6",86959688,86963593,3905
"10984","Zm00001d036404","6",86975028,86988392,13364
"10985","Zm00001d036406","6",87050981,87055612,4631
"10986","Zm00001d036407","6",87057737,87059900,2163
"10987","Zm00001d036409","6",87176109,87177459,1350
"10988","Zm00001d036410","6",87193666,87199740,6074
"10989","Zm00001d036414","6",87426580,87427860,1280
"10990","Zm00001d036415","6",87428736,87429128,392
"10991","Zm00001d036416","6",87481068,87487593,6525
"10992","Zm00001d036417","6",87639671,87644146,4475
"10993","Zm00001d036418","6",87645024,87646346,1322
"10994","Zm00001d036420","6",87683362,87688330,4968
"10995","Zm00001d036422","6",87792051,87796989,4938
"10996","Zm00001d036423","6",87796940,87800583,3643
"10997","Zm00001d036425","6",87897599,87902270,4671
"10998","Zm00001d036426","6",87953855,87955348,1493
"10999","Zm00001d036427","6",87983587,87986324,2737
"11000","Zm00001d036428","6",88151400,88156937,5537
"11001","Zm00001d036429","6",88157268,88162064,4796
"11002","Zm00001d036430","6",88163394,88164152,758
"11003","Zm00001d036431","6",88165017,88165909,892
"11004","Zm00001d036432","6",88267722,88272469,4747
"11005","Zm00001d036434","6",88294758,88313612,18854
"11006","Zm00001d036437","6",88368995,88371391,2396
"11007","Zm00001d036438","6",88449234,88449572,338
"11008","Zm00001d036439","6",88560354,88561488,1134
"11009","Zm00001d036440","6",88669540,88672608,3068
"11010","Zm00001d036441","6",88675859,88676185,326
"11011","Zm00001d036442","6",88733496,88736281,2785
"11012","Zm00001d036443","6",88822090,88827290,5200
"11013","Zm00001d036446","6",88839399,88844262,4863
"11014","Zm00001d036447","6",88839893,88864480,24587
"11015","Zm00001d036448","6",88909861,88915466,5605
"11016","Zm00001d036449","6",88958410,88964729,6319
"11017","Zm00001d036450","6",88965297,88966673,1376
"11018","Zm00001d036451","6",89030765,89033700,2935
"11019","Zm00001d036452","6",89058090,89058374,284
"11020","Zm00001d036454","6",89082529,89089703,7174
"11021","Zm00001d036455","6",89091866,89094271,2405
"11022","Zm00001d036462","6",89295382,89304942,9560
"11023","Zm00001d036463","6",89312912,89313355,443
"11024","Zm00001d036468","6",89400862,89401506,644
"11025","Zm00001d036475","6",89536271,89544837,8566
"11026","Zm00001d036477","6",89561250,89571632,10382
"11027","Zm00001d036480","6",89893907,89897716,3809
"11028","Zm00001d036481","6",90056629,90062992,6363
"11029","Zm00001d036482","6",90169969,90174190,4221
"11030","Zm00001d036483","6",90174622,90180984,6362
"11031","Zm00001d036484","6",90182314,90188051,5737
"11032","Zm00001d036485","6",90311423,90317336,5913
"11033","Zm00001d036486","6",90352423,90353243,820
"11034","Zm00001d036490","6",90468862,90473728,4866
"11035","Zm00001d036494","6",90506221,90511243,5022
"11036","Zm00001d036495","6",90589306,90596258,6952
"11037","Zm00001d036496","6",90597017,90602294,5277
"11038","Zm00001d036497","6",90604351,90605543,1192
"11039","Zm00001d036499","6",90643484,90644271,787
"11040","Zm00001d036506","6",90878266,90879517,1251
"11041","Zm00001d036507","6",90881545,90893674,12129
"11042","Zm00001d036520","6",91152540,91157315,4775
"11043","Zm00001d036521","6",91157618,91158864,1246
"11044","Zm00001d036522","6",91176402,91178744,2342
"11045","Zm00001d036524","6",91181053,91187266,6213
"11046","Zm00001d036525","6",91188116,91194325,6209
"11047","Zm00001d036527","6",91223602,91228006,4404
"11048","Zm00001d036528","6",91251480,91251551,71
"11049","Zm00001d036529","6",91275079,91276099,1020
"11050","Zm00001d036530","6",91276762,91285762,9000
"11051","Zm00001d036531","6",91287268,91293442,6174
"11052","Zm00001d036532","6",91297418,91306068,8650
"11053","Zm00001d036533","6",91324082,91328565,4483
"11054","Zm00001d036534","6",91330782,91336849,6067
"11055","Zm00001d036535","6",91338946,91340275,1329
"11056","Zm00001d036536","6",91341686,91342279,593
"11057","Zm00001d036537","6",91400310,91405273,4963
"11058","Zm00001d036540","6",91500847,91504496,3649
"11059","Zm00001d036541","6",91506006,91510877,4871
"11060","Zm00001d036543","6",91521156,91525360,4204
"11061","Zm00001d036545","6",91576585,91580520,3935
"11062","Zm00001d036546","6",91581170,91585529,4359
"11063","Zm00001d036547","6",91589807,91591096,1289
"11064","Zm00001d036550","6",91656993,91657445,452
"11065","Zm00001d036551","6",91831037,91834032,2995
"11066","Zm00001d036555","6",91867878,91871806,3928
"11067","Zm00001d036556","6",91870931,91874865,3934
"11068","Zm00001d036557","6",92017713,92023571,5858
"11069","Zm00001d036558","6",92026884,92028242,1358
"11070","Zm00001d036560","6",92296495,92300867,4372
"11071","Zm00001d036562","6",92416551,92419714,3163
"11072","Zm00001d036563","6",92446503,92451083,4580
"11073","Zm00001d036564","6",92506962,92508996,2034
"11074","Zm00001d036565","6",92667282,92669971,2689
"11075","Zm00001d036567","6",92808875,92811320,2445
"11076","Zm00001d036568","6",92896926,92902382,5456
"11077","Zm00001d036570","6",93085359,93085772,413
"11078","Zm00001d036571","6",93093255,93103441,10186
"11079","Zm00001d036573","6",93292337,93296438,4101
"11080","Zm00001d036574","6",93296775,93297158,383
"11081","Zm00001d036575","6",93371896,93375751,3855
"11082","Zm00001d036579","6",93630607,93642846,12239
"11083","Zm00001d036580","6",93652212,93652286,74
"11084","Zm00001d036583","6",93694598,93724480,29882
"11085","Zm00001d036593","6",93920665,93928357,7692
"11086","Zm00001d036594","6",93929912,93936181,6269
"11087","Zm00001d036595","6",93934409,93936181,1772
"11088","Zm00001d036597","6",94022705,94023738,1033
"11089","Zm00001d036598","6",94023965,94028647,4682
"11090","Zm00001d036602","6",94190254,94199686,9432
"11091","Zm00001d036608","6",94231654,94235649,3995
"11092","Zm00001d036609","6",94235801,94239377,3576
"11093","Zm00001d036610","6",94241463,94242644,1181
"11094","Zm00001d036611","6",94246544,94251230,4686
"11095","Zm00001d036613","6",94473770,94496176,22406
"11096","Zm00001d036615","6",94602439,94602903,464
"11097","Zm00001d036616","6",94610526,94610921,395
"11098","Zm00001d036617","6",94836282,94837115,833
"11099","Zm00001d036620","6",95017881,95025093,7212
"11100","Zm00001d036621","6",95027571,95034051,6480
"11101","Zm00001d036623","6",95057231,95057635,404
"11102","Zm00001d036624","6",95234528,95240368,5840
"11103","Zm00001d036626","6",95462355,95463470,1115
"11104","Zm00001d036628","6",95592329,95594036,1707
"11105","Zm00001d036629","6",95622534,95642405,19871
"11106","Zm00001d036630","6",95643471,95646716,3245
"11107","Zm00001d036631","6",95649670,95655779,6109
"11108","Zm00001d036632","6",95752345,95758209,5864
"11109","Zm00001d036635","6",95844090,95865714,21624
"11110","Zm00001d036636","6",95850012,95851358,1346
"11111","Zm00001d036637","6",95864690,95867176,2486
"11112","Zm00001d036640","6",95977249,95980428,3179
"11113","Zm00001d036641","6",95981467,95983819,2352
"11114","Zm00001d036642","6",95986850,95990149,3299
"11115","Zm00001d036643","6",95997155,95998900,1745
"11116","Zm00001d036646","6",96107181,96108854,1673
"11117","Zm00001d036647","6",96204324,96208206,3882
"11118","Zm00001d036648","6",96210403,96211140,737
"11119","Zm00001d036650","6",96301534,96302256,722
"11120","Zm00001d036651","6",96421952,96426369,4417
"11121","Zm00001d036654","6",96552802,96556599,3797
"11122","Zm00001d036655","6",96564582,96572729,8147
"11123","Zm00001d036656","6",96573395,96579915,6520
"11124","Zm00001d036657","6",96580482,96585750,5268
"11125","Zm00001d036659","6",96815227,96816186,959
"11126","Zm00001d036660","6",96929399,96936549,7150
"11127","Zm00001d036662","6",97029704,97030573,869
"11128","Zm00001d036663","6",97049494,97053619,4125
"11129","Zm00001d036666","6",97128102,97138573,10471
"11130","Zm00001d036667","6",97138575,97139816,1241
"11131","Zm00001d036668","6",97142398,97149112,6714
"11132","Zm00001d036669","6",97158072,97172378,14306
"11133","Zm00001d036671","6",97223887,97224333,446
"11134","Zm00001d036672","6",97225142,97229239,4097
"11135","Zm00001d036673","6",97232627,97243366,10739
"11136","Zm00001d036675","6",97366864,97377593,10729
"11137","Zm00001d036676","6",97378208,97378813,605
"11138","Zm00001d036678","6",97425061,97433288,8227
"11139","Zm00001d036679","6",97446317,97450689,4372
"11140","Zm00001d036680","6",97452879,97455139,2260
"11141","Zm00001d036689","6",97601417,97603639,2222
"11142","Zm00001d036690","6",97725849,97726826,977
"11143","Zm00001d036691","6",97806967,97809106,2139
"11144","Zm00001d036693","6",97878796,97880627,1831
"11145","Zm00001d036698","6",98069169,98071529,2360
"11146","Zm00001d036700","6",98074454,98078079,3625
"11147","Zm00001d036702","6",98134248,98134569,321
"11148","Zm00001d036703","6",98137322,98137759,437
"11149","Zm00001d036704","6",98143012,98153893,10881
"11150","Zm00001d036706","6",98210806,98211135,329
"11151","Zm00001d036707","6",98270416,98281382,10966
"11152","Zm00001d036708","6",98284028,98286043,2015
"11153","Zm00001d036709","6",98288331,98289311,980
"11154","Zm00001d036710","6",98375376,98380066,4690
"11155","Zm00001d036711","6",98381431,98383285,1854
"11156","Zm00001d036714","6",98440958,98447412,6454
"11157","Zm00001d036715","6",98447529,98450787,3258
"11158","Zm00001d036717","6",98730481,98732747,2266
"11159","Zm00001d036718","6",98733525,98736788,3263
"11160","Zm00001d036719","6",98774782,98779038,4256
"11161","Zm00001d036720","6",98782181,98784853,2672
"11162","Zm00001d036721","6",98810391,98814802,4411
"11163","Zm00001d036723","6",99027309,99034287,6978
"11164","Zm00001d036724","6",99056422,99058380,1958
"11165","Zm00001d036727","6",99181767,99186018,4251
"11166","Zm00001d036735","6",99390342,99393694,3352
"11167","Zm00001d036736","6",99406292,99413471,7179
"11168","Zm00001d036737","6",99415959,99416279,320
"11169","Zm00001d036738","6",99510698,99514397,3699
"11170","Zm00001d036740","6",99520465,99521070,605
"11171","Zm00001d036741","6",99521660,99541151,19491
"11172","Zm00001d036742","6",99718295,99725208,6913
"11173","Zm00001d036744","6",99728410,99730769,2359
"11174","Zm00001d036748","6",99742294,99745798,3504
"11175","Zm00001d036749","6",99749665,99760507,10842
"11176","Zm00001d036750","6",99763877,99766409,2532
"11177","Zm00001d036751","6",99767852,99771038,3186
"11178","Zm00001d036755","6",99918334,99928751,10417
"11179","Zm00001d036756","6",99934740,99940962,6222
"11180","Zm00001d036758","6",99942701,99945111,2410
"11181","Zm00001d036759","6",99946589,99956871,10282
"11182","Zm00001d036760","6",99957495,99960739,3244
"11183","Zm00001d036761","6",99961346,99963647,2301
"11184","Zm00001d036763","6",100071537,100073677,2140
"11185","Zm00001d036764","6",100074698,100078882,4184
"11186","Zm00001d036765","6",100099887,100107565,7678
"11187","Zm00001d036768","6",100159664,100160590,926
"11188","Zm00001d036769","6",100193112,100193462,350
"11189","Zm00001d036770","6",100193953,100197746,3793
"11190","Zm00001d036775","6",100470264,100476233,5969
"11191","Zm00001d036777","6",100491976,100495667,3691
"11192","Zm00001d036778","6",100568670,100570085,1415
"11193","Zm00001d036780","6",100661361,100661735,374
"11194","Zm00001d036781","6",100739537,100739752,215
"11195","Zm00001d036782","6",100779503,100782592,3089
"11196","Zm00001d036783","6",100789296,100790751,1455
"11197","Zm00001d036784","6",100805522,100810246,4724
"11198","Zm00001d036785","6",100865973,100876705,10732
"11199","Zm00001d036787","6",100878714,100879367,653
"11200","Zm00001d036788","6",100889664,100893620,3956
"11201","Zm00001d036789","6",100928986,100933110,4124
"11202","Zm00001d036790","6",100942359,100948393,6034
"11203","Zm00001d036793","6",101129017,101129852,835
"11204","Zm00001d036795","6",101158381,101162048,3667
"11205","Zm00001d036796","6",101178916,101181950,3034
"11206","Zm00001d036797","6",101216563,101220048,3485
"11207","Zm00001d036798","6",101221239,101231409,10170
"11208","Zm00001d036800","6",101252591,101254367,1776
"11209","Zm00001d036801","6",101297189,101299513,2324
"11210","Zm00001d036802","6",101302742,101304618,1876
"11211","Zm00001d036803","6",101323142,101323602,460
"11212","Zm00001d036807","6",101495580,101501691,6111
"11213","Zm00001d036812","6",101681449,101689673,8224
"11214","Zm00001d036814","6",101756902,101758786,1884
"11215","Zm00001d036825","6",102823171,102829865,6694
"11216","Zm00001d036827","6",102933390,102942927,9537
"11217","Zm00001d036829","6",103042150,103048591,6441
"11218","Zm00001d036830","6",103104796,103110112,5316
"11219","Zm00001d036831","6",103111955,103116521,4566
"11220","Zm00001d036833","6",103277557,103280497,2940
"11221","Zm00001d036834","6",103292537,103293895,1358
"11222","Zm00001d036835","6",103312927,103315228,2301
"11223","Zm00001d036836","6",103338158,103342026,3868
"11224","Zm00001d036837","6",103342684,103343694,1010
"11225","Zm00001d036838","6",103346593,103347847,1254
"11226","Zm00001d036839","6",103351537,103352681,1144
"11227","Zm00001d036840","6",103387819,103389624,1805
"11228","Zm00001d036854","6",103977545,103979241,1696
"11229","Zm00001d036864","6",104417769,104426263,8494
"11230","Zm00001d036867","6",104870557,104871701,1144
"11231","Zm00001d036871","6",105227157,105227559,402
"11232","Zm00001d036872","6",105291175,105293205,2030
"11233","Zm00001d036875","6",105403058,105408687,5629
"11234","Zm00001d036877","6",105439613,105441453,1840
"11235","Zm00001d036878","6",105491864,105498540,6676
"11236","Zm00001d036879","6",105515248,105521341,6093
"11237","Zm00001d036880","6",105523233,105526361,3128
"11238","Zm00001d036882","6",105557818,105557901,83
"11239","Zm00001d036888","6",105645382,105658474,13092
"11240","Zm00001d036889","6",105660981,105662401,1420
"11241","Zm00001d036892","6",105706275,105707048,773
"11242","Zm00001d036894","6",105839573,105842396,2823
"11243","Zm00001d036895","6",105843761,105848177,4416
"11244","Zm00001d036897","6",105871023,105877198,6175
"11245","Zm00001d036898","6",105899359,105900570,1211
"11246","Zm00001d036902","6",105982898,105983350,452
"11247","Zm00001d036903","6",105991903,106002178,10275
"11248","Zm00001d036904","6",106006145,106009433,3288
"11249","Zm00001d036905","6",106070137,106077362,7225
"11250","Zm00001d036911","6",106201899,106205504,3605
"11251","Zm00001d036912","6",106238198,106241939,3741
"11252","Zm00001d036913","6",106312472,106315497,3025
"11253","Zm00001d036915","6",106335440,106338228,2788
"11254","Zm00001d036917","6",106360618,106367670,7052
"11255","Zm00001d036918","6",106378038,106379735,1697
"11256","Zm00001d036919","6",106386865,106396953,10088
"11257","Zm00001d036920","6",106398277,106400487,2210
"11258","Zm00001d036925","6",106604412,106605563,1151
"11259","Zm00001d036927","6",106652202,106660237,8035
"11260","Zm00001d036929","6",106704041,106706934,2893
"11261","Zm00001d036930","6",106706944,106707189,245
"11262","Zm00001d036932","6",106773361,106776647,3286
"11263","Zm00001d036933","6",106777268,106780457,3189
"11264","Zm00001d036936","6",106823723,106846250,22527
"11265","Zm00001d036940","6",106870021,106881360,11339
"11266","Zm00001d036941","6",106888398,106895217,6819
"11267","Zm00001d036942","6",106916705,106923072,6367
"11268","Zm00001d036946","6",106962392,106964189,1797
"11269","Zm00001d036949","6",107113060,107129901,16841
"11270","Zm00001d036950","6",107185515,107185985,470
"11271","Zm00001d036951","6",107194843,107195520,677
"11272","Zm00001d036952","6",107235764,107236371,607
"11273","Zm00001d036953","6",107241602,107241865,263
"11274","Zm00001d036956","6",107321960,107324231,2271
"11275","Zm00001d036957","6",107329572,107334526,4954
"11276","Zm00001d036959","6",107398589,107403318,4729
"11277","Zm00001d036961","6",107436798,107445278,8480
"11278","Zm00001d036964","6",107568935,107571082,2147
"11279","Zm00001d036965","6",107624423,107627557,3134
"11280","Zm00001d036966","6",107628483,107635122,6639
"11281","Zm00001d036967","6",107630394,107630462,68
"11282","Zm00001d036968","6",107779208,107786220,7012
"11283","Zm00001d036970","6",107806389,107808370,1981
"11284","Zm00001d036971","6",107848587,107862507,13920
"11285","Zm00001d036972","6",108025774,108029527,3753
"11286","Zm00001d036973","6",108031600,108032377,777
"11287","Zm00001d036975","6",108061413,108063897,2484
"11288","Zm00001d036977","6",108070822,108076516,5694
"11289","Zm00001d036978","6",108109102,108113917,4815
"11290","Zm00001d036981","6",108202268,108211871,9603
"11291","Zm00001d036982","6",108212462,108219350,6888
"11292","Zm00001d036984","6",108314918,108317096,2178
"11293","Zm00001d036985","6",108317523,108319096,1573
"11294","Zm00001d036986","6",108327528,108338061,10533
"11295","Zm00001d036987","6",108388200,108395354,7154
"11296","Zm00001d036988","6",108404948,108409071,4123
"11297","Zm00001d036989","6",108445740,108450130,4390
"11298","Zm00001d036990","6",108474391,108475244,853
"11299","Zm00001d036995","6",108560874,108564768,3894
"11300","Zm00001d037000","6",108693909,108695080,1171
"11301","Zm00001d037001","6",108725545,108733553,8008
"11302","Zm00001d037002","6",108753935,108763489,9554
"11303","Zm00001d037003","6",108768745,108769776,1031
"11304","Zm00001d037004","6",108805580,108813472,7892
"11305","Zm00001d037005","6",108815418,108816992,1574
"11306","Zm00001d037006","6",108817945,108828900,10955
"11307","Zm00001d037009","6",108903771,108928531,24760
"11308","Zm00001d037010","6",108958027,108965515,7488
"11309","Zm00001d037014","6",109116275,109117215,940
"11310","Zm00001d037017","6",109255100,109256890,1790
"11311","Zm00001d037018","6",109291682,109292167,485
"11312","Zm00001d037023","6",109436100,109436648,548
"11313","Zm00001d037024","6",109437574,109438536,962
"11314","Zm00001d037025","6",109439805,109442268,2463
"11315","Zm00001d037026","6",109469447,109475875,6428
"11316","Zm00001d037027","6",109471000,109471694,694
"11317","Zm00001d037028","6",109547895,109553139,5244
"11318","Zm00001d037029","6",109567045,109568953,1908
"11319","Zm00001d037033","6",109748197,109748535,338
"11320","Zm00001d037034","6",109810848,109824120,13272
"11321","Zm00001d037035","6",109824433,109840047,15614
"11322","Zm00001d037036","6",109841574,109844183,2609
"11323","Zm00001d037038","6",110012840,110017053,4213
"11324","Zm00001d037042","6",110138379,110138762,383
"11325","Zm00001d037045","6",110223819,110232746,8927
"11326","Zm00001d037050","6",110481817,110494448,12631
"11327","Zm00001d037051","6",110497827,110502466,4639
"11328","Zm00001d037052","6",110619969,110628366,8397
"11329","Zm00001d037055","6",110698615,110710729,12114
"11330","Zm00001d037056","6",110796590,110798766,2176
"11331","Zm00001d037057","6",110845121,110851267,6146
"11332","Zm00001d037058","6",110874145,110878663,4518
"11333","Zm00001d037059","6",110970400,110982871,12471
"11334","Zm00001d037060","6",110983102,110984867,1765
"11335","Zm00001d037061","6",111052880,111054567,1687
"11336","Zm00001d037062","6",111080364,111081176,812
"11337","Zm00001d037066","6",111296289,111300781,4492
"11338","Zm00001d037067","6",111299589,111310483,10894
"11339","Zm00001d037068","6",111326579,111327256,677
"11340","Zm00001d037069","6",111332789,111336253,3464
"11341","Zm00001d037072","6",111451582,111451947,365
"11342","Zm00001d037073","6",111482487,111483803,1316
"11343","Zm00001d037076","6",111553542,111555006,1464
"11344","Zm00001d037079","6",111618610,111623602,4992
"11345","Zm00001d037080","6",111637292,111640270,2978
"11346","Zm00001d037081","6",111655549,111659511,3962
"11347","Zm00001d037084","6",111695535,111708346,12811
"11348","Zm00001d037085","6",111709689,111715108,5419
"11349","Zm00001d037086","6",111753580,111762127,8547
"11350","Zm00001d037087","6",111762433,111763755,1322
"11351","Zm00001d037089","6",111806506,111808586,2080
"11352","Zm00001d037091","6",111833522,111835548,2026
"11353","Zm00001d037092","6",111878360,111883069,4709
"11354","Zm00001d037093","6",111964410,111972005,7595
"11355","Zm00001d037094","6",111975917,111977355,1438
"11356","Zm00001d037095","6",112016445,112017440,995
"11357","Zm00001d037096","6",112019369,112024849,5480
"11358","Zm00001d037097","6",112036186,112037588,1402
"11359","Zm00001d037098","6",112038762,112044232,5470
"11360","Zm00001d037099","6",112114923,112125143,10220
"11361","Zm00001d037100","6",112267718,112290870,23152
"11362","Zm00001d037101","6",112276988,112277059,71
"11363","Zm00001d037103","6",112380521,112382016,1495
"11364","Zm00001d037104","6",112382299,112385515,3216
"11365","Zm00001d037105","6",112386544,112388553,2009
"11366","Zm00001d037108","6",112471489,112475753,4264
"11367","Zm00001d037109","6",112504977,112510057,5080
"11368","Zm00001d037110","6",112655073,112660532,5459
"11369","Zm00001d037111","6",112668246,112668674,428
"11370","Zm00001d037112","6",112673294,112675545,2251
"11371","Zm00001d037113","6",112719911,112723700,3789
"11372","Zm00001d037114","6",112856874,112864407,7533
"11373","Zm00001d037115","6",112916637,112925689,9052
"11374","Zm00001d037117","6",112965440,112967072,1632
"11375","Zm00001d037118","6",112978409,112979673,1264
"11376","Zm00001d037119","6",112983456,112988589,5133
"11377","Zm00001d037120","6",113001513,113006425,4912
"11378","Zm00001d037121","6",113111904,113158461,46557
"11379","Zm00001d037122","6",113159280,113168154,8874
"11380","Zm00001d037124","6",113254071,113256337,2266
"11381","Zm00001d037125","6",113332015,113340752,8737
"11382","Zm00001d037126","6",113374115,113374909,794
"11383","Zm00001d037128","6",113478508,113480242,1734
"11384","Zm00001d037133","6",113546755,113548492,1737
"11385","Zm00001d037140","6",113744465,113748815,4350
"11386","Zm00001d037141","6",113759867,113760413,546
"11387","Zm00001d037142","6",113765593,113776411,10818
"11388","Zm00001d037146","6",113934660,113937192,2532
"11389","Zm00001d037148","6",113944914,113946584,1670
"11390","Zm00001d037150","6",113956790,113961796,5006
"11391","Zm00001d037151","6",113968040,113971501,3461
"11392","Zm00001d037152","6",113972053,113979356,7303
"11393","Zm00001d037155","6",114061581,114063536,1955
"11394","Zm00001d037156","6",114067691,114081566,13875
"11395","Zm00001d037158","6",114233341,114234231,890
"11396","Zm00001d037159","6",114253255,114255827,2572
"11397","Zm00001d037160","6",114309734,114312011,2277
"11398","Zm00001d037163","6",114526708,114531919,5211
"11399","Zm00001d037164","6",114576817,114579035,2218
"11400","Zm00001d037168","6",114657324,114658885,1561
"11401","Zm00001d037169","6",114662414,114663228,814
"11402","Zm00001d037170","6",114741698,114745764,4066
"11403","Zm00001d037172","6",114771421,114773561,2140
"11404","Zm00001d037173","6",114774903,114775199,296
"11405","Zm00001d037174","6",114776433,114787517,11084
"11406","Zm00001d037175","6",114789943,114806702,16759
"11407","Zm00001d037180","6",114877169,114878146,977
"11408","Zm00001d037181","6",114889409,114890914,1505
"11409","Zm00001d037182","6",114979500,114981186,1686
"11410","Zm00001d037188","6",115076146,115077396,1250
"11411","Zm00001d037189","6",115183176,115189551,6375
"11412","Zm00001d037190","6",115193192,115194682,1490
"11413","Zm00001d037191","6",115198271,115201081,2810
"11414","Zm00001d037194","6",115260493,115261713,1220
"11415","Zm00001d037195","6",115288294,115303727,15433
"11416","Zm00001d037196","6",115288433,115303727,15294
"11417","Zm00001d037197","6",115431621,115432085,464
"11418","Zm00001d037198","6",115432815,115445954,13139
"11419","Zm00001d037199","6",115494237,115498366,4129
"11420","Zm00001d037200","6",115545790,115550738,4948
"11421","Zm00001d037203","6",115605845,115608609,2764
"11422","Zm00001d037205","6",115761948,115762958,1010
"11423","Zm00001d037207","6",115815843,115817364,1521
"11424","Zm00001d037208","6",115818442,115823590,5148
"11425","Zm00001d037209","6",115848018,115852402,4384
"11426","Zm00001d037211","6",115981077,115984636,3559
"11427","Zm00001d037212","6",116059964,116066361,6397
"11428","Zm00001d037213","6",116090688,116092245,1557
"11429","Zm00001d037214","6",116113744,116127172,13428
"11430","Zm00001d037215","6",116217062,116229724,12662
"11431","Zm00001d037217","6",116236754,116245875,9121
"11432","Zm00001d037220","6",116364586,116369760,5174
"11433","Zm00001d037223","6",116533572,116550745,17173
"11434","Zm00001d037225","6",116559187,116561921,2734
"11435","Zm00001d037227","6",116698204,116706842,8638
"11436","Zm00001d037229","6",116920317,116926344,6027
"11437","Zm00001d037233","6",117049106,117054838,5732
"11438","Zm00001d037234","6",117124065,117128209,4144
"11439","Zm00001d037235","6",117162124,117169213,7089
"11440","Zm00001d037236","6",117248096,117250723,2627
"11441","Zm00001d037237","6",117261580,117263989,2409
"11442","Zm00001d037239","6",117464703,117467330,2627
"11443","Zm00001d037240","6",117483616,117495193,11577
"11444","Zm00001d037241","6",117498081,117503522,5441
"11445","Zm00001d037242","6",117577794,117583731,5937
"11446","Zm00001d037243","6",117639992,117640558,566
"11447","Zm00001d037245","6",117726138,117727409,1271
"11448","Zm00001d037246","6",117736699,117745908,9209
"11449","Zm00001d037247","6",117815623,117832430,16807
"11450","Zm00001d037248","6",117881857,117883899,2042
"11451","Zm00001d037249","6",117988295,117990111,1816
"11452","Zm00001d037250","6",118024047,118027076,3029
"11453","Zm00001d037251","6",118049431,118051296,1865
"11454","Zm00001d037252","6",118129957,118140120,10163
"11455","Zm00001d037254","6",118321373,118323844,2471
"11456","Zm00001d037255","6",118326045,118326568,523
"11457","Zm00001d037257","6",118383037,118388594,5557
"11458","Zm00001d037258","6",118389667,118393190,3523
"11459","Zm00001d037260","6",118429177,118433943,4766
"11460","Zm00001d037261","6",118439137,118442333,3196
"11461","Zm00001d037263","6",118535144,118536049,905
"11462","Zm00001d037264","6",118537385,118544732,7347
"11463","Zm00001d037265","6",118726006,118741107,15101
"11464","Zm00001d037266","6",118734099,118741159,7060
"11465","Zm00001d037267","6",118742534,118745306,2772
"11466","Zm00001d037268","6",118877965,118889091,11126
"11467","Zm00001d037269","6",118884664,118884736,72
"11468","Zm00001d037270","6",118892566,118895916,3350
"11469","Zm00001d037271","6",118909983,118914417,4434
"11470","Zm00001d037272","6",118954338,118967045,12707
"11471","Zm00001d037273","6",119043969,119047721,3752
"11472","Zm00001d037274","6",119093152,119097181,4029
"11473","Zm00001d037275","6",119096565,119098065,1500
"11474","Zm00001d037277","6",119165310,119170891,5581
"11475","Zm00001d037278","6",119172801,119179266,6465
"11476","Zm00001d037279","6",119259106,119268023,8917
"11477","Zm00001d037282","6",119343777,119346194,2417
"11478","Zm00001d037284","6",119349742,119350518,776
"11479","Zm00001d037288","6",119518115,119519495,1380
"11480","Zm00001d037289","6",119523282,119528893,5611
"11481","Zm00001d037290","6",119545820,119551288,5468
"11482","Zm00001d037291","6",119610832,119619204,8372
"11483","Zm00001d037295","6",119714504,119715351,847
"11484","Zm00001d037296","6",119730324,119732243,1919
"11485","Zm00001d037297","6",119869360,119872972,3612
"11486","Zm00001d037304","6",120126529,120127479,950
"11487","Zm00001d037305","6",120190685,120196947,6262
"11488","Zm00001d037306","6",120225240,120229573,4333
"11489","Zm00001d037307","6",120259268,120263325,4057
"11490","Zm00001d037308","6",120272311,120275387,3076
"11491","Zm00001d037313","6",120389101,120407827,18726
"11492","Zm00001d037315","6",120615193,120635200,20007
"11493","Zm00001d037316","6",120703259,120705876,2617
"11494","Zm00001d037318","6",120776999,120779225,2226
"11495","Zm00001d037319","6",120826854,120827514,660
"11496","Zm00001d037321","6",120999149,121016423,17274
"11497","Zm00001d037323","6",121112271,121113696,1425
"11498","Zm00001d037326","6",121213396,121219719,6323
"11499","Zm00001d037328","6",121453440,121454543,1103
"11500","Zm00001d037329","6",121594560,121597848,3288
"11501","Zm00001d037332","6",121763690,121772901,9211
"11502","Zm00001d037333","6",121792419,121824947,32528
"11503","Zm00001d037334","6",121922624,121924231,1607
"11504","Zm00001d037336","6",121966751,121968933,2182
"11505","Zm00001d037337","6",122042511,122043530,1019
"11506","Zm00001d037338","6",122053512,122056730,3218
"11507","Zm00001d037339","6",122057882,122058903,1021
"11508","Zm00001d037340","6",122064078,122065011,933
"11509","Zm00001d037342","6",122118736,122121645,2909
"11510","Zm00001d037343","6",122125235,122136629,11394
"11511","Zm00001d037346","6",122234832,122284355,49523
"11512","Zm00001d037347","6",122237377,122237448,71
"11513","Zm00001d037352","6",122505883,122518536,12653
"11514","Zm00001d037353","6",122508673,122508744,71
"11515","Zm00001d037354","6",122602767,122607391,4624
"11516","Zm00001d037355","6",122680632,122681516,884
"11517","Zm00001d037356","6",122695800,122698691,2891
"11518","Zm00001d037359","6",122793612,122795290,1678
"11519","Zm00001d037361","6",122861914,122862492,578
"11520","Zm00001d037362","6",122862919,122881065,18146
"11521","Zm00001d037364","6",122960829,122963038,2209
"11522","Zm00001d037367","6",123035723,123040543,4820
"11523","Zm00001d037368","6",123079590,123080578,988
"11524","Zm00001d037369","6",123081049,123084407,3358
"11525","Zm00001d037371","6",123321342,123323453,2111
"11526","Zm00001d037377","6",123566898,123595849,28951
"11527","Zm00001d037381","6",123783958,123787517,3559
"11528","Zm00001d037384","6",123931487,123933195,1708
"11529","Zm00001d037386","6",124045008,124049689,4681
"11530","Zm00001d037388","6",124166021,124174765,8744
"11531","Zm00001d037392","6",124189352,124195253,5901
"11532","Zm00001d037393","6",124229448,124237937,8489
"11533","Zm00001d037395","6",124278820,124284218,5398
"11534","Zm00001d037396","6",124343156,124348169,5013
"11535","Zm00001d037401","6",124532947,124584221,51274
"11536","Zm00001d037402","6",124535996,124536069,73
"11537","Zm00001d037407","6",124688157,124698986,10829
"11538","Zm00001d037408","6",124701629,124710111,8482
"11539","Zm00001d037410","6",124806566,124807970,1404
"11540","Zm00001d037412","6",124820011,124826714,6703
"11541","Zm00001d037413","6",124872285,124877763,5478
"11542","Zm00001d037415","6",124907191,124909831,2640
"11543","Zm00001d037417","6",124924679,124928912,4233
"11544","Zm00001d037418","6",124947840,124950977,3137
"11545","Zm00001d037420","6",124955837,124958961,3124
"11546","Zm00001d037422","6",125049232,125057616,8384
"11547","Zm00001d037425","6",125123487,125128075,4588
"11548","Zm00001d037426","6",125166233,125166723,490
"11549","Zm00001d037427","6",125220572,125223061,2489
"11550","Zm00001d037429","6",125227720,125231316,3596
"11551","Zm00001d037433","6",125277479,125278059,580
"11552","Zm00001d037434","6",125282529,125288380,5851
"11553","Zm00001d037435","6",125295971,125296354,383
"11554","Zm00001d037436","6",125302098,125302733,635
"11555","Zm00001d037437","6",125370712,125373061,2349
"11556","Zm00001d037438","6",125414259,125423430,9171
"11557","Zm00001d037439","6",125464175,125465714,1539
"11558","Zm00001d037446","6",125606316,125619872,13556
"11559","Zm00001d037448","6",125639761,125644733,4972
"11560","Zm00001d037449","6",125680308,125690389,10081
"11561","Zm00001d037452","6",125852724,125855892,3168
"11562","Zm00001d037453","6",125870108,125872775,2667
"11563","Zm00001d037454","6",125910869,125913919,3050
"11564","Zm00001d037455","6",125931590,125933956,2366
"11565","Zm00001d037461","6",126010753,126018314,7561
"11566","Zm00001d037463","6",126031709,126051619,19910
"11567","Zm00001d037464","6",126133882,126136630,2748
"11568","Zm00001d037465","6",126141682,126151958,10276
"11569","Zm00001d037466","6",126235179,126238357,3178
"11570","Zm00001d037468","6",126299307,126303725,4418
"11571","Zm00001d037471","6",126309095,126311101,2006
"11572","Zm00001d037473","6",126451035,126459342,8307
"11573","Zm00001d037476","6",126489261,126491991,2730
"11574","Zm00001d037477","6",126571157,126571888,731
"11575","Zm00001d037479","6",126616442,126617184,742
"11576","Zm00001d037480","6",126663869,126667210,3341
"11577","Zm00001d037481","6",126730484,126750885,20401
"11578","Zm00001d037482","6",126792822,126795640,2818
"11579","Zm00001d037483","6",126834361,126837493,3132
"11580","Zm00001d037484","6",126845417,126851655,6238
"11581","Zm00001d037485","6",126950070,126953049,2979
"11582","Zm00001d037489","6",127109172,127111102,1930
"11583","Zm00001d037490","6",127182111,127184624,2513
"11584","Zm00001d037492","6",127210249,127215264,5015
"11585","Zm00001d037493","6",127217859,127220546,2687
"11586","Zm00001d037494","6",127256992,127257723,731
"11587","Zm00001d037495","6",127258380,127262098,3718
"11588","Zm00001d037496","6",127259760,127260594,834
"11589","Zm00001d037497","6",127269091,127274746,5655
"11590","Zm00001d037498","6",127318662,127321705,3043
"11591","Zm00001d037499","6",127482891,127494100,11209
"11592","Zm00001d037503","6",127564113,127574808,10695
"11593","Zm00001d037505","6",127619128,127623532,4404
"11594","Zm00001d037507","6",127630189,127633000,2811
"11595","Zm00001d037508","6",127633880,127633952,72
"11596","Zm00001d037509","6",127637988,127641192,3204
"11597","Zm00001d037511","6",127652281,127655143,2862
"11598","Zm00001d037512","6",127655622,127659899,4277
"11599","Zm00001d037514","6",127807250,127807771,521
"11600","Zm00001d037515","6",127808613,127809287,674
"11601","Zm00001d037518","6",127912199,127934838,22639
"11602","Zm00001d037519","6",127997696,128003597,5901
"11603","Zm00001d037521","6",128039738,128045204,5466
"11604","Zm00001d037522","6",128050251,128056674,6423
"11605","Zm00001d037528","6",128147394,128148828,1434
"11606","Zm00001d037529","6",128190263,128195748,5485
"11607","Zm00001d037530","6",128240525,128243297,2772
"11608","Zm00001d037531","6",128390186,128395804,5618
"11609","Zm00001d037532","6",128399274,128418621,19347
"11610","Zm00001d037533","6",128418712,128419587,875
"11611","Zm00001d037536","6",128541535,128605590,64055
"11612","Zm00001d037537","6",128609292,128613832,4540
"11613","Zm00001d037538","6",128640252,128648600,8348
"11614","Zm00001d037540","6",128726080,128728807,2727
"11615","Zm00001d037543","6",128788528,128789977,1449
"11616","Zm00001d037544","6",128804148,128806658,2510
"11617","Zm00001d037545","6",128884696,128886147,1451
"11618","Zm00001d037546","6",128894516,128909650,15134
"11619","Zm00001d037547","6",128952506,128954001,1495
"11620","Zm00001d037550","6",129101873,129103497,1624
"11621","Zm00001d037551","6",129107765,129110513,2748
"11622","Zm00001d037553","6",129188102,129191773,3671
"11623","Zm00001d037556","6",129373946,129378920,4974
"11624","Zm00001d037557","6",129475891,129520935,45044
"11625","Zm00001d037559","6",129537216,129538258,1042
"11626","Zm00001d037562","6",129543822,129548330,4508
"11627","Zm00001d037565","6",129802297,129807428,5131
"11628","Zm00001d037570","6",130017774,130018436,662
"11629","Zm00001d037573","6",130066372,130069036,2664
"11630","Zm00001d037574","6",130069348,130069875,527
"11631","Zm00001d037576","6",130116712,130119868,3156
"11632","Zm00001d037577","6",130275083,130291744,16661
"11633","Zm00001d037579","6",130321257,130351643,30386
"11634","Zm00001d037580","6",130371261,130381077,9816
"11635","Zm00001d037582","6",130519107,130523459,4352
"11636","Zm00001d037586","6",130614027,130621799,7772
"11637","Zm00001d037590","6",130722299,130726941,4642
"11638","Zm00001d037593","6",130757943,130781728,23785
"11639","Zm00001d037596","6",130902727,130912321,9594
"11640","Zm00001d037599","6",131075168,131092642,17474
"11641","Zm00001d037601","6",131168034,131170617,2583
"11642","Zm00001d037602","6",131217074,131220423,3349
"11643","Zm00001d037603","6",131345164,131348227,3063
"11644","Zm00001d037604","6",131348955,131353566,4611
"11645","Zm00001d037605","6",131419763,131421563,1800
"11646","Zm00001d037606","6",131468248,131476305,8057
"11647","Zm00001d037608","6",131624371,131625524,1153
"11648","Zm00001d037609","6",131653518,131657066,3548
"11649","Zm00001d037610","6",131677734,131679156,1422
"11650","Zm00001d037611","6",131705178,131706515,1337
"11651","Zm00001d037612","6",131757384,131761129,3745
"11652","Zm00001d037613","6",131765061,131777860,12799
"11653","Zm00001d037614","6",131770680,131775175,4495
"11654","Zm00001d037615","6",131885556,131892995,7439
"11655","Zm00001d037616","6",131895109,131897519,2410
"11656","Zm00001d037617","6",131900473,131902957,2484
"11657","Zm00001d037619","6",132054552,132056290,1738
"11658","Zm00001d037620","6",132064215,132066492,2277
"11659","Zm00001d037623","6",132134851,132135126,275
"11660","Zm00001d037624","6",132162188,132165945,3757
"11661","Zm00001d037625","6",132204702,132210443,5741
"11662","Zm00001d037626","6",132302357,132311438,9081
"11663","Zm00001d037628","6",132320661,132325847,5186
"11664","Zm00001d037629","6",132326378,132331523,5145
"11665","Zm00001d037631","6",132458321,132458674,353
"11666","Zm00001d037632","6",132468546,132468905,359
"11667","Zm00001d037633","6",132470913,132487481,16568
"11668","Zm00001d037634","6",132501391,132503361,1970
"11669","Zm00001d037636","6",132563362,132570425,7063
"11670","Zm00001d037637","6",132583694,132585993,2299
"11671","Zm00001d037640","6",132630007,132633967,3960
"11672","Zm00001d037642","6",132670023,132671000,977
"11673","Zm00001d037644","6",132737331,132738086,755
"11674","Zm00001d037648","6",132796567,132805878,9311
"11675","Zm00001d037650","6",132828573,132836981,8408
"11676","Zm00001d037651","6",133037545,133043210,5665
"11677","Zm00001d037652","6",133048475,133050067,1592
"11678","Zm00001d037656","6",133140745,133141716,971
"11679","Zm00001d037658","6",133192852,133194981,2129
"11680","Zm00001d037659","6",133275793,133278869,3076
"11681","Zm00001d037661","6",133296885,133300907,4022
"11682","Zm00001d037663","6",133420435,133424501,4066
"11683","Zm00001d037665","6",133519989,133523664,3675
"11684","Zm00001d037666","6",133532459,133535392,2933
"11685","Zm00001d037668","6",133555104,133557311,2207
"11686","Zm00001d037672","6",133574540,133578520,3980
"11687","Zm00001d037674","6",133714246,133717685,3439
"11688","Zm00001d037675","6",133723502,133727955,4453
"11689","Zm00001d037680","6",133844417,133848578,4161
"11690","Zm00001d037681","6",133851119,133853351,2232
"11691","Zm00001d037682","6",133908212,133909537,1325
"11692","Zm00001d037683","6",133913245,133913876,631
"11693","Zm00001d037684","6",133964806,133965066,260
"11694","Zm00001d037687","6",133982114,133986795,4681
"11695","Zm00001d037688","6",134047638,134049666,2028
"11696","Zm00001d037689","6",134063370,134066401,3031
"11697","Zm00001d037690","6",134071257,134072021,764
"11698","Zm00001d037691","6",134088831,134092670,3839
"11699","Zm00001d037693","6",134212972,134216929,3957
"11700","Zm00001d037695","6",134311545,134316068,4523
"11701","Zm00001d037696","6",134319896,134352721,32825
"11702","Zm00001d037700","6",134419542,134425842,6300
"11703","Zm00001d037701","6",134444666,134446246,1580
"11704","Zm00001d037710","6",134664172,134665749,1577
"11705","Zm00001d037711","6",134677233,134678471,1238
"11706","Zm00001d037712","6",134848645,134857406,8761
"11707","Zm00001d037713","6",134933417,134935896,2479
"11708","Zm00001d037714","6",134992108,134994036,1928
"11709","Zm00001d037715","6",135010426,135010557,131
"11710","Zm00001d037717","6",135053658,135064649,10991
"11711","Zm00001d037719","6",135118687,135122165,3478
"11712","Zm00001d037720","6",135179680,135182581,2901
"11713","Zm00001d037721","6",135226984,135228414,1430
"11714","Zm00001d037722","6",135231059,135231797,738
"11715","Zm00001d037723","6",135234049,135235703,1654
"11716","Zm00001d037724","6",135240118,135243717,3599
"11717","Zm00001d037725","6",135244800,135248890,4090
"11718","Zm00001d037727","6",135296144,135300165,4021
"11719","Zm00001d037728","6",135411231,135415832,4601
"11720","Zm00001d037729","6",135445270,135446760,1490
"11721","Zm00001d037731","6",135520819,135531374,10555
"11722","Zm00001d037732","6",135531705,135534553,2848
"11723","Zm00001d037733","6",135558617,135560426,1809
"11724","Zm00001d037734","6",135562503,135576889,14386
"11725","Zm00001d037736","6",135769274,135771300,2026
"11726","Zm00001d037737","6",135893605,135901920,8315
"11727","Zm00001d037738","6",135959877,135960266,389
"11728","Zm00001d037741","6",136056781,136057983,1202
"11729","Zm00001d037742","6",136088835,136091302,2467
"11730","Zm00001d037743","6",136122781,136123527,746
"11731","Zm00001d037744","6",136156205,136171146,14941
"11732","Zm00001d037745","6",136194441,136198848,4407
"11733","Zm00001d037746","6",136205648,136206382,734
"11734","Zm00001d037747","6",136217687,136218253,566
"11735","Zm00001d037748","6",136273610,136278904,5294
"11736","Zm00001d037751","6",136355962,136356846,884
"11737","Zm00001d037756","6",136399634,136402280,2646
"11738","Zm00001d037757","6",136409991,136410359,368
"11739","Zm00001d037759","6",136597264,136600860,3596
"11740","Zm00001d037760","6",136606701,136613008,6307
"11741","Zm00001d037766","6",136762146,136765188,3042
"11742","Zm00001d037768","6",136796927,136798665,1738
"11743","Zm00001d037769","6",136802596,136803895,1299
"11744","Zm00001d037770","6",136860907,136863580,2673
"11745","Zm00001d037771","6",136915169,136922617,7448
"11746","Zm00001d037772","6",136997576,137027536,29960
"11747","Zm00001d037773","6",137001487,137001560,73
"11748","Zm00001d037774","6",137231049,137234466,3417
"11749","Zm00001d037775","6",137239727,137260611,20884
"11750","Zm00001d037776","6",137244007,137246845,2838
"11751","Zm00001d037777","6",137318220,137325751,7531
"11752","Zm00001d037778","6",137348656,137351223,2567
"11753","Zm00001d037779","6",137396807,137399127,2320
"11754","Zm00001d037780","6",137462829,137465879,3050
"11755","Zm00001d037781","6",137503065,137509357,6292
"11756","Zm00001d037782","6",137540925,137542583,1658
"11757","Zm00001d037783","6",137664274,137666727,2453
"11758","Zm00001d037784","6",137680490,137684176,3686
"11759","Zm00001d037785","6",137686672,137693217,6545
"11760","Zm00001d037786","6",137825036,137834294,9258
"11761","Zm00001d037787","6",137836005,137838611,2606
"11762","Zm00001d037790","6",137856386,137865363,8977
"11763","Zm00001d037794","6",137924110,137933384,9274
"11764","Zm00001d037797","6",138055273,138059689,4416
"11765","Zm00001d037799","6",138087194,138087793,599
"11766","Zm00001d037802","6",138179259,138180014,755
"11767","Zm00001d037803","6",138208458,138215829,7371
"11768","Zm00001d037806","6",138376951,138377358,407
"11769","Zm00001d037807","6",138381297,138396127,14830
"11770","Zm00001d037808","6",138453460,138484610,31150
"11771","Zm00001d037810","6",138532222,138543958,11736
"11772","Zm00001d037811","6",138545312,138550589,5277
"11773","Zm00001d037813","6",138594710,138600101,5391
"11774","Zm00001d037814","6",138654839,138655693,854
"11775","Zm00001d037815","6",138659083,138665341,6258
"11776","Zm00001d037816","6",138740453,138748540,8087
"11777","Zm00001d037818","6",138768163,138775035,6872
"11778","Zm00001d037824","6",138839613,138842366,2753
"11779","Zm00001d037828","6",138946987,138948206,1219
"11780","Zm00001d037829","6",138952901,138960335,7434
"11781","Zm00001d037830","6",139004086,139006575,2489
"11782","Zm00001d037832","6",139093585,139101315,7730
"11783","Zm00001d037833","6",139171673,139177865,6192
"11784","Zm00001d037834","6",139182269,139183528,1259
"11785","Zm00001d037836","6",139238531,139250622,12091
"11786","Zm00001d037837","6",139283148,139290687,7539
"11787","Zm00001d037842","6",139372133,139379105,6972
"11788","Zm00001d037843","6",139458671,139460040,1369
"11789","Zm00001d037846","6",139569167,139584177,15010
"11790","Zm00001d037847","6",139626653,139627309,656
"11791","Zm00001d037848","6",139632912,139635759,2847
"11792","Zm00001d037849","6",139653712,139656071,2359
"11793","Zm00001d037852","6",139764198,139776293,12095
"11794","Zm00001d037856","6",139897678,139901307,3629
"11795","Zm00001d037858","6",139991985,139995915,3930
"11796","Zm00001d037859","6",140001946,140006130,4184
"11797","Zm00001d037860","6",140054498,140057628,3130
"11798","Zm00001d037861","6",140078685,140083862,5177
"11799","Zm00001d037864","6",140113133,140137256,24123
"11800","Zm00001d037867","6",140348149,140388721,40572
"11801","Zm00001d037868","6",140460105,140461421,1316
"11802","Zm00001d037870","6",140470585,140474606,4021
"11803","Zm00001d037871","6",140510019,140515127,5108
"11804","Zm00001d037872","6",140520704,140530189,9485
"11805","Zm00001d037873","6",140618302,140621444,3142
"11806","Zm00001d037874","6",140671505,140673259,1754
"11807","Zm00001d037875","6",140722761,140725875,3114
"11808","Zm00001d037876","6",140759835,140762631,2796
"11809","Zm00001d037877","6",140803654,140806857,3203
"11810","Zm00001d037884","6",141021350,141024377,3027
"11811","Zm00001d037886","6",141049435,141052489,3054
"11812","Zm00001d037889","6",141172871,141173308,437
"11813","Zm00001d037890","6",141204831,141207107,2276
"11814","Zm00001d037891","6",141258083,141260086,2003
"11815","Zm00001d037894","6",141324495,141325549,1054
"11816","Zm00001d037897","6",141442249,141445624,3375
"11817","Zm00001d037898","6",141447130,141450540,3410
"11818","Zm00001d037899","6",141471442,141476949,5507
"11819","Zm00001d037900","6",141485419,141489103,3684
"11820","Zm00001d037901","6",141534061,141535449,1388
"11821","Zm00001d037902","6",141549583,141552880,3297
"11822","Zm00001d037903","6",141555451,141555881,430
"11823","Zm00001d037904","6",141633981,141635440,1459
"11824","Zm00001d037905","6",141652564,141655295,2731
"11825","Zm00001d037909","6",141669423,141669944,521
"11826","Zm00001d037911","6",141752465,141755756,3291
"11827","Zm00001d037914","6",141839892,141840377,485
"11828","Zm00001d037915","6",141874632,141875420,788
"11829","Zm00001d037916","6",141931015,141933513,2498
"11830","Zm00001d037917","6",141963393,141966135,2742
"11831","Zm00001d037918","6",141972442,141976417,3975
"11832","Zm00001d037920","6",141997725,142002530,4805
"11833","Zm00001d037921","6",142003418,142016000,12582
"11834","Zm00001d037923","6",142037095,142039970,2875
"11835","Zm00001d037924","6",142039216,142040921,1705
"11836","Zm00001d037925","6",142153338,142157700,4362
"11837","Zm00001d037926","6",142176497,142179576,3079
"11838","Zm00001d037927","6",142228724,142235961,7237
"11839","Zm00001d037929","6",142399394,142401680,2286
"11840","Zm00001d037932","6",142512806,142521198,8392
"11841","Zm00001d037934","6",142590235,142594536,4301
"11842","Zm00001d037935","6",142626643,142628259,1616
"11843","Zm00001d037937","6",142777670,142778191,521
"11844","Zm00001d037939","6",142830033,142844642,14609
"11845","Zm00001d037940","6",142845734,142848137,2403
"11846","Zm00001d037941","6",142909977,142911255,1278
"11847","Zm00001d037942","6",142917902,142921106,3204
"11848","Zm00001d037943","6",142933942,142934535,593
"11849","Zm00001d037945","6",143003756,143004352,596
"11850","Zm00001d037946","6",143056934,143084269,27335
"11851","Zm00001d037947","6",143126162,143128998,2836
"11852","Zm00001d037949","6",143243175,143246248,3073
"11853","Zm00001d037950","6",143301519,143339329,37810
"11854","Zm00001d037951","6",143342335,143352982,10647
"11855","Zm00001d037955","6",143488436,143491447,3011
"11856","Zm00001d037956","6",143537506,143539305,1799
"11857","Zm00001d037958","6",143543082,143543567,485
"11858","Zm00001d037959","6",143547873,143549151,1278
"11859","Zm00001d037961","6",143608955,143614548,5593
"11860","Zm00001d037962","6",143657539,143663237,5698
"11861","Zm00001d037966","6",143777350,143782102,4752
"11862","Zm00001d037967","6",143821245,143826772,5527
"11863","Zm00001d037968","6",143834712,143836988,2276
"11864","Zm00001d037969","6",143835888,143836243,355
"11865","Zm00001d037970","6",143865088,143884774,19686
"11866","Zm00001d037971","6",143885595,143894219,8624
"11867","Zm00001d037972","6",143911485,143913119,1634
"11868","Zm00001d037973","6",143915647,143918223,2576
"11869","Zm00001d037974","6",143924167,143932622,8455
"11870","Zm00001d037975","6",143931547,143937625,6078
"11871","Zm00001d037978","6",144038433,144042697,4264
"11872","Zm00001d037979","6",144060572,144071744,11172
"11873","Zm00001d037980","6",144076079,144086809,10730
"11874","Zm00001d037981","6",144086688,144129140,42452
"11875","Zm00001d037982","6",144216057,144258410,42353
"11876","Zm00001d037983","6",144371484,144378333,6849
"11877","Zm00001d037984","6",144381242,144390852,9610
"11878","Zm00001d037985","6",144391967,144392983,1016
"11879","Zm00001d037986","6",144411563,144415206,3643
"11880","Zm00001d037990","6",144434359,144437934,3575
"11881","Zm00001d037992","6",144487080,144490321,3241
"11882","Zm00001d037993","6",144580998,144584809,3811
"11883","Zm00001d037994","6",144651004,144652113,1109
"11884","Zm00001d037997","6",144725371,144726215,844
"11885","Zm00001d038000","6",144772739,144778872,6133
"11886","Zm00001d038001","6",144781755,144782501,746
"11887","Zm00001d038002","6",144795979,144802557,6578
"11888","Zm00001d038003","6",144813893,144814871,978
"11889","Zm00001d038004","6",144866036,144869120,3084
"11890","Zm00001d038005","6",144871781,144875663,3882
"11891","Zm00001d038006","6",144945936,144965898,19962
"11892","Zm00001d038007","6",145000655,145009587,8932
"11893","Zm00001d038010","6",145076577,145086455,9878
"11894","Zm00001d038012","6",145094748,145101745,6997
"11895","Zm00001d038013","6",145148378,145149283,905
"11896","Zm00001d038014","6",145191041,145192604,1563
"11897","Zm00001d038016","6",145258369,145259274,905
"11898","Zm00001d038018","6",145331645,145332719,1074
"11899","Zm00001d038019","6",145386455,145388049,1594
"11900","Zm00001d038020","6",145388523,145391962,3439
"11901","Zm00001d038021","6",145393970,145398983,5013
"11902","Zm00001d038022","6",145415188,145419374,4186
"11903","Zm00001d038023","6",145529821,145531626,1805
"11904","Zm00001d038026","6",145577996,145579521,1525
"11905","Zm00001d038027","6",145584488,145588965,4477
"11906","Zm00001d038029","6",145629023,145629361,338
"11907","Zm00001d038030","6",145631230,145632801,1571
"11908","Zm00001d038034","6",145744972,145747768,2796
"11909","Zm00001d038035","6",145771770,145775848,4078
"11910","Zm00001d038036","6",145776748,145779475,2727
"11911","Zm00001d038038","6",145849942,145852944,3002
"11912","Zm00001d038039","6",145912636,145942513,29877
"11913","Zm00001d038042","6",145954175,145954865,690
"11914","Zm00001d038045","6",145988535,145990885,2350
"11915","Zm00001d038047","6",146025759,146027781,2022
"11916","Zm00001d038048","6",146337395,146338774,1379
"11917","Zm00001d038049","6",146401513,146405955,4442
"11918","Zm00001d038050","6",146409573,146410207,634
"11919","Zm00001d038051","6",146434683,146437999,3316
"11920","Zm00001d038054","6",146525775,146534899,9124
"11921","Zm00001d038056","6",146555470,146556601,1131
"11922","Zm00001d038057","6",146563551,146567353,3802
"11923","Zm00001d038058","6",146568999,146572316,3317
"11924","Zm00001d038059","6",146582007,146590440,8433
"11925","Zm00001d038060","6",146619927,146621546,1619
"11926","Zm00001d038061","6",146627115,146627729,614
"11927","Zm00001d038062","6",146675466,146678915,3449
"11928","Zm00001d038063","6",146680443,146684009,3566
"11929","Zm00001d038064","6",146725709,146727657,1948
"11930","Zm00001d038065","6",146729701,146732419,2718
"11931","Zm00001d038066","6",146740027,146741896,1869
"11932","Zm00001d038067","6",146744854,146745447,593
"11933","Zm00001d038068","6",146842279,146844363,2084
"11934","Zm00001d038070","6",146878180,146878815,635
"11935","Zm00001d038071","6",146905188,146911103,5915
"11936","Zm00001d038072","6",146915089,146916918,1829
"11937","Zm00001d038074","6",146926719,146929236,2517
"11938","Zm00001d038075","6",146934845,146935081,236
"11939","Zm00001d038076","6",146985214,146990181,4967
"11940","Zm00001d038077","6",147022015,147031210,9195
"11941","Zm00001d038080","6",147037411,147040562,3151
"11942","Zm00001d038081","6",147117119,147118645,1526
"11943","Zm00001d038082","6",147124493,147129831,5338
"11944","Zm00001d038084","6",147215793,147221548,5755
"11945","Zm00001d038085","6",147225144,147234198,9054
"11946","Zm00001d038087","6",147379164,147385725,6561
"11947","Zm00001d038088","6",147389479,147392520,3041
"11948","Zm00001d038089","6",147426612,147430336,3724
"11949","Zm00001d038090","6",147428369,147428440,71
"11950","Zm00001d038091","6",147431407,147442852,11445
"11951","Zm00001d038092","6",147483399,147495234,11835
"11952","Zm00001d038093","6",147577082,147627637,50555
"11953","Zm00001d038094","6",147638455,147639972,1517
"11954","Zm00001d038095","6",147644019,147645745,1726
"11955","Zm00001d038097","6",147746791,147774056,27265
"11956","Zm00001d038098","6",147839473,147840159,686
"11957","Zm00001d038099","6",147845748,147847416,1668
"11958","Zm00001d038100","6",147934926,147945863,10937
"11959","Zm00001d038101","6",147948838,147953091,4253
"11960","Zm00001d038104","6",148044310,148054129,9819
"11961","Zm00001d038105","6",148054774,148060314,5540
"11962","Zm00001d038106","6",148079948,148099610,19662
"11963","Zm00001d038107","6",148214266,148220654,6388
"11964","Zm00001d038108","6",148221465,148224285,2820
"11965","Zm00001d038109","6",148254777,148260114,5337
"11966","Zm00001d038113","6",148382390,148390037,7647
"11967","Zm00001d038114","6",148436043,148447618,11575
"11968","Zm00001d038117","6",148556701,148557459,758
"11969","Zm00001d038118","6",148601879,148606454,4575
"11970","Zm00001d038120","6",148607191,148610200,3009
"11971","Zm00001d038121","6",148612409,148616192,3783
"11972","Zm00001d038122","6",148671141,148673006,1865
"11973","Zm00001d038123","6",148737498,148748541,11043
"11974","Zm00001d038125","6",148759498,148761258,1760
"11975","Zm00001d038126","6",148784939,148788210,3271
"11976","Zm00001d038127","6",148802708,148805989,3281
"11977","Zm00001d038128","6",148806666,148816056,9390
"11978","Zm00001d038129","6",148850561,148854330,3769
"11979","Zm00001d038130","6",148855003,148861483,6480
"11980","Zm00001d038131","6",148929804,148934054,4250
"11981","Zm00001d038133","6",148944655,148947525,2870
"11982","Zm00001d038134","6",148972280,148984209,11929
"11983","Zm00001d038135","6",149155712,149159456,3744
"11984","Zm00001d038136","6",149167447,149172136,4689
"11985","Zm00001d038137","6",149187483,149188406,923
"11986","Zm00001d038139","6",149203856,149206407,2551
"11987","Zm00001d038142","6",149249422,149257799,8377
"11988","Zm00001d038143","6",149267387,149270633,3246
"11989","Zm00001d038144","6",149273079,149274204,1125
"11990","Zm00001d038146","6",149349113,149356312,7199
"11991","Zm00001d038147","6",149398193,149403023,4830
"11992","Zm00001d038148","6",149403737,149406493,2756
"11993","Zm00001d038149","6",149411278,149417608,6330
"11994","Zm00001d038150","6",149492907,149511919,19012
"11995","Zm00001d038153","6",149632452,149633657,1205
"11996","Zm00001d038155","6",149715910,149719371,3461
"11997","Zm00001d038156","6",149721375,149731447,10072
"11998","Zm00001d038158","6",149857328,149858539,1211
"11999","Zm00001d038161","6",149974813,149981979,7166
"12000","Zm00001d038163","6",150024486,150035717,11231
"12001","Zm00001d038164","6",150068990,150075970,6980
"12002","Zm00001d038165","6",150159091,150161690,2599
"12003","Zm00001d038166","6",150256768,150262995,6227
"12004","Zm00001d038167","6",150267525,150271745,4220
"12005","Zm00001d038170","6",150418144,150422431,4287
"12006","Zm00001d038171","6",150452628,150456212,3584
"12007","Zm00001d038172","6",150500441,150513770,13329
"12008","Zm00001d038173","6",150515309,150517736,2427
"12009","Zm00001d038174","6",150536285,150541728,5443
"12010","Zm00001d038176","6",150544683,150545888,1205
"12011","Zm00001d038177","6",150598351,150599304,953
"12012","Zm00001d038178","6",150602516,150603595,1079
"12013","Zm00001d038179","6",150651520,150652753,1233
"12014","Zm00001d038180","6",150718378,150719322,944
"12015","Zm00001d038181","6",150745127,150748423,3296
"12016","Zm00001d038184","6",150823555,150827832,4277
"12017","Zm00001d038186","6",150861505,150866590,5085
"12018","Zm00001d038187","6",150882248,150898072,15824
"12019","Zm00001d038189","6",150913450,150943935,30485
"12020","Zm00001d038190","6",151016911,151026013,9102
"12021","Zm00001d038191","6",151070539,151071477,938
"12022","Zm00001d038192","6",151106706,151108105,1399
"12023","Zm00001d038193","6",151176435,151181930,5495
"12024","Zm00001d038194","6",151182319,151192052,9733
"12025","Zm00001d038195","6",151255025,151256961,1936
"12026","Zm00001d038196","6",151266841,151271722,4881
"12027","Zm00001d038198","6",151367012,151371942,4930
"12028","Zm00001d038199","6",151386730,151390994,4264
"12029","Zm00001d038200","6",151393535,151403991,10456
"12030","Zm00001d038202","6",151448102,151448572,470
"12031","Zm00001d038203","6",151449635,151450009,374
"12032","Zm00001d038204","6",151478201,151482917,4716
"12033","Zm00001d038205","6",151484233,151503688,19455
"12034","Zm00001d038206","6",151544234,151547273,3039
"12035","Zm00001d038208","6",151703542,151710829,7287
"12036","Zm00001d038209","6",151715973,151720708,4735
"12037","Zm00001d038211","6",151749600,151753116,3516
"12038","Zm00001d038213","6",151780308,151786269,5961
"12039","Zm00001d038217","6",151823509,151834751,11242
"12040","Zm00001d038218","6",151836744,151842571,5827
"12041","Zm00001d038219","6",151838559,151838632,73
"12042","Zm00001d038220","6",151844352,151844888,536
"12043","Zm00001d038221","6",151942943,151944950,2007
"12044","Zm00001d038222","6",151951671,151955702,4031
"12045","Zm00001d038223","6",151957816,151962410,4594
"12046","Zm00001d038224","6",151975768,151979800,4032
"12047","Zm00001d038225","6",151983412,151987196,3784
"12048","Zm00001d038226","6",151988250,151991045,2795
"12049","Zm00001d038227","6",151995956,152000206,4250
"12050","Zm00001d038228","6",152043328,152047466,4138
"12051","Zm00001d038229","6",152047566,152052815,5249
"12052","Zm00001d038232","6",152065951,152068381,2430
"12053","Zm00001d038239","6",152182637,152184624,1987
"12054","Zm00001d038240","6",152198261,152212313,14052
"12055","Zm00001d038242","6",152217371,152218411,1040
"12056","Zm00001d038248","6",152313041,152316646,3605
"12057","Zm00001d038249","6",152319761,152320252,491
"12058","Zm00001d038250","6",152371396,152373310,1914
"12059","Zm00001d038251","6",152415541,152418257,2716
"12060","Zm00001d038252","6",152420069,152431280,11211
"12061","Zm00001d038257","6",152487340,152494612,7272
"12062","Zm00001d038258","6",152493588,152497473,3885
"12063","Zm00001d038262","6",152608623,152611425,2802
"12064","Zm00001d038263","6",152647225,152651923,4698
"12065","Zm00001d038266","6",152695706,152701233,5527
"12066","Zm00001d038267","6",152765549,152768497,2948
"12067","Zm00001d038268","6",152782090,152785547,3457
"12068","Zm00001d038269","6",152840908,152842890,1982
"12069","Zm00001d038270","6",152871846,152873850,2004
"12070","Zm00001d038271","6",152900544,152903712,3168
"12071","Zm00001d038272","6",152937079,152940336,3257
"12072","Zm00001d038273","6",152958703,152962372,3669
"12073","Zm00001d038274","6",153040258,153042534,2276
"12074","Zm00001d038275","6",153048413,153062282,13869
"12075","Zm00001d038280","6",153171029,153172387,1358
"12076","Zm00001d038281","6",153208694,153209677,983
"12077","Zm00001d038282","6",153243817,153250372,6555
"12078","Zm00001d038288","6",153438837,153439986,1149
"12079","Zm00001d038290","6",153552561,153558567,6006
"12080","Zm00001d038291","6",153560369,153560833,464
"12081","Zm00001d038292","6",153563038,153569387,6349
"12082","Zm00001d038293","6",153575715,153576689,974
"12083","Zm00001d038294","6",153578156,153579270,1114
"12084","Zm00001d038299","6",153761010,153764311,3301
"12085","Zm00001d038300","6",153808873,153811355,2482
"12086","Zm00001d038301","6",153933043,153935944,2901
"12087","Zm00001d038302","6",153936300,153956392,20092
"12088","Zm00001d038303","6",154043481,154046448,2967
"12089","Zm00001d038304","6",154053716,154056057,2341
"12090","Zm00001d038306","6",154116776,154122027,5251
"12091","Zm00001d038307","6",154155440,154156880,1440
"12092","Zm00001d038308","6",154161248,154162472,1224
"12093","Zm00001d038309","6",154162667,154163635,968
"12094","Zm00001d038310","6",154166396,154172068,5672
"12095","Zm00001d038311","6",154175962,154178461,2499
"12096","Zm00001d038312","6",154178760,154181261,2501
"12097","Zm00001d038316","6",154199362,154200027,665
"12098","Zm00001d038317","6",154269350,154309373,40023
"12099","Zm00001d038318","6",154317639,154322897,5258
"12100","Zm00001d038319","6",154339042,154352874,13832
"12101","Zm00001d038320","6",154382390,154383061,671
"12102","Zm00001d038321","6",154392522,154396794,4272
"12103","Zm00001d038326","6",154559425,154564538,5113
"12104","Zm00001d038327","6",154610724,154620497,9773
"12105","Zm00001d038328","6",154621237,154627300,6063
"12106","Zm00001d038329","6",154629000,154634450,5450
"12107","Zm00001d038330","6",154712695,154715814,3119
"12108","Zm00001d038331","6",154718713,154721952,3239
"12109","Zm00001d038332","6",154779604,154781235,1631
"12110","Zm00001d038333","6",154781646,154786268,4622
"12111","Zm00001d038334","6",154787169,154790440,3271
"12112","Zm00001d038335","6",154795657,154796198,541
"12113","Zm00001d038336","6",154799581,154805757,6176
"12114","Zm00001d038337","6",154805911,154809400,3489
"12115","Zm00001d038338","6",154811648,154812744,1096
"12116","Zm00001d038340","6",154857022,154859451,2429
"12117","Zm00001d038341","6",154861547,154862467,920
"12118","Zm00001d038342","6",154871823,154875711,3888
"12119","Zm00001d038343","6",154892326,154897705,5379
"12120","Zm00001d038345","6",154904607,154906544,1937
"12121","Zm00001d038346","6",154922720,154925381,2661
"12122","Zm00001d038347","6",154944968,154947107,2139
"12123","Zm00001d038348","6",154954100,154957745,3645
"12124","Zm00001d038351","6",155009149,155011475,2326
"12125","Zm00001d038352","6",155011567,155014793,3226
"12126","Zm00001d038355","6",155172016,155176200,4184
"12127","Zm00001d038357","6",155275133,155277368,2235
"12128","Zm00001d038358","6",155277368,155285524,8156
"12129","Zm00001d038359","6",155351683,155357867,6184
"12130","Zm00001d038361","6",155375902,155382809,6907
"12131","Zm00001d038362","6",155594061,155597951,3890
"12132","Zm00001d038363","6",155602190,155607181,4991
"12133","Zm00001d038364","6",155605754,155607409,1655
"12134","Zm00001d038365","6",155606052,155610646,4594
"12135","Zm00001d038366","6",155615722,155618715,2993
"12136","Zm00001d038367","6",155628842,155636644,7802
"12137","Zm00001d038368","6",155638267,155640737,2470
"12138","Zm00001d038371","6",155675685,155678583,2898
"12139","Zm00001d038372","6",155697084,155697746,662
"12140","Zm00001d038373","6",155702857,155714004,11147
"12141","Zm00001d038374","6",155771539,155773464,1925
"12142","Zm00001d038375","6",155834276,155842881,8605
"12143","Zm00001d038376","6",155902916,155911076,8160
"12144","Zm00001d038377","6",155916652,155920144,3492
"12145","Zm00001d038378","6",155920028,155922496,2468
"12146","Zm00001d038380","6",155926731,155930493,3762
"12147","Zm00001d038381","6",155954300,155955375,1075
"12148","Zm00001d038382","6",156005020,156005586,566
"12149","Zm00001d038383","6",156033417,156038359,4942
"12150","Zm00001d038384","6",156038483,156039204,721
"12151","Zm00001d038387","6",156102753,156103963,1210
"12152","Zm00001d038388","6",156196518,156197603,1085
"12153","Zm00001d038389","6",156202742,156209654,6912
"12154","Zm00001d038392","6",156251590,156252963,1373
"12155","Zm00001d038393","6",156266616,156278451,11835
"12156","Zm00001d038394","6",156292425,156294916,2491
"12157","Zm00001d038396","6",156306931,156312467,5536
"12158","Zm00001d038397","6",156313336,156319037,5701
"12159","Zm00001d038400","6",156334724,156338067,3343
"12160","Zm00001d038401","6",156376400,156376642,242
"12161","Zm00001d038403","6",156381948,156382136,188
"12162","Zm00001d038404","6",156394901,156403240,8339
"12163","Zm00001d038405","6",156409880,156412505,2625
"12164","Zm00001d038407","6",156451717,156459041,7324
"12165","Zm00001d038408","6",156584166,156585091,925
"12166","Zm00001d038409","6",156603002,156614078,11076
"12167","Zm00001d038420","6",156986729,156987259,530
"12168","Zm00001d038421","6",156994029,156997324,3295
"12169","Zm00001d038425","6",157072660,157073808,1148
"12170","Zm00001d038426","6",157076901,157083997,7096
"12171","Zm00001d038429","6",157110046,157111281,1235
"12172","Zm00001d038431","6",157123389,157125041,1652
"12173","Zm00001d038432","6",157148623,157154057,5434
"12174","Zm00001d038434","6",157157476,157160356,2880
"12175","Zm00001d038435","6",157224887,157228579,3692
"12176","Zm00001d038436","6",157247855,157248457,602
"12177","Zm00001d038437","6",157258172,157260090,1918
"12178","Zm00001d038438","6",157265153,157266777,1624
"12179","Zm00001d038439","6",157267418,157270190,2772
"12180","Zm00001d038440","6",157297323,157308181,10858
"12181","Zm00001d038442","6",157367707,157368450,743
"12182","Zm00001d038443","6",157379123,157391366,12243
"12183","Zm00001d038445","6",157396216,157403388,7172
"12184","Zm00001d038446","6",157407857,157411040,3183
"12185","Zm00001d038447","6",157414914,157416701,1787
"12186","Zm00001d038448","6",157417466,157418730,1264
"12187","Zm00001d038449","6",157427258,157434499,7241
"12188","Zm00001d038452","6",157515617,157520471,4854
"12189","Zm00001d038453","6",157518291,157524838,6547
"12190","Zm00001d038456","6",157648981,157650905,1924
"12191","Zm00001d038459","6",157664931,157677466,12535
"12192","Zm00001d038460","6",157677507,157682181,4674
"12193","Zm00001d038463","6",157760437,157795769,35332
"12194","Zm00001d038466","6",157847118,157847813,695
"12195","Zm00001d038467","6",157922722,157927689,4967
"12196","Zm00001d038469","6",157938345,157941059,2714
"12197","Zm00001d038471","6",157965104,157967206,2102
"12198","Zm00001d038473","6",158066140,158067240,1100
"12199","Zm00001d038475","6",158240771,158284439,43668
"12200","Zm00001d038476","6",158313985,158316132,2147
"12201","Zm00001d038477","6",158326966,158327436,470
"12202","Zm00001d038480","6",158345779,158351780,6001
"12203","Zm00001d038481","6",158357164,158361534,4370
"12204","Zm00001d038483","6",158365578,158366865,1287
"12205","Zm00001d038485","6",158494145,158500979,6834
"12206","Zm00001d038486","6",158501038,158506272,5234
"12207","Zm00001d038487","6",158506547,158512560,6013
"12208","Zm00001d038489","6",158517969,158522683,4714
"12209","Zm00001d038491","6",158530754,158533955,3201
"12210","Zm00001d038493","6",158542346,158546771,4425
"12211","Zm00001d038494","6",158547372,158556691,9319
"12212","Zm00001d038497","6",158602198,158603012,814
"12213","Zm00001d038498","6",158611864,158612328,464
"12214","Zm00001d038499","6",158626364,158632111,5747
"12215","Zm00001d038500","6",158634183,158640368,6185
"12216","Zm00001d038502","6",158757903,158759244,1341
"12217","Zm00001d038503","6",158787568,158795745,8177
"12218","Zm00001d038504","6",158797382,158802161,4779
"12219","Zm00001d038506","6",158825449,158829586,4137
"12220","Zm00001d038508","6",158903333,158906310,2977
"12221","Zm00001d038509","6",158906302,158909167,2865
"12222","Zm00001d038510","6",158911676,158913989,2313
"12223","Zm00001d038511","6",158957756,158969636,11880
"12224","Zm00001d038512","6",159009688,159011163,1475
"12225","Zm00001d038513","6",159016919,159021040,4121
"12226","Zm00001d038517","6",159098609,159101687,3078
"12227","Zm00001d038519","6",159118513,159119912,1399
"12228","Zm00001d038520","6",159134032,159135950,1918
"12229","Zm00001d038522","6",159140146,159146205,6059
"12230","Zm00001d038523","6",159196375,159197314,939
"12231","Zm00001d038525","6",159266842,159275183,8341
"12232","Zm00001d038526","6",159310512,159311747,1235
"12233","Zm00001d038527","6",159314690,159317806,3116
"12234","Zm00001d038528","6",159346413,159347414,1001
"12235","Zm00001d038529","6",159350688,159355063,4375
"12236","Zm00001d038530","6",159360268,159371993,11725
"12237","Zm00001d038531","6",159372275,159375470,3195
"12238","Zm00001d038532","6",159376647,159378030,1383
"12239","Zm00001d038533","6",159380616,159390229,9613
"12240","Zm00001d038534","6",159485637,159487450,1813
"12241","Zm00001d038535","6",159533551,159536132,2581
"12242","Zm00001d038536","6",159537562,159543625,6063
"12243","Zm00001d038537","6",159545684,159546748,1064
"12244","Zm00001d038538","6",159592404,159594335,1931
"12245","Zm00001d038539","6",159595837,159598231,2394
"12246","Zm00001d038540","6",159599268,159602738,3470
"12247","Zm00001d038541","6",159603966,159608236,4270
"12248","Zm00001d038542","6",159649836,159650908,1072
"12249","Zm00001d038543","6",159654814,159659232,4418
"12250","Zm00001d038545","6",159656851,159657300,449
"12251","Zm00001d038546","6",159661656,159665659,4003
"12252","Zm00001d038547","6",159734306,159738603,4297
"12253","Zm00001d038548","6",159741949,159745380,3431
"12254","Zm00001d038549","6",159748176,159754138,5962
"12255","Zm00001d038550","6",159758961,159760338,1377
"12256","Zm00001d038552","6",159770092,159772070,1978
"12257","Zm00001d038553","6",159774069,159775714,1645
"12258","Zm00001d038554","6",159783705,159785565,1860
"12259","Zm00001d038555","6",159789930,159794329,4399
"12260","Zm00001d038556","6",159791266,159791335,69
"12261","Zm00001d038557","6",159799343,159805085,5742
"12262","Zm00001d038558","6",159804909,159805962,1053
"12263","Zm00001d038562","6",159894087,159895160,1073
"12264","Zm00001d038563","6",159913154,159914041,887
"12265","Zm00001d038564","6",159977702,159980430,2728
"12266","Zm00001d038565","6",159994811,159998101,3290
"12267","Zm00001d038566","6",160002479,160007625,5146
"12268","Zm00001d038570","6",160117977,160132682,14705
"12269","Zm00001d038571","6",160122421,160125471,3050
"12270","Zm00001d038572","6",160153885,160158041,4156
"12271","Zm00001d038574","6",160173085,160179557,6472
"12272","Zm00001d038576","6",160345574,160353313,7739
"12273","Zm00001d038577","6",160386564,160392779,6215
"12274","Zm00001d038578","6",160391004,160393071,2067
"12275","Zm00001d038579","6",160393660,160396437,2777
"12276","Zm00001d038581","6",160412399,160413031,632
"12277","Zm00001d038582","6",160508907,160510308,1401
"12278","Zm00001d038583","6",160510691,160523981,13290
"12279","Zm00001d038584","6",160527296,160527928,632
"12280","Zm00001d038585","6",160539493,160540155,662
"12281","Zm00001d038586","6",160544165,160544485,320
"12282","Zm00001d038587","6",160544943,160563220,18277
"12283","Zm00001d038589","6",160579671,160585683,6012
"12284","Zm00001d038592","6",160631298,160631955,657
"12285","Zm00001d038593","6",160633519,160633884,365
"12286","Zm00001d038594","6",160662673,160664840,2167
"12287","Zm00001d038595","6",160665554,160668934,3380
"12288","Zm00001d038597","6",160677919,160678539,620
"12289","Zm00001d038598","6",160693573,160695070,1497
"12290","Zm00001d038599","6",160734732,160736672,1940
"12291","Zm00001d038600","6",160737498,160741340,3842
"12292","Zm00001d038605","6",160888107,160889679,1572
"12293","Zm00001d038607","6",160895233,160895538,305
"12294","Zm00001d038608","6",160896290,160898350,2060
"12295","Zm00001d038610","6",160902233,160902907,674
"12296","Zm00001d038612","6",160910269,160912709,2440
"12297","Zm00001d038613","6",160916434,160917435,1001
"12298","Zm00001d038616","6",160984295,160985107,812
"12299","Zm00001d038617","6",160995175,160996938,1763
"12300","Zm00001d038618","6",161016360,161021055,4695
"12301","Zm00001d038619","6",161021494,161023204,1710
"12302","Zm00001d038620","6",161058760,161063969,5209
"12303","Zm00001d038622","6",161065061,161069213,4152
"12304","Zm00001d038623","6",161118605,161123856,5251
"12305","Zm00001d038624","6",161158655,161159509,854
"12306","Zm00001d038625","6",161162525,161167432,4907
"12307","Zm00001d038626","6",161183072,161183254,182
"12308","Zm00001d038628","6",161293205,161293941,736
"12309","Zm00001d038631","6",161384697,161385708,1011
"12310","Zm00001d038638","6",161446678,161447555,877
"12311","Zm00001d038642","6",161549380,161551931,2551
"12312","Zm00001d038644","6",161622743,161636125,13382
"12313","Zm00001d038645","6",161639242,161641010,1768
"12314","Zm00001d038646","6",161644067,161647957,3890
"12315","Zm00001d038647","6",161688483,161688986,503
"12316","Zm00001d038648","6",161702211,161706863,4652
"12317","Zm00001d038649","6",161716055,161718253,2198
"12318","Zm00001d038650","6",161720010,161726844,6834
"12319","Zm00001d038651","6",161809629,161813487,3858
"12320","Zm00001d038652","6",161892117,161896560,4443
"12321","Zm00001d038653","6",161892150,161896354,4204
"12322","Zm00001d038655","6",161921883,161936270,14387
"12323","Zm00001d038656","6",161924907,161924980,73
"12324","Zm00001d038657","6",161938045,161943212,5167
"12325","Zm00001d038658","6",161945970,161951107,5137
"12326","Zm00001d038660","6",161968078,161971277,3199
"12327","Zm00001d038661","6",161973344,161977653,4309
"12328","Zm00001d038664","6",162201437,162205584,4147
"12329","Zm00001d038666","6",162225825,162227478,1653
"12330","Zm00001d038667","6",162268229,162273500,5271
"12331","Zm00001d038668","6",162275763,162277797,2034
"12332","Zm00001d038669","6",162277981,162278064,83
"12333","Zm00001d038670","6",162280071,162280155,84
"12334","Zm00001d038671","6",162280368,162287252,6884
"12335","Zm00001d038672","6",162349398,162358421,9023
"12336","Zm00001d038673","6",162361472,162373818,12346
"12337","Zm00001d038675","6",162375302,162385552,10250
"12338","Zm00001d038676","6",162387696,162391572,3876
"12339","Zm00001d038678","6",162432307,162441044,8737
"12340","Zm00001d038680","6",162442729,162443088,359
"12341","Zm00001d038681","6",162449712,162452059,2347
"12342","Zm00001d038682","6",162456348,162458601,2253
"12343","Zm00001d038684","6",162562559,162568746,6187
"12344","Zm00001d038685","6",162571773,162577138,5365
"12345","Zm00001d038686","6",162595881,162598103,2222
"12346","Zm00001d038687","6",162598342,162601795,3453
"12347","Zm00001d038688","6",162602604,162605160,2556
"12348","Zm00001d038689","6",162605299,162610720,5421
"12349","Zm00001d038690","6",162618614,162620125,1511
"12350","Zm00001d038691","6",162624149,162628635,4486
"12351","Zm00001d038692","6",162628784,162630681,1897
"12352","Zm00001d038695","6",162656616,162658442,1826
"12353","Zm00001d038698","6",162803581,162809813,6232
"12354","Zm00001d038699","6",162814646,162816895,2249
"12355","Zm00001d038704","6",163076771,163080204,3433
"12356","Zm00001d038706","6",163083691,163084116,425
"12357","Zm00001d038707","6",163088333,163090310,1977
"12358","Zm00001d038708","6",163090769,163092715,1946
"12359","Zm00001d038709","6",163106824,163109751,2927
"12360","Zm00001d038712","6",163221629,163222424,795
"12361","Zm00001d038717","6",163280343,163281305,962
"12362","Zm00001d038718","6",163324435,163325813,1378
"12363","Zm00001d038719","6",163328211,163329067,856
"12364","Zm00001d038720","6",163334324,163340060,5736
"12365","Zm00001d038722","6",163343609,163345297,1688
"12366","Zm00001d038723","6",163346653,163362540,15887
"12367","Zm00001d038724","6",163366091,163367753,1662
"12368","Zm00001d038725","6",163368049,163369489,1440
"12369","Zm00001d038728","6",163411334,163420782,9448
"12370","Zm00001d038729","6",163421612,163422133,521
"12371","Zm00001d038730","6",163424160,163426976,2816
"12372","Zm00001d038731","6",163495781,163501518,5737
"12373","Zm00001d038732","6",163536956,163538558,1602
"12374","Zm00001d038733","6",163540535,163542535,2000
"12375","Zm00001d038734","6",163542891,163546787,3896
"12376","Zm00001d038737","6",163553024,163560354,7330
"12377","Zm00001d038739","6",163589309,163593731,4422
"12378","Zm00001d038740","6",163596670,163597706,1036
"12379","Zm00001d038741","6",163651425,163652698,1273
"12380","Zm00001d038742","6",163657410,163658979,1569
"12381","Zm00001d038745","6",163755404,163785784,30380
"12382","Zm00001d038746","6",163786743,163788401,1658
"12383","Zm00001d038747","6",163792911,163797435,4524
"12384","Zm00001d038751","6",163857513,163860102,2589
"12385","Zm00001d038752","6",163885170,163891049,5879
"12386","Zm00001d038753","6",163895782,163898198,2416
"12387","Zm00001d038754","6",163898325,163906090,7765
"12388","Zm00001d038755","6",163931390,163932118,728
"12389","Zm00001d038756","6",163936343,163940582,4239
"12390","Zm00001d038758","6",163955489,163956164,675
"12391","Zm00001d038759","6",163962932,163968900,5968
"12392","Zm00001d038760","6",163970657,163972392,1735
"12393","Zm00001d038762","6",164016293,164027578,11285
"12394","Zm00001d038764","6",164059209,164060630,1421
"12395","Zm00001d038765","6",164061073,164062509,1436
"12396","Zm00001d038766","6",164157903,164159112,1209
"12397","Zm00001d038768","6",164162505,164164754,2249
"12398","Zm00001d038769","6",164167046,164171996,4950
"12399","Zm00001d038770","6",164172805,164173786,981
"12400","Zm00001d038772","6",164180911,164182075,1164
"12401","Zm00001d038773","6",164182716,164189415,6699
"12402","Zm00001d038775","6",164201228,164206800,5572
"12403","Zm00001d038776","6",164207910,164212069,4159
"12404","Zm00001d038777","6",164213807,164221095,7288
"12405","Zm00001d038779","6",164285328,164289068,3740
"12406","Zm00001d038780","6",164298313,164299530,1217
"12407","Zm00001d038783","6",164327814,164329029,1215
"12408","Zm00001d038784","6",164332917,164336272,3355
"12409","Zm00001d038785","6",164343980,164346838,2858
"12410","Zm00001d038786","6",164348042,164349173,1131
"12411","Zm00001d038791","6",164385494,164389823,4329
"12412","Zm00001d038792","6",164389095,164395441,6346
"12413","Zm00001d038793","6",164489575,164491362,1787
"12414","Zm00001d038794","6",164493063,164495421,2358
"12415","Zm00001d038795","6",164497600,164497797,197
"12416","Zm00001d038796","6",164512504,164517175,4671
"12417","Zm00001d038797","6",164581424,164588542,7118
"12418","Zm00001d038799","6",164652743,164653636,893
"12419","Zm00001d038801","6",164734361,164736397,2036
"12420","Zm00001d038803","6",164788926,164791422,2496
"12421","Zm00001d038804","6",164792289,164799307,7018
"12422","Zm00001d038805","6",164801102,164807892,6790
"12423","Zm00001d038806","6",164808309,164812048,3739
"12424","Zm00001d038807","6",164812460,164817085,4625
"12425","Zm00001d038808","6",164864362,164873057,8695
"12426","Zm00001d038809","6",164889311,164893253,3942
"12427","Zm00001d038810","6",164906424,164907077,653
"12428","Zm00001d038811","6",164911115,164915840,4725
"12429","Zm00001d038812","6",164961618,164983809,22191
"12430","Zm00001d038813","6",165035382,165052474,17092
"12431","Zm00001d038814","6",165172005,165172457,452
"12432","Zm00001d038815","6",165173445,165179189,5744
"12433","Zm00001d038818","6",165184068,165186023,1955
"12434","Zm00001d038819","6",165191824,165199320,7496
"12435","Zm00001d038820","6",165215562,165222835,7273
"12436","Zm00001d038821","6",165268896,165269868,972
"12437","Zm00001d038823","6",165273721,165278568,4847
"12438","Zm00001d038824","6",165288575,165294725,6150
"12439","Zm00001d038826","6",165295976,165298500,2524
"12440","Zm00001d038829","6",165358120,165363022,4902
"12441","Zm00001d038830","6",165363326,165369825,6499
"12442","Zm00001d038831","6",165370492,165374422,3930
"12443","Zm00001d038832","6",165376374,165379007,2633
"12444","Zm00001d038833","6",165387137,165388585,1448
"12445","Zm00001d038834","6",165390011,165401570,11559
"12446","Zm00001d038835","6",165526277,165530828,4551
"12447","Zm00001d038838","6",165588358,165592492,4134
"12448","Zm00001d038839","6",165594007,165597229,3222
"12449","Zm00001d038840","6",165624432,165627829,3397
"12450","Zm00001d038841","6",165629567,165639979,10412
"12451","Zm00001d038843","6",165655159,165656827,1668
"12452","Zm00001d038844","6",165658547,165666640,8093
"12453","Zm00001d038845","6",165684131,165730362,46231
"12454","Zm00001d038846","6",165730468,165734191,3723
"12455","Zm00001d038847","6",165737562,165747422,9860
"12456","Zm00001d038848","6",165799691,165801344,1653
"12457","Zm00001d038849","6",165819453,165832524,13071
"12458","Zm00001d038850","6",165838014,165840784,2770
"12459","Zm00001d038851","6",165842393,165845801,3408
"12460","Zm00001d038852","6",165889541,165893007,3466
"12461","Zm00001d038853","6",165894363,165897634,3271
"12462","Zm00001d038854","6",165898066,165902250,4184
"12463","Zm00001d038855","6",165902624,165906657,4033
"12464","Zm00001d038856","6",165906918,165907226,308
"12465","Zm00001d038857","6",165907842,165913299,5457
"12466","Zm00001d038859","6",165987036,165991710,4674
"12467","Zm00001d038860","6",165996710,165998543,1833
"12468","Zm00001d038861","6",166018995,166021892,2897
"12469","Zm00001d038862","6",166027177,166029976,2799
"12470","Zm00001d038863","6",166057719,166058909,1190
"12471","Zm00001d038864","6",166062936,166069293,6357
"12472","Zm00001d038865","6",166071467,166073407,1940
"12473","Zm00001d038866","6",166084251,166095366,11115
"12474","Zm00001d038867","6",166103499,166106031,2532
"12475","Zm00001d038868","6",166150090,166157348,7258
"12476","Zm00001d038870","6",166160261,166161550,1289
"12477","Zm00001d038871","6",166175556,166182507,6951
"12478","Zm00001d038873","6",166203666,166203977,311
"12479","Zm00001d038874","6",166206492,166209003,2511
"12480","Zm00001d038875","6",166212064,166214501,2437
"12481","Zm00001d038877","6",166217714,166220866,3152
"12482","Zm00001d038878","6",166302446,166304056,1610
"12483","Zm00001d038879","6",166305348,166309167,3819
"12484","Zm00001d038880","6",166312844,166318260,5416
"12485","Zm00001d038881","6",166318647,166321564,2917
"12486","Zm00001d038882","6",166324613,166330458,5845
"12487","Zm00001d038883","6",166334798,166336207,1409
"12488","Zm00001d038884","6",166348689,166350140,1451
"12489","Zm00001d038885","6",166378953,166383380,4427
"12490","Zm00001d038887","6",166387302,166388228,926
"12491","Zm00001d038890","6",166482384,166485202,2818
"12492","Zm00001d038891","6",166502169,166507064,4895
"12493","Zm00001d038892","6",166531936,166538352,6416
"12494","Zm00001d038894","6",166576973,166590299,13326
"12495","Zm00001d038896","6",166661658,166665264,3606
"12496","Zm00001d038897","6",166669163,166674601,5438
"12497","Zm00001d038901","6",166727943,166729302,1359
"12498","Zm00001d038902","6",166729578,166735664,6086
"12499","Zm00001d038903","6",166750125,166754016,3891
"12500","Zm00001d038904","6",166755499,166757076,1577
"12501","Zm00001d038905","6",166761639,166768315,6676
"12502","Zm00001d038907","6",166776865,166778085,1220
"12503","Zm00001d038908","6",166802962,166806226,3264
"12504","Zm00001d038909","6",166809707,166813310,3603
"12505","Zm00001d038910","6",166848168,166849957,1789
"12506","Zm00001d038911","6",166851524,166851829,305
"12507","Zm00001d038914","6",166871193,166875978,4785
"12508","Zm00001d038915","6",166879015,166882711,3696
"12509","Zm00001d038916","6",166888284,166895783,7499
"12510","Zm00001d038917","6",166896688,166899871,3183
"12511","Zm00001d038918","6",166901843,166903348,1505
"12512","Zm00001d038919","6",166929506,166930365,859
"12513","Zm00001d038920","6",166933133,166934403,1270
"12514","Zm00001d038921","6",166949706,166950815,1109
"12515","Zm00001d038922","6",166977536,166982310,4774
"12516","Zm00001d038923","6",167106090,167108422,2332
"12517","Zm00001d038925","6",167142116,167146479,4363
"12518","Zm00001d038926","6",167147365,167149347,1982
"12519","Zm00001d038927","6",167149767,167155236,5469
"12520","Zm00001d038928","6",167156842,167161458,4616
"12521","Zm00001d038929","6",167164721,167168568,3847
"12522","Zm00001d038930","6",167214153,167215654,1501
"12523","Zm00001d038931","6",167229386,167236425,7039
"12524","Zm00001d038932","6",167236940,167241191,4251
"12525","Zm00001d038933","6",167242937,167243527,590
"12526","Zm00001d038935","6",167253391,167254599,1208
"12527","Zm00001d038936","6",167317799,167323586,5787
"12528","Zm00001d038937","6",167324066,167326614,2548
"12529","Zm00001d038941","6",167366368,167367203,835
"12530","Zm00001d038944","6",167398430,167401428,2998
"12531","Zm00001d038946","6",167402294,167403996,1702
"12532","Zm00001d038948","6",167441439,167452966,11527
"12533","Zm00001d038949","6",167539996,167542087,2091
"12534","Zm00001d038954","6",167624782,167632082,7300
"12535","Zm00001d038955","6",167632187,167639074,6887
"12536","Zm00001d038959","6",167699425,167706622,7197
"12537","Zm00001d038960","6",167706703,167708035,1332
"12538","Zm00001d038961","6",167708117,167712890,4773
"12539","Zm00001d038963","6",167828328,167832943,4615
"12540","Zm00001d038964","6",167834181,167838452,4271
"12541","Zm00001d038965","6",167867757,167868857,1100
"12542","Zm00001d038968","6",167937166,167939239,2073
"12543","Zm00001d038969","6",167985167,167988002,2835
"12544","Zm00001d038970","6",167991224,167998724,7500
"12545","Zm00001d038971","6",167998749,168001300,2551
"12546","Zm00001d038972","6",168004770,168021297,16527
"12547","Zm00001d038973","6",168027264,168030325,3061
"12548","Zm00001d038974","6",168033169,168037377,4208
"12549","Zm00001d038975","6",168039021,168040019,998
"12550","Zm00001d038976","6",168040258,168043248,2990
"12551","Zm00001d038977","6",168044712,168045446,734
"12552","Zm00001d038980","6",168099647,168104795,5148
"12553","Zm00001d038981","6",168192154,168195705,3551
"12554","Zm00001d038982","6",168195382,168207024,11642
"12555","Zm00001d038984","6",168207284,168208191,907
"12556","Zm00001d038988","6",168296702,168299778,3076
"12557","Zm00001d038989","6",168300047,168303054,3007
"12558","Zm00001d038990","6",168304564,168305262,698
"12559","Zm00001d038991","6",168305998,168308728,2730
"12560","Zm00001d038993","6",168345096,168345887,791
"12561","Zm00001d038994","6",168356470,168357501,1031
"12562","Zm00001d038995","6",168419978,168423074,3096
"12563","Zm00001d038996","6",168446326,168448293,1967
"12564","Zm00001d038998","6",168506016,168510678,4662
"12565","Zm00001d038999","6",168511300,168514580,3280
"12566","Zm00001d039000","6",168516159,168518324,2165
"12567","Zm00001d039001","6",168525940,168527755,1815
"12568","Zm00001d039002","6",168609968,168621490,11522
"12569","Zm00001d039003","6",168619608,168619681,73
"12570","Zm00001d039005","6",168638018,168645494,7476
"12571","Zm00001d039006","6",168658572,168663801,5229
"12572","Zm00001d039007","6",168671553,168674425,2872
"12573","Zm00001d039010","6",168690217,168691038,821
"12574","Zm00001d039011","6",168696882,168697316,434
"12575","Zm00001d039012","6",168699352,168705946,6594
"12576","Zm00001d039013","6",168706048,168709435,3387
"12577","Zm00001d039014","6",168713527,168714450,923
"12578","Zm00001d039015","6",168716951,168722841,5890
"12579","Zm00001d039016","6",168723799,168725535,1736
"12580","Zm00001d039017","6",168767482,168771320,3838
"12581","Zm00001d039019","6",168819645,168820517,872
"12582","Zm00001d039020","6",168822275,168828891,6616
"12583","Zm00001d039021","6",168832409,168834314,1905
"12584","Zm00001d039022","6",168834757,168838473,3716
"12585","Zm00001d039026","6",168872299,168875758,3459
"12586","Zm00001d039029","6",168918320,168921679,3359
"12587","Zm00001d039031","6",168922998,168923408,410
"12588","Zm00001d039036","6",168999800,169005010,5210
"12589","Zm00001d039037","6",169005842,169010502,4660
"12590","Zm00001d039038","6",169020979,169022727,1748
"12591","Zm00001d039039","6",169026421,169029775,3354
"12592","Zm00001d039040","6",169030660,169031891,1231
"12593","Zm00001d039041","6",169128664,169140520,11856
"12594","Zm00001d039043","6",169159820,169166340,6520
"12595","Zm00001d039045","6",169173758,169178038,4280
"12596","Zm00001d039046","6",169221601,169230479,8878
"12597","Zm00001d039047","6",169233073,169239126,6053
"12598","Zm00001d039049","6",169245888,169247273,1385
"12599","Zm00001d039050","6",169248094,169248969,875
"12600","Zm00001d039051","6",169293985,169306439,12454
"12601","Zm00001d039052","6",169320793,169327039,6246
"12602","Zm00001d039053","6",169331804,169333348,1544
"12603","Zm00001d039057","6",169390376,169391098,722
"12604","Zm00001d039058","6",169392575,169393240,665
"12605","Zm00001d039059","6",169394180,169398433,4253
"12606","Zm00001d039061","6",169431270,169449026,17756
"12607","Zm00001d039062","6",169450029,169464591,14562
"12608","Zm00001d039064","6",169464744,169465894,1150
"12609","Zm00001d039065","6",169491185,169496107,4922
"12610","Zm00001d039066","6",169497057,169501065,4008
"12611","Zm00001d039070","6",169540188,169541266,1078
"12612","Zm00001d039071","6",169541385,169542607,1222
"12613","Zm00001d039072","6",169543363,169552829,9466
"12614","Zm00001d039073","6",169553336,169557268,3932
"12615","Zm00001d039076","6",169623657,169625207,1550
"12616","Zm00001d039078","6",169680125,169682173,2048
"12617","Zm00001d039079","6",169685197,169688921,3724
"12618","Zm00001d039080","6",169689637,169690380,743
"12619","Zm00001d039081","6",169691992,169698377,6385
"12620","Zm00001d039083","6",169713138,169713554,416
"12621","Zm00001d039085","6",169718647,169721555,2908
"12622","Zm00001d039086","6",169733422,169738386,4964
"12623","Zm00001d039087","6",169776869,169778071,1202
"12624","Zm00001d039088","6",169778445,169780307,1862
"12625","Zm00001d039089","6",169782693,169787367,4674
"12626","Zm00001d039090","6",169788530,169791254,2724
"12627","Zm00001d039091","6",169864685,169867294,2609
"12628","Zm00001d039093","6",169875540,169877140,1600
"12629","Zm00001d039094","6",169955183,169956712,1529
"12630","Zm00001d039095","6",169957762,169959656,1894
"12631","Zm00001d039096","6",169961091,169964660,3569
"12632","Zm00001d039097","6",169964430,169967225,2795
"12633","Zm00001d039098","6",169966997,169967774,777
"12634","Zm00001d039099","6",169968197,169968679,482
"12635","Zm00001d039101","6",170023704,170025807,2103
"12636","Zm00001d039102","6",170102019,170103743,1724
"12637","Zm00001d039103","6",170106206,170106700,494
"12638","Zm00001d039104","6",170108921,170113150,4229
"12639","Zm00001d039105","6",170114771,170120452,5681
"12640","Zm00001d039106","6",170128583,170130302,1719
"12641","Zm00001d039108","6",170139690,170140607,917
"12642","Zm00001d039109","6",170146663,170148632,1969
"12643","Zm00001d039110","6",170150152,170150670,518
"12644","Zm00001d039111","6",170221278,170225996,4718
"12645","Zm00001d039115","6",170339523,170340530,1007
"12646","Zm00001d039116","6",170344563,170350619,6056
"12647","Zm00001d039120","6",170405737,170413431,7694
"12648","Zm00001d039125","6",170538103,170546811,8708
"12649","Zm00001d039126","6",170553012,170561461,8449
"12650","Zm00001d039127","6",170606812,170620414,13602
"12651","Zm00001d039129","6",170665580,170666314,734
"12652","Zm00001d039131","6",170732907,170739381,6474
"12653","Zm00001d039132","6",170742212,170753847,11635
"12654","Zm00001d039133","6",170759206,170773388,14182
"12655","Zm00001d039135","6",170789131,170789949,818
"12656","Zm00001d039138","6",170946769,170955570,8801
"12657","Zm00001d039139","6",170961639,170963179,1540
"12658","Zm00001d039141","6",170970064,170973973,3909
"12659","Zm00001d039142","6",170975626,170982870,7244
"12660","Zm00001d039143","6",170982506,171007919,25413
"12661","Zm00001d039144","6",171009263,171031047,21784
"12662","Zm00001d039145","6",171033311,171034198,887
"12663","Zm00001d039146","6",171035380,171036741,1361
"12664","Zm00001d039147","6",171041056,171048997,7941
"12665","Zm00001d039150","6",171097451,171099773,2322
"12666","Zm00001d039151","6",171104667,171105771,1104
"12667","Zm00001d039154","6",171163852,171169201,5349
"12668","Zm00001d039155","6",171177893,171180993,3100
"12669","Zm00001d039156","6",171181094,171184464,3370
"12670","Zm00001d039157","6",171239022,171243031,4009
"12671","Zm00001d039158","6",171285758,171287677,1919
"12672","Zm00001d039160","6",171405188,171429963,24775
"12673","Zm00001d039162","6",171474447,171478804,4357
"12674","Zm00001d039163","6",171547967,171551165,3198
"12675","Zm00001d039165","6",171554081,171582712,28631
"12676","Zm00001d039166","6",171614957,171617611,2654
"12677","Zm00001d039167","6",171659500,171663327,3827
"12678","Zm00001d039168","6",171661937,171662010,73
"12679","Zm00001d039169","6",171663438,171664675,1237
"12680","Zm00001d039171","6",171694783,171720418,25635
"12681","Zm00001d039173","6",171777021,171780090,3069
"12682","Zm00001d039174","6",171784068,171787645,3577
"12683","Zm00001d039176","6",171824227,171828823,4596
"12684","Zm00001d039177","6",171867295,171868587,1292
"12685","Zm00001d039179","6",171880132,171881868,1736
"12686","Zm00001d039180","6",171890678,171895329,4651
"12687","Zm00001d039181","6",172035940,172039648,3708
"12688","Zm00001d039182","6",172040849,172046215,5366
"12689","Zm00001d039183","6",172092066,172094056,1990
"12690","Zm00001d039184","6",172147999,172149784,1785
"12691","Zm00001d039185","6",172151411,172155517,4106
"12692","Zm00001d039189","6",172192573,172210474,17901
"12693","Zm00001d039190","6",172210868,172212590,1722
"12694","Zm00001d039192","6",172237415,172245052,7637
"12695","Zm00001d039193","6",172245214,172254138,8924
"12696","Zm00001d039194","6",172321981,172324231,2250
"12697","Zm00001d039196","6",172328092,172333861,5769
"12698","Zm00001d039200","6",172421714,172433606,11892
"12699","Zm00001d039203","6",172441150,172445607,4457
"12700","Zm00001d039204","6",172469419,172471819,2400
"12701","Zm00001d039210","6",172596018,172596749,731
"12702","Zm00001d039211","6",172597217,172606774,9557
"12703","Zm00001d039213","6",172671146,172672496,1350
"12704","Zm00001d039214","6",172672133,172683962,11829
"12705","Zm00001d039215","6",172880197,172888256,8059
"12706","Zm00001d039216","6",172922907,172924082,1175
"12707","Zm00001d039218","6",173060926,173064481,3555
"12708","Zm00001d039219","6",173069266,173071685,2419
"12709","Zm00001d039221","6",173160217,173162244,2027
"12710","Zm00001d039222","6",173162199,173164010,1811
"12711","Zm00001d039226","6",173879951,173882009,2058
"12712","Zm00001d039228","6",173891704,173893494,1790
"12713","Zm00001d039230","6",173903300,173905358,2058
"12714","Zm00001d039231","6",173932423,173936047,3624
"12715","Zm00001d039241","3",393259,395283,2024
"12716","Zm00001d039243","3",446254,447387,1133
"12717","Zm00001d039245","3",474649,476986,2337
"12718","Zm00001d039246","3",480469,481982,1513
"12719","Zm00001d039250","3",557240,559220,1980
"12720","Zm00001d039251","3",562303,563193,890
"12721","Zm00001d039252","3",563497,566145,2648
"12722","Zm00001d039253","3",567922,571079,3157
"12723","Zm00001d039255","3",623618,628529,4911
"12724","Zm00001d039256","3",628459,629427,968
"12725","Zm00001d039258","3",697981,701289,3308
"12726","Zm00001d039259","3",701136,705353,4217
"12727","Zm00001d039260","3",750258,754984,4726
"12728","Zm00001d039261","3",754731,757177,2446
"12729","Zm00001d039262","3",763210,765019,1809
"12730","Zm00001d039263","3",765433,766898,1465
"12731","Zm00001d039264","3",767084,768838,1754
"12732","Zm00001d039265","3",822132,826368,4236
"12733","Zm00001d039266","3",826815,835054,8239
"12734","Zm00001d039267","3",838392,842742,4350
"12735","Zm00001d039268","3",857137,857796,659
"12736","Zm00001d039270","3",882732,883925,1193
"12737","Zm00001d039271","3",888050,889900,1850
"12738","Zm00001d039272","3",897637,901853,4216
"12739","Zm00001d039274","3",903521,918970,15449
"12740","Zm00001d039276","3",916629,921348,4719
"12741","Zm00001d039278","3",960351,964772,4421
"12742","Zm00001d039279","3",965601,966515,914
"12743","Zm00001d039280","3",971730,975829,4099
"12744","Zm00001d039282","3",978306,979808,1502
"12745","Zm00001d039283","3",999935,1002234,2299
"12746","Zm00001d039284","3",1009359,1014295,4936
"12747","Zm00001d039285","3",1014360,1017859,3499
"12748","Zm00001d039286","3",1019242,1020384,1142
"12749","Zm00001d039287","3",1055429,1064364,8935
"12750","Zm00001d039294","3",1171066,1176375,5309
"12751","Zm00001d039295","3",1201798,1203788,1990
"12752","Zm00001d039296","3",1205141,1223280,18139
"12753","Zm00001d039299","3",1290583,1292589,2006
"12754","Zm00001d039300","3",1298938,1304213,5275
"12755","Zm00001d039301","3",1325146,1327618,2472
"12756","Zm00001d039303","3",1394245,1395354,1109
"12757","Zm00001d039304","3",1395539,1402948,7409
"12758","Zm00001d039305","3",1404117,1408225,4108
"12759","Zm00001d039306","3",1424835,1430811,5976
"12760","Zm00001d039307","3",1431991,1433866,1875
"12761","Zm00001d039310","3",1447428,1449364,1936
"12762","Zm00001d039311","3",1451511,1456285,4774
"12763","Zm00001d039312","3",1461989,1466446,4457
"12764","Zm00001d039313","3",1469769,1470902,1133
"12765","Zm00001d039315","3",1533825,1541740,7915
"12766","Zm00001d039316","3",1541745,1544300,2555
"12767","Zm00001d039318","3",1628530,1630150,1620
"12768","Zm00001d039319","3",1692001,1706793,14792
"12769","Zm00001d039321","3",1752431,1773507,21076
"12770","Zm00001d039323","3",1839047,1842858,3811
"12771","Zm00001d039324","3",1876337,1877401,1064
"12772","Zm00001d039325","3",1945996,1950106,4110
"12773","Zm00001d039327","3",1953626,1957132,3506
"12774","Zm00001d039328","3",1958218,1965694,7476
"12775","Zm00001d039330","3",1992693,2001495,8802
"12776","Zm00001d039331","3",2013965,2017590,3625
"12777","Zm00001d039335","3",2038756,2040110,1354
"12778","Zm00001d039337","3",2048830,2051183,2353
"12779","Zm00001d039338","3",2050951,2052284,1333
"12780","Zm00001d039339","3",2053380,2053649,269
"12781","Zm00001d039340","3",2056798,2059422,2624
"12782","Zm00001d039341","3",2111719,2119789,8070
"12783","Zm00001d039342","3",2136520,2141448,4928
"12784","Zm00001d039343","3",2185548,2190937,5389
"12785","Zm00001d039345","3",2191276,2193951,2675
"12786","Zm00001d039346","3",2195056,2197943,2887
"12787","Zm00001d039347","3",2201670,2203002,1332
"12788","Zm00001d039348","3",2277773,2281085,3312
"12789","Zm00001d039349","3",2346497,2358180,11683
"12790","Zm00001d039350","3",2358190,2362977,4787
"12791","Zm00001d039352","3",2368803,2371476,2673
"12792","Zm00001d039354","3",2377347,2378063,716
"12793","Zm00001d039355","3",2451357,2465548,14191
"12794","Zm00001d039356","3",2466221,2466923,702
"12795","Zm00001d039357","3",2490334,2494816,4482
"12796","Zm00001d039358","3",2495318,2505484,10166
"12797","Zm00001d039361","3",2564233,2567342,3109
"12798","Zm00001d039362","3",2569176,2574119,4943
"12799","Zm00001d039363","3",2609206,2612957,3751
"12800","Zm00001d039364","3",2629900,2632050,2150
"12801","Zm00001d039365","3",2632877,2633794,917
"12802","Zm00001d039366","3",2655450,2658490,3040
"12803","Zm00001d039367","3",2662224,2662619,395
"12804","Zm00001d039368","3",2664440,2669139,4699
"12805","Zm00001d039369","3",2681579,2690651,9072
"12806","Zm00001d039370","3",2692603,2696275,3672
"12807","Zm00001d039371","3",2709285,2712754,3469
"12808","Zm00001d039372","3",2737895,2741152,3257
"12809","Zm00001d039373","3",2742442,2748689,6247
"12810","Zm00001d039374","3",2749185,2754443,5258
"12811","Zm00001d039377","3",2784185,2784721,536
"12812","Zm00001d039378","3",2791183,2793926,2743
"12813","Zm00001d039379","3",2932314,2932748,434
"12814","Zm00001d039380","3",2938833,2959820,20987
"12815","Zm00001d039383","3",3077422,3079293,1871
"12816","Zm00001d039384","3",3087368,3088918,1550
"12817","Zm00001d039385","3",3092385,3107653,15268
"12818","Zm00001d039387","3",3142741,3145531,2790
"12819","Zm00001d039388","3",3146607,3147757,1150
"12820","Zm00001d039390","3",3168983,3171512,2529
"12821","Zm00001d039392","3",3179455,3181317,1862
"12822","Zm00001d039395","3",3336553,3338859,2306
"12823","Zm00001d039396","3",3398961,3399929,968
"12824","Zm00001d039397","3",3407198,3409321,2123
"12825","Zm00001d039399","3",3410500,3411160,660
"12826","Zm00001d039400","3",3413511,3425991,12480
"12827","Zm00001d039401","3",3433891,3437244,3353
"12828","Zm00001d039402","3",3461779,3462858,1079
"12829","Zm00001d039403","3",3463017,3468930,5913
"12830","Zm00001d039404","3",3475442,3479629,4187
"12831","Zm00001d039405","3",3513700,3514582,882
"12832","Zm00001d039406","3",3607952,3612391,4439
"12833","Zm00001d039407","3",3614006,3618190,4184
"12834","Zm00001d039408","3",3618712,3619434,722
"12835","Zm00001d039409","3",3620280,3630504,10224
"12836","Zm00001d039411","3",3708911,3716373,7462
"12837","Zm00001d039412","3",3797720,3798556,836
"12838","Zm00001d039416","3",3821519,3825271,3752
"12839","Zm00001d039417","3",3828028,3837246,9218
"12840","Zm00001d039418","3",3843958,3844417,459
"12841","Zm00001d039421","3",3856170,3863883,7713
"12842","Zm00001d039422","3",3904536,3910859,6323
"12843","Zm00001d039425","3",3943651,3949813,6162
"12844","Zm00001d039426","3",3976696,3979365,2669
"12845","Zm00001d039427","3",3979996,3984914,4918
"12846","Zm00001d039428","3",3991577,3992224,647
"12847","Zm00001d039430","3",4037437,4038767,1330
"12848","Zm00001d039431","3",4039914,4043431,3517
"12849","Zm00001d039432","3",4122095,4123749,1654
"12850","Zm00001d039434","3",4140509,4150100,9591
"12851","Zm00001d039435","3",4161898,4175012,13114
"12852","Zm00001d039436","3",4165231,4165302,71
"12853","Zm00001d039437","3",4316527,4318099,1572
"12854","Zm00001d039439","3",4457841,4460509,2668
"12855","Zm00001d039441","3",4480927,4485095,4168
"12856","Zm00001d039444","3",4497708,4499243,1535
"12857","Zm00001d039446","3",4590953,4596170,5217
"12858","Zm00001d039448","3",4599630,4609909,10279
"12859","Zm00001d039449","3",4731561,4733303,1742
"12860","Zm00001d039450","3",4733251,4734144,893
"12861","Zm00001d039451","3",4734400,4737230,2830
"12862","Zm00001d039452","3",4737374,4743944,6570
"12863","Zm00001d039453","3",4745784,4752166,6382
"12864","Zm00001d039454","3",4760989,4762395,1406
"12865","Zm00001d039455","3",4833807,4837335,3528
"12866","Zm00001d039456","3",4838566,4841548,2982
"12867","Zm00001d039458","3",4929664,4931699,2035
"12868","Zm00001d039460","3",4951058,4954231,3173
"12869","Zm00001d039462","3",4961276,4962325,1049
"12870","Zm00001d039464","3",4994687,4995196,509
"12871","Zm00001d039465","3",5020648,5027627,6979
"12872","Zm00001d039467","3",5057283,5059997,2714
"12873","Zm00001d039468","3",5118949,5119466,517
"12874","Zm00001d039469","3",5145889,5150710,4821
"12875","Zm00001d039471","3",5157787,5160649,2862
"12876","Zm00001d039472","3",5168766,5172360,3594
"12877","Zm00001d039474","3",5278569,5284172,5603
"12878","Zm00001d039475","3",5284136,5296963,12827
"12879","Zm00001d039477","3",5328994,5333477,4483
"12880","Zm00001d039480","3",5485889,5491107,5218
"12881","Zm00001d039483","3",5499567,5507791,8224
"12882","Zm00001d039487","3",5625096,5627096,2000
"12883","Zm00001d039488","3",5706491,5709917,3426
"12884","Zm00001d039489","3",5709978,5715485,5507
"12885","Zm00001d039492","3",5810144,5811850,1706
"12886","Zm00001d039494","3",5816185,5817345,1160
"12887","Zm00001d039495","3",5849060,5850172,1112
"12888","Zm00001d039496","3",5913103,5914797,1694
"12889","Zm00001d039497","3",5918558,5920805,2247
"12890","Zm00001d039498","3",6001073,6005346,4273
"12891","Zm00001d039499","3",6010215,6014021,3806
"12892","Zm00001d039505","3",6094711,6099557,4846
"12893","Zm00001d039506","3",6101834,6112905,11071
"12894","Zm00001d039507","3",6124415,6127999,3584
"12895","Zm00001d039510","3",6138823,6141058,2235
"12896","Zm00001d039512","3",6248365,6252317,3952
"12897","Zm00001d039513","3",6287613,6290045,2432
"12898","Zm00001d039514","3",6298954,6307353,8399
"12899","Zm00001d039517","3",6375732,6379654,3922
"12900","Zm00001d039518","3",6553963,6562166,8203
"12901","Zm00001d039519","3",6563954,6567416,3462
"12902","Zm00001d039520","3",6768568,6770834,2266
"12903","Zm00001d039521","3",6773232,6777038,3806
"12904","Zm00001d039522","3",6823791,6842767,18976
"12905","Zm00001d039524","3",7085192,7086610,1418
"12906","Zm00001d039526","3",7120511,7130258,9747
"12907","Zm00001d039528","3",7292722,7301317,8595
"12908","Zm00001d039529","3",7302032,7304942,2910
"12909","Zm00001d039530","3",7377640,7381732,4092
"12910","Zm00001d039532","3",7399394,7401753,2359
"12911","Zm00001d039533","3",7446385,7450083,3698
"12912","Zm00001d039534","3",7451813,7457371,5558
"12913","Zm00001d039535","3",7479692,7482979,3287
"12914","Zm00001d039536","3",7484018,7486445,2427
"12915","Zm00001d039537","3",7487245,7530464,43219
"12916","Zm00001d039538","3",7522982,7524007,1025
"12917","Zm00001d039539","3",7538219,7539682,1463
"12918","Zm00001d039540","3",7617345,7618116,771
"12919","Zm00001d039541","3",7729971,7733618,3647
"12920","Zm00001d039542","3",7735746,7737263,1517
"12921","Zm00001d039544","3",7774836,7804037,29201
"12922","Zm00001d039545","3",7775304,7776765,1461
"12923","Zm00001d039546","3",7807270,7812273,5003
"12924","Zm00001d039547","3",7812566,7818795,6229
"12925","Zm00001d039548","3",7821886,7823250,1364
"12926","Zm00001d039549","3",7825317,7831190,5873
"12927","Zm00001d039558","3",7974205,7978519,4314
"12928","Zm00001d039559","3",7978261,7980510,2249
"12929","Zm00001d039560","3",7987440,7994846,7406
"12930","Zm00001d039563","3",8042762,8065502,22740
"12931","Zm00001d039565","3",8100419,8101465,1046
"12932","Zm00001d039566","3",8104720,8105217,497
"12933","Zm00001d039567","3",8105931,8108924,2993
"12934","Zm00001d039568","3",8111485,8115811,4326
"12935","Zm00001d039575","3",8204808,8206696,1888
"12936","Zm00001d039576","3",8207193,8209232,2039
"12937","Zm00001d039578","3",8255397,8262495,7098
"12938","Zm00001d039579","3",8262683,8264981,2298
"12939","Zm00001d039580","3",8286007,8288201,2194
"12940","Zm00001d039581","3",8291514,8292125,611
"12941","Zm00001d039582","3",8333382,8337535,4153
"12942","Zm00001d039584","3",8455756,8463632,7876
"12943","Zm00001d039589","3",8521898,8533430,11532
"12944","Zm00001d039590","3",8533849,8540284,6435
"12945","Zm00001d039591","3",8542395,8542877,482
"12946","Zm00001d039592","3",8548416,8548952,536
"12947","Zm00001d039594","3",8560758,8564979,4221
"12948","Zm00001d039595","3",8566171,8571656,5485
"12949","Zm00001d039596","3",8649713,8661900,12187
"12950","Zm00001d039597","3",8669243,8671574,2331
"12951","Zm00001d039598","3",8673429,8679636,6207
"12952","Zm00001d039600","3",8723887,8725695,1808
"12953","Zm00001d039606","3",8775583,8780670,5087
"12954","Zm00001d039607","3",8849004,8850470,1466
"12955","Zm00001d039608","3",8850882,8860079,9197
"12956","Zm00001d039611","3",9001419,9004068,2649
"12957","Zm00001d039612","3",9050686,9081730,31044
"12958","Zm00001d039613","3",9084078,9086850,2772
"12959","Zm00001d039614","3",9087885,9092751,4866
"12960","Zm00001d039615","3",9134058,9135428,1370
"12961","Zm00001d039616","3",9143670,9147316,3646
"12962","Zm00001d039617","3",9147898,9161936,14038
"12963","Zm00001d039618","3",9212789,9214936,2147
"12964","Zm00001d039619","3",9222554,9227913,5359
"12965","Zm00001d039620","3",9228971,9231614,2643
"12966","Zm00001d039621","3",9287477,9289330,1853
"12967","Zm00001d039624","3",9366940,9370004,3064
"12968","Zm00001d039625","3",9377677,9380955,3278
"12969","Zm00001d039626","3",9425807,9428729,2922
"12970","Zm00001d039628","3",9468905,9474712,5807
"12971","Zm00001d039629","3",9515545,9516015,470
"12972","Zm00001d039631","3",9567326,9577428,10102
"12973","Zm00001d039632","3",9613563,9616820,3257
"12974","Zm00001d039633","3",9624091,9640996,16905
"12975","Zm00001d039636","3",9813743,9817036,3293
"12976","Zm00001d039637","3",9819488,9821687,2199
"12977","Zm00001d039638","3",9873989,9877437,3448
"12978","Zm00001d039639","3",9879223,9883575,4352
"12979","Zm00001d039640","3",9896408,9899890,3482
"12980","Zm00001d039641","3",9974966,9976264,1298
"12981","Zm00001d039642","3",9977323,9980023,2700
"12982","Zm00001d039644","3",10158507,10159904,1397
"12983","Zm00001d039647","3",10279429,10286500,7071
"12984","Zm00001d039648","3",10362846,10363205,359
"12985","Zm00001d039650","3",10539593,10543488,3895
"12986","Zm00001d039653","3",10752207,10756034,3827
"12987","Zm00001d039654","3",10773612,10776369,2757
"12988","Zm00001d039655","3",10780460,10783098,2638
"12989","Zm00001d039656","3",10861809,10866922,5113
"12990","Zm00001d039657","3",10867413,10868160,747
"12991","Zm00001d039658","3",10933798,10935205,1407
"12992","Zm00001d039660","3",10945251,10952016,6765
"12993","Zm00001d039661","3",10953007,10953435,428
"12994","Zm00001d039663","3",11198572,11201977,3405
"12995","Zm00001d039664","3",11337018,11344782,7764
"12996","Zm00001d039665","3",11341288,11341948,660
"12997","Zm00001d039667","3",11442638,11443719,1081
"12998","Zm00001d039669","3",11471850,11472899,1049
"12999","Zm00001d039670","3",11500060,11504969,4909
"13000","Zm00001d039672","3",11567055,11567825,770
"13001","Zm00001d039673","3",11568307,11574682,6375
"13002","Zm00001d039674","3",11575059,11577604,2545
"13003","Zm00001d039675","3",11578624,11583177,4553
"13004","Zm00001d039677","3",11687031,11691460,4429
"13005","Zm00001d039678","3",11696624,11701476,4852
"13006","Zm00001d039680","3",11779457,11781199,1742
"13007","Zm00001d039681","3",11794445,11797039,2594
"13008","Zm00001d039682","3",11808671,11813842,5171
"13009","Zm00001d039683","3",11816779,11831510,14731
"13010","Zm00001d039684","3",11839625,11841440,1815
"13011","Zm00001d039685","3",11843728,11847491,3763
"13012","Zm00001d039686","3",11849125,11853356,4231
"13013","Zm00001d039687","3",11887224,11888369,1145
"13014","Zm00001d039691","3",11918669,11922644,3975
"13015","Zm00001d039693","3",12049978,12088417,38439
"13016","Zm00001d039694","3",12158280,12159065,785
"13017","Zm00001d039697","3",12344885,12347351,2466
"13018","Zm00001d039701","3",12554733,12560537,5804
"13019","Zm00001d039702","3",12560753,12564409,3656
"13020","Zm00001d039703","3",12596468,12600760,4292
"13021","Zm00001d039706","3",12674400,12677866,3466
"13022","Zm00001d039709","3",12747718,12750928,3210
"13023","Zm00001d039710","3",12751564,12753836,2272
"13024","Zm00001d039711","3",12758934,12763812,4878
"13025","Zm00001d039712","3",12779834,12783263,3429
"13026","Zm00001d039714","3",12827313,12829202,1889
"13027","Zm00001d039715","3",12833463,12833825,362
"13028","Zm00001d039716","3",12835341,12836601,1260
"13029","Zm00001d039717","3",12897204,12900576,3372
"13030","Zm00001d039718","3",12973562,12977694,4132
"13031","Zm00001d039719","3",12978279,12981269,2990
"13032","Zm00001d039721","3",12984712,12987761,3049
"13033","Zm00001d039722","3",12988064,12989439,1375
"13034","Zm00001d039723","3",12989962,12990863,901
"13035","Zm00001d039726","3",13012899,13013782,883
"13036","Zm00001d039727","3",13017991,13020628,2637
"13037","Zm00001d039729","3",13049177,13066499,17322
"13038","Zm00001d039730","3",13142126,13150267,8141
"13039","Zm00001d039731","3",13151690,13170852,19162
"13040","Zm00001d039732","3",13174525,13178562,4037
"13041","Zm00001d039733","3",13212197,13212828,631
"13042","Zm00001d039735","3",13253265,13253804,539
"13043","Zm00001d039739","3",13454894,13456467,1573
"13044","Zm00001d039740","3",13457481,13470008,12527
"13045","Zm00001d039745","3",13650821,13654113,3292
"13046","Zm00001d039746","3",13655404,13661672,6268
"13047","Zm00001d039747","3",13687680,13693484,5804
"13048","Zm00001d039749","3",13697952,13705516,7564
"13049","Zm00001d039750","3",13772095,13776752,4657
"13050","Zm00001d039754","3",13966411,13969623,3212
"13051","Zm00001d039757","3",14091333,14109853,18520
"13052","Zm00001d039758","3",14110160,14141200,31040
"13053","Zm00001d039761","3",14133477,14135554,2077
"13054","Zm00001d039762","3",14137632,14141177,3545
"13055","Zm00001d039763","3",14143865,14145214,1349
"13056","Zm00001d039764","3",14220288,14222436,2148
"13057","Zm00001d039768","3",14322487,14330117,7630
"13058","Zm00001d039769","3",14333996,14339635,5639
"13059","Zm00001d039770","3",14342781,14343560,779
"13060","Zm00001d039771","3",14423056,14424523,1467
"13061","Zm00001d039772","3",14469749,14484983,15234
"13062","Zm00001d039776","3",14514622,14517814,3192
"13063","Zm00001d039777","3",14518943,14519897,954
"13064","Zm00001d039780","3",14530210,14536258,6048
"13065","Zm00001d039781","3",14536096,14537308,1212
"13066","Zm00001d039782","3",14537998,14538768,770
"13067","Zm00001d039784","3",14600793,14605179,4386
"13068","Zm00001d039785","3",14614435,14617037,2602
"13069","Zm00001d039786","3",14617725,14618667,942
"13070","Zm00001d039787","3",14736642,14747309,10667
"13071","Zm00001d039790","3",14754274,14754684,410
"13072","Zm00001d039803","3",15231630,15232507,877
"13073","Zm00001d039805","3",15349457,15350327,870
"13074","Zm00001d039808","3",15427029,15432943,5914
"13075","Zm00001d039812","3",15573951,15575142,1191
"13076","Zm00001d039816","3",15640787,15654396,13609
"13077","Zm00001d039821","3",15909790,15910239,449
"13078","Zm00001d039822","3",15911040,15915529,4489
"13079","Zm00001d039824","3",15918978,15922548,3570
"13080","Zm00001d039825","3",15958238,15958636,398
"13081","Zm00001d039826","3",15959937,15961252,1315
"13082","Zm00001d039827","3",15992310,15992768,458
"13083","Zm00001d039831","3",16022131,16023061,930
"13084","Zm00001d039837","3",16287892,16290203,2311
"13085","Zm00001d039841","3",16413698,16414265,567
"13086","Zm00001d039842","3",16468276,16468803,527
"13087","Zm00001d039843","3",16518696,16526342,7646
"13088","Zm00001d039845","3",16527096,16527461,365
"13089","Zm00001d039848","3",16535244,16539074,3830
"13090","Zm00001d039849","3",16540227,16540640,413
"13091","Zm00001d039850","3",16541641,16554770,13129
"13092","Zm00001d039851","3",16611925,16616740,4815
"13093","Zm00001d039852","3",16634991,16640993,6002
"13094","Zm00001d039853","3",16645907,16646347,440
"13095","Zm00001d039854","3",16734903,16736516,1613
"13096","Zm00001d039856","3",16786916,16799630,12714
"13097","Zm00001d039858","3",16934865,16939848,4983
"13098","Zm00001d039859","3",16955374,16956401,1027
"13099","Zm00001d039860","3",16957506,16980111,22605
"13100","Zm00001d039865","3",17163334,17167131,3797
"13101","Zm00001d039866","3",17168377,17172935,4558
"13102","Zm00001d039867","3",17266726,17272686,5960
"13103","Zm00001d039870","3",17281142,17286871,5729
"13104","Zm00001d039871","3",17287896,17294429,6533
"13105","Zm00001d039872","3",17307142,17312267,5125
"13106","Zm00001d039873","3",17358564,17364997,6433
"13107","Zm00001d039874","3",17365718,17369090,3372
"13108","Zm00001d039875","3",17369870,17370960,1090
"13109","Zm00001d039878","3",17379356,17380994,1638
"13110","Zm00001d039879","3",17381216,17384469,3253
"13111","Zm00001d039880","3",17453267,17454450,1183
"13112","Zm00001d039881","3",17540895,17545272,4377
"13113","Zm00001d039882","3",17546111,17550377,4266
"13114","Zm00001d039883","3",17590735,17593442,2707
"13115","Zm00001d039884","3",17599025,17603565,4540
"13116","Zm00001d039886","3",17688942,17693135,4193
"13117","Zm00001d039887","3",17697650,17702661,5011
"13118","Zm00001d039891","3",18182217,18183569,1352
"13119","Zm00001d039892","3",18228304,18228780,476
"13120","Zm00001d039893","3",18371543,18374234,2691
"13121","Zm00001d039899","3",18636392,18639644,3252
"13122","Zm00001d039900","3",18639696,18644424,4728
"13123","Zm00001d039901","3",18645159,18650625,5466
"13124","Zm00001d039903","3",18828114,18860141,32027
"13125","Zm00001d039904","3",18861813,18870713,8900
"13126","Zm00001d039906","3",18883010,18883416,406
"13127","Zm00001d039907","3",18927896,18929032,1136
"13128","Zm00001d039908","3",19082590,19083063,473
"13129","Zm00001d039910","3",19165400,19166920,1520
"13130","Zm00001d039911","3",19172631,19188173,15542
"13131","Zm00001d039913","3",19194748,19210804,16056
"13132","Zm00001d039914","3",19237764,19238975,1211
"13133","Zm00001d039916","3",19335810,19341690,5880
"13134","Zm00001d039918","3",19350843,19355642,4799
"13135","Zm00001d039919","3",19356289,19359406,3117
"13136","Zm00001d039920","3",19381633,19385490,3857
"13137","Zm00001d039921","3",19472832,19481948,9116
"13138","Zm00001d039923","3",19591961,19602966,11005
"13139","Zm00001d039925","3",19641934,19642752,818
"13140","Zm00001d039926","3",19724663,19729488,4825
"13141","Zm00001d039928","3",19804533,19805393,860
"13142","Zm00001d039929","3",19809738,19810514,776
"13143","Zm00001d039930","3",19815106,19816391,1285
"13144","Zm00001d039931","3",19818598,19829515,10917
"13145","Zm00001d039932","3",19837328,19837744,416
"13146","Zm00001d039933","3",19846081,19846545,464
"13147","Zm00001d039934","3",19865880,19867576,1696
"13148","Zm00001d039935","3",19868724,19869483,759
"13149","Zm00001d039936","3",19966205,19966663,458
"13150","Zm00001d039940","3",20004768,20010840,6072
"13151","Zm00001d039944","3",20126203,20126790,587
"13152","Zm00001d039946","3",20167524,20169961,2437
"13153","Zm00001d039953","3",20547776,20548475,699
"13154","Zm00001d039959","3",20751341,20761528,10187
"13155","Zm00001d039963","3",20813902,20816454,2552
"13156","Zm00001d039964","3",20827148,20827558,410
"13157","Zm00001d039965","3",20882799,20892393,9594
"13158","Zm00001d039966","3",20997443,20999788,2345
"13159","Zm00001d039967","3",21008384,21010566,2182
"13160","Zm00001d039969","3",21077618,21079197,1579
"13161","Zm00001d039971","3",21174447,21199574,25127
"13162","Zm00001d039973","3",21311762,21317259,5497
"13163","Zm00001d039974","3",21321680,21322321,641
"13164","Zm00001d039975","3",21323159,21327454,4295
"13165","Zm00001d039976","3",21378007,21379604,1597
"13166","Zm00001d039978","3",21466749,21467524,775
"13167","Zm00001d039981","3",21725432,21731309,5877
"13168","Zm00001d039982","3",21732380,21733390,1010
"13169","Zm00001d039986","3",21807442,21807515,73
"13170","Zm00001d039987","3",21834374,21839071,4697
"13171","Zm00001d039988","3",21865295,21866122,827
"13172","Zm00001d039989","3",21877778,21879721,1943
"13173","Zm00001d039990","3",22042224,22048676,6452
"13174","Zm00001d039991","3",22050506,22051063,557
"13175","Zm00001d039993","3",22154104,22154574,470
"13176","Zm00001d039994","3",22276219,22281890,5671
"13177","Zm00001d039997","3",22422784,22423236,452
"13178","Zm00001d039998","3",22428440,22429366,926
"13179","Zm00001d040002","3",22475494,22479185,3691
"13180","Zm00001d040003","3",22543761,22544342,581
"13181","Zm00001d040004","3",22562754,22564198,1444
"13182","Zm00001d040005","3",22637988,22641399,3411
"13183","Zm00001d040006","3",22671932,22673242,1310
"13184","Zm00001d040008","3",22775158,22785289,10131
"13185","Zm00001d040010","3",22854232,22860850,6618
"13186","Zm00001d040011","3",22863277,22864673,1396
"13187","Zm00001d040014","3",22985961,22987942,1981
"13188","Zm00001d040019","3",23109131,23110862,1731
"13189","Zm00001d040020","3",23248796,23254822,6026
"13190","Zm00001d040023","3",23309375,23312957,3582
"13191","Zm00001d040026","3",23369523,23371202,1679
"13192","Zm00001d040027","3",23377488,23378234,746
"13193","Zm00001d040028","3",23433456,23434226,770
"13194","Zm00001d040029","3",23586531,23587232,701
"13195","Zm00001d040032","3",23643662,23643868,206
"13196","Zm00001d040033","3",23715934,23728557,12623
"13197","Zm00001d040034","3",23839256,23843414,4158
"13198","Zm00001d040035","3",23935439,23937788,2349
"13199","Zm00001d040036","3",23950641,23966362,15721
"13200","Zm00001d040037","3",24013047,24016012,2965
"13201","Zm00001d040038","3",24228908,24237843,8935
"13202","Zm00001d040040","3",24347329,24350219,2890
"13203","Zm00001d040046","3",24643431,24647894,4463
"13204","Zm00001d040047","3",24745630,24752851,7221
"13205","Zm00001d040048","3",24757160,24757639,479
"13206","Zm00001d040050","3",24828379,24828873,494
"13207","Zm00001d040051","3",24858774,24877660,18886
"13208","Zm00001d040052","3",24865530,24867484,1954
"13209","Zm00001d040056","3",25353066,25358271,5205
"13210","Zm00001d040057","3",25371011,25371619,608
"13211","Zm00001d040058","3",25400406,25405798,5392
"13212","Zm00001d040059","3",25411899,25415727,3828
"13213","Zm00001d040060","3",25498657,25500782,2125
"13214","Zm00001d040061","3",25514772,25518392,3620
"13215","Zm00001d040064","3",25572404,25573429,1025
"13216","Zm00001d040065","3",25585787,25590704,4917
"13217","Zm00001d040066","3",25592413,25595079,2666
"13218","Zm00001d040067","3",25757941,25760426,2485
"13219","Zm00001d040071","3",25807741,25810352,2611
"13220","Zm00001d040075","3",25850590,25853929,3339
"13221","Zm00001d040076","3",25952306,25959681,7375
"13222","Zm00001d040080","3",26104464,26106720,2256
"13223","Zm00001d040082","3",26319889,26343497,23608
"13224","Zm00001d040084","3",26931529,26935231,3702
"13225","Zm00001d040087","3",26976836,26977327,491
"13226","Zm00001d040088","3",26988619,26989794,1175
"13227","Zm00001d040090","3",27133419,27141104,7685
"13228","Zm00001d040094","3",27358348,27364324,5976
"13229","Zm00001d040097","3",27389178,27390122,944
"13230","Zm00001d040100","3",27425353,27426229,876
"13231","Zm00001d040103","3",27621668,27623670,2002
"13232","Zm00001d040107","3",27840060,27843743,3683
"13233","Zm00001d040108","3",27850931,27852740,1809
"13234","Zm00001d040109","3",27953105,27954241,1136
"13235","Zm00001d040110","3",27957742,27958215,473
"13236","Zm00001d040111","3",27971283,27971801,518
"13237","Zm00001d040112","3",27973901,27974206,305
"13238","Zm00001d040113","3",28018444,28020104,1660
"13239","Zm00001d040116","3",28229697,28230965,1268
"13240","Zm00001d040117","3",28234385,28236975,2590
"13241","Zm00001d040118","3",28238999,28239742,743
"13242","Zm00001d040120","3",28257656,28258249,593
"13243","Zm00001d040123","3",28444734,28454983,10249
"13244","Zm00001d040124","3",28464665,28466799,2134
"13245","Zm00001d040125","3",28534287,28540068,5781
"13246","Zm00001d040126","3",28539909,28541148,1239
"13247","Zm00001d040127","3",28623780,28627767,3987
"13248","Zm00001d040129","3",28668662,28677463,8801
"13249","Zm00001d040130","3",28711131,28713722,2591
"13250","Zm00001d040133","3",28853090,28854282,1192
"13251","Zm00001d040137","3",28977570,28978298,728
"13252","Zm00001d040139","3",29032711,29034750,2039
"13253","Zm00001d040140","3",29053844,29055169,1325
"13254","Zm00001d040142","3",29090120,29096389,6269
"13255","Zm00001d040144","3",29125843,29141429,15586
"13256","Zm00001d040145","3",29132749,29135982,3233
"13257","Zm00001d040146","3",29163755,29173445,9690
"13258","Zm00001d040147","3",29191550,29194489,2939
"13259","Zm00001d040148","3",29230164,29233762,3598
"13260","Zm00001d040149","3",29238403,29239929,1526
"13261","Zm00001d040152","3",29271520,29275778,4258
"13262","Zm00001d040153","3",29316628,29318539,1911
"13263","Zm00001d040154","3",29437444,29458737,21293
"13264","Zm00001d040155","3",29580356,29584912,4556
"13265","Zm00001d040157","3",29588852,29590774,1922
"13266","Zm00001d040159","3",29654835,29657131,2296
"13267","Zm00001d040160","3",29671949,29675882,3933
"13268","Zm00001d040162","3",29759892,29766821,6929
"13269","Zm00001d040163","3",29846486,29852954,6468
"13270","Zm00001d040164","3",29854180,29858304,4124
"13271","Zm00001d040166","3",30043617,30172018,128401
"13272","Zm00001d040169","3",30449625,30452363,2738
"13273","Zm00001d040171","3",30518924,30520051,1127
"13274","Zm00001d040172","3",30544411,30545361,950
"13275","Zm00001d040173","3",30593009,30594535,1526
"13276","Zm00001d040175","3",30633138,30635367,2229
"13277","Zm00001d040178","3",30685394,30692365,6971
"13278","Zm00001d040183","3",30975610,30980210,4600
"13279","Zm00001d040185","3",31042767,31047281,4514
"13280","Zm00001d040186","3",31047438,31052508,5070
"13281","Zm00001d040188","3",31148377,31151382,3005
"13282","Zm00001d040189","3",31401124,31403248,2124
"13283","Zm00001d040190","3",31509737,31513060,3323
"13284","Zm00001d040191","3",31619279,31626394,7115
"13285","Zm00001d040192","3",31627408,31630769,3361
"13286","Zm00001d040193","3",31631301,31641725,10424
"13287","Zm00001d040196","3",31701671,31703349,1678
"13288","Zm00001d040197","3",31705710,31707058,1348
"13289","Zm00001d040201","3",31720341,31722326,1985
"13290","Zm00001d040202","3",31827897,31838331,10434
"13291","Zm00001d040203","3",31841673,31847295,5622
"13292","Zm00001d040204","3",32003230,32005866,2636
"13293","Zm00001d040205","3",32011584,32013797,2213
"13294","Zm00001d040210","3",32101450,32101662,212
"13295","Zm00001d040212","3",32141755,32141967,212
"13296","Zm00001d040213","3",32148638,32152132,3494
"13297","Zm00001d040214","3",32351595,32353238,1643
"13298","Zm00001d040215","3",32388537,32391284,2747
"13299","Zm00001d040218","3",32561179,32570368,9189
"13300","Zm00001d040220","3",32671215,32675049,3834
"13301","Zm00001d040221","3",32675617,32678236,2619
"13302","Zm00001d040222","3",32685138,32687678,2540
"13303","Zm00001d040223","3",32749014,32750911,1897
"13304","Zm00001d040228","3",32974823,32976064,1241
"13305","Zm00001d040231","3",33110293,33110631,338
"13306","Zm00001d040233","3",33140377,33144906,4529
"13307","Zm00001d040234","3",33191029,33198395,7366
"13308","Zm00001d040235","3",33200742,33208919,8177
"13309","Zm00001d040236","3",33244332,33246922,2590
"13310","Zm00001d040238","3",33378958,33381861,2903
"13311","Zm00001d040239","3",33381788,33383589,1801
"13312","Zm00001d040242","3",33401353,33402804,1451
"13313","Zm00001d040244","3",33433245,33434570,1325
"13314","Zm00001d040247","3",33681248,33682108,860
"13315","Zm00001d040248","3",33740978,33743632,2654
"13316","Zm00001d040251","3",33857210,33859958,2748
"13317","Zm00001d040254","3",34201668,34202867,1199
"13318","Zm00001d040257","3",34256905,34263420,6515
"13319","Zm00001d040259","3",34373666,34378966,5300
"13320","Zm00001d040260","3",34385034,34385420,386
"13321","Zm00001d040263","3",34652668,34657191,4523
"13322","Zm00001d040264","3",34730647,34732561,1914
"13323","Zm00001d040266","3",35094355,35099823,5468
"13324","Zm00001d040268","3",35119839,35130918,11079
"13325","Zm00001d040269","3",35197326,35199956,2630
"13326","Zm00001d040270","3",35200228,35207787,7559
"13327","Zm00001d040272","3",35298875,35300319,1444
"13328","Zm00001d040274","3",35350411,35356233,5822
"13329","Zm00001d040275","3",35356505,35357660,1155
"13330","Zm00001d040276","3",35447344,35450045,2701
"13331","Zm00001d040278","3",35457174,35462504,5330
"13332","Zm00001d040279","3",35510649,35520277,9628
"13333","Zm00001d040281","3",35652118,35654852,2734
"13334","Zm00001d040285","3",35692155,35692739,584
"13335","Zm00001d040286","3",35721411,35728565,7154
"13336","Zm00001d040287","3",35732184,35735342,3158
"13337","Zm00001d040290","3",35941532,35951651,10119
"13338","Zm00001d040291","3",36013414,36017372,3958
"13339","Zm00001d040292","3",36020981,36021268,287
"13340","Zm00001d040293","3",36027929,36029668,1739
"13341","Zm00001d040294","3",36194689,36199305,4616
"13342","Zm00001d040295","3",36255672,36256522,850
"13343","Zm00001d040297","3",36319753,36320169,416
"13344","Zm00001d040301","3",36557966,36563190,5224
"13345","Zm00001d040302","3",36669164,36675206,6042
"13346","Zm00001d040303","3",36817316,36823842,6526
"13347","Zm00001d040305","3",36893536,36902030,8494
"13348","Zm00001d040306","3",36998433,36999059,626
"13349","Zm00001d040308","3",37004302,37006317,2015
"13350","Zm00001d040309","3",37107695,37114751,7056
"13351","Zm00001d040310","3",37114976,37116953,1977
"13352","Zm00001d040311","3",37403121,37412755,9634
"13353","Zm00001d040312","3",37521244,37527593,6349
"13354","Zm00001d040314","3",37618168,37622190,4022
"13355","Zm00001d040317","3",37802079,37807763,5684
"13356","Zm00001d040318","3",37808012,37817360,9348
"13357","Zm00001d040320","3",37923664,37936779,13115
"13358","Zm00001d040321","3",37993717,37995805,2088
"13359","Zm00001d040322","3",37997055,38010551,13496
"13360","Zm00001d040323","3",38197170,38197511,341
"13361","Zm00001d040324","3",38203704,38204900,1196
"13362","Zm00001d040325","3",38294402,38299380,4978
"13363","Zm00001d040331","3",38375080,38380515,5435
"13364","Zm00001d040332","3",38384939,38407118,22179
"13365","Zm00001d040333","3",38407996,38413383,5387
"13366","Zm00001d040334","3",38519353,38522310,2957
"13367","Zm00001d040336","3",38594554,38595060,506
"13368","Zm00001d040340","3",38778973,38786131,7158
"13369","Zm00001d040341","3",38862363,38865341,2978
"13370","Zm00001d040342","3",39030992,39040579,9587
"13371","Zm00001d040343","3",39041880,39045335,3455
"13372","Zm00001d040344","3",39045836,39049419,3583
"13373","Zm00001d040348","3",39314836,39322904,8068
"13374","Zm00001d040351","3",39393105,39396421,3316
"13375","Zm00001d040356","3",39647289,39648626,1337
"13376","Zm00001d040357","3",39649104,39653644,4540
"13377","Zm00001d040358","3",39841432,39849816,8384
"13378","Zm00001d040360","3",39908343,39913413,5070
"13379","Zm00001d040361","3",40036927,40037825,898
"13380","Zm00001d040362","3",40080595,40084385,3790
"13381","Zm00001d040363","3",40085191,40088463,3272
"13382","Zm00001d040364","3",40090612,40092906,2294
"13383","Zm00001d040365","3",40180433,40190546,10113
"13384","Zm00001d040366","3",40204612,40225799,21187
"13385","Zm00001d040368","3",40485059,40492537,7478
"13386","Zm00001d040370","3",40525886,40528005,2119
"13387","Zm00001d040371","3",40532878,40546676,13798
"13388","Zm00001d040372","3",40547924,40552973,5049
"13389","Zm00001d040373","3",40594451,40596646,2195
"13390","Zm00001d040375","3",40750419,40751111,692
"13391","Zm00001d040381","3",40861828,40871645,9817
"13392","Zm00001d040382","3",40872493,40873464,971
"13393","Zm00001d040383","3",40873806,40877173,3367
"13394","Zm00001d040387","3",40996638,41001613,4975
"13395","Zm00001d040388","3",41005050,41006364,1314
"13396","Zm00001d040389","3",41017675,41024229,6554
"13397","Zm00001d040390","3",41115000,41122806,7806
"13398","Zm00001d040392","3",41124192,41130989,6797
"13399","Zm00001d040393","3",41209163,41210950,1787
"13400","Zm00001d040396","3",41248476,41249543,1067
"13401","Zm00001d040399","3",41314143,41316176,2033
"13402","Zm00001d040402","3",41382312,41382913,601
"13403","Zm00001d040405","3",41585464,41588346,2882
"13404","Zm00001d040408","3",41714129,41721654,7525
"13405","Zm00001d040409","3",41725412,41729804,4392
"13406","Zm00001d040411","3",42015187,42023609,8422
"13407","Zm00001d040414","3",42233620,42234145,525
"13408","Zm00001d040416","3",42358259,42375810,17551
"13409","Zm00001d040417","3",42398298,42399134,836
"13410","Zm00001d040422","3",42672281,42680006,7725
"13411","Zm00001d040423","3",42817665,42819244,1579
"13412","Zm00001d040426","3",42867274,42868539,1265
"13413","Zm00001d040428","3",43065775,43066839,1064
"13414","Zm00001d040429","3",43101748,43117241,15493
"13415","Zm00001d040431","3",43187479,43194914,7435
"13416","Zm00001d040435","3",43323740,43326702,2962
"13417","Zm00001d040438","3",43449762,43455057,5295
"13418","Zm00001d040439","3",43495123,43496495,1372
"13419","Zm00001d040440","3",43522797,43523973,1176
"13420","Zm00001d040441","3",43539013,43539885,872
"13421","Zm00001d040442","3",43569410,43571119,1709
"13422","Zm00001d040443","3",43581871,43582958,1087
"13423","Zm00001d040445","3",43699969,43701009,1040
"13424","Zm00001d040446","3",43701925,43707461,5536
"13425","Zm00001d040448","3",43804063,43808293,4230
"13426","Zm00001d040449","3",43825329,43828852,3523
"13427","Zm00001d040455","3",44149350,44152864,3514
"13428","Zm00001d040456","3",44227038,44234125,7087
"13429","Zm00001d040459","3",44576874,44585570,8696
"13430","Zm00001d040460","3",44588751,44589602,851
"13431","Zm00001d040461","3",44588915,44589664,749
"13432","Zm00001d040462","3",44592736,44610510,17774
"13433","Zm00001d040463","3",44744039,44746612,2573
"13434","Zm00001d040464","3",44811230,44812811,1581
"13435","Zm00001d040466","3",44985546,44989066,3520
"13436","Zm00001d040467","3",44999238,45000743,1505
"13437","Zm00001d040468","3",45120037,45134869,14832
"13438","Zm00001d040470","3",45272539,45288631,16092
"13439","Zm00001d040474","3",45686067,45686785,718
"13440","Zm00001d040475","3",45714344,45718276,3932
"13441","Zm00001d040477","3",45760766,45764334,3568
"13442","Zm00001d040479","3",46076165,46080173,4008
"13443","Zm00001d040489","3",46469890,46472564,2674
"13444","Zm00001d040497","3",46812763,46816168,3405
"13445","Zm00001d040499","3",46902050,46915340,13290
"13446","Zm00001d040503","3",47223813,47241740,17927
"13447","Zm00001d040504","3",47292181,47293995,1814
"13448","Zm00001d040505","3",47342388,47350717,8329
"13449","Zm00001d040506","3",47375333,47377044,1711
"13450","Zm00001d040507","3",47408698,47409472,774
"13451","Zm00001d040508","3",47519975,47520226,251
"13452","Zm00001d040509","3",47520802,47522705,1903
"13453","Zm00001d040513","3",47623384,47630229,6845
"13454","Zm00001d040515","3",47731374,47737817,6443
"13455","Zm00001d040516","3",47740478,47740720,242
"13456","Zm00001d040517","3",47815613,47816293,680
"13457","Zm00001d040518","3",47874630,47875010,380
"13458","Zm00001d040519","3",47878960,47880339,1379
"13459","Zm00001d040523","3",47967032,47971616,4584
"13460","Zm00001d040526","3",48128556,48131414,2858
"13461","Zm00001d040527","3",48286239,48288111,1872
"13462","Zm00001d040533","3",48430285,48430358,73
"13463","Zm00001d040534","3",48541454,48545929,4475
"13464","Zm00001d040535","3",48587357,48602676,15319
"13465","Zm00001d040536","3",48598914,48602327,3413
"13466","Zm00001d040537","3",48718848,48719919,1071
"13467","Zm00001d040539","3",48724573,48727639,3066
"13468","Zm00001d040540","3",48724704,48725590,886
"13469","Zm00001d040541","3",48775678,48777774,2096
"13470","Zm00001d040542","3",48843790,48845484,1694
"13471","Zm00001d040544","3",48922461,48923574,1113
"13472","Zm00001d040545","3",48943589,48944483,894
"13473","Zm00001d040554","3",49328805,49332591,3786
"13474","Zm00001d040555","3",49418717,49420159,1442
"13475","Zm00001d040560","3",49802802,49805909,3107
"13476","Zm00001d040561","3",49806344,49811108,4764
"13477","Zm00001d040562","3",49886321,49902674,16353
"13478","Zm00001d040563","3",50101600,50104729,3129
"13479","Zm00001d040567","3",50460159,50465139,4980
"13480","Zm00001d040568","3",50466188,50467228,1040
"13481","Zm00001d040569","3",50556666,50560812,4146
"13482","Zm00001d040571","3",50763985,50771779,7794
"13483","Zm00001d040578","3",50995292,50996597,1305
"13484","Zm00001d040582","3",51542116,51543817,1701
"13485","Zm00001d040583","3",51559677,51568254,8577
"13486","Zm00001d040584","3",51573436,51598500,25064
"13487","Zm00001d040588","3",51611323,51616452,5129
"13488","Zm00001d040589","3",51740462,51742521,2059
"13489","Zm00001d040593","3",52125428,52128327,2899
"13490","Zm00001d040596","3",52321295,52324902,3607
"13491","Zm00001d040597","3",52325138,52326913,1775
"13492","Zm00001d040599","3",52499476,52521065,21589
"13493","Zm00001d040603","3",52758777,52777667,18890
"13494","Zm00001d040604","3",52836903,52839305,2402
"13495","Zm00001d040606","3",53035908,53040506,4598
"13496","Zm00001d040611","3",53767845,53777713,9868
"13497","Zm00001d040612","3",53863310,53874662,11352
"13498","Zm00001d040613","3",53996519,53997786,1267
"13499","Zm00001d040614","3",54002070,54005318,3248
"13500","Zm00001d040617","3",54060892,54062596,1704
"13501","Zm00001d040619","3",54139362,54139841,479
"13502","Zm00001d040621","3",54361997,54365806,3809
"13503","Zm00001d040622","3",54366428,54368879,2451
"13504","Zm00001d040623","3",54606634,54607098,464
"13505","Zm00001d040624","3",54717613,54718843,1230
"13506","Zm00001d040625","3",54768172,54773642,5470
"13507","Zm00001d040628","3",55023821,55026070,2249
"13508","Zm00001d040629","3",55075888,55088174,12286
"13509","Zm00001d040630","3",55088527,55091474,2947
"13510","Zm00001d040632","3",55277734,55283618,5884
"13511","Zm00001d040633","3",55286388,55287802,1414
"13512","Zm00001d040634","3",55294376,55294903,527
"13513","Zm00001d040638","3",55395451,55396215,764
"13514","Zm00001d040639","3",55591117,55592820,1703
"13515","Zm00001d040641","3",55745498,55752488,6990
"13516","Zm00001d040644","3",55831479,55833662,2183
"13517","Zm00001d040650","3",56240764,56246825,6061
"13518","Zm00001d040651","3",56282555,56283711,1156
"13519","Zm00001d040652","3",56429593,56438793,9200
"13520","Zm00001d040656","3",56766328,56774152,7824
"13521","Zm00001d040659","3",56852785,56854547,1762
"13522","Zm00001d040660","3",56947607,56948312,705
"13523","Zm00001d040665","3",57044875,57051682,6807
"13524","Zm00001d040666","3",57051883,57058654,6771
"13525","Zm00001d040667","3",57058571,57062010,3439
"13526","Zm00001d040670","3",57107138,57111915,4777
"13527","Zm00001d040671","3",57175975,57178104,2129
"13528","Zm00001d040672","3",57179173,57201044,21871
"13529","Zm00001d040673","3",57203920,57204860,940
"13530","Zm00001d040674","3",57206032,57206889,857
"13531","Zm00001d040677","3",57355673,57358004,2331
"13532","Zm00001d040678","3",57611250,57618983,7733
"13533","Zm00001d040679","3",57622567,57628595,6028
"13534","Zm00001d040680","3",57626353,57628141,1788
"13535","Zm00001d040681","3",57632523,57633509,986
"13536","Zm00001d040682","3",57962007,57963593,1586
"13537","Zm00001d040684","3",58038460,58041414,2954
"13538","Zm00001d040685","3",58047531,58048955,1424
"13539","Zm00001d040686","3",58049539,58063745,14206
"13540","Zm00001d040688","3",58087494,58088371,877
"13541","Zm00001d040689","3",58288839,58305955,17116
"13542","Zm00001d040691","3",58480096,58484905,4809
"13543","Zm00001d040693","3",58561843,58565202,3359
"13544","Zm00001d040695","3",58717714,58721522,3808
"13545","Zm00001d040696","3",58880502,58892481,11979
"13546","Zm00001d040697","3",58920202,58921386,1184
"13547","Zm00001d040698","3",58957180,58958429,1249
"13548","Zm00001d040702","3",59064582,59072226,7644
"13549","Zm00001d040704","3",59236020,59244876,8856
"13550","Zm00001d040705","3",59360005,59362184,2179
"13551","Zm00001d040708","3",59518770,59521824,3054
"13552","Zm00001d040710","3",59535876,59536193,317
"13553","Zm00001d040711","3",59632308,59633892,1584
"13554","Zm00001d040712","3",59635229,59648248,13019
"13555","Zm00001d040715","3",59746543,59746863,320
"13556","Zm00001d040717","3",59836378,59845920,9542
"13557","Zm00001d040720","3",59856753,59860252,3499
"13558","Zm00001d040721","3",59860481,59869531,9050
"13559","Zm00001d040723","3",60039974,60040911,937
"13560","Zm00001d040724","3",60048141,60062020,13879
"13561","Zm00001d040725","3",60285344,60288098,2754
"13562","Zm00001d040726","3",60288264,60293502,5238
"13563","Zm00001d040727","3",60294162,60294729,567
"13564","Zm00001d040728","3",60340516,60341581,1065
"13565","Zm00001d040730","3",60566359,60577844,11485
"13566","Zm00001d040731","3",60610220,60613780,3560
"13567","Zm00001d040733","3",60679832,60682468,2636
"13568","Zm00001d040734","3",60728812,60733163,4351
"13569","Zm00001d040735","3",60817984,60822374,4390
"13570","Zm00001d040738","3",60984964,60989776,4812
"13571","Zm00001d040741","3",61277845,61281064,3219
"13572","Zm00001d040743","3",61373603,61380589,6986
"13573","Zm00001d040744","3",61451035,61462754,11719
"13574","Zm00001d040748","3",62644341,62666053,21712
"13575","Zm00001d040752","3",63579469,63581973,2504
"13576","Zm00001d040753","3",63599746,63600762,1016
"13577","Zm00001d040755","3",63750504,63753717,3213
"13578","Zm00001d040756","3",63771715,63771966,251
"13579","Zm00001d040757","3",63809562,63812638,3076
"13580","Zm00001d040758","3",63811366,63811425,59
"13581","Zm00001d040759","3",63854696,63861323,6627
"13582","Zm00001d040760","3",64043562,64058749,15187
"13583","Zm00001d040763","3",64298061,64299284,1223
"13584","Zm00001d040765","3",64549385,64551952,2567
"13585","Zm00001d040766","3",64552842,64556161,3319
"13586","Zm00001d040768","3",64615279,64626483,11204
"13587","Zm00001d040769","3",64639554,64644932,5378
"13588","Zm00001d040772","3",64746270,64747029,759
"13589","Zm00001d040773","3",64817879,64818616,737
"13590","Zm00001d040775","3",64946021,64948546,2525
"13591","Zm00001d040777","3",65156611,65158321,1710
"13592","Zm00001d040780","3",65423933,65426147,2214
"13593","Zm00001d040781","3",65577764,65578456,692
"13594","Zm00001d040782","3",65578036,65579997,1961
"13595","Zm00001d040783","3",65628348,65628851,503
"13596","Zm00001d040784","3",65852183,65858475,6292
"13597","Zm00001d040786","3",65871460,65871780,320
"13598","Zm00001d040787","3",65889207,65889515,308
"13599","Zm00001d040788","3",65988895,65991327,2432
"13600","Zm00001d040789","3",66020807,66026623,5816
"13601","Zm00001d040793","3",66276384,66278065,1681
"13602","Zm00001d040794","3",66297255,66297619,364
"13603","Zm00001d040795","3",66300601,66309143,8542
"13604","Zm00001d040796","3",66375799,66379752,3953
"13605","Zm00001d040798","3",66473780,66485780,12000
"13606","Zm00001d040803","3",66922907,66923248,341
"13607","Zm00001d040804","3",66959532,66964277,4745
"13608","Zm00001d040805","3",67066176,67071878,5702
"13609","Zm00001d040807","3",67151874,67157763,5889
"13610","Zm00001d040818","3",67922595,67928066,5471
"13611","Zm00001d040819","3",67929346,67929810,464
"13612","Zm00001d040823","3",68049564,68070844,21280
"13613","Zm00001d040826","3",68119804,68120244,440
"13614","Zm00001d040827","3",68155590,68175332,19742
"13615","Zm00001d040829","3",68286049,68295110,9061
"13616","Zm00001d040830","3",68299131,68300672,1541
"13617","Zm00001d040831","3",68533978,68545245,11267
"13618","Zm00001d040832","3",68740786,68744236,3450
"13619","Zm00001d040833","3",68840759,68843582,2823
"13620","Zm00001d040834","3",68850848,68852784,1936
"13621","Zm00001d040838","3",69660612,69661469,857
"13622","Zm00001d040839","3",69848831,69850299,1468
"13623","Zm00001d040842","3",70151471,70153788,2317
"13624","Zm00001d040846","3",70935430,70938240,2810
"13625","Zm00001d040850","3",71571869,71601459,29590
"13626","Zm00001d040851","3",71655185,71657626,2441
"13627","Zm00001d040855","3",72170003,72172709,2706
"13628","Zm00001d040857","3",72226157,72228051,1894
"13629","Zm00001d040864","3",73203868,73290655,86787
"13630","Zm00001d040865","3",73281426,73283616,2190
"13631","Zm00001d040873","3",74197008,74217788,20780
"13632","Zm00001d040874","3",74396946,74397410,464
"13633","Zm00001d040878","3",74729449,74733697,4248
"13634","Zm00001d040879","3",74904443,74905796,1353
"13635","Zm00001d040880","3",74906493,74908019,1526
"13636","Zm00001d040883","3",75383382,75399957,16575
"13637","Zm00001d040888","3",75749883,75757594,7711
"13638","Zm00001d040893","3",76453764,76456175,2411
"13639","Zm00001d040898","3",77271432,77272559,1127
"13640","Zm00001d040899","3",77278832,77279660,828
"13641","Zm00001d040901","3",77281572,77301205,19633
"13642","Zm00001d040905","3",77818840,77819376,536
"13643","Zm00001d040920","3",79222601,79256661,34060
"13644","Zm00001d040921","3",79226928,79227000,72
"13645","Zm00001d040924","3",79577922,79578656,734
"13646","Zm00001d040925","3",79594871,79595503,632
"13647","Zm00001d040930","3",80105405,80105866,461
"13648","Zm00001d040933","3",80405320,80410199,4879
"13649","Zm00001d040934","3",80430114,80430734,620
"13650","Zm00001d040936","3",80811933,80814817,2884
"13651","Zm00001d040937","3",80851037,80855987,4950
"13652","Zm00001d040939","3",81212924,81213289,365
"13653","Zm00001d040941","3",81369102,81382294,13192
"13654","Zm00001d040942","3",81480789,81480875,86
"13655","Zm00001d040943","3",81488677,81488751,74
"13656","Zm00001d040946","3",81494514,81494587,73
"13657","Zm00001d040947","3",81710564,81722446,11882
"13658","Zm00001d040952","3",82337239,82340801,3562
"13659","Zm00001d040953","3",82375568,82389198,13630
"13660","Zm00001d040954","3",82416424,82429112,12688
"13661","Zm00001d040958","3",83071425,83074361,2936
"13662","Zm00001d040959","3",83206343,83223323,16980
"13663","Zm00001d040960","3",83471507,83498515,27008
"13664","Zm00001d040966","3",85314327,85317254,2927
"13665","Zm00001d040971","3",85998366,86001982,3616
"13666","Zm00001d040972","3",86811615,86815169,3554
"13667","Zm00001d040980","3",87902604,87907835,5231
"13668","Zm00001d040981","3",87908250,87915687,7437
"13669","Zm00001d040985","3",88156952,88158670,1718
"13670","Zm00001d040986","3",88400804,88401646,842
"13671","Zm00001d040987","3",88405267,88405340,73
"13672","Zm00001d040988","3",88431308,88434145,2837
"13673","Zm00001d040990","3",88731145,88732143,998
"13674","Zm00001d040991","3",88848426,88849686,1260
"13675","Zm00001d040996","3",89082044,89084928,2884
"13676","Zm00001d041004","3",89704604,89708058,3454
"13677","Zm00001d041006","3",89809703,89810953,1250
"13678","Zm00001d041007","3",89966268,89970132,3864
"13679","Zm00001d041013","3",90297051,90300915,3864
"13680","Zm00001d041020","3",90717576,90719133,1557
"13681","Zm00001d041026","3",91368964,91370839,1875
"13682","Zm00001d041030","3",91721445,91722458,1013
"13683","Zm00001d041032","3",92031733,92033232,1499
"13684","Zm00001d041035","3",92247530,92264499,16969
"13685","Zm00001d041036","3",92302528,92325633,23105
"13686","Zm00001d041038","3",92328970,92332013,3043
"13687","Zm00001d041039","3",92330809,92330882,73
"13688","Zm00001d041041","3",92478450,92479007,557
"13689","Zm00001d041046","3",92703174,92704212,1038
"13690","Zm00001d041049","3",92907263,92913722,6459
"13691","Zm00001d041052","3",93317222,93328676,11454
"13692","Zm00001d041054","3",93370356,93370934,578
"13693","Zm00001d041055","3",93411371,93412687,1316
"13694","Zm00001d041056","3",93516867,93523481,6614
"13695","Zm00001d041057","3",93566119,93566826,707
"13696","Zm00001d041059","3",93625618,93626315,697
"13697","Zm00001d041062","3",93955609,93955923,314
"13698","Zm00001d041063","3",94045566,94050496,4930
"13699","Zm00001d041064","3",94315459,94325421,9962
"13700","Zm00001d041065","3",94352255,94352482,227
"13701","Zm00001d041069","3",94744009,94744639,630
"13702","Zm00001d041070","3",94780475,94810989,30514
"13703","Zm00001d041072","3",95099503,95103250,3747
"13704","Zm00001d041073","3",95280130,95310416,30286
"13705","Zm00001d041075","3",95549742,95571404,21662
"13706","Zm00001d041076","3",95571464,95572771,1307
"13707","Zm00001d041077","3",95600395,95603031,2636
"13708","Zm00001d041078","3",95620266,95620339,73
"13709","Zm00001d041079","3",95623144,95623951,807
"13710","Zm00001d041082","3",96077271,96081198,3927
"13711","Zm00001d041083","3",96133441,96171332,37891
"13712","Zm00001d041087","3",96428158,96432932,4774
"13713","Zm00001d041088","3",96602269,96606539,4270
"13714","Zm00001d041090","3",96813247,96816859,3612
"13715","Zm00001d041092","3",96989702,97015813,26111
"13716","Zm00001d041095","3",97125804,97129214,3410
"13717","Zm00001d041098","3",97280292,97285444,5152
"13718","Zm00001d041099","3",97286151,97293583,7432
"13719","Zm00001d041101","3",97412506,97416279,3773
"13720","Zm00001d041105","3",97492098,97509622,17524
"13721","Zm00001d041107","3",97598594,97599321,727
"13722","Zm00001d041108","3",97773979,97798160,24181
"13723","Zm00001d041112","3",98130861,98139735,8874
"13724","Zm00001d041119","3",98749658,98758321,8663
"13725","Zm00001d041124","3",99054552,99065304,10752
"13726","Zm00001d041127","3",99309485,99310774,1289
"13727","Zm00001d041132","3",99481870,99482433,563
"13728","Zm00001d041134","3",99558872,99558942,70
"13729","Zm00001d041135","3",99559401,99559856,455
"13730","Zm00001d041136","3",99757561,99779623,22062
"13731","Zm00001d041138","3",99796959,99830105,33146
"13732","Zm00001d041139","3",99819823,99822601,2778
"13733","Zm00001d041140","3",100023567,100025302,1735
"13734","Zm00001d041142","3",100232730,100240533,7803
"13735","Zm00001d041143","3",100305164,100309225,4061
"13736","Zm00001d041147","3",100320158,100324726,4568
"13737","Zm00001d041148","3",100335184,100337063,1879
"13738","Zm00001d041152","3",100446858,100447724,866
"13739","Zm00001d041154","3",100564945,100565897,952
"13740","Zm00001d041157","3",100613388,100615143,1755
"13741","Zm00001d041159","3",100689824,100703020,13196
"13742","Zm00001d041161","3",100922606,100923721,1115
"13743","Zm00001d041165","3",101289527,101292306,2779
"13744","Zm00001d041168","3",101765199,101769211,4012
"13745","Zm00001d041175","3",102201746,102218167,16421
"13746","Zm00001d041179","3",102862285,102878926,16641
"13747","Zm00001d041180","3",102996073,102998771,2698
"13748","Zm00001d041183","3",103246216,103257481,11265
"13749","Zm00001d041186","3",103858898,103868467,9569
"13750","Zm00001d041187","3",104105105,104120602,15497
"13751","Zm00001d041189","3",104290096,104292116,2020
"13752","Zm00001d041190","3",104292581,104293207,626
"13753","Zm00001d041191","3",104337246,104338289,1043
"13754","Zm00001d041192","3",104338411,104343309,4898
"13755","Zm00001d041196","3",104914531,104915523,992
"13756","Zm00001d041199","3",105169280,105170167,887
"13757","Zm00001d041200","3",105170722,105172871,2149
"13758","Zm00001d041201","3",105179821,105183171,3350
"13759","Zm00001d041202","3",105279624,105280642,1018
"13760","Zm00001d041203","3",105353282,105355800,2518
"13761","Zm00001d041204","3",105356377,105359732,3355
"13762","Zm00001d041214","3",105721654,105727958,6304
"13763","Zm00001d041215","3",105826354,105830061,3707
"13764","Zm00001d041216","3",105946908,105964472,17564
"13765","Zm00001d041220","3",106078570,106079511,941
"13766","Zm00001d041221","3",106171262,106172646,1384
"13767","Zm00001d041222","3",106275407,106276417,1010
"13768","Zm00001d041225","3",106397425,106403000,5575
"13769","Zm00001d041226","3",106474320,106475189,869
"13770","Zm00001d041229","3",106709675,106715943,6268
"13771","Zm00001d041230","3",106717834,106718637,803
"13772","Zm00001d041231","3",106719708,106720535,827
"13773","Zm00001d041232","3",106917387,106920828,3441
"13774","Zm00001d041236","3",107564987,107567956,2969
"13775","Zm00001d041240","3",107748274,107749105,831
"13776","Zm00001d041243","3",107817035,107822167,5132
"13777","Zm00001d041246","3",108034638,108035490,852
"13778","Zm00001d041248","3",108082544,108085594,3050
"13779","Zm00001d041253","3",108409516,108419571,10055
"13780","Zm00001d041255","3",108510230,108519488,9258
"13781","Zm00001d041256","3",108570791,108576761,5970
"13782","Zm00001d041258","3",108744749,108745942,1193
"13783","Zm00001d041265","3",109138059,109141587,3528
"13784","Zm00001d041266","3",109152384,109154435,2051
"13785","Zm00001d041267","3",109160420,109163574,3154
"13786","Zm00001d041268","3",109251220,109254962,3742
"13787","Zm00001d041269","3",109536115,109540830,4715
"13788","Zm00001d041272","3",109593753,109596738,2985
"13789","Zm00001d041277","3",109762671,109768864,6193
"13790","Zm00001d041280","3",110162431,110171208,8777
"13791","Zm00001d041282","3",110290137,110292427,2290
"13792","Zm00001d041287","3",110465002,110469594,4592
"13793","Zm00001d041288","3",110562307,110562648,341
"13794","Zm00001d041290","3",110647125,110652889,5764
"13795","Zm00001d041298","3",110788361,110796970,8609
"13796","Zm00001d041299","3",110841496,110842590,1094
"13797","Zm00001d041300","3",110923261,110924173,912
"13798","Zm00001d041305","3",111211600,111212685,1085
"13799","Zm00001d041307","3",111414229,111424569,10340
"13800","Zm00001d041308","3",111434917,111440097,5180
"13801","Zm00001d041309","3",111440781,111443015,2234
"13802","Zm00001d041315","3",111763751,111768222,4471
"13803","Zm00001d041319","3",111919013,111920827,1814
"13804","Zm00001d041321","3",111999384,112010144,10760
"13805","Zm00001d041322","3",112343277,112349197,5920
"13806","Zm00001d041323","3",112350290,112355140,4850
"13807","Zm00001d041325","3",112366449,112368629,2180
"13808","Zm00001d041326","3",112369233,112370720,1487
"13809","Zm00001d041327","3",112397485,112399899,2414
"13810","Zm00001d041329","3",112425983,112426954,971
"13811","Zm00001d041331","3",112434449,112436175,1726
"13812","Zm00001d041332","3",112492977,112493612,635
"13813","Zm00001d041334","3",112555101,112557464,2363
"13814","Zm00001d041339","3",112926773,112927623,850
"13815","Zm00001d041343","3",113590531,113594266,3735
"13816","Zm00001d041345","3",113725965,113728247,2282
"13817","Zm00001d041346","3",113860754,113865747,4993
"13818","Zm00001d041352","3",113916459,113919793,3334
"13819","Zm00001d041353","3",114000176,114013919,13743
"13820","Zm00001d041354","3",114016666,114022450,5784
"13821","Zm00001d041362","3",114244392,114251164,6772
"13822","Zm00001d041363","3",114363894,114370258,6364
"13823","Zm00001d041365","3",114433709,114437553,3844
"13824","Zm00001d041374","3",114710869,114712284,1415
"13825","Zm00001d041375","3",114714553,114715324,771
"13826","Zm00001d041377","3",114787992,114789464,1472
"13827","Zm00001d041378","3",114791126,114801047,9921
"13828","Zm00001d041380","3",115123329,115124939,1610
"13829","Zm00001d041381","3",115132711,115134129,1418
"13830","Zm00001d041382","3",115221999,115222295,296
"13831","Zm00001d041383","3",115222850,115230962,8112
"13832","Zm00001d041384","3",115238920,115239614,694
"13833","Zm00001d041387","3",115337244,115338278,1034
"13834","Zm00001d041389","3",115402846,115406878,4032
"13835","Zm00001d041392","3",115687793,115691499,3706
"13836","Zm00001d041393","3",115711929,115715470,3541
"13837","Zm00001d041395","3",116053637,116080626,26989
"13838","Zm00001d041397","3",116329475,116332435,2960
"13839","Zm00001d041399","3",116657804,116660281,2477
"13840","Zm00001d041403","3",117197766,117198365,599
"13841","Zm00001d041404","3",117199059,117199622,563
"13842","Zm00001d041405","3",117289104,117299908,10804
"13843","Zm00001d041406","3",117381964,117383316,1352
"13844","Zm00001d041407","3",117384058,117395212,11154
"13845","Zm00001d041410","3",117580526,117581753,1227
"13846","Zm00001d041414","3",117921013,117927080,6067
"13847","Zm00001d041415","3",118017625,118031114,13489
"13848","Zm00001d041416","3",118101071,118105468,4397
"13849","Zm00001d041418","3",118360550,118362225,1675
"13850","Zm00001d041420","3",118460621,118471129,10508
"13851","Zm00001d041421","3",118473258,118475075,1817
"13852","Zm00001d041422","3",118593557,118594862,1305
"13853","Zm00001d041425","3",118825684,118829192,3508
"13854","Zm00001d041430","3",119199463,119199972,509
"13855","Zm00001d041436","3",119390525,119392009,1484
"13856","Zm00001d041438","3",119806037,119835241,29204
"13857","Zm00001d041439","3",119832439,119836443,4004
"13858","Zm00001d041443","3",120171712,120179837,8125
"13859","Zm00001d041444","3",120186769,120190340,3571
"13860","Zm00001d041445","3",120191179,120204285,13106
"13861","Zm00001d041450","3",120550732,120561987,11255
"13862","Zm00001d041453","3",120947618,120954091,6473
"13863","Zm00001d041454","3",121253595,121256150,2555
"13864","Zm00001d041455","3",121298178,121301899,3721
"13865","Zm00001d041456","3",121302653,121303933,1280
"13866","Zm00001d041457","3",121378873,121382541,3668
"13867","Zm00001d041458","3",121467044,121469050,2006
"13868","Zm00001d041464","3",121900435,121902537,2102
"13869","Zm00001d041471","3",122354669,122364344,9675
"13870","Zm00001d041472","3",122367956,122372020,4064
"13871","Zm00001d041474","3",122398912,122402304,3392
"13872","Zm00001d041475","3",122403732,122410495,6763
"13873","Zm00001d041476","3",122414822,122416911,2089
"13874","Zm00001d041480","3",122677055,122681572,4517
"13875","Zm00001d041481","3",122812178,122814203,2025
"13876","Zm00001d041484","3",123242703,123249152,6449
"13877","Zm00001d041488","3",123488067,123493205,5138
"13878","Zm00001d041489","3",123607100,123613712,6612
"13879","Zm00001d041491","3",123760201,123767258,7057
"13880","Zm00001d041495","3",124129914,124133015,3101
"13881","Zm00001d041496","3",124141793,124143878,2085
"13882","Zm00001d041497","3",124224716,124231074,6358
"13883","Zm00001d041498","3",124367636,124370607,2971
"13884","Zm00001d041504","3",124540297,124543804,3507
"13885","Zm00001d041506","3",124671506,124674990,3484
"13886","Zm00001d041508","3",124919974,124923682,3708
"13887","Zm00001d041509","3",124926387,124927241,854
"13888","Zm00001d041510","3",125020876,125028056,7180
"13889","Zm00001d041511","3",125028657,125033309,4652
"13890","Zm00001d041513","3",125119438,125121733,2295
"13891","Zm00001d041514","3",125122808,125126410,3602
"13892","Zm00001d041515","3",125289850,125330088,40238
"13893","Zm00001d041516","3",125552392,125557077,4685
"13894","Zm00001d041518","3",125560575,125561600,1025
"13895","Zm00001d041519","3",125563618,125564283,665
"13896","Zm00001d041520","3",125608671,125609400,729
"13897","Zm00001d041521","3",125708192,125710214,2022
"13898","Zm00001d041522","3",125843356,125846615,3259
"13899","Zm00001d041523","3",125849221,125851417,2196
"13900","Zm00001d041525","3",125901674,125905287,3613
"13901","Zm00001d041526","3",125967179,125969813,2634
"13902","Zm00001d041528","3",125971928,125972875,947
"13903","Zm00001d041529","3",126000149,126004313,4164
"13904","Zm00001d041530","3",126035560,126036633,1073
"13905","Zm00001d041531","3",126088939,126092644,3705
"13906","Zm00001d041533","3",126104284,126105794,1510
"13907","Zm00001d041534","3",126106707,126109981,3274
"13908","Zm00001d041536","3",126130758,126132890,2132
"13909","Zm00001d041537","3",126166316,126167305,989
"13910","Zm00001d041538","3",126304770,126305192,422
"13911","Zm00001d041539","3",126342753,126344912,2159
"13912","Zm00001d041544","3",126522185,126523196,1011
"13913","Zm00001d041545","3",126535818,126539525,3707
"13914","Zm00001d041548","3",126577794,126583834,6040
"13915","Zm00001d041549","3",126665476,126667691,2215
"13916","Zm00001d041550","3",126862145,126865908,3763
"13917","Zm00001d041551","3",126876629,126878600,1971
"13918","Zm00001d041553","3",126926038,126926802,764
"13919","Zm00001d041556","3",127112005,127118515,6510
"13920","Zm00001d041568","3",127512197,127514125,1928
"13921","Zm00001d041569","3",127515565,127518644,3079
"13922","Zm00001d041574","3",127727027,127731169,4142
"13923","Zm00001d041575","3",127806143,127822116,15973
"13924","Zm00001d041576","3",127808680,127810192,1512
"13925","Zm00001d041577","3",128002093,128004209,2116
"13926","Zm00001d041578","3",128055991,128056665,674
"13927","Zm00001d041582","3",128236186,128248639,12453
"13928","Zm00001d041583","3",128252628,128254186,1558
"13929","Zm00001d041584","3",128389890,128392834,2944
"13930","Zm00001d041588","3",128517097,128520764,3667
"13931","Zm00001d041589","3",128535527,128535904,377
"13932","Zm00001d041590","3",128629007,128633579,4572
"13933","Zm00001d041591","3",128764784,128765575,791
"13934","Zm00001d041592","3",128767268,128773473,6205
"13935","Zm00001d041593","3",129044635,129048672,4037
"13936","Zm00001d041594","3",129061337,129065180,3843
"13937","Zm00001d041595","3",129152770,129155366,2596
"13938","Zm00001d041596","3",129159709,129161496,1787
"13939","Zm00001d041597","3",129182927,129187885,4958
"13940","Zm00001d041598","3",129189389,129190168,779
"13941","Zm00001d041599","3",129314606,129321791,7185
"13942","Zm00001d041600","3",129353827,129354513,686
"13943","Zm00001d041601","3",129401171,129403931,2760
"13944","Zm00001d041603","3",129427114,129430257,3143
"13945","Zm00001d041604","3",129456939,129457397,458
"13946","Zm00001d041606","3",129567273,129572209,4936
"13947","Zm00001d041607","3",129572368,129574614,2246
"13948","Zm00001d041608","3",129601695,129605205,3510
"13949","Zm00001d041609","3",129607891,129609142,1251
"13950","Zm00001d041610","3",129609526,129612757,3231
"13951","Zm00001d041611","3",129670740,129671244,504
"13952","Zm00001d041612","3",129682628,129687971,5343
"13953","Zm00001d041613","3",129691796,129694081,2285
"13954","Zm00001d041614","3",129720545,129721619,1074
"13955","Zm00001d041618","3",129737148,129738522,1374
"13956","Zm00001d041620","3",129742372,129749098,6726
"13957","Zm00001d041623","3",129812156,129815014,2858
"13958","Zm00001d041624","3",129822259,129827276,5017
"13959","Zm00001d041625","3",129830088,129834815,4727
"13960","Zm00001d041626","3",129953081,129955906,2825
"13961","Zm00001d041627","3",130023580,130034797,11217
"13962","Zm00001d041632","3",130485354,130507208,21854
"13963","Zm00001d041634","3",130575669,130579006,3337
"13964","Zm00001d041635","3",130621558,130626835,5277
"13965","Zm00001d041636","3",130705125,130707350,2225
"13966","Zm00001d041647","3",131547216,131554367,7151
"13967","Zm00001d041649","3",131635306,131638817,3511
"13968","Zm00001d041650","3",131645616,131647820,2204
"13969","Zm00001d041656","3",132167800,132168741,941
"13970","Zm00001d041663","3",132595159,132596215,1056
"13971","Zm00001d041669","3",132743387,132744631,1244
"13972","Zm00001d041671","3",132868467,132868983,516
"13973","Zm00001d041672","3",132881408,132881963,555
"13974","Zm00001d041675","3",132925647,132926099,452
"13975","Zm00001d041678","3",132996819,132998307,1488
"13976","Zm00001d041679","3",133009146,133013325,4179
"13977","Zm00001d041681","3",133073301,133074972,1671
"13978","Zm00001d041682","3",133075625,133080137,4512
"13979","Zm00001d041685","3",133286614,133286988,374
"13980","Zm00001d041686","3",133326293,133327820,1527
"13981","Zm00001d041690","3",133491020,133493729,2709
"13982","Zm00001d050022","4",60692710,60696653,3943
"13983","Zm00001d050023","4",60696494,60714980,18486
"13984","Zm00001d050024","4",60837568,60886545,48977
"13985","Zm00001d050026","4",60974368,60977492,3124
"13986","Zm00001d050032","4",61315575,61321350,5775
"13987","Zm00001d050033","4",61379817,61395297,15480
"13988","Zm00001d050034","4",61498693,61502376,3683
"13989","Zm00001d050039","4",61707240,61708265,1025
"13990","Zm00001d050040","4",61821579,61821875,296
"13991","Zm00001d050041","4",61838624,61838977,353
"13992","Zm00001d050043","4",62014684,62018896,4212
"13993","Zm00001d050045","4",62072937,62073575,638
"13994","Zm00001d050048","4",62421196,62426479,5283
"13995","Zm00001d050051","4",62584040,62593761,9721
"13996","Zm00001d050052","4",62592592,62601076,8484
"13997","Zm00001d050054","4",62652401,62672981,20580
"13998","Zm00001d050055","4",62771016,62771591,575
"13999","Zm00001d050056","4",62778364,62779875,1511
"14000","Zm00001d050061","4",63223873,63230486,6613
"14001","Zm00001d050062","4",63286057,63292020,5963
"14002","Zm00001d050063","4",63443250,63444701,1451
"14003","Zm00001d050068","4",63825396,63828818,3422
"14004","Zm00001d050069","4",63832557,63836587,4030
"14005","Zm00001d050073","4",64145485,64146411,926
"14006","Zm00001d050074","4",64147004,64157156,10152
"14007","Zm00001d050076","4",64429643,64432844,3201
"14008","Zm00001d050079","4",64642353,64642925,572
"14009","Zm00001d050081","4",64819264,64825467,6203
"14010","Zm00001d050082","4",64847021,64848362,1341
"14011","Zm00001d050083","4",64869289,64871716,2427
"14012","Zm00001d050084","4",64873330,64876073,2743
"14013","Zm00001d050085","4",64882472,64888748,6276
"14014","Zm00001d050089","4",65078952,65090738,11786
"14015","Zm00001d050091","4",65307872,65310883,3011
"14016","Zm00001d050092","4",65314401,65316809,2408
"14017","Zm00001d050093","4",65383709,65384116,407
"14018","Zm00001d050095","4",65387724,65389604,1880
"14019","Zm00001d050096","4",65397409,65400059,2650
"14020","Zm00001d050099","4",65577972,65578400,428
"14021","Zm00001d050100","4",65618139,65618591,452
"14022","Zm00001d050102","4",65730522,65731367,845
"14023","Zm00001d050103","4",65733096,65736167,3071
"14024","Zm00001d050104","4",65810672,65819113,8441
"14025","Zm00001d050106","4",65967344,65976964,9620
"14026","Zm00001d050107","4",66086547,66090296,3749
"14027","Zm00001d050109","4",66244370,66250581,6211
"14028","Zm00001d050112","4",66635305,66651391,16086
"14029","Zm00001d050115","4",66963138,66969242,6104
"14030","Zm00001d050116","4",66968368,66992497,24129
"14031","Zm00001d050119","4",67238635,67241981,3346
"14032","Zm00001d050120","4",67367536,67368396,860
"14033","Zm00001d050121","4",67400633,67405329,4696
"14034","Zm00001d050122","4",67429076,67433816,4740
"14035","Zm00001d050123","4",67476538,67489450,12912
"14036","Zm00001d050125","4",67726988,67745706,18718
"14037","Zm00001d050126","4",67739325,67739397,72
"14038","Zm00001d050129","4",68039493,68040116,623
"14039","Zm00001d050130","4",68040872,68057079,16207
"14040","Zm00001d050131","4",68132589,68156074,23485
"14041","Zm00001d050132","4",68202250,68205876,3626
"14042","Zm00001d050133","4",68209203,68220619,11416
"14043","Zm00001d050134","4",68237414,68255070,17656
"14044","Zm00001d050137","4",68398270,68400314,2044
"14045","Zm00001d050139","4",68410505,68416118,5613
"14046","Zm00001d050141","4",68733685,68752441,18756
"14047","Zm00001d050143","4",69043209,69046748,3539
"14048","Zm00001d050144","4",69047870,69051734,3864
"14049","Zm00001d050145","4",69072298,69075609,3311
"14050","Zm00001d050146","4",69100276,69104100,3824
"14051","Zm00001d050148","4",69214939,69217467,2528
"14052","Zm00001d050149","4",69353358,69355399,2041
"14053","Zm00001d050150","4",69407277,69429725,22448
"14054","Zm00001d050153","4",69519897,69526796,6899
"14055","Zm00001d050155","4",69592907,69594252,1345
"14056","Zm00001d050157","4",69661222,69669618,8396
"14057","Zm00001d050163","4",69979608,69982793,3185
"14058","Zm00001d050164","4",70178212,70181943,3731
"14059","Zm00001d050165","4",70184869,70192641,7772
"14060","Zm00001d050166","4",70207743,70219453,11710
"14061","Zm00001d050167","4",70210553,70218286,7733
"14062","Zm00001d050168","4",70220491,70221662,1171
"14063","Zm00001d050170","4",70328124,70329750,1626
"14064","Zm00001d050171","4",70421589,70428063,6474
"14065","Zm00001d050172","4",70545123,70545792,669
"14066","Zm00001d050173","4",70689730,70698125,8395
"14067","Zm00001d050174","4",70781882,70785711,3829
"14068","Zm00001d050178","4",71005585,71008083,2498
"14069","Zm00001d050179","4",71069808,71072994,3186
"14070","Zm00001d050180","4",71186718,71187311,593
"14071","Zm00001d050182","4",71328242,71331175,2933
"14072","Zm00001d050184","4",71447978,71455940,7962
"14073","Zm00001d050186","4",71494441,71496209,1768
"14074","Zm00001d050187","4",71545646,71551090,5444
"14075","Zm00001d050190","4",71977812,71978354,542
"14076","Zm00001d050191","4",72039466,72044085,4619
"14077","Zm00001d050192","4",72086321,72089873,3552
"14078","Zm00001d050193","4",72526574,72528866,2292
"14079","Zm00001d050195","4",72636377,72637297,920
"14080","Zm00001d050196","4",72786474,72789077,2603
"14081","Zm00001d050198","4",72854696,72856775,2079
"14082","Zm00001d050199","4",73083855,73085463,1608
"14083","Zm00001d050200","4",73314108,73315352,1244
"14084","Zm00001d050202","4",73397381,73401948,4567
"14085","Zm00001d050207","4",73538288,73546110,7822
"14086","Zm00001d050208","4",73550491,73555374,4883
"14087","Zm00001d050211","4",73767159,73769062,1903
"14088","Zm00001d050214","4",73910369,73915173,4804
"14089","Zm00001d050216","4",73974628,73980464,5836
"14090","Zm00001d050218","4",74240150,74245597,5447
"14091","Zm00001d050219","4",74335082,74344859,9777
"14092","Zm00001d050220","4",74498853,74512180,13327
"14093","Zm00001d050222","4",74519081,74519623,542
"14094","Zm00001d050224","4",74614191,74625017,10826
"14095","Zm00001d050225","4",74666636,74669902,3266
"14096","Zm00001d050227","4",74759042,74763247,4205
"14097","Zm00001d050231","4",75005457,75005816,359
"14098","Zm00001d050234","4",75106267,75107484,1217
"14099","Zm00001d050238","4",75293161,75301669,8508
"14100","Zm00001d050241","4",75536877,75538808,1931
"14101","Zm00001d050242","4",75567139,75573713,6574
"14102","Zm00001d050244","4",75667940,75675684,7744
"14103","Zm00001d050245","4",75823246,75830658,7412
"14104","Zm00001d050247","4",76138362,76139324,962
"14105","Zm00001d050248","4",76139696,76156035,16339
"14106","Zm00001d050250","4",76349533,76351893,2360
"14107","Zm00001d050251","4",76390366,76395911,5545
"14108","Zm00001d050253","4",76519506,76527273,7767
"14109","Zm00001d050254","4",76616970,76627079,10109
"14110","Zm00001d050256","4",76976633,76985641,9008
"14111","Zm00001d050258","4",77041321,77044916,3595
"14112","Zm00001d050259","4",77087087,77098401,11314
"14113","Zm00001d050260","4",77186734,77191499,4765
"14114","Zm00001d050265","4",77232457,77236007,3550
"14115","Zm00001d050266","4",77360985,77363033,2048
"14116","Zm00001d050267","4",77405120,77406901,1781
"14117","Zm00001d050271","4",77617238,77617588,350
"14118","Zm00001d050272","4",77692886,77695103,2217
"14119","Zm00001d050273","4",77789524,77791626,2102
"14120","Zm00001d050274","4",77866649,77878557,11908
"14121","Zm00001d050277","4",78271436,78274987,3551
"14122","Zm00001d050283","4",78443935,78447990,4055
"14123","Zm00001d050284","4",78468137,78471732,3595
"14124","Zm00001d050287","4",78898312,78909395,11083
"14125","Zm00001d050293","4",79156177,79162011,5834
"14126","Zm00001d050294","4",79210012,79211052,1040
"14127","Zm00001d050295","4",79407612,79412327,4715
"14128","Zm00001d050297","4",79515945,79517217,1272
"14129","Zm00001d050299","4",79712256,79715441,3185
"14130","Zm00001d050300","4",79804777,79808322,3545
"14131","Zm00001d050302","4",80005891,80007018,1127
"14132","Zm00001d050303","4",80186398,80188770,2372
"14133","Zm00001d050304","4",80218201,80223483,5282
"14134","Zm00001d050307","4",80275728,80278473,2745
"14135","Zm00001d050310","4",80432810,80437142,4332
"14136","Zm00001d050314","4",80555403,80569023,13620
"14137","Zm00001d050315","4",80625267,80631776,6509
"14138","Zm00001d050316","4",80724087,80730316,6229
"14139","Zm00001d050317","4",80845142,80846473,1331
"14140","Zm00001d050318","4",81114062,81114744,682
"14141","Zm00001d050319","4",81114782,81118190,3408
"14142","Zm00001d050320","4",81159444,81162911,3467
"14143","Zm00001d050321","4",81381143,81382183,1040
"14144","Zm00001d050322","4",81384514,81385708,1194
"14145","Zm00001d050323","4",81389772,81391571,1799
"14146","Zm00001d050324","4",81458133,81461911,3778
"14147","Zm00001d050326","4",81502013,81514974,12961
"14148","Zm00001d050327","4",81506365,81509106,2741
"14149","Zm00001d050328","4",81520996,81526559,5563
"14150","Zm00001d050329","4",81617937,81624334,6397
"14151","Zm00001d050330","4",81873702,81879578,5876
"14152","Zm00001d050333","4",81916818,81925688,8870
"14153","Zm00001d050334","4",81951656,81955294,3638
"14154","Zm00001d050335","4",81955812,81958175,2363
"14155","Zm00001d050336","4",82004913,82010291,5378
"14156","Zm00001d050339","4",82300133,82306079,5946
"14157","Zm00001d050340","4",82307002,82310302,3300
"14158","Zm00001d050341","4",82446616,82448213,1597
"14159","Zm00001d050343","4",82487605,82499371,11766
"14160","Zm00001d050344","4",82553255,82555347,2092
"14161","Zm00001d050346","4",82622937,82623890,953
"14162","Zm00001d050347","4",82700498,82704162,3664
"14163","Zm00001d050352","4",83021179,83023418,2239
"14164","Zm00001d050353","4",83021109,83030776,9667
"14165","Zm00001d050355","4",83104468,83106843,2375
"14166","Zm00001d050357","4",83387415,83392828,5413
"14167","Zm00001d050358","4",83464018,83466332,2314
"14168","Zm00001d050359","4",83491443,83500858,9415
"14169","Zm00001d050365","4",83772143,83775016,2873
"14170","Zm00001d050368","4",84247503,84248847,1344
"14171","Zm00001d050371","4",84598981,84600903,1922
"14172","Zm00001d050372","4",84608085,84616205,8120
"14173","Zm00001d050375","4",84712648,84716234,3586
"14174","Zm00001d050378","4",84775066,84782972,7906
"14175","Zm00001d050380","4",84839682,84845035,5353
"14176","Zm00001d050382","4",84993276,84998613,5337
"14177","Zm00001d050383","4",85015212,85019176,3964
"14178","Zm00001d050384","4",85019366,85020259,893
"14179","Zm00001d050386","4",85167106,85168653,1547
"14180","Zm00001d050388","4",85201775,85202762,987
"14181","Zm00001d050389","4",85370757,85371581,824
"14182","Zm00001d050393","4",85560423,85563767,3344
"14183","Zm00001d050394","4",85655816,85658613,2797
"14184","Zm00001d050395","4",85834807,85839887,5080
"14185","Zm00001d050396","4",85840349,85841523,1174
"14186","Zm00001d050400","4",85967006,85968538,1532
"14187","Zm00001d050401","4",86092885,86099265,6380
"14188","Zm00001d050403","4",86240240,86241629,1389
"14189","Zm00001d050404","4",86263641,86265848,2207
"14190","Zm00001d050406","4",86374931,86394607,19676
"14191","Zm00001d050409","4",86577059,86578252,1193
"14192","Zm00001d050411","4",86643865,86646080,2215
"14193","Zm00001d050412","4",86684719,86687129,2410
"14194","Zm00001d050422","4",87191790,87193196,1406
"14195","Zm00001d050424","4",87203970,87205189,1219
"14196","Zm00001d050428","4",87289139,87294301,5162
"14197","Zm00001d050430","4",87428111,87436083,7972
"14198","Zm00001d050433","4",87612524,87613366,842
"14199","Zm00001d050434","4",87633804,87639553,5749
"14200","Zm00001d050436","4",88042697,88043923,1226
"14201","Zm00001d050437","4",88049142,88061119,11977
"14202","Zm00001d050438","4",88136447,88141962,5515
"14203","Zm00001d050440","4",88238965,88243691,4726
"14204","Zm00001d050443","4",88621453,88622553,1100
"14205","Zm00001d050448","4",89034532,89036502,1970
"14206","Zm00001d050449","4",89038219,89039283,1064
"14207","Zm00001d050451","4",89081300,89082192,892
"14208","Zm00001d050455","4",89654139,89655850,1711
"14209","Zm00001d050456","4",89800374,89802252,1878
"14210","Zm00001d050457","4",89899331,89903754,4423
"14211","Zm00001d050463","4",90402428,90420961,18533
"14212","Zm00001d050465","4",90609494,90614658,5164
"14213","Zm00001d050470","4",91088125,91091939,3814
"14214","Zm00001d050475","4",91278970,91282052,3082
"14215","Zm00001d050477","4",91451166,91454331,3165
"14216","Zm00001d050479","4",91832546,91833685,1139
"14217","Zm00001d050480","4",91845028,91847184,2156
"14218","Zm00001d050483","4",91998934,92018898,19964
"14219","Zm00001d050484","4",92592461,92598606,6145
"14220","Zm00001d050488","4",92816855,92826876,10021
"14221","Zm00001d050489","4",92846870,92856560,9690
"14222","Zm00001d050490","4",92934891,92935615,724
"14223","Zm00001d050493","4",93017163,93018146,983
"14224","Zm00001d050495","4",93358403,93360172,1769
"14225","Zm00001d050496","4",93366803,93368149,1346
"14226","Zm00001d050498","4",93521446,93537998,16552
"14227","Zm00001d050501","4",94344459,94348629,4170
"14228","Zm00001d050507","4",94918988,94919425,437
"14229","Zm00001d050508","4",94920389,94922734,2345
"14230","Zm00001d050510","4",95033433,95035647,2214
"14231","Zm00001d050514","4",95579920,95581684,1764
"14232","Zm00001d050518","4",96149394,96155109,5715
"14233","Zm00001d050521","4",96348481,96352321,3840
"14234","Zm00001d050526","4",96801958,96828810,26852
"14235","Zm00001d050529","4",97391348,97394811,3463
"14236","Zm00001d050530","4",97418143,97420271,2128
"14237","Zm00001d050532","4",97643888,97647942,4054
"14238","Zm00001d050533","4",97663969,97666090,2121
"14239","Zm00001d050534","4",97668347,97671152,2805
"14240","Zm00001d050536","4",98036993,98037796,803
"14241","Zm00001d050541","4",98816261,98828001,11740
"14242","Zm00001d050544","4",99146922,99149682,2760
"14243","Zm00001d050548","4",99408021,99411915,3894
"14244","Zm00001d050550","4",99564893,99569244,4351
"14245","Zm00001d050551","4",99642502,99668891,26389
"14246","Zm00001d050553","4",99761885,99762466,581
"14247","Zm00001d050557","4",100410423,100410989,566
"14248","Zm00001d050558","4",100654474,100655253,779
"14249","Zm00001d050559","4",100659813,100660443,630
"14250","Zm00001d050565","4",101167830,101169764,1934
"14251","Zm00001d050567","4",101325893,101328003,2110
"14252","Zm00001d050572","4",101438256,101439631,1375
"14253","Zm00001d050575","4",101589397,101597227,7830
"14254","Zm00001d050577","4",101826608,101828504,1896
"14255","Zm00001d050580","4",102242515,102251909,9394
"14256","Zm00001d050583","4",102471564,102475941,4377
"14257","Zm00001d050584","4",102551161,102570725,19564
"14258","Zm00001d050594","4",103195208,103196125,917
"14259","Zm00001d050595","4",103198005,103199960,1955
"14260","Zm00001d050604","4",103421701,103431079,9378
"14261","Zm00001d050606","4",103706600,103714666,8066
"14262","Zm00001d050607","4",103730673,103735243,4570
"14263","Zm00001d050608","4",103849781,103854158,4377
"14264","Zm00001d050610","4",104008719,104014187,5468
"14265","Zm00001d050611","4",104292732,104293847,1115
"14266","Zm00001d050612","4",104301142,104382663,81521
"14267","Zm00001d050614","4",104549299,104563850,14551
"14268","Zm00001d050615","4",104782609,104788194,5585
"14269","Zm00001d050616","4",104893593,104901497,7904
"14270","Zm00001d050620","4",105049982,105123422,73440
"14271","Zm00001d050623","4",105380510,105380713,203
"14272","Zm00001d050633","4",106715915,106719762,3847
"14273","Zm00001d050637","4",107948303,107950926,2623
"14274","Zm00001d050642","4",109006158,109009903,3745
"14275","Zm00001d050643","4",109043904,109048540,4636
"14276","Zm00001d050645","4",109286090,109296510,10420
"14277","Zm00001d050656","4",112444502,112445649,1147
"14278","Zm00001d050658","4",112869136,112870028,892
"14279","Zm00001d050659","4",112876484,112876557,73
"14280","Zm00001d050660","4",112893892,112897195,3303
"14281","Zm00001d050664","4",112999831,113003992,4161
"14282","Zm00001d050666","4",113569136,113572987,3851
"14283","Zm00001d050669","4",114048204,114058719,10515
"14284","Zm00001d050670","4",114197687,114203124,5437
"14285","Zm00001d050673","4",114812806,114817974,5168
"14286","Zm00001d050675","4",115077479,115078665,1186
"14287","Zm00001d050676","4",115125576,115126378,802
"14288","Zm00001d050678","4",115229324,115229542,218
"14289","Zm00001d050682","4",115264536,115264979,443
"14290","Zm00001d050684","4",115319276,115320818,1542
"14291","Zm00001d050687","4",115368623,115369994,1371
"14292","Zm00001d050689","4",115493076,115494365,1289
"14293","Zm00001d050690","4",115495849,115496802,953
"14294","Zm00001d050694","4",116195309,116209741,14432
"14295","Zm00001d050696","4",116411125,116414932,3807
"14296","Zm00001d050697","4",116465391,116465801,410
"14297","Zm00001d050698","4",116657649,116658845,1196
"14298","Zm00001d050704","4",116743277,116747606,4329
"14299","Zm00001d050705","4",116879810,116881150,1340
"14300","Zm00001d050708","4",117425493,117430233,4740
"14301","Zm00001d050714","4",117910694,117919249,8555
"14302","Zm00001d050715","4",117954981,117960595,5614
"14303","Zm00001d050716","4",118325912,118331112,5200
"14304","Zm00001d050718","4",118685784,118686770,986
"14305","Zm00001d050723","4",118811903,118822922,11019
"14306","Zm00001d050726","4",118938226,118944157,5931
"14307","Zm00001d050728","4",118948741,118953034,4293
"14308","Zm00001d050730","4",119102206,119105094,2888
"14309","Zm00001d050735","4",119801304,119810726,9422
"14310","Zm00001d050737","4",120110147,120128389,18242
"14311","Zm00001d050741","4",120378585,120385640,7055
"14312","Zm00001d050747","4",120547880,120553889,6009
"14313","Zm00001d050748","4",120553807,120555054,1247
"14314","Zm00001d050753","4",120953532,120958594,5062
"14315","Zm00001d050754","4",121060923,121062516,1593
"14316","Zm00001d050755","4",121089534,121100926,11392
"14317","Zm00001d050757","4",121107888,121108294,406
"14318","Zm00001d050764","4",121650617,121651904,1287
"14319","Zm00001d050768","4",121766673,121769040,2367
"14320","Zm00001d050774","4",122051630,122053414,1784
"14321","Zm00001d050775","4",122097911,122117487,19576
"14322","Zm00001d050781","4",122461155,122466889,5734
"14323","Zm00001d050783","4",122501200,122502744,1544
"14324","Zm00001d050785","4",122622543,122625780,3237
"14325","Zm00001d050790","4",123187727,123191108,3381
"14326","Zm00001d050793","4",123426631,123433901,7270
"14327","Zm00001d050794","4",123434274,123435480,1206
"14328","Zm00001d050797","4",123582684,123584329,1645
"14329","Zm00001d050798","4",123592234,123595083,2849
"14330","Zm00001d050800","4",123700150,123705290,5140
"14331","Zm00001d050810","4",124187282,124193089,5807
"14332","Zm00001d050815","4",124389946,124391067,1121
"14333","Zm00001d050816","4",124419619,124423060,3441
"14334","Zm00001d050822","4",124710801,124717438,6637
"14335","Zm00001d050823","4",124721384,124725338,3954
"14336","Zm00001d050824","4",124820187,124820977,790
"14337","Zm00001d050826","4",124866183,124869067,2884
"14338","Zm00001d050827","4",125016396,125019060,2664
"14339","Zm00001d050828","4",125020175,125022264,2089
"14340","Zm00001d050830","4",125143613,125143942,329
"14341","Zm00001d050833","4",125336562,125339109,2547
"14342","Zm00001d050834","4",125421188,125423374,2186
"14343","Zm00001d050837","4",125665547,125666545,998
"14344","Zm00001d050838","4",125848028,125857181,9153
"14345","Zm00001d050840","4",126162793,126163788,995
"14346","Zm00001d050841","4",126164604,126165239,635
"14347","Zm00001d050844","4",126332970,126339128,6158
"14348","Zm00001d050848","4",126651604,126652854,1250
"14349","Zm00001d050850","4",126958963,126962865,3902
"14350","Zm00001d050851","4",126959985,126984791,24806
"14351","Zm00001d050852","4",126980289,126983404,3115
"14352","Zm00001d050857","4",127181356,127182295,939
"14353","Zm00001d050862","4",127378539,127379909,1370
"14354","Zm00001d050864","4",127438148,127438405,257
"14355","Zm00001d050865","4",127524931,127527698,2767
"14356","Zm00001d050868","4",127596451,127602837,6386
"14357","Zm00001d050870","4",127748628,127751133,2505
"14358","Zm00001d050872","4",127892921,127894804,1883
"14359","Zm00001d050873","4",127915099,127918352,3253
"14360","Zm00001d050874","4",128050675,128059411,8736
"14361","Zm00001d050875","4",128051709,128054759,3050
"14362","Zm00001d050876","4",128063990,128064647,657
"14363","Zm00001d050883","4",128302295,128305583,3288
"14364","Zm00001d050884","4",128320234,128324274,4040
"14365","Zm00001d050885","4",128462507,128465617,3110
"14366","Zm00001d050886","4",128466573,128467412,839
"14367","Zm00001d050892","4",128771730,128772780,1050
"14368","Zm00001d050893","4",128778456,128780327,1871
"14369","Zm00001d050897","4",128983979,129000129,16150
"14370","Zm00001d050903","4",129344494,129346979,2485
"14371","Zm00001d050904","4",129475394,129476203,809
"14372","Zm00001d050905","4",129476399,129478809,2410
"14373","Zm00001d050907","4",129650946,129657013,6067
"14374","Zm00001d050908","4",129888749,129888976,227
"14375","Zm00001d050909","4",129967527,129968030,503
"14376","Zm00001d050910","4",130225510,130230340,4830
"14377","Zm00001d050911","4",130234985,130237238,2253
"14378","Zm00001d050913","4",130433445,130436939,3494
"14379","Zm00001d050914","4",130551672,130554134,2462
"14380","Zm00001d050915","4",130729909,130734070,4161
"14381","Zm00001d050916","4",130734772,130738021,3249
"14382","Zm00001d050917","4",130884294,130889709,5415
"14383","Zm00001d050918","4",130988293,130988613,320
"14384","Zm00001d050920","4",131271148,131273486,2338
"14385","Zm00001d050921","4",131330257,131332547,2290
"14386","Zm00001d050922","4",131523906,131546487,22581
"14387","Zm00001d050923","4",131648774,131659340,10566
"14388","Zm00001d050924","4",131894510,131897473,2963
"14389","Zm00001d050925","4",131908776,131919507,10731
"14390","Zm00001d050926","4",131921289,131921999,710
"14391","Zm00001d050928","4",132055627,132064369,8742
"14392","Zm00001d050929","4",132081433,132106195,24762
"14393","Zm00001d050935","4",132604348,132607277,2929
"14394","Zm00001d050936","4",132624366,132627942,3576
"14395","Zm00001d050937","4",132629396,132632436,3040
"14396","Zm00001d050938","4",132686030,132688678,2648
"14397","Zm00001d050942","4",132808315,132811106,2791
"14398","Zm00001d050943","4",132886764,132891622,4858
"14399","Zm00001d050944","4",132913179,132914110,931
"14400","Zm00001d050947","4",133090522,133096403,5881
"14401","Zm00001d050950","4",133212697,133224018,11321
"14402","Zm00001d050954","4",133267824,133270945,3121
"14403","Zm00001d050955","4",133307812,133317401,9589
"14404","Zm00001d050960","4",133589483,133593214,3731
"14405","Zm00001d050961","4",133641371,133644757,3386
"14406","Zm00001d050963","4",133975455,133979495,4040
"14407","Zm00001d050964","4",134035097,134035699,602
"14408","Zm00001d050965","4",134060297,134069849,9552
"14409","Zm00001d050967","4",134076041,134077261,1220
"14410","Zm00001d050969","4",134223301,134224950,1649
"14411","Zm00001d050970","4",134314763,134318362,3599
"14412","Zm00001d050972","4",134412097,134423581,11484
"14413","Zm00001d050973","4",134671743,134673166,1423
"14414","Zm00001d050974","4",134742632,134745145,2513
"14415","Zm00001d050977","4",134811334,134813467,2133
"14416","Zm00001d050978","4",134816363,134819668,3305
"14417","Zm00001d050981","4",134987117,134991511,4394
"14418","Zm00001d050984","4",135263242,135264494,1252
"14419","Zm00001d050985","4",135266797,135270002,3205
"14420","Zm00001d050988","4",135624966,135626604,1638
"14421","Zm00001d050989","4",135644800,135655106,10306
"14422","Zm00001d050992","4",135837972,135841317,3345
"14423","Zm00001d050993","4",135911611,135915582,3971
"14424","Zm00001d050994","4",135919677,135920485,808
"14425","Zm00001d050995","4",135919974,135922107,2133
"14426","Zm00001d051001","4",136187079,136190530,3451
"14427","Zm00001d051005","4",136343710,136345439,1729
"14428","Zm00001d051008","4",136478809,136491478,12669
"14429","Zm00001d051009","4",136545955,136551221,5266
"14430","Zm00001d051012","4",136765871,136767712,1841
"14431","Zm00001d051014","4",136927072,136932493,5421
"14432","Zm00001d051015","4",137040314,137042915,2601
"14433","Zm00001d051016","4",137043230,137046561,3331
"14434","Zm00001d051017","4",137134973,137140355,5382
"14435","Zm00001d051018","4",137141449,137142700,1251
"14436","Zm00001d051020","4",137281299,137300733,19434
"14437","Zm00001d051021","4",137406673,137419478,12805
"14438","Zm00001d051022","4",137413743,137414787,1044
"14439","Zm00001d051026","4",137444505,137445057,552
"14440","Zm00001d051033","4",137842313,137846513,4200
"14441","Zm00001d051036","4",137981717,137982761,1044
"14442","Zm00001d051039","4",138146222,138152526,6304
"14443","Zm00001d051041","4",138224292,138227545,3253
"14444","Zm00001d051043","4",138316944,138322251,5307
"14445","Zm00001d051044","4",138472340,138473695,1355
"14446","Zm00001d051047","4",138655083,138656121,1038
"14447","Zm00001d051048","4",138664616,138682976,18360
"14448","Zm00001d051052","4",138842282,138850449,8167
"14449","Zm00001d051053","4",139077000,139080912,3912
"14450","Zm00001d051054","4",139211337,139211540,203
"14451","Zm00001d051055","4",139227889,139235098,7209
"14452","Zm00001d051056","4",139235984,139238663,2679
"14453","Zm00001d051057","4",139249914,139270422,20508
"14454","Zm00001d051061","4",139808491,139811963,3472
"14455","Zm00001d051062","4",140038366,140041673,3307
"14456","Zm00001d051063","4",140062183,140065382,3199
"14457","Zm00001d051064","4",140067332,140068075,743
"14458","Zm00001d051065","4",140072303,140076402,4099
"14459","Zm00001d051067","4",140445939,140453069,7130
"14460","Zm00001d051068","4",140487323,140489935,2612
"14461","Zm00001d051069","4",140513011,140519548,6537
"14462","Zm00001d051072","4",140598513,140599754,1241
"14463","Zm00001d051075","4",140677217,140705861,28644
"14464","Zm00001d051080","4",141102390,141105818,3428
"14465","Zm00001d051081","4",141308554,141313944,5390
"14466","Zm00001d051082","4",141314024,141316009,1985
"14467","Zm00001d051086","4",141571153,141571479,326
"14468","Zm00001d051092","4",141766812,141768428,1616
"14469","Zm00001d051094","4",141819150,141821792,2642
"14470","Zm00001d051099","4",142300764,142304520,3756
"14471","Zm00001d051102","4",142625579,142626955,1376
"14472","Zm00001d051103","4",142662758,142671086,8328
"14473","Zm00001d051104","4",142715733,142719083,3350
"14474","Zm00001d051108","4",143105165,143105238,73
"14475","Zm00001d051110","4",143182686,143184776,2090
"14476","Zm00001d051111","4",143184893,143209446,24553
"14477","Zm00001d051112","4",143546529,143548079,1550
"14478","Zm00001d051114","4",143867613,143870730,3117
"14479","Zm00001d051116","4",143960387,143962013,1626
"14480","Zm00001d051119","4",144245000,144249858,4858
"14481","Zm00001d051120","4",144431067,144431288,221
"14482","Zm00001d051121","4",144439743,144440680,937
"14483","Zm00001d051122","4",144442494,144458431,15937
"14484","Zm00001d051125","4",144574444,144581365,6921
"14485","Zm00001d051126","4",144683071,144691088,8017
"14486","Zm00001d051128","4",144753085,144753555,470
"14487","Zm00001d051129","4",144987566,144994135,6569
"14488","Zm00001d051130","4",145118778,145122364,3586
"14489","Zm00001d051132","4",145253410,145257735,4325
"14490","Zm00001d051135","4",145465734,145473140,7406
"14491","Zm00001d051136","4",145475618,145476526,908
"14492","Zm00001d051138","4",145541889,145545820,3931
"14493","Zm00001d051139","4",145546078,145549609,3531
"14494","Zm00001d051140","4",145569635,145572065,2430
"14495","Zm00001d051141","4",145585268,145586352,1084
"14496","Zm00001d051145","4",145776469,145777894,1425
"14497","Zm00001d051147","4",145809478,145810525,1047
"14498","Zm00001d051151","4",146158202,146167180,8978
"14499","Zm00001d051156","4",146401256,146402641,1385
"14500","Zm00001d051157","4",146405890,146410901,5011
"14501","Zm00001d051161","4",146706971,146710589,3618
"14502","Zm00001d051163","4",146793740,146798809,5069
"14503","Zm00001d051166","4",146846109,146848259,2150
"14504","Zm00001d051167","4",146942600,146944389,1789
"14505","Zm00001d051172","4",147112461,147115250,2789
"14506","Zm00001d051175","4",147195105,147202339,7234
"14507","Zm00001d051178","4",147335724,147347180,11456
"14508","Zm00001d051179","4",147432269,147442727,10458
"14509","Zm00001d051180","4",147443012,147450623,7611
"14510","Zm00001d051183","4",147599308,147617964,18656
"14511","Zm00001d051186","4",147697543,147700824,3281
"14512","Zm00001d051187","4",147806078,147820382,14304
"14513","Zm00001d051188","4",147841756,147843477,1721
"14514","Zm00001d051193","4",148030454,148036401,5947
"14515","Zm00001d051203","4",148592297,148593612,1315
"14516","Zm00001d051206","4",148675866,148680836,4970
"14517","Zm00001d051207","4",148681587,148681998,411
"14518","Zm00001d051211","4",148716630,148733408,16778
"14519","Zm00001d051214","4",148918694,148925044,6350
"14520","Zm00001d051216","4",148970275,148970931,656
"14521","Zm00001d051219","4",148978271,148980970,2699
"14522","Zm00001d051223","4",149062470,149063624,1154
"14523","Zm00001d051225","4",149090331,149091691,1360
"14524","Zm00001d051227","4",149227927,149231063,3136
"14525","Zm00001d051229","4",149278220,149283886,5666
"14526","Zm00001d051231","4",149355775,149356525,750
"14527","Zm00001d051232","4",149360114,149365666,5552
"14528","Zm00001d051233","4",149418083,149420564,2481
"14529","Zm00001d051234","4",149421262,149424901,3639
"14530","Zm00001d051235","4",149499913,149502215,2302
"14531","Zm00001d051239","4",149655139,149656476,1337
"14532","Zm00001d051241","4",149904706,149910230,5524
"14533","Zm00001d051242","4",150058238,150077866,19628
"14534","Zm00001d051244","4",150196592,150200033,3441
"14535","Zm00001d051245","4",150310448,150317777,7329
"14536","Zm00001d051247","4",150383021,150385548,2527
"14537","Zm00001d051249","4",150498265,150503275,5010
"14538","Zm00001d051250","4",150569015,150572646,3631
"14539","Zm00001d051254","4",150839036,150842944,3908
"14540","Zm00001d051260","4",151010423,151011778,1355
"14541","Zm00001d051261","4",151013320,151016985,3665
"14542","Zm00001d051264","4",151089764,151090957,1193
"14543","Zm00001d051265","4",151150937,151154386,3449
"14544","Zm00001d051267","4",151178362,151181128,2766
"14545","Zm00001d051268","4",151295170,151303295,8125
"14546","Zm00001d051269","4",151309707,151312076,2369
"14547","Zm00001d051272","4",151408424,151411182,2758
"14548","Zm00001d051280","4",151470325,151470815,490
"14549","Zm00001d051281","4",151512768,151513433,665
"14550","Zm00001d051286","4",151640705,151648438,7733
"14551","Zm00001d051287","4",151763880,151768589,4709
"14552","Zm00001d051288","4",151822045,151825605,3560
"14553","Zm00001d051289","4",151884025,151886501,2476
"14554","Zm00001d051290","4",151992317,151993665,1348
"14555","Zm00001d051291","4",151994339,152000527,6188
"14556","Zm00001d051302","4",152451610,152452209,599
"14557","Zm00001d051304","4",152535910,152549086,13176
"14558","Zm00001d051305","4",152550362,152554262,3900
"14559","Zm00001d051306","4",152560547,152566694,6147
"14560","Zm00001d051307","4",152668573,152674431,5858
"14561","Zm00001d051308","4",152675908,152682127,6219
"14562","Zm00001d051309","4",152948011,152949738,1727
"14563","Zm00001d051313","4",153190850,153192172,1322
"14564","Zm00001d051314","4",153285700,153287292,1592
"14565","Zm00001d051315","4",153336798,153337816,1018
"14566","Zm00001d051316","4",153362817,153366616,3799
"14567","Zm00001d051318","4",153778712,153782477,3765
"14568","Zm00001d051320","4",153916343,153921722,5379
"14569","Zm00001d051321","4",154082129,154088581,6452
"14570","Zm00001d051323","4",154123980,154127155,3175
"14571","Zm00001d051324","4",154315290,154320142,4852
"14572","Zm00001d051325","4",154378507,154379055,548
"14573","Zm00001d051328","4",154581235,154589610,8375
"14574","Zm00001d051329","4",154796970,154799734,2764
"14575","Zm00001d051333","4",154919132,154920079,947
"14576","Zm00001d051334","4",154980581,154984053,3472
"14577","Zm00001d051336","4",155037243,155041178,3935
"14578","Zm00001d051337","4",155162552,155169092,6540
"14579","Zm00001d051338","4",155169035,155171080,2045
"14580","Zm00001d051339","4",155195395,155198782,3387
"14581","Zm00001d051341","4",155250191,155251690,1499
"14582","Zm00001d051342","4",155253907,155256153,2246
"14583","Zm00001d051343","4",155258558,155260752,2194
"14584","Zm00001d051344","4",155262275,155263156,881
"14585","Zm00001d051345","4",155274022,155300046,26024
"14586","Zm00001d051346","4",155293569,155293645,76
"14587","Zm00001d051347","4",155301447,155306131,4684
"14588","Zm00001d051349","4",155450584,155453865,3281
"14589","Zm00001d051355","4",155723238,155723924,686
"14590","Zm00001d051359","4",155950792,155951832,1040
"14591","Zm00001d051360","4",155952319,155960221,7902
"14592","Zm00001d051361","4",155965412,155966998,1586
"14593","Zm00001d051362","4",155984860,155986408,1548
"14594","Zm00001d051366","4",156035646,156037543,1897
"14595","Zm00001d051367","4",156084055,156087139,3084
"14596","Zm00001d051368","4",156126172,156127387,1215
"14597","Zm00001d051371","4",156285393,156286412,1019
"14598","Zm00001d051373","4",156362348,156364213,1865
"14599","Zm00001d051374","4",156364789,156365286,497
"14600","Zm00001d051375","4",156366550,156371415,4865
"14601","Zm00001d051376","4",156414146,156415564,1418
"14602","Zm00001d051380","4",156492223,156492837,614
"14603","Zm00001d051382","4",156503524,156514144,10620
"14604","Zm00001d051383","4",156517895,156521289,3394
"14605","Zm00001d051384","4",156546030,156546425,395
"14606","Zm00001d051387","4",156767880,156770006,2126
"14607","Zm00001d051389","4",156895149,156897641,2492
"14608","Zm00001d051392","4",156972673,156976747,4074
"14609","Zm00001d051393","4",156981767,156986407,4640
"14610","Zm00001d051394","4",157047271,157051256,3985
"14611","Zm00001d051396","4",157082319,157089154,6835
"14612","Zm00001d051397","4",157102240,157105793,3553
"14613","Zm00001d051399","4",157106497,157120550,14053
"14614","Zm00001d051403","4",157200400,157203987,3587
"14615","Zm00001d051404","4",157204494,157214368,9874
"14616","Zm00001d051405","4",157330998,157334207,3209
"14617","Zm00001d051406","4",157351875,157355526,3651
"14618","Zm00001d051410","4",157417342,157417767,425
"14619","Zm00001d051411","4",157424577,157424966,389
"14620","Zm00001d051412","4",157553721,157554966,1245
"14621","Zm00001d051413","4",157575562,157576829,1267
"14622","Zm00001d051414","4",157588271,157589268,997
"14623","Zm00001d051415","4",157604148,157608446,4298
"14624","Zm00001d051416","4",157609029,157610057,1028
"14625","Zm00001d051418","4",157820475,157822417,1942
"14626","Zm00001d051419","4",157822997,157827073,4076
"14627","Zm00001d051420","4",157872166,157873662,1496
"14628","Zm00001d051421","4",158016051,158023794,7743
"14629","Zm00001d051422","4",158027318,158027632,314
"14630","Zm00001d051427","4",158189751,158191758,2007
"14631","Zm00001d051429","4",158250987,158252072,1085
"14632","Zm00001d051430","4",158331291,158334196,2905
"14633","Zm00001d051431","4",158375271,158380457,5186
"14634","Zm00001d051434","4",158470458,158471156,698
"14635","Zm00001d051435","4",158471088,158473134,2046
"14636","Zm00001d051438","4",158511587,158522751,11164
"14637","Zm00001d051439","4",158534101,158536459,2358
"14638","Zm00001d051440","4",158717084,158717401,317
"14639","Zm00001d051441","4",158731165,158736098,4933
"14640","Zm00001d051442","4",158807351,158810855,3504
"14641","Zm00001d051446","4",158847444,158849781,2337
"14642","Zm00001d051447","4",158953884,158958522,4638
"14643","Zm00001d051448","4",159031088,159035197,4109
"14644","Zm00001d051452","4",159114506,159117096,2590
"14645","Zm00001d051453","4",159243303,159244550,1247
"14646","Zm00001d051454","4",159245449,159248592,3143
"14647","Zm00001d051455","4",159251080,159254747,3667
"14648","Zm00001d051456","4",159322444,159323547,1103
"14649","Zm00001d051457","4",159341143,159347527,6384
"14650","Zm00001d051458","4",159348371,159355666,7295
"14651","Zm00001d051459","4",159425350,159426505,1155
"14652","Zm00001d051461","4",159541879,159543702,1823
"14653","Zm00001d051465","4",159603384,159610425,7041
"14654","Zm00001d051466","4",159708453,159710073,1620
"14655","Zm00001d051468","4",159713956,159714438,482
"14656","Zm00001d051473","4",159922789,159923796,1007
"14657","Zm00001d051474","4",159937998,159943579,5581
"14658","Zm00001d051475","4",159943730,159944701,971
"14659","Zm00001d051478","4",160007880,160008267,387
"14660","Zm00001d051479","4",160033824,160039530,5706
"14661","Zm00001d051480","4",160038260,160042852,4592
"14662","Zm00001d051484","4",160245754,160247270,1516
"14663","Zm00001d051485","4",160248452,160249003,551
"14664","Zm00001d051488","4",160292329,160292772,443
"14665","Zm00001d051490","4",160320340,160323058,2718
"14666","Zm00001d051491","4",160324170,160324939,769
"14667","Zm00001d051496","4",160437529,160438553,1024
"14668","Zm00001d051498","4",160459315,160463822,4507
"14669","Zm00001d051499","4",160463943,160465412,1469
"14670","Zm00001d051500","4",160468989,160472372,3383
"14671","Zm00001d051502","4",160498471,160504465,5994
"14672","Zm00001d051504","4",160587772,160594710,6938
"14673","Zm00001d051506","4",160648877,160649566,689
"14674","Zm00001d051507","4",160674777,160711821,37044
"14675","Zm00001d051508","4",160712148,160724932,12784
"14676","Zm00001d051509","4",160961176,160963697,2521
"14677","Zm00001d051511","4",160984327,160986154,1827
"14678","Zm00001d051513","4",161032328,161036601,4273
"14679","Zm00001d051514","4",161089336,161097086,7750
"14680","Zm00001d051515","4",161107400,161107660,260
"14681","Zm00001d051516","4",161110193,161112086,1893
"14682","Zm00001d051518","4",161180363,161183976,3613
"14683","Zm00001d051520","4",161213576,161215329,1753
"14684","Zm00001d051521","4",161219551,161225597,6046
"14685","Zm00001d051524","4",161338299,161340781,2482
"14686","Zm00001d051525","4",161345010,161349694,4684
"14687","Zm00001d051526","4",161421254,161441845,20591
"14688","Zm00001d051527","4",161520154,161525256,5102
"14689","Zm00001d051528","4",161585947,161594533,8586
"14690","Zm00001d051529","4",161594500,161598938,4438
"14691","Zm00001d051534","4",161756938,161758313,1375
"14692","Zm00001d051535","4",161759716,161766998,7282
"14693","Zm00001d051538","4",161854203,161855748,1545
"14694","Zm00001d051541","4",161909367,161914340,4973
"14695","Zm00001d051542","4",161946553,161954535,7982
"14696","Zm00001d051543","4",162016341,162016841,500
"14697","Zm00001d051544","4",162017524,162021747,4223
"14698","Zm00001d051545","4",162051563,162062835,11272
"14699","Zm00001d051546","4",162063429,162066609,3180
"14700","Zm00001d051549","4",162292322,162297188,4866
"14701","Zm00001d051550","4",162305826,162310127,4301
"14702","Zm00001d051552","4",162529433,162531336,1903
"14703","Zm00001d051553","4",162532245,162537805,5560
"14704","Zm00001d051554","4",162654597,162657413,2816
"14705","Zm00001d052216","4",183515085,183516581,1496
"14706","Zm00001d052218","4",183560903,183567280,6377
"14707","Zm00001d052219","4",183567891,183571569,3678
"14708","Zm00001d052220","4",183587060,183587659,599
"14709","Zm00001d052221","4",183593619,183599554,5935
"14710","Zm00001d052224","4",183710484,183711678,1194
"14711","Zm00001d052225","4",183713779,183717084,3305
"14712","Zm00001d052227","4",183819885,183822900,3015
"14713","Zm00001d052229","4",183995749,183996699,950
"14714","Zm00001d052230","4",184114356,184118862,4506
"14715","Zm00001d052231","4",184152128,184156210,4082
"14716","Zm00001d052232","4",184156145,184159248,3103
"14717","Zm00001d052233","4",184160265,184163189,2924
"14718","Zm00001d052234","4",184184459,184186027,1568
"14719","Zm00001d052237","4",184283129,184292636,9507
"14720","Zm00001d052239","4",184363869,184367772,3903
"14721","Zm00001d052240","4",184369041,184371794,2753
"14722","Zm00001d052242","4",184373518,184374270,752
"14723","Zm00001d052243","4",184464169,184467579,3410
"14724","Zm00001d052244","4",184571783,184572199,416
"14725","Zm00001d052245","4",184611231,184665800,54569
"14726","Zm00001d052247","4",184666747,184669386,2639
"14727","Zm00001d052248","4",184713954,184731540,17586
"14728","Zm00001d052249","4",184733719,184734402,683
"14729","Zm00001d052252","4",184794380,184795486,1106
"14730","Zm00001d052253","4",184810866,184812137,1271
"14731","Zm00001d052254","4",184820400,184821661,1261
"14732","Zm00001d052256","4",184920711,184921880,1169
"14733","Zm00001d052258","4",185025000,185026943,1943
"14734","Zm00001d052259","4",185028906,185032530,3624
"14735","Zm00001d052260","4",185139277,185141193,1916
"14736","Zm00001d052261","4",185174497,185177596,3099
"14737","Zm00001d052262","4",185219020,185227410,8390
"14738","Zm00001d052263","4",185228834,185234452,5618
"14739","Zm00001d052264","4",185237792,185239505,1713
"14740","Zm00001d052266","4",185249435,185254161,4726
"14741","Zm00001d052268","4",185307585,185310033,2448
"14742","Zm00001d052269","4",185371637,185375098,3461
"14743","Zm00001d052270","4",185403361,185407544,4183
"14744","Zm00001d052271","4",185511457,185520217,8760
"14745","Zm00001d052272","4",185522144,185523983,1839
"14746","Zm00001d052273","4",185525524,185529258,3734
"14747","Zm00001d052276","4",185636179,185645200,9021
"14748","Zm00001d052277","4",185652134,185653830,1696
"14749","Zm00001d052278","4",185660671,185667821,7150
"14750","Zm00001d052282","4",185921084,185959323,38239
"14751","Zm00001d052285","4",185966317,185967390,1073
"14752","Zm00001d052286","4",185988305,185993910,5605
"14753","Zm00001d052288","4",186086302,186089507,3205
"14754","Zm00001d052289","4",186090480,186095214,4734
"14755","Zm00001d052292","4",186143719,186145605,1886
"14756","Zm00001d052294","4",186233311,186244991,11680
"14757","Zm00001d052295","4",186310057,186316348,6291
"14758","Zm00001d052297","4",186404242,186405579,1337
"14759","Zm00001d052298","4",186405579,186415852,10273
"14760","Zm00001d052299","4",186407437,186408159,722
"14761","Zm00001d052302","4",186496379,186497071,692
"14762","Zm00001d052303","4",186500641,186503477,2836
"14763","Zm00001d052306","4",186584218,186599725,15507
"14764","Zm00001d052307","4",186590729,186605159,14430
"14765","Zm00001d052308","4",186709918,186725196,15278
"14766","Zm00001d052310","4",186760770,186762839,2069
"14767","Zm00001d052311","4",186764931,186766853,1922
"14768","Zm00001d052312","4",186768430,186772162,3732
"14769","Zm00001d052314","4",186822052,186828926,6874
"14770","Zm00001d052315","4",186971650,186972263,613
"14771","Zm00001d052316","4",186976119,186978547,2428
"14772","Zm00001d052317","4",186984558,187006976,22418
"14773","Zm00001d052318","4",187010485,187013768,3283
"14774","Zm00001d052320","4",187038296,187044482,6186
"14775","Zm00001d052321","4",187091291,187093728,2437
"14776","Zm00001d052322","4",187094618,187095187,569
"14777","Zm00001d052323","4",187098714,187102249,3535
"14778","Zm00001d052324","4",187125056,187127854,2798
"14779","Zm00001d052325","4",187128002,187130399,2397
"14780","Zm00001d052326","4",187130986,187132071,1085
"14781","Zm00001d052327","4",187152491,187165484,12993
"14782","Zm00001d052329","4",187324298,187327433,3135
"14783","Zm00001d052331","4",187327877,187329255,1378
"14784","Zm00001d052333","4",187330814,187332060,1246
"14785","Zm00001d052334","4",187337794,187340606,2812
"14786","Zm00001d052335","4",187347862,187349757,1895
"14787","Zm00001d052336","4",187360339,187362982,2643
"14788","Zm00001d052338","4",187390157,187391133,976
"14789","Zm00001d052339","4",187394441,187398371,3930
"14790","Zm00001d052340","4",187401028,187402359,1331
"14791","Zm00001d052343","4",187573638,187579315,5677
"14792","Zm00001d052344","4",187581510,187595662,14152
"14793","Zm00001d052346","4",187721211,187732975,11764
"14794","Zm00001d052347","4",187777853,187794625,16772
"14795","Zm00001d052348","4",187795917,187820518,24601
"14796","Zm00001d052349","4",187824423,187826520,2097
"14797","Zm00001d052351","4",187871447,187872521,1074
"14798","Zm00001d052353","4",187985546,187991884,6338
"14799","Zm00001d052354","4",187991865,187996222,4357
"14800","Zm00001d052357","4",188104225,188107989,3764
"14801","Zm00001d052358","4",188123494,188124602,1108
"14802","Zm00001d052361","4",188290914,188296399,5485
"14803","Zm00001d052362","4",188298857,188304297,5440
"14804","Zm00001d052364","4",188300298,188308076,7778
"14805","Zm00001d052365","4",188309258,188309908,650
"14806","Zm00001d052366","4",188310661,188312700,2039
"14807","Zm00001d052367","4",188338102,188344212,6110
"14808","Zm00001d052368","4",188382524,188385950,3426
"14809","Zm00001d052370","4",188389283,188390883,1600
"14810","Zm00001d052371","4",188392275,188393223,948
"14811","Zm00001d052372","4",188398086,188400838,2752
"14812","Zm00001d052373","4",188401588,188403066,1478
"14813","Zm00001d052375","4",188485472,188486399,927
"14814","Zm00001d052376","4",188525182,188530268,5086
"14815","Zm00001d052377","4",188547876,188549444,1568
"14816","Zm00001d052378","4",188624228,188629005,4777
"14817","Zm00001d052379","4",188629163,188633869,4706
"14818","Zm00001d052380","4",188747594,188751193,3599
"14819","Zm00001d052385","4",188826682,188830788,4106
"14820","Zm00001d052389","4",188964865,188968597,3732
"14821","Zm00001d052391","4",188982584,188986172,3588
"14822","Zm00001d052392","4",188988474,188990386,1912
"14823","Zm00001d052393","4",189029262,189037143,7881
"14824","Zm00001d052394","4",189052994,189054170,1176
"14825","Zm00001d052395","4",189092400,189092698,298
"14826","Zm00001d052396","4",189093521,189098209,4688
"14827","Zm00001d052397","4",189105110,189106135,1025
"14828","Zm00001d052399","4",189146967,189154702,7735
"14829","Zm00001d052401","4",189173442,189175233,1791
"14830","Zm00001d052402","4",189176100,189176435,335
"14831","Zm00001d052403","4",189183505,189185481,1976
"14832","Zm00001d052404","4",189185653,189190003,4350
"14833","Zm00001d052405","4",189190071,189194808,4737
"14834","Zm00001d052407","4",189217458,189230120,12662
"14835","Zm00001d052408","4",189233170,189243975,10805
"14836","Zm00001d052409","4",189311314,189312757,1443
"14837","Zm00001d052410","4",189313573,189318438,4865
"14838","Zm00001d052411","4",189319773,189323656,3883
"14839","Zm00001d052415","4",189488248,189489580,1332
"14840","Zm00001d052416","4",189489014,189494599,5585
"14841","Zm00001d052418","4",189574258,189579089,4831
"14842","Zm00001d052419","4",189604408,189606965,2557
"14843","Zm00001d052420","4",189608905,189612305,3400
"14844","Zm00001d052423","4",189657778,189662193,4415
"14845","Zm00001d052424","4",189733493,189734148,655
"14846","Zm00001d052425","4",189734359,189742773,8414
"14847","Zm00001d052433","4",189869346,189870859,1513
"14848","Zm00001d052434","4",189873712,189877696,3984
"14849","Zm00001d052435","4",189981671,189987040,5369
"14850","Zm00001d052436","4",190062610,190072524,9914
"14851","Zm00001d052437","4",190065405,190067801,2396
"14852","Zm00001d052438","4",190068552,190071190,2638
"14853","Zm00001d052439","4",190073152,190083229,10077
"14854","Zm00001d052442","4",190119181,190122383,3202
"14855","Zm00001d052443","4",190127612,190131377,3765
"14856","Zm00001d052444","4",190133615,190136497,2882
"14857","Zm00001d052445","4",190136423,190185316,48893
"14858","Zm00001d052447","4",190152353,190153749,1396
"14859","Zm00001d052450","4",190301720,190308562,6842
"14860","Zm00001d052451","4",190311193,190312446,1253
"14861","Zm00001d052452","4",190313659,190322111,8452
"14862","Zm00001d052453","4",190322244,190347108,24864
"14863","Zm00001d052457","4",190405622,190411632,6010
"14864","Zm00001d052458","4",190412358,190415523,3165
"14865","Zm00001d052460","4",190483731,190486181,2450
"14866","Zm00001d052461","4",190489712,190491821,2109
"14867","Zm00001d052462","4",190492832,190496934,4102
"14868","Zm00001d052468","4",190667383,190670787,3404
"14869","Zm00001d052471","4",190740161,190743671,3510
"14870","Zm00001d052472","4",190781502,190787238,5736
"14871","Zm00001d052473","4",190787804,190793714,5910
"14872","Zm00001d052474","4",190817825,190818617,792
"14873","Zm00001d052475","4",190839085,190842202,3117
"14874","Zm00001d052478","4",190886721,190889462,2741
"14875","Zm00001d052479","4",190891760,190893259,1499
"14876","Zm00001d052480","4",190894833,190896279,1446
"14877","Zm00001d052482","4",190922252,190924942,2690
"14878","Zm00001d052483","4",190957624,190961961,4337
"14879","Zm00001d052485","4",191046511,191057109,10598
"14880","Zm00001d052488","4",191183827,191190388,6561
"14881","Zm00001d052489","4",191190689,191192997,2308
"14882","Zm00001d052492","4",191250808,191252184,1376
"14883","Zm00001d052493","4",191343386,191345393,2007
"14884","Zm00001d052494","4",191353211,191358538,5327
"14885","Zm00001d052495","4",191453257,191461522,8265
"14886","Zm00001d052496","4",191485574,191486847,1273
"14887","Zm00001d052498","4",191492314,191497801,5487
"14888","Zm00001d052500","4",191500962,191502109,1147
"14889","Zm00001d052504","4",191567590,191568323,733
"14890","Zm00001d052507","4",191592127,191594935,2808
"14891","Zm00001d052509","4",191654457,191657111,2654
"14892","Zm00001d052517","4",191940668,191942545,1877
"14893","Zm00001d052518","4",191958402,191959679,1277
"14894","Zm00001d052519","4",191968167,191972580,4413
"14895","Zm00001d052520","4",191984692,191985651,959
"14896","Zm00001d052523","4",192071709,192075928,4219
"14897","Zm00001d052525","4",192080883,192084967,4084
"14898","Zm00001d052532","4",192393400,192396824,3424
"14899","Zm00001d052533","4",192456676,192458255,1579
"14900","Zm00001d052534","4",192501575,192501838,263
"14901","Zm00001d052538","4",192571833,192575168,3335
"14902","Zm00001d052539","4",192576328,192576824,496
"14903","Zm00001d052540","4",192578172,192581289,3117
"14904","Zm00001d052541","4",192585144,192585767,623
"14905","Zm00001d052542","4",192655475,192657030,1555
"14906","Zm00001d052543","4",192657367,192664592,7225
"14907","Zm00001d052544","4",192688133,192689416,1283
"14908","Zm00001d052545","4",192840524,192840907,383
"14909","Zm00001d052552","4",192877412,192879576,2164
"14910","Zm00001d052553","4",192878895,192880111,1216
"14911","Zm00001d052554","4",192882248,192887170,4922
"14912","Zm00001d052556","4",192908263,192917762,9499
"14913","Zm00001d052558","4",193039267,193040628,1361
"14914","Zm00001d052559","4",193103474,193108776,5302
"14915","Zm00001d052561","4",193202058,193205855,3797
"14916","Zm00001d052562","4",193207888,193210831,2943
"14917","Zm00001d052565","4",193327563,193330318,2755
"14918","Zm00001d052566","4",193332151,193334983,2832
"14919","Zm00001d052578","4",193424088,193425099,1011
"14920","Zm00001d052579","4",193431416,193432308,892
"14921","Zm00001d052584","4",193545827,193587771,41944
"14922","Zm00001d052586","4",193763661,193768265,4604
"14923","Zm00001d052587","4",193771468,193772642,1174
"14924","Zm00001d052591","4",193980224,193982206,1982
"14925","Zm00001d052594","4",194213915,194214238,323
"14926","Zm00001d052601","4",194400316,194401184,868
"14927","Zm00001d052602","4",194404228,194405764,1536
"14928","Zm00001d052603","4",194406339,194407475,1136
"14929","Zm00001d052604","4",194475545,194476454,909
"14930","Zm00001d052605","4",194504909,194506069,1160
"14931","Zm00001d052612","4",194612477,194615657,3180
"14932","Zm00001d052613","4",194772400,194778428,6028
"14933","Zm00001d052614","4",194779071,194785446,6375
"14934","Zm00001d052615","4",194836767,194848932,12165
"14935","Zm00001d052616","4",194836862,194838079,1217
"14936","Zm00001d052618","4",195014439,195017173,2734
"14937","Zm00001d052619","4",195017888,195024192,6304
"14938","Zm00001d052620","4",195052534,195057314,4780
"14939","Zm00001d052621","4",195062098,195068004,5906
"14940","Zm00001d052622","4",195068477,195072679,4202
"14941","Zm00001d052624","4",195157434,195163992,6558
"14942","Zm00001d052627","4",195242053,195243429,1376
"14943","Zm00001d052628","4",195247667,195249106,1439
"14944","Zm00001d052630","4",195316205,195318961,2756
"14945","Zm00001d052632","4",195421971,195454136,32165
"14946","Zm00001d052633","4",195455543,195455971,428
"14947","Zm00001d052635","4",195461695,195465336,3641
"14948","Zm00001d052637","4",195493984,195495108,1124
"14949","Zm00001d052638","4",195494547,195499545,4998
"14950","Zm00001d052639","4",195500434,195501450,1016
"14951","Zm00001d052640","4",195562366,195563256,890
"14952","Zm00001d052648","4",195797119,195798103,984
"14953","Zm00001d052651","4",195816208,195818206,1998
"14954","Zm00001d052652","4",195879376,195881620,2244
"14955","Zm00001d052653","4",196008355,196012956,4601
"14956","Zm00001d052654","4",196019083,196022515,3432
"14957","Zm00001d052655","4",196024569,196028339,3770
"14958","Zm00001d052656","4",196029340,196038723,9383
"14959","Zm00001d052657","4",196129556,196129822,266
"14960","Zm00001d052660","4",196207748,196212963,5215
"14961","Zm00001d052662","4",196294664,196295872,1208
"14962","Zm00001d052666","4",196473381,196480603,7222
"14963","Zm00001d052667","4",196491344,196494760,3416
"14964","Zm00001d052668","4",196532890,196537939,5049
"14965","Zm00001d052670","4",196848835,196851691,2856
"14966","Zm00001d052673","4",196893203,196896534,3331
"14967","Zm00001d052675","4",196963480,196969861,6381
"14968","Zm00001d052678","4",197047799,197050973,3174
"14969","Zm00001d052680","4",197106177,197117342,11165
"14970","Zm00001d052681","4",197111474,197112625,1151
"14971","Zm00001d052682","4",197136258,197138506,2248
"14972","Zm00001d052685","4",197407585,197409841,2256
"14973","Zm00001d052686","4",197442870,197444096,1226
"14974","Zm00001d052687","4",197443750,197447439,3689
"14975","Zm00001d052689","4",197452015,197456304,4289
"14976","Zm00001d052690","4",197459890,197461683,1793
"14977","Zm00001d052691","4",197465975,197482120,16145
"14978","Zm00001d052692","4",197537383,197538393,1010
"14979","Zm00001d052693","4",197540486,197558257,17771
"14980","Zm00001d052695","4",197650460,197663462,13002
"14981","Zm00001d052696","4",197665264,197668765,3501
"14982","Zm00001d052697","4",197821516,197840855,19339
"14983","Zm00001d052698","4",197880938,197884313,3375
"14984","Zm00001d052700","4",198053637,198078957,25320
"14985","Zm00001d052701","4",198079781,198083069,3288
"14986","Zm00001d052702","4",198185534,198190149,4615
"14987","Zm00001d052703","4",198199216,198204394,5178
"14988","Zm00001d052709","4",198300956,198313710,12754
"14989","Zm00001d052713","4",198407129,198409355,2226
"14990","Zm00001d052715","4",198518947,198521666,2719
"14991","Zm00001d052717","4",198573893,198576750,2857
"14992","Zm00001d052718","4",198621668,198623660,1992
"14993","Zm00001d052719","4",198623918,198625685,1767
"14994","Zm00001d052720","4",198683020,198688653,5633
"14995","Zm00001d052721","4",198787191,198796324,9133
"14996","Zm00001d052723","4",198870467,198882404,11937
"14997","Zm00001d052725","4",199034864,199038928,4064
"14998","Zm00001d052726","4",199113827,199127980,14153
"14999","Zm00001d052727","4",199132015,199137288,5273
"15000","Zm00001d052731","4",199254071,199256122,2051
"15001","Zm00001d052733","4",199294141,199296531,2390
"15002","Zm00001d052734","4",199304832,199310418,5586
"15003","Zm00001d052735","4",199333912,199344027,10115
"15004","Zm00001d052736","4",199343999,199344667,668
"15005","Zm00001d052738","4",199404178,199405434,1256
"15006","Zm00001d052741","4",199478963,199481434,2471
"15007","Zm00001d052742","4",199485281,199490594,5313
"15008","Zm00001d052744","4",199500941,199503963,3022
"15009","Zm00001d052746","4",199610449,199611144,695
"15010","Zm00001d052747","4",199611240,199615525,4285
"15011","Zm00001d052748","4",199642595,199648641,6046
"15012","Zm00001d052749","4",199665081,199666577,1496
"15013","Zm00001d052750","4",199667552,199671247,3695
"15014","Zm00001d052751","4",199802512,199811051,8539
"15015","Zm00001d052752","4",199814168,199815358,1190
"15016","Zm00001d052753","4",199817594,199826803,9209
"15017","Zm00001d052756","4",199893960,199896656,2696
"15018","Zm00001d052757","4",199896932,199897600,668
"15019","Zm00001d052758","4",199897723,199902231,4508
"15020","Zm00001d052759","4",199958327,199958620,293
"15021","Zm00001d052760","4",199963308,199964048,740
"15022","Zm00001d052763","4",199989647,199997578,7931
"15023","Zm00001d052765","4",200038358,200042350,3992
"15024","Zm00001d052766","4",200042610,200046436,3826
"15025","Zm00001d052767","4",200049293,200052657,3364
"15026","Zm00001d052768","4",200053584,200054153,569
"15027","Zm00001d052769","4",200157142,200159041,1899
"15028","Zm00001d052773","4",200380344,200387770,7426
"15029","Zm00001d052775","4",200464359,200466005,1646
"15030","Zm00001d052776","4",200548688,200549329,641
"15031","Zm00001d052777","4",200552117,200558570,6453
"15032","Zm00001d052779","4",200645982,200652925,6943
"15033","Zm00001d052781","4",200737914,200744017,6103
"15034","Zm00001d052785","4",200790947,200793361,2414
"15035","Zm00001d052786","4",200820489,200821865,1376
"15036","Zm00001d052788","4",200896697,200897657,960
"15037","Zm00001d052791","4",201054861,201057784,2923
"15038","Zm00001d052792","4",201124962,201130788,5826
"15039","Zm00001d052794","4",201187450,201192914,5464
"15040","Zm00001d052795","4",201191080,201192210,1130
"15041","Zm00001d052796","4",201214849,201216177,1328
"15042","Zm00001d052797","4",201290250,201299726,9476
"15043","Zm00001d052798","4",201305242,201306120,878
"15044","Zm00001d052799","4",201308914,201309837,923
"15045","Zm00001d052800","4",201391815,201399000,7185
"15046","Zm00001d052801","4",201400731,201410178,9447
"15047","Zm00001d052803","4",201411028,201419311,8283
"15048","Zm00001d052804","4",201420640,201421910,1270
"15049","Zm00001d052806","4",201496773,201500095,3322
"15050","Zm00001d052809","4",201661975,201666670,4695
"15051","Zm00001d052810","4",201667424,201671532,4108
"15052","Zm00001d052811","4",201672789,201675151,2362
"15053","Zm00001d052813","4",201685568,201686995,1427
"15054","Zm00001d052815","4",201800701,201801516,815
"15055","Zm00001d052816","4",201805607,201807418,1811
"15056","Zm00001d052818","4",201941630,201942553,923
"15057","Zm00001d052820","4",202005991,202009436,3445
"15058","Zm00001d052822","4",202017225,202022004,4779
"15059","Zm00001d052823","4",202022423,202022860,437
"15060","Zm00001d052833","4",202137427,202148422,10995
"15061","Zm00001d052835","4",202206244,202210001,3757
"15062","Zm00001d052837","4",202248589,202251858,3269
"15063","Zm00001d052838","4",202307193,202307801,608
"15064","Zm00001d052840","4",202385873,202394624,8751
"15065","Zm00001d052842","4",202395006,202396286,1280
"15066","Zm00001d052843","4",202399060,202399842,782
"15067","Zm00001d052845","4",202430132,202439991,9859
"15068","Zm00001d052847","4",202445149,202447772,2623
"15069","Zm00001d052848","4",202462858,202466951,4093
"15070","Zm00001d052849","4",202483958,202485821,1863
"15071","Zm00001d052850","4",202488427,202491267,2840
"15072","Zm00001d052851","4",202584989,202599532,14543
"15073","Zm00001d052852","4",202627305,202631414,4109
"15074","Zm00001d052853","4",202635306,202636943,1637
"15075","Zm00001d052854","4",202637706,202639231,1525
"15076","Zm00001d052855","4",202671658,202675792,4134
"15077","Zm00001d052856","4",202676879,202680949,4070
"15078","Zm00001d052859","4",202734381,202764655,30274
"15079","Zm00001d052860","4",202740388,202742011,1623
"15080","Zm00001d052864","4",202868717,202869526,809
"15081","Zm00001d052865","4",202871774,202875602,3828
"15082","Zm00001d052869","4",203035688,203037078,1390
"15083","Zm00001d052871","4",203084837,203085460,623
"15084","Zm00001d052872","4",203086812,203087530,718
"15085","Zm00001d052873","4",203088415,203093168,4753
"15086","Zm00001d052874","4",203093379,203094541,1162
"15087","Zm00001d052876","4",203132196,203134271,2075
"15088","Zm00001d052877","4",203188147,203189626,1479
"15089","Zm00001d052878","4",203191381,203193332,1951
"15090","Zm00001d052880","4",203195134,203209175,14041
"15091","Zm00001d052881","4",203236781,203238037,1256
"15092","Zm00001d052882","4",203237227,203240756,3529
"15093","Zm00001d052883","4",203324761,203327583,2822
"15094","Zm00001d052885","4",203405706,203407600,1894
"15095","Zm00001d052886","4",203407872,203412281,4409
"15096","Zm00001d052888","4",203494690,203511433,16743
"15097","Zm00001d052889","4",203544095,203547230,3135
"15098","Zm00001d052890","4",203611347,203615518,4171
"15099","Zm00001d052892","4",203758689,203774225,15536
"15100","Zm00001d052893","4",203852542,203856158,3616
"15101","Zm00001d052895","4",203909773,203910891,1118
"15102","Zm00001d052896","4",203986763,203987254,491
"15103","Zm00001d052901","4",204071169,204075125,3956
"15104","Zm00001d052902","4",204185325,204195660,10335
"15105","Zm00001d052903","4",204205739,204209741,4002
"15106","Zm00001d052904","4",204238907,204245663,6756
"15107","Zm00001d052905","4",204257286,204262667,5381
"15108","Zm00001d052910","4",204477980,204479339,1359
"15109","Zm00001d052911","4",204480764,204485845,5081
"15110","Zm00001d052912","4",204486535,204486879,344
"15111","Zm00001d052918","4",204769934,204773771,3837
"15112","Zm00001d052921","4",204933175,204939255,6080
"15113","Zm00001d052922","4",204942596,204947439,4843
"15114","Zm00001d052927","4",205136484,205145445,8961
"15115","Zm00001d052928","4",205227775,205231894,4119
"15116","Zm00001d052929","4",205239149,205243077,3928
"15117","Zm00001d052930","4",205243518,205248438,4920
"15118","Zm00001d052932","4",205269595,205274287,4692
"15119","Zm00001d052933","4",205274822,205277906,3084
"15120","Zm00001d052935","4",205366187,205366918,731
"15121","Zm00001d052937","4",205501809,205504770,2961
"15122","Zm00001d052938","4",205505452,205509591,4139
"15123","Zm00001d052939","4",205515247,205517845,2598
"15124","Zm00001d052941","4",205569379,205575176,5797
"15125","Zm00001d052943","4",205690232,205738686,48454
"15126","Zm00001d052944","4",205745035,205748279,3244
"15127","Zm00001d052945","4",205815603,205819193,3590
"15128","Zm00001d052946","4",205821051,205824128,3077
"15129","Zm00001d052947","4",205833914,205836511,2597
"15130","Zm00001d052948","4",205895319,205899917,4598
"15131","Zm00001d052949","4",205988263,205990716,2453
"15132","Zm00001d052950","4",206094011,206095432,1421
"15133","Zm00001d052951","4",206108330,206113498,5168
"15134","Zm00001d052952","4",206113707,206115890,2183
"15135","Zm00001d052953","4",206116499,206121004,4505
"15136","Zm00001d052955","4",206259152,206261935,2783
"15137","Zm00001d052961","4",206347511,206358362,10851
"15138","Zm00001d052962","4",206380174,206382649,2475
"15139","Zm00001d052963","4",206410616,206412587,1971
"15140","Zm00001d052964","4",206412662,206415299,2637
"15141","Zm00001d052965","4",206446171,206447418,1247
"15142","Zm00001d052967","4",206535429,206538212,2783
"15143","Zm00001d052971","4",206735622,206763689,28067
"15144","Zm00001d052972","4",206764024,206767895,3871
"15145","Zm00001d052974","4",206845955,206851313,5358
"15146","Zm00001d052977","4",206919670,206923445,3775
"15147","Zm00001d052978","4",207028261,207031432,3171
"15148","Zm00001d052979","4",207070948,207072073,1125
"15149","Zm00001d052981","4",207129314,207132225,2911
"15150","Zm00001d052983","4",207295657,207297380,1723
"15151","Zm00001d052985","4",207561707,207563124,1417
"15152","Zm00001d052987","4",207669918,207672512,2594
"15153","Zm00001d052988","4",207717951,207724249,6298
"15154","Zm00001d052989","4",207785244,207786582,1338
"15155","Zm00001d052990","4",207848210,207850413,2203
"15156","Zm00001d052991","4",207876148,207879557,3409
"15157","Zm00001d052992","4",207905668,207929332,23664
"15158","Zm00001d052993","4",207980504,207985428,4924
"15159","Zm00001d052994","4",207996235,207996755,520
"15160","Zm00001d052995","4",207996763,207997339,576
"15161","Zm00001d052996","4",207999101,208002906,3805
"15162","Zm00001d052997","4",208057520,208063839,6319
"15163","Zm00001d052998","4",208163447,208175529,12082
"15164","Zm00001d053003","4",208580901,208590962,10061
"15165","Zm00001d053004","4",208649304,208651866,2562
"15166","Zm00001d053006","4",208792099,208794207,2108
"15167","Zm00001d053009","4",208861873,208866868,4995
"15168","Zm00001d053010","4",208870548,208873085,2537
"15169","Zm00001d053011","4",208898899,208906294,7395
"15170","Zm00001d053014","4",209053063,209058856,5793
"15171","Zm00001d053016","4",209194062,209197337,3275
"15172","Zm00001d053017","4",209242258,209246990,4732
"15173","Zm00001d053018","4",209379065,209386572,7507
"15174","Zm00001d053022","4",209718384,209734577,16193
"15175","Zm00001d053024","4",209800024,209801937,1913
"15176","Zm00001d053026","4",209835802,209837190,1388
"15177","Zm00001d053028","4",209915947,209947775,31828
"15178","Zm00001d053029","4",209946031,209946122,91
"15179","Zm00001d053030","4",210038763,210053588,14825
"15180","Zm00001d053031","4",210053344,210059055,5711
"15181","Zm00001d053036","4",210072745,210076531,3786
"15182","Zm00001d053038","4",210204174,210230007,25833
"15183","Zm00001d053039","4",210211938,210212011,73
"15184","Zm00001d053041","4",210317942,210328393,10451
"15185","Zm00001d053042","4",210354523,210354873,350
"15186","Zm00001d053049","4",210622232,210626878,4646
"15187","Zm00001d053050","4",210625114,210626541,1427
"15188","Zm00001d053053","4",210921163,210924729,3566
"15189","Zm00001d053055","4",211054808,211055547,739
"15190","Zm00001d053059","4",211206048,211234555,28507
"15191","Zm00001d053060","4",211442081,211444631,2550
"15192","Zm00001d053063","4",211743675,211744787,1112
"15193","Zm00001d053064","4",211825818,211837744,11926
"15194","Zm00001d053065","4",211838548,211843655,5107
"15195","Zm00001d053066","4",211860106,211862819,2713
"15196","Zm00001d053067","4",211990615,211995460,4845
"15197","Zm00001d053068","4",212048116,212048751,635
"15198","Zm00001d053070","4",212271641,212301061,29420
"15199","Zm00001d053076","4",212544690,212574174,29484
"15200","Zm00001d053077","4",212575867,212576421,554
"15201","Zm00001d053080","4",212685412,212689787,4375
"15202","Zm00001d053081","4",212716817,212717492,675
"15203","Zm00001d053082","4",212908487,212917385,8898
"15204","Zm00001d053084","4",212998426,212999208,782
"15205","Zm00001d053086","4",213016496,213022201,5705
"15206","Zm00001d053087","4",213023215,213025176,1961
"15207","Zm00001d053090","4",213265064,213268433,3369
"15208","Zm00001d053091","4",213273271,213276371,3100
"15209","Zm00001d053092","4",213303554,213309579,6025
"15210","Zm00001d053095","4",213516014,213516612,598
"15211","Zm00001d053098","4",213555874,213556483,609
"15212","Zm00001d053099","4",213559077,213566432,7355
"15213","Zm00001d053100","4",213729522,213756192,26670
"15214","Zm00001d053101","4",213756616,213759917,3301
"15215","Zm00001d053102","4",213816113,213818258,2145
"15216","Zm00001d053103","4",213945196,213945561,365
"15217","Zm00001d053104","4",213972766,213977120,4354
"15218","Zm00001d053107","4",214129873,214132827,2954
"15219","Zm00001d053108","4",214198923,214199570,647
"15220","Zm00001d053109","4",214211925,214218577,6652
"15221","Zm00001d053112","4",214258440,214258980,540
"15222","Zm00001d053113","4",214318801,214319435,634
"15223","Zm00001d053114","4",214338164,214338629,465
"15224","Zm00001d053117","4",214448821,214449765,944
"15225","Zm00001d053118","4",214485248,214486943,1695
"15226","Zm00001d053119","4",214489373,214495402,6029
"15227","Zm00001d053120","4",214561712,214564106,2394
"15228","Zm00001d053122","4",214600465,214603009,2544
"15229","Zm00001d053123","4",214603758,214606109,2351
"15230","Zm00001d053127","4",214702095,214710403,8308
"15231","Zm00001d053128","4",214987652,214989841,2189
"15232","Zm00001d053134","4",215435670,215436816,1146
"15233","Zm00001d053138","4",215588067,215592113,4046
"15234","Zm00001d053142","4",215890554,215902303,11749
"15235","Zm00001d053143","4",215990887,215992543,1656
"15236","Zm00001d053144","4",216038534,216040340,1806
"15237","Zm00001d053146","4",216159315,216159899,584
"15238","Zm00001d053149","4",216214682,216218840,4158
"15239","Zm00001d053150","4",216311306,216317666,6360
"15240","Zm00001d053151","4",216317487,216322672,5185
"15241","Zm00001d053155","4",216733100,216760207,27107
"15242","Zm00001d053157","4",217060747,217062010,1263
"15243","Zm00001d053158","4",217089050,217091972,2922
"15244","Zm00001d053162","4",217387342,217403410,16068
"15245","Zm00001d053163","4",217428587,217430008,1421
"15246","Zm00001d053166","4",217736469,217737859,1390
"15247","Zm00001d053168","4",217742350,217753101,10751
"15248","Zm00001d053171","4",217818667,217827678,9011
"15249","Zm00001d053172","4",217828727,217832507,3780
"15250","Zm00001d053173","4",218017452,218021002,3550
"15251","Zm00001d053175","4",218265429,218267915,2486
"15252","Zm00001d053177","4",218290530,218293089,2559
"15253","Zm00001d053178","4",218338854,218340164,1310
"15254","Zm00001d053179","4",218421396,218425679,4283
"15255","Zm00001d053181","4",218555323,218556585,1262
"15256","Zm00001d053182","4",218560577,218598417,37840
"15257","Zm00001d053183","4",218603373,218605795,2422
"15258","Zm00001d053184","4",218710756,218715755,4999
"15259","Zm00001d053186","4",218848501,218848974,473
"15260","Zm00001d053187","4",218888590,218889166,576
"15261","Zm00001d053188","4",218975864,218976193,329
"15262","Zm00001d053189","4",218977061,218981425,4364
"15263","Zm00001d053191","4",219105146,219109779,4633
"15264","Zm00001d053196","4",219324704,219347025,22321
"15265","Zm00001d053197","4",219370679,219377038,6359
"15266","Zm00001d053199","4",219485792,219490670,4878
"15267","Zm00001d053200","4",219495567,219513312,17745
"15268","Zm00001d053202","4",219687772,219690119,2347
"15269","Zm00001d053206","4",219890775,219894865,4090
"15270","Zm00001d053207","4",219937359,219942038,4679
"15271","Zm00001d053208","4",220087908,220093065,5157
"15272","Zm00001d053210","4",220292682,220295236,2554
"15273","Zm00001d053211","4",220339203,220343300,4097
"15274","Zm00001d053212","4",220417152,220419734,2582
"15275","Zm00001d053213","4",220420178,220420600,422
"15276","Zm00001d053215","4",220475424,220477483,2059
"15277","Zm00001d053216","4",220543718,220544782,1064
"15278","Zm00001d053217","4",220620484,220622928,2444
"15279","Zm00001d053221","4",220726001,220728839,2838
"15280","Zm00001d053223","4",220786140,220792268,6128
"15281","Zm00001d053225","4",220840800,220845933,5133
"15282","Zm00001d053228","4",220896827,220899845,3018
"15283","Zm00001d053229","4",220932421,220932795,374
"15284","Zm00001d053230","4",220986655,220987053,398
"15285","Zm00001d053232","4",221137227,221144081,6854
"15286","Zm00001d053233","4",221199877,221210480,10603
"15287","Zm00001d053234","4",221211009,221213468,2459
"15288","Zm00001d053236","4",221553758,221555439,1681
"15289","Zm00001d053239","4",221656653,221658921,2268
"15290","Zm00001d053240","4",221660755,221661906,1151
"15291","Zm00001d053241","4",221662490,221663213,723
"15292","Zm00001d053244","4",221728680,221731688,3008
"15293","Zm00001d053245","4",221815416,221833216,17800
"15294","Zm00001d053247","4",222077006,222089641,12635
"15295","Zm00001d053250","4",222238222,222241030,2808
"15296","Zm00001d053251","4",222300066,222320233,20167
"15297","Zm00001d053252","4",222450297,222458066,7769
"15298","Zm00001d053254","4",222507686,222510091,2405
"15299","Zm00001d053259","4",222860694,222874686,13992
"15300","Zm00001d053260","4",222931270,222948448,17178
"15301","Zm00001d053261","4",222940168,222942575,2407
"15302","Zm00001d053262","4",222969266,223050007,80741
"15303","Zm00001d053263","4",223175098,223178174,3076
"15304","Zm00001d053265","4",223186357,223201475,15118
"15305","Zm00001d053266","4",223202079,223203844,1765
"15306","Zm00001d053268","4",223286478,223317315,30837
"15307","Zm00001d053269","4",223338980,223340903,1923
"15308","Zm00001d053272","4",223440058,223443279,3221
"15309","Zm00001d053273","4",223581945,223588791,6846
"15310","Zm00001d053275","4",223795615,223808189,12574
"15311","Zm00001d053280","4",223890925,223892216,1291
"15312","Zm00001d053281","4",223892837,223896295,3458
"15313","Zm00001d053282","4",223911515,223915010,3495
"15314","Zm00001d053283","4",223933580,223937015,3435
"15315","Zm00001d053284","4",224035603,224051363,15760
"15316","Zm00001d053286","4",224096212,224115964,19752
"15317","Zm00001d053287","4",224264606,224270559,5953
"15318","Zm00001d053288","4",224314851,224315663,812
"15319","Zm00001d053289","4",224316801,224320722,3921
"15320","Zm00001d053290","4",224374428,224381560,7132
"15321","Zm00001d053293","4",224621867,224623388,1521
"15322","Zm00001d053295","4",224781307,224784094,2787
"15323","Zm00001d053296","4",224801163,224804512,3349
"15324","Zm00001d053298","4",224897414,224899075,1661
"15325","Zm00001d053300","4",224942731,224952442,9711
"15326","Zm00001d053301","4",225026663,225038512,11849
"15327","Zm00001d053305","4",225237362,225240230,2868
"15328","Zm00001d053306","4",225241915,225255002,13087
"15329","Zm00001d053308","4",225414701,225429993,15292
"15330","Zm00001d053309","4",225422067,225424845,2778
"15331","Zm00001d053313","4",225615375,225638309,22934
"15332","Zm00001d053314","4",225654474,225657529,3055
"15333","Zm00001d053315","4",225842256,225842618,362
"15334","Zm00001d053316","4",225850593,225868212,17619
"15335","Zm00001d053322","4",226105246,226107297,2051
"15336","Zm00001d053328","4",226362367,226363218,851
"15337","Zm00001d053329","4",226395349,226396012,663
"15338","Zm00001d053331","4",226420587,226421326,739
"15339","Zm00001d053332","4",226437139,226437806,667
"15340","Zm00001d053333","4",226564818,226576452,11634
"15341","Zm00001d053334","4",226583266,226590664,7398
"15342","Zm00001d053342","4",226826897,226831036,4139
"15343","Zm00001d053345","4",227003445,227017484,14039
"15344","Zm00001d053346","4",227036350,227036721,371
"15345","Zm00001d053348","4",227078338,227081827,3489
"15346","Zm00001d053350","4",227153210,227164438,11228
"15347","Zm00001d053351","4",227178840,227181299,2459
"15348","Zm00001d053352","4",227182919,227183827,908
"15349","Zm00001d053353","4",227250804,227252883,2079
"15350","Zm00001d053354","4",227321023,227336942,15919
"15351","Zm00001d053356","4",227420839,227426796,5957
"15352","Zm00001d053358","4",227482692,227483909,1217
"15353","Zm00001d053359","4",227597483,227599681,2198
"15354","Zm00001d053360","4",227599786,227600895,1109
"15355","Zm00001d053367","4",227757287,227761033,3746
"15356","Zm00001d053369","4",227812359,227814181,1822
"15357","Zm00001d053371","4",227975997,227984197,8200
"15358","Zm00001d053372","4",228098294,228104444,6150
"15359","Zm00001d053374","4",228206043,228208659,2616
"15360","Zm00001d053375","4",228266069,228269806,3737
"15361","Zm00001d053376","4",228362986,228367005,4019
"15362","Zm00001d053377","4",228374544,228378081,3537
"15363","Zm00001d053378","4",228397961,228399787,1826
"15364","Zm00001d053379","4",228494907,228499700,4793
"15365","Zm00001d053382","4",228563709,228568890,5181
"15366","Zm00001d053384","4",228801769,228804957,3188
"15367","Zm00001d053386","4",228807825,228811030,3205
"15368","Zm00001d053394","4",229142099,229143133,1034
"15369","Zm00001d053395","4",229171718,229174509,2791
"15370","Zm00001d053396","4",229215684,229219292,3608
"15371","Zm00001d053397","4",229276261,229284755,8494
"15372","Zm00001d053398","4",229316921,229322898,5977
"15373","Zm00001d053399","4",229326856,229336149,9293
"15374","Zm00001d053401","4",230194894,230205389,10495
"15375","Zm00001d053403","4",230382808,230384485,1677
"15376","Zm00001d053404","4",230456902,230474482,17580
"15377","Zm00001d053405","4",230484237,230484310,73
"15378","Zm00001d053406","4",230521921,230522307,386
"15379","Zm00001d053409","4",230626155,230634841,8686
"15380","Zm00001d053412","4",230692649,230697870,5221
"15381","Zm00001d053416","4",230820849,230823728,2879
"15382","Zm00001d053417","4",230829447,230829518,71
"15383","Zm00001d053419","4",230847625,230847696,71
"15384","Zm00001d053421","4",230850821,230850892,71
"15385","Zm00001d053423","4",230877342,230878205,863
"15386","Zm00001d053425","4",230958229,230961825,3596
"15387","Zm00001d053427","4",230972493,230978467,5974
"15388","Zm00001d053431","4",231124120,231132890,8770
"15389","Zm00001d053432","4",231193933,231195575,1642
"15390","Zm00001d053438","4",231449438,231452036,2598
"15391","Zm00001d053442","4",231582689,231584787,2098
"15392","Zm00001d053444","4",231765421,231770451,5030
"15393","Zm00001d053446","4",231900509,231904788,4279
"15394","Zm00001d053447","4",231905997,231909123,3126
"15395","Zm00001d053448","4",231999507,232004462,4955
"15396","Zm00001d053450","4",232067299,232077638,10339
"15397","Zm00001d053452","4",232176354,232182440,6086
"15398","Zm00001d053453","4",232245967,232253821,7854
"15399","Zm00001d053513","4",232561161,232562672,1511
"15400","Zm00001d053515","4",232669790,232729100,59310
"15401","Zm00001d053518","4",232854573,232857488,2915
"15402","Zm00001d053519","4",232883169,232885409,2240
"15403","Zm00001d053521","4",232902680,232925350,22670
"15404","Zm00001d053522","4",232990810,232991886,1076
"15405","Zm00001d053523","4",232995548,232998598,3050
"15406","Zm00001d053524","4",233018950,233022916,3966
"15407","Zm00001d053525","4",233023783,233024650,867
"15408","Zm00001d053526","4",233099607,233100023,416
"15409","Zm00001d053528","4",233126072,233126482,410
"15410","Zm00001d053530","4",233157430,233157855,425
"15411","Zm00001d053531","4",233184870,233185317,447
"15412","Zm00001d053532","4",233189143,233192918,3775
"15413","Zm00001d053534","4",233252865,233253284,419
"15414","Zm00001d053538","4",233331462,233331872,410
"15415","Zm00001d053539","4",233364868,233366082,1214
"15416","Zm00001d053541","4",233438443,233443072,4629
"15417","Zm00001d053542","4",233511988,233522943,10955
"15418","Zm00001d053543","4",233528735,233529987,1252
"15419","Zm00001d053544","4",233597108,233599306,2198
"15420","Zm00001d053545","4",233601699,233611100,9401
"15421","Zm00001d053547","4",233618739,233621527,2788
"15422","Zm00001d053548","4",233637127,233642207,5080
"15423","Zm00001d053552","4",233795513,233798629,3116
"15424","Zm00001d053553","4",233807693,233818548,10855
"15425","Zm00001d053555","4",233903498,233911308,7810
"15426","Zm00001d053556","4",233911426,233914642,3216
"15427","Zm00001d053557","4",233941031,233941850,819
"15428","Zm00001d053558","4",234052510,234054315,1805
"15429","Zm00001d053559","4",234082150,234089274,7124
"15430","Zm00001d053560","4",234188219,234192183,3964
"15431","Zm00001d053561","4",234194672,234201038,6366
"15432","Zm00001d053562","4",234332132,234333448,1316
"15433","Zm00001d053563","4",234357519,234361884,4365
"15434","Zm00001d053564","4",234422924,234429170,6246
"15435","Zm00001d053565","4",234504377,234514028,9651
"15436","Zm00001d053566","4",234540871,234543612,2741
"15437","Zm00001d053572","4",234902783,234907567,4784
"15438","Zm00001d053575","4",234970571,234980633,10062
"15439","Zm00001d053576","4",235104770,235108555,3785
"15440","Zm00001d053580","4",235225983,235235156,9173
"15441","Zm00001d053581","4",235232984,235233628,644
"15442","Zm00001d053582","4",235339074,235344833,5759
"15443","Zm00001d053585","4",235371631,235376042,4411
"15444","Zm00001d053587","4",235506533,235510751,4218
"15445","Zm00001d053588","4",235516296,235520305,4009
"15446","Zm00001d053589","4",235580791,235593799,13008
"15447","Zm00001d053591","4",235612471,235617126,4655
"15448","Zm00001d053593","4",235759774,235760235,461
"15449","Zm00001d053594","4",235781411,235784209,2798
"15450","Zm00001d053595","4",235825666,235832657,6991
"15451","Zm00001d053599","4",235959812,235961740,1928
"15452","Zm00001d053600","4",235974581,235975690,1109
"15453","Zm00001d053603","4",236105402,236116126,10724
"15454","Zm00001d053604","4",236138479,236139918,1439
"15455","Zm00001d053608","4",236219515,236220535,1020
"15456","Zm00001d053609","4",236276719,236286959,10240
"15457","Zm00001d053610","4",236302759,236309429,6670
"15458","Zm00001d053611","4",236401648,236414481,12833
"15459","Zm00001d053612","4",236474079,236481803,7724
"15460","Zm00001d053613","4",236483017,236493152,10135
"15461","Zm00001d053616","4",236545424,236550919,5495
"15462","Zm00001d053617","4",236577171,236580231,3060
"15463","Zm00001d053620","4",236807529,236818076,10547
"15464","Zm00001d053622","4",236999463,237006338,6875
"15465","Zm00001d053623","4",237045122,237049187,4065
"15466","Zm00001d053624","4",237051179,237059836,8657
"15467","Zm00001d053625","4",237083050,237084813,1763
"15468","Zm00001d053626","4",237108971,237110604,1633
"15469","Zm00001d053627","4",237217927,237222627,4700
"15470","Zm00001d053628","4",237227892,237245986,18094
"15471","Zm00001d053630","4",237401529,237403959,2430
"15472","Zm00001d053631","4",237406007,237408981,2974
"15473","Zm00001d053632","4",237551123,237553636,2513
"15474","Zm00001d053633","4",237652430,237654962,2532
"15475","Zm00001d053634","4",237749322,237752017,2695
"15476","Zm00001d053635","4",237827704,237830052,2348
"15477","Zm00001d053636","4",237928384,237930905,2521
"15478","Zm00001d053639","4",238009255,238010118,863
"15479","Zm00001d053640","4",238064255,238068266,4011
"15480","Zm00001d053641","4",238085130,238087584,2454
"15481","Zm00001d053642","4",238091051,238094140,3089
"15482","Zm00001d053643","4",238099957,238103666,3709
"15483","Zm00001d053648","4",238153226,238159523,6297
"15484","Zm00001d053649","4",238178510,238183266,4756
"15485","Zm00001d053650","4",238222901,238224184,1283
"15486","Zm00001d053655","4",238257756,238259787,2031
"15487","Zm00001d053656","4",238261328,238261819,491
"15488","Zm00001d053657","4",238263508,238269634,6126
"15489","Zm00001d053658","4",238273707,238279967,6260
"15490","Zm00001d053659","4",238361212,238365340,4128
"15491","Zm00001d053660","4",238366195,238369060,2865
"15492","Zm00001d053661","4",238372013,238372712,699
"15493","Zm00001d053662","4",238375990,238382185,6195
"15494","Zm00001d053664","4",238418653,238426106,7453
"15495","Zm00001d053665","4",238450073,238455388,5315
"15496","Zm00001d053667","4",238496402,238499951,3549
"15497","Zm00001d053671","4",238612589,238613017,428
"15498","Zm00001d053672","4",238614444,238621452,7008
"15499","Zm00001d053674","4",238699493,238722387,22894
"15500","Zm00001d053675","4",238805319,238809230,3911
"15501","Zm00001d053676","4",238814470,238849085,34615
"15502","Zm00001d053678","4",238898500,238900342,1842
"15503","Zm00001d053680","4",238937667,238941680,4013
"15504","Zm00001d053682","4",238942996,238945802,2806
"15505","Zm00001d053684","4",238977831,238989000,11169
"15506","Zm00001d053685","4",239005570,239012726,7156
"15507","Zm00001d053686","4",239029245,239032219,2974
"15508","Zm00001d053687","4",239036651,239041066,4415
"15509","Zm00001d053688","4",239044809,239054055,9246
"15510","Zm00001d053694","4",239185830,239186700,870
"15511","Zm00001d053695","4",239190056,239192283,2227
"15512","Zm00001d053696","4",239308529,239315649,7120
"15513","Zm00001d053697","4",239382347,239406395,24048
"15514","Zm00001d053698","4",239526556,239537752,11196
"15515","Zm00001d053699","4",239540604,239540843,239
"15516","Zm00001d053702","4",239551734,239557534,5800
"15517","Zm00001d053703","4",239596872,239597402,530
"15518","Zm00001d053704","4",239601161,239602231,1070
"15519","Zm00001d053705","4",239603849,239605741,1892
"15520","Zm00001d053706","4",239617826,239627509,9683
"15521","Zm00001d053707","4",239645670,239646296,626
"15522","Zm00001d053709","4",239664547,239667110,2563
"15523","Zm00001d053713","4",239697573,239699575,2002
"15524","Zm00001d053715","4",239764267,239765769,1502
"15525","Zm00001d053716","4",239767587,239770836,3249
"15526","Zm00001d053718","4",239807329,239820801,13472
"15527","Zm00001d053719","4",239822270,239826055,3785
"15528","Zm00001d053722","4",239849713,239853306,3593
"15529","Zm00001d053724","4",239880295,239882266,1971
"15530","Zm00001d053725","4",239886491,239899381,12890
"15531","Zm00001d053726","4",239913835,239917002,3167
"15532","Zm00001d053727","4",239922850,239929510,6660
"15533","Zm00001d053728","4",239931355,239934020,2665
"15534","Zm00001d053729","4",240003935,240004372,437
"15535","Zm00001d053731","4",240024809,240026803,1994
"15536","Zm00001d053732","4",240026737,240030496,3759
"15537","Zm00001d053733","4",240031712,240032737,1025
"15538","Zm00001d053734","4",240034739,240035311,572
"15539","Zm00001d053735","4",240040925,240048316,7391
"15540","Zm00001d053738","4",240108049,240115362,7313
"15541","Zm00001d053739","4",240117939,240121912,3973
"15542","Zm00001d053740","4",240122896,240124863,1967
"15543","Zm00001d053741","4",240158918,240164128,5210
"15544","Zm00001d053742","4",240210328,240213810,3482
"15545","Zm00001d053743","4",240292897,240297013,4116
"15546","Zm00001d053746","4",240330758,240332367,1609
"15547","Zm00001d053747","4",240384798,240389879,5081
"15548","Zm00001d053748","4",240407321,240410509,3188
"15549","Zm00001d053749","4",240414100,240417560,3460
"15550","Zm00001d053750","4",240418305,240418613,308
"15551","Zm00001d053751","4",240442253,240456485,14232
"15552","Zm00001d053753","4",240492305,240500796,8491
"15553","Zm00001d053754","4",240517367,240520135,2768
"15554","Zm00001d053759","4",240555075,240556819,1744
"15555","Zm00001d053760","4",240617821,240619006,1185
"15556","Zm00001d053761","4",240633406,240644815,11409
"15557","Zm00001d053762","4",240649680,240653939,4259
"15558","Zm00001d053763","4",240654631,240663764,9133
"15559","Zm00001d053764","4",240670090,240670898,808
"15560","Zm00001d053765","4",240696980,240703366,6386
"15561","Zm00001d053767","4",240714911,240718427,3516
"15562","Zm00001d053770","4",240808236,240810658,2422
"15563","Zm00001d053772","4",240821769,240823832,2063
"15564","Zm00001d053775","4",240849637,240853547,3910
"15565","Zm00001d053776","4",240858680,240875478,16798
"15566","Zm00001d053778","4",240939248,240942799,3551
"15567","Zm00001d053782","4",240980104,240984661,4557
"15568","Zm00001d053783","4",240989903,240995095,5192
"15569","Zm00001d053784","4",240998127,240999016,889
"15570","Zm00001d053785","4",241014851,241015599,748
"15571","Zm00001d053786","4",241016863,241020231,3368
"15572","Zm00001d053788","4",241098990,241099587,597
"15573","Zm00001d053792","4",241158773,241159221,448
"15574","Zm00001d053797","4",241315568,241316226,658
"15575","Zm00001d053798","4",241317348,241322396,5048
"15576","Zm00001d053799","4",241325593,241338982,13389
"15577","Zm00001d053800","4",241341720,241343521,1801
"15578","Zm00001d053801","4",241344798,241348496,3698
"15579","Zm00001d053802","4",241403906,241405327,1421
"15580","Zm00001d053803","4",241416859,241440702,23843
"15581","Zm00001d053805","4",241441900,241443616,1716
"15582","Zm00001d053807","4",241453021,241456437,3416
"15583","Zm00001d053808","4",241457479,241460882,3403
"15584","Zm00001d053809","4",241467379,241469250,1871
"15585","Zm00001d053810","4",241470455,241478524,8069
"15586","Zm00001d053813","4",241592153,241604223,12070
"15587","Zm00001d053816","4",241615198,241618538,3340
"15588","Zm00001d053818","4",241643895,241648565,4670
"15589","Zm00001d053819","4",241710056,241716042,5986
"15590","Zm00001d053822","4",241795748,241799360,3612
"15591","Zm00001d053824","4",241806773,241807078,305
"15592","Zm00001d053825","4",241807558,241811083,3525
"15593","Zm00001d053826","4",241891771,241932626,40855
"15594","Zm00001d053827","4",241938610,241946692,8082
"15595","Zm00001d053828","4",241949508,241950525,1017
"15596","Zm00001d053831","4",241982040,241984774,2734
"15597","Zm00001d053832","4",242004150,242006948,2798
"15598","Zm00001d053834","4",242111156,242114341,3185
"15599","Zm00001d053835","4",242115475,242116610,1135
"15600","Zm00001d053838","4",242132524,242136885,4361
"15601","Zm00001d053839","4",242139070,242141067,1997
"15602","Zm00001d053841","4",242143111,242149682,6571
"15603","Zm00001d053843","4",242157651,242157947,296
"15604","Zm00001d053844","4",242160117,242160434,317
"15605","Zm00001d053848","4",242177398,242180739,3341
"15606","Zm00001d053851","4",242207541,242208121,580
"15607","Zm00001d053852","4",242208559,242212798,4239
"15608","Zm00001d053853","4",242214223,242216703,2480
"15609","Zm00001d053855","4",242281659,242285564,3905
"15610","Zm00001d053856","4",242285614,242288863,3249
"15611","Zm00001d053857","4",242293269,242298482,5213
"15612","Zm00001d053858","4",242390665,242395306,4641
"15613","Zm00001d053859","4",242396086,242396676,590
"15614","Zm00001d053861","4",242512382,242522531,10149
"15615","Zm00001d053862","4",242512732,242523643,10911
"15616","Zm00001d053863","4",242524003,242526153,2150
"15617","Zm00001d053865","4",242558034,242564564,6530
"15618","Zm00001d053867","4",242568084,242571603,3519
"15619","Zm00001d053870","4",242621418,242623305,1887
"15620","Zm00001d053872","4",242631115,242643653,12538
"15621","Zm00001d053873","4",242643886,242649671,5785
"15622","Zm00001d053874","4",242693585,242697891,4306
"15623","Zm00001d053875","4",242702075,242707311,5236
"15624","Zm00001d053876","4",242707529,242711404,3875
"15625","Zm00001d053881","4",242880578,242889256,8678
"15626","Zm00001d053882","4",242948908,242952750,3842
"15627","Zm00001d053883","4",242953208,242954479,1271
"15628","Zm00001d053884","4",242957976,242958374,398
"15629","Zm00001d053885","4",242962955,242966398,3443
"15630","Zm00001d053886","4",242972197,242981389,9192
"15631","Zm00001d053887","4",242981995,242982564,569
"15632","Zm00001d053888","4",243030348,243034085,3737
"15633","Zm00001d053889","4",243042533,243050543,8010
"15634","Zm00001d053890","4",243050411,243053629,3218
"15635","Zm00001d053891","4",243143280,243151346,8066
"15636","Zm00001d053894","4",243184586,243227697,43111
"15637","Zm00001d053895","4",243230105,243233634,3529
"15638","Zm00001d053897","4",243335691,243336832,1141
"15639","Zm00001d053899","4",243343911,243347704,3793
"15640","Zm00001d053900","4",243349088,243352645,3557
"15641","Zm00001d053901","4",243354098,243358656,4558
"15642","Zm00001d053902","4",243363296,243364260,964
"15643","Zm00001d053903","4",243365264,243368551,3287
"15644","Zm00001d053904","4",243370767,243373481,2714
"15645","Zm00001d053906","4",243382173,243392450,10277
"15646","Zm00001d053908","4",243422436,243423185,749
"15647","Zm00001d053909","4",243464108,243468711,4603
"15648","Zm00001d053911","4",243523053,243529919,6866
"15649","Zm00001d053912","4",243585590,243589716,4126
"15650","Zm00001d053913","4",243607475,243612187,4712
"15651","Zm00001d053914","4",243619946,243620230,284
"15652","Zm00001d053917","4",243631001,243639724,8723
"15653","Zm00001d053918","4",243641011,243642284,1273
"15654","Zm00001d053919","4",243647953,243651842,3889
"15655","Zm00001d053923","4",243656212,243665866,9654
"15656","Zm00001d053924","4",243678500,243679356,856
"15657","Zm00001d053925","4",243689888,243690757,869
"15658","Zm00001d053926","4",243692664,243693167,503
"15659","Zm00001d053927","4",243694661,243710688,16027
"15660","Zm00001d053928","4",243712603,243720508,7905
"15661","Zm00001d053930","4",243754727,243759497,4770
"15662","Zm00001d053931","4",243761987,243766788,4801
"15663","Zm00001d053932","4",243768090,243771031,2941
"15664","Zm00001d053935","4",243872583,243882769,10186
"15665","Zm00001d053936","4",243883854,243885686,1832
"15666","Zm00001d053938","4",243885929,243886813,884
"15667","Zm00001d053939","4",243889035,243890221,1186
"15668","Zm00001d053952","4",244166895,244169117,2222
"15669","Zm00001d053953","4",244172415,244173660,1245
"15670","Zm00001d053954","4",244173564,244185255,11691
"15671","Zm00001d053955","4",244179086,244182250,3164
"15672","Zm00001d053957","4",244191142,244196175,5033
"15673","Zm00001d053960","4",244300872,244304783,3911
"15674","Zm00001d053961","4",244355937,244357746,1809
"15675","Zm00001d053962","4",244374970,244377279,2309
"15676","Zm00001d053963","4",244377983,244382136,4153
"15677","Zm00001d053964","4",244385754,244388332,2578
"15678","Zm00001d053965","4",244409108,244409662,554
"15679","Zm00001d053966","4",244410784,244413920,3136
"15680","Zm00001d053967","4",244414417,244418397,3980
"15681","Zm00001d053968","4",244419437,244425157,5720
"15682","Zm00001d053969","4",244427064,244433697,6633
"15683","Zm00001d053972","4",244497283,244500068,2785
"15684","Zm00001d053974","4",244500837,244504634,3797
"15685","Zm00001d053975","4",244506167,244518266,12099
"15686","Zm00001d053976","4",244546944,244550190,3246
"15687","Zm00001d053977","4",244550392,244554499,4107
"15688","Zm00001d053978","4",244554823,244557117,2294
"15689","Zm00001d053979","4",244557959,244560095,2136
"15690","Zm00001d053980","4",244560276,244565801,5525
"15691","Zm00001d053981","4",244568059,244571526,3467
"15692","Zm00001d053983","4",244581797,244585737,3940
"15693","Zm00001d053984","4",244585903,244597338,11435
"15694","Zm00001d053985","4",244597367,244601788,4421
"15695","Zm00001d053986","4",244603430,244608318,4888
"15696","Zm00001d053987","4",244609336,244612754,3418
"15697","Zm00001d053988","4",244691517,244692145,628
"15698","Zm00001d053989","4",244755447,244765434,9987
"15699","Zm00001d053991","4",244778206,244778835,629
"15700","Zm00001d053993","4",244794743,244798364,3621
"15701","Zm00001d053994","4",244798741,244803302,4561
"15702","Zm00001d053995","4",244812184,244812993,809
"15703","Zm00001d053996","4",244816657,244819588,2931
"15704","Zm00001d053997","4",244821758,244829813,8055
"15705","Zm00001d053998","4",244830012,244833977,3965
"15706","Zm00001d054000","4",244877193,244879409,2216
"15707","Zm00001d054001","4",244881871,244901087,19216
"15708","Zm00001d054002","4",244902407,244906004,3597
"15709","Zm00001d054003","4",244908292,244921759,13467
"15710","Zm00001d054004","4",245028338,245031545,3207
"15711","Zm00001d054005","4",245031731,245044871,13140
"15712","Zm00001d054006","4",245045258,245045943,685
"15713","Zm00001d054008","4",245047656,245055438,7782
"15714","Zm00001d054009","4",245084211,245085341,1130
"15715","Zm00001d054010","4",245086289,245088507,2218
"15716","Zm00001d054011","4",245090218,245095937,5719
"15717","Zm00001d054012","4",245105914,245109405,3491
"15718","Zm00001d054013","4",245162166,245166098,3932
"15719","Zm00001d054014","4",245166573,245170425,3852
"15720","Zm00001d054015","4",245185866,245187341,1475
"15721","Zm00001d054016","4",245187634,245193207,5573
"15722","Zm00001d054017","4",245195523,245206342,10819
"15723","Zm00001d054018","4",245214753,245221247,6494
"15724","Zm00001d054031","4",245306140,245316755,10615
"15725","Zm00001d054032","4",245343872,245345462,1590
"15726","Zm00001d054033","4",245347415,245348407,992
"15727","Zm00001d054034","4",245348907,245352015,3108
"15728","Zm00001d054037","4",245438586,245441410,2824
"15729","Zm00001d054038","4",245455205,245458068,2863
"15730","Zm00001d054039","4",245458106,245461203,3097
"15731","Zm00001d054042","4",245465214,245468061,2847
"15732","Zm00001d054043","4",245469383,245473221,3838
"15733","Zm00001d054044","4",245523681,245525759,2078
"15734","Zm00001d054046","4",245531842,245532369,527
"15735","Zm00001d054047","4",245533965,245537220,3255
"15736","Zm00001d054049","4",245578689,245583665,4976
"15737","Zm00001d054050","4",245580869,245585798,4929
"15738","Zm00001d054051","4",245588906,245599941,11035
"15739","Zm00001d054052","4",245603675,245608917,5242
"15740","Zm00001d054054","4",245624694,245630094,5400
"15741","Zm00001d054056","4",245635496,245637121,1625
"15742","Zm00001d054060","4",245649222,245650796,1574
"15743","Zm00001d054065","4",245794577,245796505,1928
"15744","Zm00001d054066","4",245798564,245800978,2414
"15745","Zm00001d054067","4",245806161,245807669,1508
"15746","Zm00001d054069","4",245857045,245859477,2432
"15747","Zm00001d054070","4",245864833,245876851,12018
"15748","Zm00001d054071","4",245923058,245924965,1907
"15749","Zm00001d054072","4",245924924,245928505,3581
"15750","Zm00001d054075","4",245956890,245959339,2449
"15751","Zm00001d054076","4",245959882,245967187,7305
"15752","Zm00001d054077","4",245967720,245970243,2523
"15753","Zm00001d054078","4",245970675,245974001,3326
"15754","Zm00001d054079","4",245974145,245978028,3883
"15755","Zm00001d054080","4",246034945,246038140,3195
"15756","Zm00001d054084","4",246124963,246127627,2664
"15757","Zm00001d054085","4",246129578,246131408,1830
"15758","Zm00001d054088","4",246271622,246276744,5122
"15759","Zm00001d054089","4",246276749,246281182,4433
"15760","Zm00001d054090","4",246281442,246286803,5361
"15761","Zm00001d054093","4",246371114,246375126,4012
"15762","Zm00001d054094","4",246376639,246377577,938
"15763","Zm00001d054095","4",246377520,246379135,1615
"15764","Zm00001d054104","4",246521633,246556919,35286
"15765","Zm00001d054105","4",246607951,246614423,6472
"15766","Zm00001d054106","4",246775383,246780965,5582
"15767","Zm00001d054107","4",246781157,246784724,3567
"15768","Zm00001d054110","4",246820417,246848272,27855
"15769","Zm00001d054111","4",246927028,246933038,6010
"15770","Zm00001d054112","4",246942997,246943782,785
"15771","zma-MIR156b","3",6928278,6928401,123
"15772","zma-MIR156d","5",94725847,94725965,118
"15773","zma-MIR156e","2",33005026,33005151,125
"15774","zma-MIR156j","7",134663764,134663888,124
"15775","zma-MIR159a","8",10753073,10753318,245
"15776","zma-MIR159b","8",10950933,10951153,220
"15777","zma-MIR159f","3",25007834,25008048,214
"15778","zma-MIR159g","8",10912332,10912583,251
"15779","zma-MIR159h","8",10885935,10886134,199
"15780","zma-MIR159j","8",10920901,10921152,251
"15781","zma-MIR159k","8",10947058,10947257,199
"15782","zma-MIR160b","5",44296768,44296888,120
"15783","zma-MIR160d","1",288700634,288700775,141
"15784","zma-MIR164b","6",145727415,145727542,127
"15785","zma-MIR164c","6",157477837,157478106,269
"15786","zma-MIR166a","6",87381728,87381940,212
"15787","zma-MIR166c","4",153858453,153858544,91
"15788","zma-MIR166d","5",22443534,22443637,103
"15789","zma-MIR167a","3",119392621,119392810,189
"15790","zma-MIR167b","5",7976369,7976495,126
"15791","zma-MIR167d","1",292918639,292918771,132
"15792","zma-MIR167e","7",10115799,10115917,118
"15793","zma-MIR167g","3",119394584,119394826,242
"15794","zma-MIR167h","6",95985872,95986014,142
"15795","zma-MIR167j","1",12791799,12791907,108
"15796","zma-MIR168a","5",76534928,76535031,103
"15797","zma-MIR168b","4",244520636,244520739,103
"15798","zma-MIR169c","2",11553338,11553471,133
"15799","zma-MIR169e","4",49625356,49625483,127
"15800","zma-MIR169h","4",49625355,49625482,127
"15801","zma-MIR169j","2",198435908,198436058,150
"15802","zma-MIR171e","1",7976712,7976837,125
"15803","zma-MIR171f","5",8896283,8896437,154
"15804","zma-MIR171m","5",20785928,20786009,81
"15805","zma-MIR172e","3",145801592,145801765,173
"15806","zma-MIR2118c","10",118813614,118813746,132
"15807","zma-MIR319a","3",215788718,215788926,208
"15808","zma-MIR319c","8",152709450,152709665,215
"15809","zma-MIR319d","8",27608247,27608458,211
"15810","zma-MIR393a","2",738724,738849,125
"15811","zma-MIR394b","4",157728375,157728496,121
"15812","zma-MIR396a","4",176326883,176327019,136
"15813","zma-MIR396b","9",15122740,15122875,135
"15814","zma-MIR396e","4",176331864,176332029,165
"15815","zma-MIR396g","5",220222148,220222261,113
"15816","zma-MIR396h","9",15122758,15122881,123
"15817","zma-MIR397b","5",84610591,84610674,83
"15818","zma-MIR398a","2",174319898,174320037,139
"15819","zma-MIR399a","4",233617206,233617328,122
"15820","zma-MIR408b","8",39583938,39584084,146
"15821","zma-MIR528a","1",6412284,6412406,122
"15822","zma-MIR528b","9",156643654,156643731,77
